Poker Hand #RC2078594599: Hold'em No Limit ($0.02/$0.05) - 2023/12/22 22:13:26
Table 'RushAndCash811114' 6-max Seat #1 is the button
Seat 1: Hero ($5.64 in chips)
Seat 2: 8a87948c ($5 in chips)
Seat 3: 6ff1e240 ($6.25 in chips)
Seat 4: c4ea81a5 ($1.82 in chips)
Seat 5: d7f451d5 ($10.44 in chips)
Seat 6: d79b0c6a ($5.18 in chips)
8a87948c: posts small blind $0.02
6ff1e240: posts big blind $0.05
*** HOLE CARDS ***
Dealt to Hero [3h Tc]
Dealt to 8a87948c 
Dealt to 6ff1e240 
Dealt to c4ea81a5 
Dealt to d7f451d5 
Dealt to d79b0c6a 
c4ea81a5: raises $0.1 to $0.15
d7f451d5: folds
d79b0c6a: folds
Hero: folds
8a87948c: folds
6ff1e240: folds
Uncalled bet ($0.1) returned to c4ea81a5
*** SHOWDOWN ***
c4ea81a5 collected $0.12 from pot
*** SUMMARY ***
Total pot $0.12 | Rake $0 | Jackpot $0 | Bingo $0 | Fortune $0 | Tax $0
Seat 1: Hero (button) folded before Flop (didn't bet)
Seat 2: 8a87948c (small blind) folded before Flop
Seat 3: 6ff1e240 (big blind) folded before Flop
Seat 4: c4ea81a5 collected ($0.12)
Seat 5: d7f451d5 folded before Flop (didn't bet)
Seat 6: d79b0c6a folded before Flop (didn't bet)


Poker Hand #RC2078594536: Hold'em No Limit ($0.02/$0.05) - 2023/12/22 22:13:22
Table 'RushAndCash811086' 6-max Seat #1 is the button
Seat 1: c4ea81a5 ($1.82 in chips)
Seat 2: 7cbe470f ($5.4 in chips)
Seat 3: 8e806d22 ($5.07 in chips)
Seat 4: eb4aaed4 ($5 in chips)
Seat 5: Hero ($5.64 in chips)
Seat 6: fab544c8 ($9 in chips)
7cbe470f: posts small blind $0.02
8e806d22: posts big blind $0.05
*** HOLE CARDS ***
Dealt to c4ea81a5 
Dealt to 7cbe470f 
Dealt to 8e806d22 
Dealt to eb4aaed4 
Dealt to Hero [6h Kd]
Dealt to fab544c8 
eb4aaed4: folds
Hero: folds
fab544c8: folds
c4ea81a5: folds
7cbe470f: raises $0.1 to $0.15
8e806d22: calls $0.1
*** FLOP *** [Jh Qd Ks]
7cbe470f: checks
8e806d22: checks
*** TURN *** [Jh Qd Ks] [3c]
7cbe470f: checks
8e806d22: bets $0.23
7cbe470f: folds
Uncalled bet ($0.23) returned to 8e806d22
*** SHOWDOWN ***
8e806d22 collected $0.29 from pot
*** SUMMARY ***
Total pot $0.3 | Rake $0.01 | Jackpot $0 | Bingo $0 | Fortune $0 | Tax $0
Board [Jh Qd Ks 3c]
Seat 1: c4ea81a5 (button) folded before Flop (didn't bet)
Seat 2: 7cbe470f (small blind) folded on the Turn
Seat 3: 8e806d22 (big blind) won ($0.29)
Seat 4: eb4aaed4 folded before Flop (didn't bet)
Seat 5: Hero folded before Flop (didn't bet)
Seat 6: fab544c8 folded before Flop (didn't bet)


Poker Hand #RC2078593933: Hold'em No Limit ($0.02/$0.05) - 2023/12/22 22:12:49
Table 'RushAndCash810815' 6-max Seat #1 is the button
Seat 1: 4ab8a557 ($14.22 in chips)
Seat 2: Hero ($5.66 in chips)
Seat 3: 32d35226 ($5 in chips)
Seat 4: 449c8d9b ($5 in chips)
Seat 5: 9a865ca9 ($5.56 in chips)
Seat 6: d32741ba ($5.9 in chips)
Hero: posts small blind $0.02
32d35226: posts big blind $0.05
*** HOLE CARDS ***
Dealt to 4ab8a557 
Dealt to Hero [Tc Ad]
Dealt to 32d35226 
Dealt to 449c8d9b 
Dealt to 9a865ca9 
Dealt to d32741ba 
449c8d9b: folds
9a865ca9: raises $0.05 to $0.1
d32741ba: folds
4ab8a557: folds
Hero: folds
32d35226: folds
Uncalled bet ($0.05) returned to 9a865ca9
*** SHOWDOWN ***
9a865ca9 collected $0.12 from pot
*** SUMMARY ***
Total pot $0.12 | Rake $0 | Jackpot $0 | Bingo $0 | Fortune $0 | Tax $0
Seat 1: 4ab8a557 (button) folded before Flop (didn't bet)
Seat 2: Hero (small blind) folded before Flop
Seat 3: 32d35226 (big blind) folded before Flop
Seat 4: 449c8d9b folded before Flop (didn't bet)
Seat 5: 9a865ca9 collected ($0.12)
Seat 6: d32741ba folded before Flop (didn't bet)


Poker Hand #RC2078593744: Hold'em No Limit ($0.02/$0.05) - 2023/12/22 22:12:38
Table 'RushAndCash810726' 6-max Seat #1 is the button
Seat 1: d45bc7f3 ($6.38 in chips)
Seat 2: 6787a4d2 ($5.99 in chips)
Seat 3: 71e11b53 ($5 in chips)
Seat 4: Hero ($5.66 in chips)
Seat 5: 8e806d22 ($5.07 in chips)
Seat 6: c3adc948 ($19.55 in chips)
6787a4d2: posts small blind $0.02
71e11b53: posts big blind $0.05
*** HOLE CARDS ***
Dealt to d45bc7f3 
Dealt to 6787a4d2 
Dealt to 71e11b53 
Dealt to Hero [4c Th]
Dealt to 8e806d22 
Dealt to c3adc948 
Hero: folds
8e806d22: folds
c3adc948: raises $0.08 to $0.13
d45bc7f3: folds
6787a4d2: folds
71e11b53: folds
Uncalled bet ($0.08) returned to c3adc948
*** SHOWDOWN ***
c3adc948 collected $0.12 from pot
*** SUMMARY ***
Total pot $0.12 | Rake $0 | Jackpot $0 | Bingo $0 | Fortune $0 | Tax $0
Seat 1: d45bc7f3 (button) folded before Flop (didn't bet)
Seat 2: 6787a4d2 (small blind) folded before Flop
Seat 3: 71e11b53 (big blind) folded before Flop
Seat 4: Hero folded before Flop (didn't bet)
Seat 5: 8e806d22 folded before Flop (didn't bet)
Seat 6: c3adc948 collected ($0.12)


Poker Hand #RC2078593480: Hold'em No Limit ($0.02/$0.05) - 2023/12/22 22:12:23
Table 'RushAndCash810606' 6-max Seat #1 is the button
Seat 1: 2eea48d3 ($5 in chips)
Seat 2: af5e2eda ($5.33 in chips)
Seat 3: f60e42f0 ($11.86 in chips)
Seat 4: b49c4561 ($4.86 in chips)
Seat 5: 78624e82 ($5 in chips)
Seat 6: Hero ($5.59 in chips)
af5e2eda: posts small blind $0.02
f60e42f0: posts big blind $0.05
*** HOLE CARDS ***
Dealt to 2eea48d3 
Dealt to af5e2eda 
Dealt to f60e42f0 
Dealt to b49c4561 
Dealt to 78624e82 
Dealt to Hero [5s As]
b49c4561: folds
78624e82: folds
Hero: raises $0.05 to $0.1
2eea48d3: folds
af5e2eda: folds
f60e42f0: folds
Uncalled bet ($0.05) returned to Hero
*** SHOWDOWN ***
Hero collected $0.12 from pot
*** SUMMARY ***
Total pot $0.12 | Rake $0 | Jackpot $0 | Bingo $0 | Fortune $0 | Tax $0
Seat 1: 2eea48d3 (button) folded before Flop (didn't bet)
Seat 2: af5e2eda (small blind) folded before Flop
Seat 3: f60e42f0 (big blind) folded before Flop
Seat 4: b49c4561 folded before Flop (didn't bet)
Seat 5: 78624e82 folded before Flop (didn't bet)
Seat 6: Hero collected ($0.12)


Poker Hand #RC2078593413: Hold'em No Limit ($0.02/$0.05) - 2023/12/22 22:12:20
Table 'RushAndCash810577' 6-max Seat #1 is the button
Seat 1: Hero ($5.59 in chips)
Seat 2: e65ad772 ($18.63 in chips)
Seat 3: 77f8786f ($13.99 in chips)
Seat 4: 8bcf7ba7 ($6.53 in chips)
Seat 5: 247d342d ($5.36 in chips)
Seat 6: 5896c682 ($4.97 in chips)
e65ad772: posts small blind $0.02
77f8786f: posts big blind $0.05
*** HOLE CARDS ***
Dealt to Hero [4c 9h]
Dealt to e65ad772 
Dealt to 77f8786f 
Dealt to 8bcf7ba7 
Dealt to 247d342d 
Dealt to 5896c682 
8bcf7ba7: folds
247d342d: raises $0.05 to $0.1
5896c682: folds
Hero: folds
e65ad772: folds
77f8786f: calls $0.05
*** FLOP *** [9s 9c As]
77f8786f: checks
247d342d: checks
*** TURN *** [9s 9c As] [2c]
77f8786f: bets $0.11
247d342d: calls $0.11
*** RIVER *** [9s 9c As 2c] [3s]
77f8786f: checks
247d342d: checks
77f8786f: shows [6d Ad] (Pair of Aces and Pair of Nines)
247d342d: shows [Kc Kh] (Pair of Kings and Pair of Nines)
*** SHOWDOWN ***
77f8786f collected $0.42 from pot
*** SUMMARY ***
Total pot $0.44 | Rake $0.02 | Jackpot $0 | Bingo $0 | Fortune $0 | Tax $0
Board [9s 9c As 2c 3s]
Seat 1: Hero (button) folded before Flop (didn't bet)
Seat 2: e65ad772 (small blind) folded before Flop
Seat 3: 77f8786f (big blind) showed [6d Ad] and won ($0.42) with Pair of Aces and Pair of Nines
Seat 4: 8bcf7ba7 folded before Flop (didn't bet)
Seat 5: 247d342d showed [Kc Kh] and lost with Pair of Kings and Pair of Nines
Seat 6: 5896c682 folded before Flop (didn't bet)


Poker Hand #RC2078593334: Hold'em No Limit ($0.02/$0.05) - 2023/12/22 22:12:15
Table 'RushAndCash810537' 6-max Seat #1 is the button
Seat 1: d6431e00 ($7.85 in chips)
Seat 2: 6c75362e ($11.11 in chips)
Seat 3: 5208eb88 ($5.14 in chips)
Seat 4: Hero ($5.59 in chips)
Seat 5: 4eec4948 ($1.05 in chips)
Seat 6: 1fbf4612 ($4.93 in chips)
6c75362e: posts small blind $0.02
5208eb88: posts big blind $0.05
*** HOLE CARDS ***
Dealt to d6431e00 
Dealt to 6c75362e 
Dealt to 5208eb88 
Dealt to Hero [Qc 8c]
Dealt to 4eec4948 
Dealt to 1fbf4612 
Hero: folds
4eec4948: folds
1fbf4612: folds
d6431e00: folds
6c75362e: raises $0.1 to $0.15
5208eb88: calls $0.1
*** FLOP *** [5s Js 8d]
6c75362e: bets $0.15
5208eb88: calls $0.15
*** TURN *** [5s Js 8d] [Qs]
6c75362e: bets $0.3
5208eb88: calls $0.3
*** RIVER *** [5s Js 8d Qs] [9d]
6c75362e: bets $0.9
5208eb88: calls $0.9
6c75362e: shows [Ks Ts] (King High Flush)
5208eb88: shows [Td 9h] (Queens-High Straight)
*** SHOWDOWN ***
6c75362e collected $2.79 from pot
*** SUMMARY ***
Total pot $3 | Rake $0.14 | Jackpot $0.07 | Bingo $0 | Fortune $0 | Tax $0
Board [5s Js 8d Qs 9d]
Seat 1: d6431e00 (button) folded before Flop (didn't bet)
Seat 2: 6c75362e (small blind) showed [Ks Ts] and won ($2.79) with King High Flush
Seat 3: 5208eb88 (big blind) showed [Td 9h] and lost with Queens-High Straight
Seat 4: Hero folded before Flop (didn't bet)
Seat 5: 4eec4948 folded before Flop (didn't bet)
Seat 6: 1fbf4612 folded before Flop (didn't bet)


Poker Hand #RC2078592567: Hold'em No Limit ($0.02/$0.05) - 2023/12/22 22:11:31
Table 'RushAndCash810201' 6-max Seat #1 is the button
Seat 1: 8c340ae9 ($5.06 in chips)
Seat 2: b6451f9b ($8.33 in chips)
Seat 3: Hero ($5.48 in chips)
Seat 4: 859547f3 ($5.05 in chips)
Seat 5: c8adf5d ($6.54 in chips)
Seat 6: 7ae330b3 ($5.65 in chips)
b6451f9b: posts small blind $0.02
Hero: posts big blind $0.05
*** HOLE CARDS ***
Dealt to 8c340ae9 
Dealt to b6451f9b 
Dealt to Hero [Ts Kd]
Dealt to 859547f3 
Dealt to c8adf5d 
Dealt to 7ae330b3 
859547f3: raises $0.05 to $0.1
c8adf5d: folds
7ae330b3: folds
8c340ae9: folds
b6451f9b: folds
Hero: calls $0.05
*** FLOP *** [Qc Tc 8d]
Hero: checks
859547f3: checks
*** TURN *** [Qc Tc 8d] [Jc]
Hero: checks
859547f3: checks
*** RIVER *** [Qc Tc 8d Jc] [2d]
Hero: checks
859547f3: checks
Hero: shows [Ts Kd] (Pair of Tens)
859547f3: shows [6h 6c] (Pair of Sixes)
*** SHOWDOWN ***
Hero collected $0.21 from pot
*** SUMMARY ***
Total pot $0.22 | Rake $0.01 | Jackpot $0 | Bingo $0 | Fortune $0 | Tax $0
Board [Qc Tc 8d Jc 2d]
Seat 1: 8c340ae9 (button) folded before Flop (didn't bet)
Seat 2: b6451f9b (small blind) folded before Flop
Seat 3: Hero (big blind) showed [Ts Kd] and won ($0.21) with Pair of Tens
Seat 4: 859547f3 showed [6h 6c] and lost with Pair of Sixes
Seat 5: c8adf5d folded before Flop (didn't bet)
Seat 6: 7ae330b3 folded before Flop (didn't bet)


Poker Hand #RC2078592495: Hold'em No Limit ($0.02/$0.05) - 2023/12/22 22:11:27
Table 'RushAndCash810168' 6-max Seat #1 is the button
Seat 1: 3c14ea5f ($5 in chips)
Seat 2: Hero ($5.5 in chips)
Seat 3: 9092f4bf ($3.77 in chips)
Seat 4: f5ffb37c ($5.18 in chips)
Seat 5: 306735ed ($5 in chips)
Seat 6: 60ea60cb ($5.57 in chips)
Hero: posts small blind $0.02
9092f4bf: posts big blind $0.05
*** HOLE CARDS ***
Dealt to 3c14ea5f 
Dealt to Hero [7s Tc]
Dealt to 9092f4bf 
Dealt to f5ffb37c 
Dealt to 306735ed 
Dealt to 60ea60cb 
f5ffb37c: raises $0.05 to $0.1
306735ed: folds
60ea60cb: calls $0.1
3c14ea5f: raises $0.32 to $0.42
Hero: folds
9092f4bf: folds
f5ffb37c: folds
60ea60cb: folds
Uncalled bet ($0.32) returned to 3c14ea5f
*** SHOWDOWN ***
3c14ea5f collected $0.36 from pot
*** SUMMARY ***
Total pot $0.37 | Rake $0.01 | Jackpot $0 | Bingo $0 | Fortune $0 | Tax $0
Seat 1: 3c14ea5f (button) collected ($0.36)
Seat 2: Hero (small blind) folded before Flop
Seat 3: 9092f4bf (big blind) folded before Flop
Seat 4: f5ffb37c folded before Flop
Seat 5: 306735ed folded before Flop (didn't bet)
Seat 6: 60ea60cb folded before Flop


Poker Hand #RC2078592419: Hold'em No Limit ($0.02/$0.05) - 2023/12/22 22:11:23
Table 'RushAndCash810135' 6-max Seat #1 is the button
Seat 1: Hero ($5.5 in chips)
Seat 2: 398f151b ($4.95 in chips)
Seat 3: 34ce5e3 ($7.9 in chips)
Seat 4: 3c14ea5f ($5 in chips)
Seat 5: 2fabf60c ($5.17 in chips)
Seat 6: 86f62bb0 ($9.78 in chips)
398f151b: posts small blind $0.02
34ce5e3: posts big blind $0.05
*** HOLE CARDS ***
Dealt to Hero [5h 2h]
Dealt to 398f151b 
Dealt to 34ce5e3 
Dealt to 3c14ea5f 
Dealt to 2fabf60c 
Dealt to 86f62bb0 
3c14ea5f: folds
2fabf60c: raises $0.06 to $0.11
86f62bb0: folds
Hero: folds
398f151b: calls $0.09
34ce5e3: folds
*** FLOP *** [Kd Th Js]
398f151b: checks
2fabf60c: checks
*** TURN *** [Kd Th Js] [Qc]
398f151b: checks
2fabf60c: checks
*** RIVER *** [Kd Th Js Qc] [Jh]
398f151b: checks
2fabf60c: checks
398f151b: shows [Qs 8s] (Pair of Queens and Pair of Jacks)
2fabf60c: shows [4s 4c] (Pair of Jacks and Pair of Fours)
*** SHOWDOWN ***
398f151b collected $0.26 from pot
*** SUMMARY ***
Total pot $0.27 | Rake $0.01 | Jackpot $0 | Bingo $0 | Fortune $0 | Tax $0
Board [Kd Th Js Qc Jh]
Seat 1: Hero (button) folded before Flop (didn't bet)
Seat 2: 398f151b (small blind) showed [Qs 8s] and won ($0.26) with Pair of Queens and Pair of Jacks
Seat 3: 34ce5e3 (big blind) folded before Flop
Seat 4: 3c14ea5f folded before Flop (didn't bet)
Seat 5: 2fabf60c showed [4s 4c] and lost with Pair of Jacks and Pair of Fours
Seat 6: 86f62bb0 folded before Flop (didn't bet)


Poker Hand #RC2078591563: Hold'em No Limit ($0.02/$0.05) - 2023/12/22 22:10:32
Table 'RushAndCash809737' 6-max Seat #1 is the button
Seat 1: d3564cc0 ($12.48 in chips)
Seat 2: Hero ($5.33 in chips)
Seat 3: 1c5ffeb9 ($5.59 in chips)
Seat 4: 6c4d56b8 ($5.6 in chips)
Seat 5: 7157dd36 ($9.11 in chips)
Seat 6: 28846e83 ($6.33 in chips)
Hero: posts small blind $0.02
1c5ffeb9: posts big blind $0.05
*** HOLE CARDS ***
Dealt to d3564cc0 
Dealt to Hero [Jd Kc]
Dealt to 1c5ffeb9 
Dealt to 6c4d56b8 
Dealt to 7157dd36 
Dealt to 28846e83 
6c4d56b8: folds
7157dd36: folds
28846e83: raises $0.08 to $0.13
d3564cc0: folds
Hero: calls $0.11
1c5ffeb9: folds
*** FLOP *** [Js 5c Th]
Hero: checks
28846e83: checks
*** TURN *** [Js 5c Th] [Jh]
Hero: checks
28846e83: checks
*** RIVER *** [Js 5c Th Jh] [4c]
Hero: bets $0.16
28846e83: folds
Uncalled bet ($0.16) returned to Hero
*** SHOWDOWN ***
Hero collected $0.3 from pot
*** SUMMARY ***
Total pot $0.31 | Rake $0.01 | Jackpot $0 | Bingo $0 | Fortune $0 | Tax $0
Board [Js 5c Th Jh 4c]
Seat 1: d3564cc0 (button) folded before Flop (didn't bet)
Seat 2: Hero (small blind) won ($0.3)
Seat 3: 1c5ffeb9 (big blind) folded before Flop
Seat 4: 6c4d56b8 folded before Flop (didn't bet)
Seat 5: 7157dd36 folded before Flop (didn't bet)
Seat 6: 28846e83 folded on the River


Poker Hand #RC2078591405: Hold'em No Limit ($0.02/$0.05) - 2023/12/22 22:10:23
Table 'RushAndCash809664' 6-max Seat #1 is the button
Seat 1: 8aaa95a5 ($3.75 in chips)
Seat 2: feea99ad ($4.31 in chips)
Seat 3: 2c2f2262 ($3.93 in chips)
Seat 4: e9deb15a ($23.04 in chips)
Seat 5: f1f11b26 ($10.18 in chips)
Seat 6: Hero ($5.33 in chips)
feea99ad: posts small blind $0.02
2c2f2262: posts big blind $0.05
*** HOLE CARDS ***
Dealt to 8aaa95a5 
Dealt to feea99ad 
Dealt to 2c2f2262 
Dealt to e9deb15a 
Dealt to f1f11b26 
Dealt to Hero [9d 6c]
e9deb15a: raises $0.05 to $0.1
f1f11b26: folds
Hero: folds
8aaa95a5: folds
feea99ad: folds
2c2f2262: folds
Uncalled bet ($0.05) returned to e9deb15a
*** SHOWDOWN ***
e9deb15a collected $0.12 from pot
*** SUMMARY ***
Total pot $0.12 | Rake $0 | Jackpot $0 | Bingo $0 | Fortune $0 | Tax $0
Seat 1: 8aaa95a5 (button) folded before Flop (didn't bet)
Seat 2: feea99ad (small blind) folded before Flop
Seat 3: 2c2f2262 (big blind) folded before Flop
Seat 4: e9deb15a collected ($0.12)
Seat 5: f1f11b26 folded before Flop (didn't bet)
Seat 6: Hero folded before Flop (didn't bet)


Poker Hand #RC2078591306: Hold'em No Limit ($0.02/$0.05) - 2023/12/22 22:10:17
Table 'RushAndCash809621' 6-max Seat #1 is the button
Seat 1: cd7afddd ($6.03 in chips)
Seat 2: 1100a2e5 ($5 in chips)
Seat 3: 75daa184 ($15.6 in chips)
Seat 4: d132ea52 ($2.88 in chips)
Seat 5: bba39737 ($5.59 in chips)
Seat 6: Hero ($5.33 in chips)
1100a2e5: posts small blind $0.02
75daa184: posts big blind $0.05
*** HOLE CARDS ***
Dealt to cd7afddd 
Dealt to 1100a2e5 
Dealt to 75daa184 
Dealt to d132ea52 
Dealt to bba39737 
Dealt to Hero [Jc 3h]
d132ea52: folds
bba39737: folds
Hero: folds
cd7afddd: raises $0.1 to $0.15
1100a2e5: raises $0.4 to $0.55
75daa184: folds
cd7afddd: folds
Uncalled bet ($0.4) returned to 1100a2e5
*** SHOWDOWN ***
1100a2e5 collected $0.34 from pot
*** SUMMARY ***
Total pot $0.35 | Rake $0.01 | Jackpot $0 | Bingo $0 | Fortune $0 | Tax $0
Seat 1: cd7afddd (button) folded before Flop
Seat 2: 1100a2e5 (small blind) collected ($0.34)
Seat 3: 75daa184 (big blind) folded before Flop
Seat 4: d132ea52 folded before Flop (didn't bet)
Seat 5: bba39737 folded before Flop (didn't bet)
Seat 6: Hero folded before Flop (didn't bet)


Poker Hand #RC2078591193: Hold'em No Limit ($0.02/$0.05) - 2023/12/22 22:10:11
Table 'RushAndCash809568' 6-max Seat #1 is the button
Seat 1: b55e2f56 ($3.75 in chips)
Seat 2: ca88dd67 ($8.95 in chips)
Seat 3: 55f39ac6 ($1.85 in chips)
Seat 4: Hero ($5.33 in chips)
Seat 5: edac6d16 ($7.13 in chips)
Seat 6: b6451f9b ($8.64 in chips)
ca88dd67: posts small blind $0.02
55f39ac6: posts big blind $0.05
*** HOLE CARDS ***
Dealt to b55e2f56 
Dealt to ca88dd67 
Dealt to 55f39ac6 
Dealt to Hero [Td Qc]
Dealt to edac6d16 
Dealt to b6451f9b 
Hero: folds
edac6d16: folds
b6451f9b: raises $0.08 to $0.13
b55e2f56: calls $0.13
ca88dd67: folds
55f39ac6: folds
*** FLOP *** [8s 4d Qs]
b6451f9b: bets $0.11
b55e2f56: calls $0.11
*** TURN *** [8s 4d Qs] [9d]
b6451f9b: checks
b55e2f56: bets $0.28
b6451f9b: folds
Uncalled bet ($0.28) returned to b55e2f56
*** SHOWDOWN ***
b55e2f56 collected $0.53 from pot
*** SUMMARY ***
Total pot $0.55 | Rake $0.02 | Jackpot $0 | Bingo $0 | Fortune $0 | Tax $0
Board [8s 4d Qs 9d]
Seat 1: b55e2f56 (button) won ($0.53)
Seat 2: ca88dd67 (small blind) folded before Flop
Seat 3: 55f39ac6 (big blind) folded before Flop
Seat 4: Hero folded before Flop (didn't bet)
Seat 5: edac6d16 folded before Flop (didn't bet)
Seat 6: b6451f9b folded on the Turn


Poker Hand #RC2078591123: Hold'em No Limit ($0.02/$0.05) - 2023/12/22 22:10:07
Table 'RushAndCash809535' 6-max Seat #1 is the button
Seat 1: 80af7fe3 ($8 in chips)
Seat 2: d82e5b20 ($7.09 in chips)
Seat 3: 1d497d4f ($5.61 in chips)
Seat 4: bba39737 ($5.64 in chips)
Seat 5: Hero ($5.33 in chips)
Seat 6: a20c0bea ($6.62 in chips)
d82e5b20: posts small blind $0.02
1d497d4f: posts big blind $0.05
*** HOLE CARDS ***
Dealt to 80af7fe3 
Dealt to d82e5b20 
Dealt to 1d497d4f 
Dealt to bba39737 
Dealt to Hero [2h 3h]
Dealt to a20c0bea 
bba39737: folds
Hero: folds
a20c0bea: folds
80af7fe3: folds
d82e5b20: folds
Uncalled bet ($0.03) returned to 1d497d4f
*** SHOWDOWN ***
1d497d4f collected $0.04 from pot
*** SUMMARY ***
Total pot $0.04 | Rake $0 | Jackpot $0 | Bingo $0 | Fortune $0 | Tax $0
Seat 1: 80af7fe3 (button) folded before Flop (didn't bet)
Seat 2: d82e5b20 (small blind) folded before Flop
Seat 3: 1d497d4f (big blind) collected ($0.04)
Seat 4: bba39737 folded before Flop (didn't bet)
Seat 5: Hero folded before Flop (didn't bet)
Seat 6: a20c0bea folded before Flop (didn't bet)


Poker Hand #RC2078591044: Hold'em No Limit ($0.02/$0.05) - 2023/12/22 22:10:03
Table 'RushAndCash809500' 6-max Seat #1 is the button
Seat 1: b75c858f ($5.67 in chips)
Seat 2: db4b7f75 ($5.8 in chips)
Seat 3: f60e42f0 ($11.19 in chips)
Seat 4: 2eea48d3 ($5 in chips)
Seat 5: Hero ($5.33 in chips)
Seat 6: 86ce4b26 ($2.47 in chips)
db4b7f75: posts small blind $0.02
f60e42f0: posts big blind $0.05
*** HOLE CARDS ***
Dealt to b75c858f 
Dealt to db4b7f75 
Dealt to f60e42f0 
Dealt to 2eea48d3 
Dealt to Hero [Ah 5d]
Dealt to 86ce4b26 
2eea48d3: folds
Hero: folds
86ce4b26: folds
b75c858f: raises $0.06 to $0.11
db4b7f75: calls $0.09
f60e42f0: calls $0.06
*** FLOP *** [Kh Qc 3d]
db4b7f75: checks
f60e42f0: checks
b75c858f: checks
*** TURN *** [Kh Qc 3d] [2d]
db4b7f75: bets $0.11
f60e42f0: calls $0.11
b75c858f: folds
*** RIVER *** [Kh Qc 3d 2d] [4c]
db4b7f75: bets $0.19
f60e42f0: calls $0.19
db4b7f75: shows [9d Js] (King-High)
f60e42f0: shows [Qd Ts] (Pair of Queens)
*** SHOWDOWN ***
f60e42f0 collected $0.89 from pot
*** SUMMARY ***
Total pot $0.93 | Rake $0.04 | Jackpot $0 | Bingo $0 | Fortune $0 | Tax $0
Board [Kh Qc 3d 2d 4c]
Seat 1: b75c858f (button) folded on the Turn
Seat 2: db4b7f75 (small blind) showed [9d Js] and lost with King-High
Seat 3: f60e42f0 (big blind) showed [Qd Ts] and won ($0.89) with Pair of Queens
Seat 4: 2eea48d3 folded before Flop (didn't bet)
Seat 5: Hero folded before Flop (didn't bet)
Seat 6: 86ce4b26 folded before Flop (didn't bet)


Poker Hand #RC2078590909: Hold'em No Limit ($0.02/$0.05) - 2023/12/22 22:09:54
Table 'RushAndCash809439' 6-max Seat #1 is the button
Seat 1: af5e2eda ($5.57 in chips)
Seat 2: 10def899 ($6.44 in chips)
Seat 3: Hero ($5.31 in chips)
Seat 4: 2679d6e2 ($5.46 in chips)
Seat 5: 9ffc9c0 ($3.42 in chips)
Seat 6: cf3c4384 ($4.74 in chips)
10def899: posts small blind $0.02
Hero: posts big blind $0.05
*** HOLE CARDS ***
Dealt to af5e2eda 
Dealt to 10def899 
Dealt to Hero [7c Qc]
Dealt to 2679d6e2 
Dealt to 9ffc9c0 
Dealt to cf3c4384 
2679d6e2: folds
9ffc9c0: folds
cf3c4384: folds
af5e2eda: folds
10def899: folds
Uncalled bet ($0.03) returned to Hero
*** SHOWDOWN ***
Hero collected $0.04 from pot
*** SUMMARY ***
Total pot $0.04 | Rake $0 | Jackpot $0 | Bingo $0 | Fortune $0 | Tax $0
Seat 1: af5e2eda (button) folded before Flop (didn't bet)
Seat 2: 10def899 (small blind) folded before Flop
Seat 3: Hero (big blind) collected ($0.04)
Seat 4: 2679d6e2 folded before Flop (didn't bet)
Seat 5: 9ffc9c0 folded before Flop (didn't bet)
Seat 6: cf3c4384 folded before Flop (didn't bet)


Poker Hand #RC2078590737: Hold'em No Limit ($0.02/$0.05) - 2023/12/22 22:09:44
Table 'RushAndCash809362' 6-max Seat #1 is the button
Seat 1: Hero ($5.31 in chips)
Seat 2: 3a20c3a ($8.89 in chips)
Seat 3: 384d7f2c ($5 in chips)
Seat 4: 5f9f6e5e ($5.34 in chips)
Seat 5: 754a57b2 ($5 in chips)
Seat 6: 1c5ffeb9 ($5.59 in chips)
3a20c3a: posts small blind $0.02
384d7f2c: posts big blind $0.05
*** HOLE CARDS ***
Dealt to Hero [9s 3h]
Dealt to 3a20c3a 
Dealt to 384d7f2c 
Dealt to 5f9f6e5e 
Dealt to 754a57b2 
Dealt to 1c5ffeb9 
5f9f6e5e: raises $0.05 to $0.1
754a57b2: folds
1c5ffeb9: folds
Hero: folds
3a20c3a: folds
384d7f2c: folds
Uncalled bet ($0.05) returned to 5f9f6e5e
*** SHOWDOWN ***
5f9f6e5e collected $0.12 from pot
*** SUMMARY ***
Total pot $0.12 | Rake $0 | Jackpot $0 | Bingo $0 | Fortune $0 | Tax $0
Seat 1: Hero (button) folded before Flop (didn't bet)
Seat 2: 3a20c3a (small blind) folded before Flop
Seat 3: 384d7f2c (big blind) folded before Flop
Seat 4: 5f9f6e5e collected ($0.12)
Seat 5: 754a57b2 folded before Flop (didn't bet)
Seat 6: 1c5ffeb9 folded before Flop (didn't bet)


Poker Hand #RC2078590678: Hold'em No Limit ($0.02/$0.05) - 2023/12/22 22:09:41
Table 'RushAndCash809336' 6-max Seat #1 is the button
Seat 1: e49e39a2 ($11.98 in chips)
Seat 2: 11612373 ($16.84 in chips)
Seat 3: e657ae1e ($5 in chips)
Seat 4: Hero ($5.31 in chips)
Seat 5: 28985ec8 ($13.22 in chips)
Seat 6: 2e699c3b ($5.21 in chips)
11612373: posts small blind $0.02
e657ae1e: posts big blind $0.05
*** HOLE CARDS ***
Dealt to e49e39a2 
Dealt to 11612373 
Dealt to e657ae1e 
Dealt to Hero [7c Ah]
Dealt to 28985ec8 
Dealt to 2e699c3b 
Hero: folds
28985ec8: raises $0.05 to $0.1
2e699c3b: folds
e49e39a2: folds
11612373: folds
e657ae1e: calls $0.05
*** FLOP *** [Td 6s Qd]
e657ae1e: checks
28985ec8: bets $0.11
e657ae1e: folds
Uncalled bet ($0.11) returned to 28985ec8
*** SHOWDOWN ***
28985ec8 collected $0.21 from pot
*** SUMMARY ***
Total pot $0.22 | Rake $0.01 | Jackpot $0 | Bingo $0 | Fortune $0 | Tax $0
Board [Td 6s Qd]
Seat 1: e49e39a2 (button) folded before Flop (didn't bet)
Seat 2: 11612373 (small blind) folded before Flop
Seat 3: e657ae1e (big blind) folded on the Flop
Seat 4: Hero folded before Flop (didn't bet)
Seat 5: 28985ec8 won ($0.21)
Seat 6: 2e699c3b folded before Flop (didn't bet)


Poker Hand #RC2078590621: Hold'em No Limit ($0.02/$0.05) - 2023/12/22 22:09:37
Table 'RushAndCash809310' 6-max Seat #1 is the button
Seat 1: 45ce1aed ($8.14 in chips)
Seat 2: c3adc948 ($19.52 in chips)
Seat 3: 8d188907 ($5 in chips)
Seat 4: 2e11c0b5 ($6.4 in chips)
Seat 5: Hero ($5.31 in chips)
Seat 6: 1b4a662e ($6.03 in chips)
c3adc948: posts small blind $0.02
8d188907: posts big blind $0.05
*** HOLE CARDS ***
Dealt to 45ce1aed 
Dealt to c3adc948 
Dealt to 8d188907 
Dealt to 2e11c0b5 
Dealt to Hero [Qd 8h]
Dealt to 1b4a662e 
2e11c0b5: folds
Hero: folds
1b4a662e: folds
45ce1aed: folds
c3adc948: raises $0.1 to $0.15
8d188907: calls $0.1
*** FLOP *** [8s Kh 9c]
c3adc948: bets $0.1
8d188907: calls $0.1
*** TURN *** [8s Kh 9c] [5s]
c3adc948: bets $0.38
8d188907: calls $0.38
*** RIVER *** [8s Kh 9c 5s] [5d]
c3adc948: bets $0.95
8d188907: folds
Uncalled bet ($0.95) returned to c3adc948
*** SHOWDOWN ***
c3adc948 collected $1.2 from pot
*** SUMMARY ***
Total pot $1.26 | Rake $0.06 | Jackpot $0 | Bingo $0 | Fortune $0 | Tax $0
Board [8s Kh 9c 5s 5d]
Seat 1: 45ce1aed (button) folded before Flop (didn't bet)
Seat 2: c3adc948 (small blind) won ($1.2)
Seat 3: 8d188907 (big blind) folded on the River
Seat 4: 2e11c0b5 folded before Flop (didn't bet)
Seat 5: Hero folded before Flop (didn't bet)
Seat 6: 1b4a662e folded before Flop (didn't bet)


Poker Hand #RC2078590497: Hold'em No Limit ($0.02/$0.05) - 2023/12/22 22:09:31
Table 'RushAndCash809254' 6-max Seat #1 is the button
Seat 1: 37f17992 ($4.93 in chips)
Seat 2: 8f80311 ($8.42 in chips)
Seat 3: 947be4c8 ($4.86 in chips)
Seat 4: c84db7d6 ($4.15 in chips)
Seat 5: Hero ($5.31 in chips)
Seat 6: 57896c91 ($8.95 in chips)
8f80311: posts small blind $0.02
947be4c8: posts big blind $0.05
*** HOLE CARDS ***
Dealt to 37f17992 
Dealt to 8f80311 
Dealt to 947be4c8 
Dealt to c84db7d6 
Dealt to Hero [9c 7c]
Dealt to 57896c91 
c84db7d6: raises $0.07 to $0.12
Hero: folds
57896c91: calls $0.12
37f17992: calls $0.12
8f80311: folds
947be4c8: calls $0.07
*** FLOP *** [Jd 5c 6d]
947be4c8: checks
c84db7d6: checks
57896c91: checks
37f17992: bets $0.25
947be4c8: calls $0.25
c84db7d6: calls $0.25
57896c91: folds
*** TURN *** [Jd 5c 6d] [Kc]
947be4c8: checks
c84db7d6: checks
37f17992: bets $0.63
947be4c8: folds
c84db7d6: folds
Uncalled bet ($0.63) returned to 37f17992
*** SHOWDOWN ***
37f17992 collected $1.19 from pot
*** SUMMARY ***
Total pot $1.25 | Rake $0.06 | Jackpot $0 | Bingo $0 | Fortune $0 | Tax $0
Board [Jd 5c 6d Kc]
Seat 1: 37f17992 (button) won ($1.19)
Seat 2: 8f80311 (small blind) folded before Flop
Seat 3: 947be4c8 (big blind) folded on the Turn
Seat 4: c84db7d6 folded on the Turn
Seat 5: Hero folded before Flop (didn't bet)
Seat 6: 57896c91 folded on the Flop


Poker Hand #RC2078590437: Hold'em No Limit ($0.02/$0.05) - 2023/12/22 22:09:27
Table 'RushAndCash809225' 6-max Seat #1 is the button
Seat 1: Hero ($5.31 in chips)
Seat 2: 8f240b5e ($9.18 in chips)
Seat 3: 886872c9 ($7.38 in chips)
Seat 4: 2e539c23 ($4.29 in chips)
Seat 5: 190cd877 ($6.45 in chips)
Seat 6: 517da49 ($11.62 in chips)
8f240b5e: posts small blind $0.02
886872c9: posts big blind $0.05
*** HOLE CARDS ***
Dealt to Hero [8d 2s]
Dealt to 8f240b5e 
Dealt to 886872c9 
Dealt to 2e539c23 
Dealt to 190cd877 
Dealt to 517da49 
2e539c23: folds
190cd877: folds
517da49: folds
Hero: folds
8f240b5e: folds
Uncalled bet ($0.03) returned to 886872c9
*** SHOWDOWN ***
886872c9 collected $0.04 from pot
*** SUMMARY ***
Total pot $0.04 | Rake $0 | Jackpot $0 | Bingo $0 | Fortune $0 | Tax $0
Seat 1: Hero (button) folded before Flop (didn't bet)
Seat 2: 8f240b5e (small blind) folded before Flop
Seat 3: 886872c9 (big blind) collected ($0.04)
Seat 4: 2e539c23 folded before Flop (didn't bet)
Seat 5: 190cd877 folded before Flop (didn't bet)
Seat 6: 517da49 folded before Flop (didn't bet)


Poker Hand #RC2078590291: Hold'em No Limit ($0.02/$0.05) - 2023/12/22 22:09:19
Table 'RushAndCash809159' 6-max Seat #1 is the button
Seat 1: 1259a422 ($8.03 in chips)
Seat 2: Hero ($5.33 in chips)
Seat 3: 97ff30a6 ($5.7 in chips)
Seat 4: 5162d63f ($7.57 in chips)
Seat 5: 6b3ca2ea ($5 in chips)
Seat 6: ee1f67f7 ($5.14 in chips)
Hero: posts small blind $0.02
97ff30a6: posts big blind $0.05
*** HOLE CARDS ***
Dealt to 1259a422 
Dealt to Hero [8c Ts]
Dealt to 97ff30a6 
Dealt to 5162d63f 
Dealt to 6b3ca2ea 
Dealt to ee1f67f7 
5162d63f: raises $0.05 to $0.1
6b3ca2ea: folds
ee1f67f7: folds
1259a422: folds
Hero: folds
97ff30a6: folds
Uncalled bet ($0.05) returned to 5162d63f
*** SHOWDOWN ***
5162d63f collected $0.12 from pot
*** SUMMARY ***
Total pot $0.12 | Rake $0 | Jackpot $0 | Bingo $0 | Fortune $0 | Tax $0
Seat 1: 1259a422 (button) folded before Flop (didn't bet)
Seat 2: Hero (small blind) folded before Flop
Seat 3: 97ff30a6 (big blind) folded before Flop
Seat 4: 5162d63f collected ($0.12)
Seat 5: 6b3ca2ea folded before Flop (didn't bet)
Seat 6: ee1f67f7 folded before Flop (didn't bet)


Poker Hand #RC2078590227: Hold'em No Limit ($0.02/$0.05) - 2023/12/22 22:09:15
Table 'RushAndCash809128' 6-max Seat #1 is the button
Seat 1: 38e42730 ($8.92 in chips)
Seat 2: 67e3c817 ($5.02 in chips)
Seat 3: Hero ($5.38 in chips)
Seat 4: 8f1a23de ($6.21 in chips)
Seat 5: 31dd0354 ($5.34 in chips)
Seat 6: 47ffe1d8 ($5.04 in chips)
67e3c817: posts small blind $0.02
Hero: posts big blind $0.05
*** HOLE CARDS ***
Dealt to 38e42730 
Dealt to 67e3c817 
Dealt to Hero [2c 9d]
Dealt to 8f1a23de 
Dealt to 31dd0354 
Dealt to 47ffe1d8 
8f1a23de: folds
31dd0354: folds
47ffe1d8: folds
38e42730: folds
67e3c817: raises $0.09 to $0.14
Hero: folds
Uncalled bet ($0.09) returned to 67e3c817
*** SHOWDOWN ***
67e3c817 collected $0.1 from pot
*** SUMMARY ***
Total pot $0.1 | Rake $0 | Jackpot $0 | Bingo $0 | Fortune $0 | Tax $0
Seat 1: 38e42730 (button) folded before Flop (didn't bet)
Seat 2: 67e3c817 (small blind) collected ($0.1)
Seat 3: Hero (big blind) folded before Flop
Seat 4: 8f1a23de folded before Flop (didn't bet)
Seat 5: 31dd0354 folded before Flop (didn't bet)
Seat 6: 47ffe1d8 folded before Flop (didn't bet)


Poker Hand #RC2078590163: Hold'em No Limit ($0.02/$0.05) - 2023/12/22 22:09:11
Table 'RushAndCash809101' 6-max Seat #1 is the button
Seat 1: 77a2d2f ($9.15 in chips)
Seat 2: 43f14982 ($4.23 in chips)
Seat 3: fe1e0829 ($5.11 in chips)
Seat 4: 30f8d14e ($3.48 in chips)
Seat 5: Hero ($5.38 in chips)
Seat 6: 1936d86f ($5.95 in chips)
43f14982: posts small blind $0.02
fe1e0829: posts big blind $0.05
*** HOLE CARDS ***
Dealt to 77a2d2f 
Dealt to 43f14982 
Dealt to fe1e0829 
Dealt to 30f8d14e 
Dealt to Hero [Ac 7s]
Dealt to 1936d86f 
30f8d14e: folds
Hero: folds
1936d86f: folds
77a2d2f: folds
43f14982: raises $0.06 to $0.11
fe1e0829: folds
Uncalled bet ($0.06) returned to 43f14982
*** SHOWDOWN ***
43f14982 collected $0.1 from pot
*** SUMMARY ***
Total pot $0.1 | Rake $0 | Jackpot $0 | Bingo $0 | Fortune $0 | Tax $0
Seat 1: 77a2d2f (button) folded before Flop (didn't bet)
Seat 2: 43f14982 (small blind) collected ($0.1)
Seat 3: fe1e0829 (big blind) folded before Flop
Seat 4: 30f8d14e folded before Flop (didn't bet)
Seat 5: Hero folded before Flop (didn't bet)
Seat 6: 1936d86f folded before Flop (didn't bet)


Poker Hand #RC2078589832: Hold'em No Limit ($0.02/$0.05) - 2023/12/22 22:08:53
Table 'RushAndCash808955' 6-max Seat #1 is the button
Seat 1: 153b1345 ($7.39 in chips)
Seat 2: c84db7d6 ($4.24 in chips)
Seat 3: Hero ($5.43 in chips)
Seat 4: c7726580 ($4.94 in chips)
Seat 5: 376e9d31 ($5.25 in chips)
Seat 6: f71b25e9 ($7.76 in chips)
c84db7d6: posts small blind $0.02
Hero: posts big blind $0.05
*** HOLE CARDS ***
Dealt to 153b1345 
Dealt to c84db7d6 
Dealt to Hero [Th 4h]
Dealt to c7726580 
Dealt to 376e9d31 
Dealt to f71b25e9 
c7726580: raises $0.05 to $0.1
376e9d31: folds
f71b25e9: folds
153b1345: raises $0.2 to $0.3
c84db7d6: folds
Hero: folds
c7726580: raises $0.67 to $0.97
153b1345: folds
Uncalled bet ($0.67) returned to c7726580
*** SHOWDOWN ***
c7726580 collected $0.64 from pot
*** SUMMARY ***
Total pot $0.67 | Rake $0.03 | Jackpot $0 | Bingo $0 | Fortune $0 | Tax $0
Seat 1: 153b1345 (button) folded before Flop
Seat 2: c84db7d6 (small blind) folded before Flop
Seat 3: Hero (big blind) folded before Flop
Seat 4: c7726580 collected ($0.64)
Seat 5: 376e9d31 folded before Flop (didn't bet)
Seat 6: f71b25e9 folded before Flop (didn't bet)


Poker Hand #RC2078589745: Hold'em No Limit ($0.02/$0.05) - 2023/12/22 22:08:48
Table 'RushAndCash808913' 6-max Seat #1 is the button
Seat 1: 438044f8 ($14.31 in chips)
Seat 2: def6b062 ($5.26 in chips)
Seat 3: b78775ac ($4.2 in chips)
Seat 4: 9134f24d ($4.93 in chips)
Seat 5: 2f7f1fcd ($6.19 in chips)
Seat 6: Hero ($5.43 in chips)
def6b062: posts small blind $0.02
b78775ac: posts big blind $0.05
*** HOLE CARDS ***
Dealt to 438044f8 
Dealt to def6b062 
Dealt to b78775ac 
Dealt to 9134f24d 
Dealt to 2f7f1fcd 
Dealt to Hero [9h 4h]
9134f24d: folds
2f7f1fcd: raises $0.07 to $0.12
Hero: folds
438044f8: folds
def6b062: folds
b78775ac: folds
Uncalled bet ($0.07) returned to 2f7f1fcd
*** SHOWDOWN ***
2f7f1fcd collected $0.12 from pot
*** SUMMARY ***
Total pot $0.12 | Rake $0 | Jackpot $0 | Bingo $0 | Fortune $0 | Tax $0
Seat 1: 438044f8 (button) folded before Flop (didn't bet)
Seat 2: def6b062 (small blind) folded before Flop
Seat 3: b78775ac (big blind) folded before Flop
Seat 4: 9134f24d folded before Flop (didn't bet)
Seat 5: 2f7f1fcd collected ($0.12)
Seat 6: Hero folded before Flop (didn't bet)


Poker Hand #RC2078589491: Hold'em No Limit ($0.02/$0.05) - 2023/12/22 22:08:33
Table 'RushAndCash808793' 6-max Seat #1 is the button
Seat 1: 2df55086 ($8.69 in chips)
Seat 2: Hero ($5.45 in chips)
Seat 3: 5916f023 ($14.17 in chips)
Seat 4: 846054b0 ($9.45 in chips)
Seat 5: cd7afddd ($6.48 in chips)
Seat 6: 75daa184 ($15.46 in chips)
Hero: posts small blind $0.02
5916f023: posts big blind $0.05
*** HOLE CARDS ***
Dealt to 2df55086 
Dealt to Hero [6s 6c]
Dealt to 5916f023 
Dealt to 846054b0 
Dealt to cd7afddd 
Dealt to 75daa184 
846054b0: folds
cd7afddd: raises $0.1 to $0.15
75daa184: raises $0.35 to $0.5
2df55086: folds
Hero: folds
5916f023: folds
cd7afddd: folds
Uncalled bet ($0.35) returned to 75daa184
*** SHOWDOWN ***
75daa184 collected $0.36 from pot
*** SUMMARY ***
Total pot $0.37 | Rake $0.01 | Jackpot $0 | Bingo $0 | Fortune $0 | Tax $0
Seat 1: 2df55086 (button) folded before Flop (didn't bet)
Seat 2: Hero (small blind) folded before Flop
Seat 3: 5916f023 (big blind) folded before Flop
Seat 4: 846054b0 folded before Flop (didn't bet)
Seat 5: cd7afddd folded before Flop
Seat 6: 75daa184 collected ($0.36)


Poker Hand #RC2078589430: Hold'em No Limit ($0.02/$0.05) - 2023/12/22 22:08:30
Table 'RushAndCash808762' 6-max Seat #1 is the button
Seat 1: 7b8defcb ($4.84 in chips)
Seat 2: 5df9a842 ($10.05 in chips)
Seat 3: 4c0d7324 ($6.32 in chips)
Seat 4: 97ff30a6 ($6.14 in chips)
Seat 5: 6ff1e240 ($5.38 in chips)
Seat 6: Hero ($5.45 in chips)
5df9a842: posts small blind $0.02
4c0d7324: posts big blind $0.05
*** HOLE CARDS ***
Dealt to 7b8defcb 
Dealt to 5df9a842 
Dealt to 4c0d7324 
Dealt to 97ff30a6 
Dealt to 6ff1e240 
Dealt to Hero [Ts 8h]
97ff30a6: raises $0.1 to $0.15
6ff1e240: folds
Hero: folds
7b8defcb: folds
5df9a842: calls $0.13
4c0d7324: folds
*** FLOP *** [9c 7s 7c]
5df9a842: checks
97ff30a6: checks
*** TURN *** [9c 7s 7c] [Qc]
5df9a842: checks
97ff30a6: bets $0.27
5df9a842: calls $0.27
*** RIVER *** [9c 7s 7c Qc] [9s]
5df9a842: checks
97ff30a6: checks
5df9a842: shows [7d 8d] (Sevens Full over Nines)
97ff30a6: shows [Js Ac] (Pair of Nines and Pair of Sevens)
*** SHOWDOWN ***
5df9a842 collected $0.85 from pot
*** SUMMARY ***
Total pot $0.89 | Rake $0.04 | Jackpot $0 | Bingo $0 | Fortune $0 | Tax $0
Board [9c 7s 7c Qc 9s]
Seat 1: 7b8defcb (button) folded before Flop (didn't bet)
Seat 2: 5df9a842 (small blind) showed [7d 8d] and won ($0.85) with Sevens Full over Nines
Seat 3: 4c0d7324 (big blind) folded before Flop
Seat 4: 97ff30a6 showed [Js Ac] and lost with Pair of Nines and Pair of Sevens
Seat 5: 6ff1e240 folded before Flop (didn't bet)
Seat 6: Hero folded before Flop (didn't bet)


Poker Hand #RC2078589335: Hold'em No Limit ($0.02/$0.05) - 2023/12/22 22:08:24
Table 'RushAndCash808720' 6-max Seat #1 is the button
Seat 1: Hero ($5.45 in chips)
Seat 2: 58c8aa5f ($5 in chips)
Seat 3: f6b5f68e ($5.84 in chips)
Seat 4: 1e3d103d ($7.91 in chips)
Seat 5: bc26f2e1 ($5.25 in chips)
Seat 6: 2e11c0b5 ($6.63 in chips)
58c8aa5f: posts small blind $0.02
f6b5f68e: posts big blind $0.05
*** HOLE CARDS ***
Dealt to Hero [8c 6s]
Dealt to 58c8aa5f 
Dealt to f6b5f68e 
Dealt to 1e3d103d 
Dealt to bc26f2e1 
Dealt to 2e11c0b5 
1e3d103d: folds
bc26f2e1: folds
2e11c0b5: folds
Hero: folds
58c8aa5f: folds
Uncalled bet ($0.03) returned to f6b5f68e
*** SHOWDOWN ***
f6b5f68e collected $0.04 from pot
*** SUMMARY ***
Total pot $0.04 | Rake $0 | Jackpot $0 | Bingo $0 | Fortune $0 | Tax $0
Seat 1: Hero (button) folded before Flop (didn't bet)
Seat 2: 58c8aa5f (small blind) folded before Flop
Seat 3: f6b5f68e (big blind) collected ($0.04)
Seat 4: 1e3d103d folded before Flop (didn't bet)
Seat 5: bc26f2e1 folded before Flop (didn't bet)
Seat 6: 2e11c0b5 folded before Flop (didn't bet)


Poker Hand #RC2078589270: Hold'em No Limit ($0.02/$0.05) - 2023/12/22 22:08:21
Table 'RushAndCash808689' 6-max Seat #1 is the button
Seat 1: 1e6e058c ($12.47 in chips)
Seat 2: 37951557 ($5 in chips)
Seat 3: f94de4b0 ($5.44 in chips)
Seat 4: Hero ($5.45 in chips)
Seat 5: d6c4e270 ($3.34 in chips)
Seat 6: b0eab1b5 ($5.03 in chips)
37951557: posts small blind $0.02
f94de4b0: posts big blind $0.05
*** HOLE CARDS ***
Dealt to 1e6e058c 
Dealt to 37951557 
Dealt to f94de4b0 
Dealt to Hero [9h Qs]
Dealt to d6c4e270 
Dealt to b0eab1b5 
Hero: folds
d6c4e270: raises $0.05 to $0.1
b0eab1b5: folds
1e6e058c: folds
37951557: folds
f94de4b0: folds
Uncalled bet ($0.05) returned to d6c4e270
*** SHOWDOWN ***
d6c4e270 collected $0.12 from pot
*** SUMMARY ***
Total pot $0.12 | Rake $0 | Jackpot $0 | Bingo $0 | Fortune $0 | Tax $0
Seat 1: 1e6e058c (button) folded before Flop (didn't bet)
Seat 2: 37951557 (small blind) folded before Flop
Seat 3: f94de4b0 (big blind) folded before Flop
Seat 4: Hero folded before Flop (didn't bet)
Seat 5: d6c4e270 collected ($0.12)
Seat 6: b0eab1b5 folded before Flop (didn't bet)


Poker Hand #RC2078589201: Hold'em No Limit ($0.02/$0.05) - 2023/12/22 22:08:17
Table 'RushAndCash808660' 6-max Seat #1 is the button
Seat 1: 1259a422 ($8.3 in chips)
Seat 2: f94de4b0 ($5.46 in chips)
Seat 3: 1e3d103d ($7.89 in chips)
Seat 4: 8e806d22 ($5.04 in chips)
Seat 5: 165766e4 ($5.4 in chips)
Seat 6: Hero ($5.45 in chips)
f94de4b0: posts small blind $0.02
1e3d103d: posts big blind $0.05
*** HOLE CARDS ***
Dealt to 1259a422 
Dealt to f94de4b0 
Dealt to 1e3d103d 
Dealt to 8e806d22 
Dealt to 165766e4 
Dealt to Hero [2c Ts]
8e806d22: folds
165766e4: folds
Hero: folds
1259a422: folds
f94de4b0: folds
Uncalled bet ($0.03) returned to 1e3d103d
*** SHOWDOWN ***
1e3d103d collected $0.04 from pot
*** SUMMARY ***
Total pot $0.04 | Rake $0 | Jackpot $0 | Bingo $0 | Fortune $0 | Tax $0
Seat 1: 1259a422 (button) folded before Flop (didn't bet)
Seat 2: f94de4b0 (small blind) folded before Flop
Seat 3: 1e3d103d (big blind) collected ($0.04)
Seat 4: 8e806d22 folded before Flop (didn't bet)
Seat 5: 165766e4 folded before Flop (didn't bet)
Seat 6: Hero folded before Flop (didn't bet)


Poker Hand #RC2078589127: Hold'em No Limit ($0.02/$0.05) - 2023/12/22 22:08:12
Table 'RushAndCash808625' 6-max Seat #1 is the button
Seat 1: 6aa0a400 ($5 in chips)
Seat 2: 859547f3 ($5 in chips)
Seat 3: 90b5844 ($6.51 in chips)
Seat 4: Hero ($5.45 in chips)
Seat 5: a5d2dfd ($5.42 in chips)
Seat 6: d0b2d784 ($8.59 in chips)
859547f3: posts small blind $0.02
90b5844: posts big blind $0.05
*** HOLE CARDS ***
Dealt to 6aa0a400 
Dealt to 859547f3 
Dealt to 90b5844 
Dealt to Hero [3h Kd]
Dealt to a5d2dfd 
Dealt to d0b2d784 
Hero: folds
a5d2dfd: folds
d0b2d784: raises $0.08 to $0.13
6aa0a400: folds
859547f3: folds
90b5844: folds
Uncalled bet ($0.08) returned to d0b2d784
*** SHOWDOWN ***
d0b2d784 collected $0.12 from pot
*** SUMMARY ***
Total pot $0.12 | Rake $0 | Jackpot $0 | Bingo $0 | Fortune $0 | Tax $0
Seat 1: 6aa0a400 (button) folded before Flop (didn't bet)
Seat 2: 859547f3 (small blind) folded before Flop
Seat 3: 90b5844 (big blind) folded before Flop
Seat 4: Hero folded before Flop (didn't bet)
Seat 5: a5d2dfd folded before Flop (didn't bet)
Seat 6: d0b2d784 collected ($0.12)


Poker Hand #RC2078588678: Hold'em No Limit ($0.02/$0.05) - 2023/12/22 22:07:45
Table 'RushAndCash808418' 6-max Seat #1 is the button
Seat 1: 756c67e1 ($5.61 in chips)
Seat 2: Hero ($5.6 in chips)
Seat 3: a78fec7d ($3.61 in chips)
Seat 4: a2ebb3c7 ($5.02 in chips)
Seat 5: cd7afddd ($5.78 in chips)
Seat 6: 1d0d69cf ($5.05 in chips)
Hero: posts small blind $0.02
a78fec7d: posts big blind $0.05
*** HOLE CARDS ***
Dealt to 756c67e1 
Dealt to Hero [5c 5d]
Dealt to a78fec7d 
Dealt to a2ebb3c7 
Dealt to cd7afddd 
Dealt to 1d0d69cf 
a2ebb3c7: folds
cd7afddd: raises $0.1 to $0.15
1d0d69cf: folds
756c67e1: folds
Hero: calls $0.13
a78fec7d: calls $0.1
*** FLOP *** [Jh 6d Qd]
Hero: checks
a78fec7d: bets $0.17
cd7afddd: calls $0.17
Hero: folds
*** TURN *** [Jh 6d Qd] [8d]
a78fec7d: bets $0.29
cd7afddd: calls $0.29
*** RIVER *** [Jh 6d Qd 8d] [2d]
a78fec7d: checks
cd7afddd: bets $1.04
a78fec7d: folds
Uncalled bet ($1.04) returned to cd7afddd
*** SHOWDOWN ***
cd7afddd collected $1.31 from pot
*** SUMMARY ***
Total pot $1.37 | Rake $0.06 | Jackpot $0 | Bingo $0 | Fortune $0 | Tax $0
Board [Jh 6d Qd 8d 2d]
Seat 1: 756c67e1 (button) folded before Flop (didn't bet)
Seat 2: Hero (small blind) folded on the Flop
Seat 3: a78fec7d (big blind) folded on the River
Seat 4: a2ebb3c7 folded before Flop (didn't bet)
Seat 5: cd7afddd won ($1.31)
Seat 6: 1d0d69cf folded before Flop (didn't bet)


Poker Hand #RC2078588627: Hold'em No Limit ($0.02/$0.05) - 2023/12/22 22:07:42
Table 'RushAndCash808396' 6-max Seat #1 is the button
Seat 1: Hero ($5.6 in chips)
Seat 2: 5e413422 ($1.76 in chips)
Seat 3: e91020c6 ($5.68 in chips)
Seat 4: 4d43d419 ($9.13 in chips)
Seat 5: 5a7ccd94 ($4.73 in chips)
Seat 6: 271c38e0 ($7.2 in chips)
5e413422: posts small blind $0.02
e91020c6: posts big blind $0.05
*** HOLE CARDS ***
Dealt to Hero [8d Kh]
Dealt to 5e413422 
Dealt to e91020c6 
Dealt to 4d43d419 
Dealt to 5a7ccd94 
Dealt to 271c38e0 
4d43d419: folds
5a7ccd94: folds
271c38e0: folds
Hero: folds
5e413422: folds
Uncalled bet ($0.03) returned to e91020c6
*** SHOWDOWN ***
e91020c6 collected $0.04 from pot
*** SUMMARY ***
Total pot $0.04 | Rake $0 | Jackpot $0 | Bingo $0 | Fortune $0 | Tax $0
Seat 1: Hero (button) folded before Flop (didn't bet)
Seat 2: 5e413422 (small blind) folded before Flop
Seat 3: e91020c6 (big blind) collected ($0.04)
Seat 4: 4d43d419 folded before Flop (didn't bet)
Seat 5: 5a7ccd94 folded before Flop (didn't bet)
Seat 6: 271c38e0 folded before Flop (didn't bet)


Poker Hand #RC2078588475: Hold'em No Limit ($0.02/$0.05) - 2023/12/22 22:07:33
Table 'RushAndCash808327' 6-max Seat #1 is the button
Seat 1: 4a7d05b1 ($6.45 in chips)
Seat 2: e2bebe69 ($5.26 in chips)
Seat 3: Hero ($5.58 in chips)
Seat 4: c01fa199 ($5.47 in chips)
Seat 5: 459d0f5c ($6.56 in chips)
Seat 6: 1d497d4f ($5.7 in chips)
e2bebe69: posts small blind $0.02
Hero: posts big blind $0.05
*** HOLE CARDS ***
Dealt to 4a7d05b1 
Dealt to e2bebe69 
Dealt to Hero [4h Qs]
Dealt to c01fa199 
Dealt to 459d0f5c 
Dealt to 1d497d4f 
c01fa199: folds
459d0f5c: folds
1d497d4f: folds
4a7d05b1: folds
e2bebe69: folds
Uncalled bet ($0.03) returned to Hero
*** SHOWDOWN ***
Hero collected $0.04 from pot
*** SUMMARY ***
Total pot $0.04 | Rake $0 | Jackpot $0 | Bingo $0 | Fortune $0 | Tax $0
Seat 1: 4a7d05b1 (button) folded before Flop (didn't bet)
Seat 2: e2bebe69 (small blind) folded before Flop
Seat 3: Hero (big blind) collected ($0.04)
Seat 4: c01fa199 folded before Flop (didn't bet)
Seat 5: 459d0f5c folded before Flop (didn't bet)
Seat 6: 1d497d4f folded before Flop (didn't bet)


Poker Hand #RC2078588407: Hold'em No Limit ($0.02/$0.05) - 2023/12/22 22:07:29
Table 'RushAndCash808296' 6-max Seat #1 is the button
Seat 1: 32cf626d ($5.56 in chips)
Seat 2: 2679d6e2 ($4.95 in chips)
Seat 3: f6b5f68e ($5.91 in chips)
Seat 4: Hero ($5.58 in chips)
Seat 5: 24503504 ($7.96 in chips)
Seat 6: 3933d58 ($5.37 in chips)
2679d6e2: posts small blind $0.02
f6b5f68e: posts big blind $0.05
*** HOLE CARDS ***
Dealt to 32cf626d 
Dealt to 2679d6e2 
Dealt to f6b5f68e 
Dealt to Hero [8d 5d]
Dealt to 24503504 
Dealt to 3933d58 
Hero: folds
24503504: folds
3933d58: folds
32cf626d: folds
2679d6e2: folds
Uncalled bet ($0.03) returned to f6b5f68e
*** SHOWDOWN ***
f6b5f68e collected $0.04 from pot
*** SUMMARY ***
Total pot $0.04 | Rake $0 | Jackpot $0 | Bingo $0 | Fortune $0 | Tax $0
Seat 1: 32cf626d (button) folded before Flop (didn't bet)
Seat 2: 2679d6e2 (small blind) folded before Flop
Seat 3: f6b5f68e (big blind) collected ($0.04)
Seat 4: Hero folded before Flop (didn't bet)
Seat 5: 24503504 folded before Flop (didn't bet)
Seat 6: 3933d58 folded before Flop (didn't bet)


Poker Hand #RC2078587917: Hold'em No Limit ($0.02/$0.05) - 2023/12/22 22:07:02
Table 'RushAndCash808073' 6-max Seat #1 is the button
Seat 1: cb9a7609 ($5.37 in chips)
Seat 2: Hero ($5.6 in chips)
Seat 3: f0e3b048 ($8.6 in chips)
Seat 4: 2e44f78e ($7.96 in chips)
Seat 5: ec5f3643 ($4.61 in chips)
Seat 6: 517da49 ($10.68 in chips)
Hero: posts small blind $0.02
f0e3b048: posts big blind $0.05
*** HOLE CARDS ***
Dealt to cb9a7609 
Dealt to Hero [7c 8c]
Dealt to f0e3b048 
Dealt to 2e44f78e 
Dealt to ec5f3643 
Dealt to 517da49 
2e44f78e: raises $0.07 to $0.12
ec5f3643: raises $0.24 to $0.36
517da49: folds
cb9a7609: folds
Hero: folds
f0e3b048: folds
2e44f78e: folds
Uncalled bet ($0.24) returned to ec5f3643
*** SHOWDOWN ***
ec5f3643 collected $0.3 from pot
*** SUMMARY ***
Total pot $0.31 | Rake $0.01 | Jackpot $0 | Bingo $0 | Fortune $0 | Tax $0
Seat 1: cb9a7609 (button) folded before Flop (didn't bet)
Seat 2: Hero (small blind) folded before Flop
Seat 3: f0e3b048 (big blind) folded before Flop
Seat 4: 2e44f78e folded before Flop
Seat 5: ec5f3643 collected ($0.3)
Seat 6: 517da49 folded before Flop (didn't bet)


Poker Hand #RC2078587833: Hold'em No Limit ($0.02/$0.05) - 2023/12/22 22:06:57
Table 'RushAndCash808039' 6-max Seat #1 is the button
Seat 1: Hero ($5.6 in chips)
Seat 2: b55e2f56 ($3.94 in chips)
Seat 3: c8c732ca ($5.64 in chips)
Seat 4: d79b0c6a ($5.38 in chips)
Seat 5: 7ae330b3 ($5.51 in chips)
Seat 6: 8d188907 ($5.02 in chips)
b55e2f56: posts small blind $0.02
c8c732ca: posts big blind $0.05
*** HOLE CARDS ***
Dealt to Hero [3h Ad]
Dealt to b55e2f56 
Dealt to c8c732ca 
Dealt to d79b0c6a 
Dealt to 7ae330b3 
Dealt to 8d188907 
d79b0c6a: folds
7ae330b3: raises $0.07 to $0.12
8d188907: folds
Hero: folds
b55e2f56: calls $0.1
c8c732ca: folds
*** FLOP *** [Ks Js 6h]
b55e2f56: checks
7ae330b3: bets $0.16
b55e2f56: calls $0.16
*** TURN *** [Ks Js 6h] [Ac]
b55e2f56: checks
7ae330b3: bets $0.2
b55e2f56: folds
Uncalled bet ($0.2) returned to 7ae330b3
*** SHOWDOWN ***
7ae330b3 collected $0.58 from pot
*** SUMMARY ***
Total pot $0.61 | Rake $0.03 | Jackpot $0 | Bingo $0 | Fortune $0 | Tax $0
Board [Ks Js 6h Ac]
Seat 1: Hero (button) folded before Flop (didn't bet)
Seat 2: b55e2f56 (small blind) folded on the Turn
Seat 3: c8c732ca (big blind) folded before Flop
Seat 4: d79b0c6a folded before Flop (didn't bet)
Seat 5: 7ae330b3 won ($0.58)
Seat 6: 8d188907 folded before Flop (didn't bet)


Poker Hand #RC2078587347: Hold'em No Limit ($0.02/$0.05) - 2023/12/22 22:06:29
Table 'RushAndCash807815' 6-max Seat #1 is the button
Seat 1: d79b0c6a ($5.73 in chips)
Seat 2: d82e5b20 ($7.11 in chips)
Seat 3: 475a0563 ($4.97 in chips)
Seat 4: 2fb7c647 ($1.43 in chips)
Seat 5: Hero ($5.21 in chips)
Seat 6: c71b7029 ($8.48 in chips)
d82e5b20: posts small blind $0.02
475a0563: posts big blind $0.05
*** HOLE CARDS ***
Dealt to d79b0c6a 
Dealt to d82e5b20 
Dealt to 475a0563 
Dealt to 2fb7c647 
Dealt to Hero [8s 9s]
Dealt to c71b7029 
2fb7c647: folds
Hero: raises $0.05 to $0.1
c71b7029: folds
d79b0c6a: raises $0.25 to $0.35
d82e5b20: folds
475a0563: folds
Hero: raises $0.68 to $1.03
d79b0c6a: folds
Uncalled bet ($0.68) returned to Hero
*** SHOWDOWN ***
Hero collected $0.74 from pot
*** SUMMARY ***
Total pot $0.77 | Rake $0.03 | Jackpot $0 | Bingo $0 | Fortune $0 | Tax $0
Seat 1: d79b0c6a (button) folded before Flop
Seat 2: d82e5b20 (small blind) folded before Flop
Seat 3: 475a0563 (big blind) folded before Flop
Seat 4: 2fb7c647 folded before Flop (didn't bet)
Seat 5: Hero collected ($0.74)
Seat 6: c71b7029 folded before Flop (didn't bet)


Poker Hand #RC2078586773: Hold'em No Limit ($0.02/$0.05) - 2023/12/22 22:05:56
Table 'RushAndCash807541' 6-max Seat #1 is the button
Seat 1: d21cc812 ($6.36 in chips)
Seat 2: d79b0c6a ($5.07 in chips)
Seat 3: 58782f5b ($5.29 in chips)
Seat 4: Hero ($5.81 in chips)
Seat 5: 834fcc3f ($8.9 in chips)
Seat 6: 2486bc4b ($26.05 in chips)
d79b0c6a: posts small blind $0.02
58782f5b: posts big blind $0.05
*** HOLE CARDS ***
Dealt to d21cc812 
Dealt to d79b0c6a 
Dealt to 58782f5b 
Dealt to Hero [Js As]
Dealt to 834fcc3f 
Dealt to 2486bc4b 
Hero: raises $0.05 to $0.1
834fcc3f: folds
2486bc4b: folds
d21cc812: folds
d79b0c6a: raises $0.25 to $0.35
58782f5b: folds
Hero: calls $0.25
*** FLOP *** [Td 8h 3d]
d79b0c6a: bets $0.25
Hero: calls $0.25
*** TURN *** [Td 8h 3d] [Qh]
d79b0c6a: bets $0.75
Hero: folds
Uncalled bet ($0.75) returned to d79b0c6a
*** SHOWDOWN ***
d79b0c6a collected $1.19 from pot
*** SUMMARY ***
Total pot $1.25 | Rake $0.06 | Jackpot $0 | Bingo $0 | Fortune $0 | Tax $0
Board [Td 8h 3d Qh]
Seat 1: d21cc812 (button) folded before Flop (didn't bet)
Seat 2: d79b0c6a (small blind) won ($1.19)
Seat 3: 58782f5b (big blind) folded before Flop
Seat 4: Hero folded on the Turn
Seat 5: 834fcc3f folded before Flop (didn't bet)
Seat 6: 2486bc4b folded before Flop (didn't bet)


Poker Hand #RC2078585768: Hold'em No Limit ($0.02/$0.05) - 2023/12/22 22:04:57
Table 'RushAndCash807078' 6-max Seat #1 is the button
Seat 1: 834fcc3f ($9.54 in chips)
Seat 2: 440a38cc ($2.4 in chips)
Seat 3: Hero ($5.21 in chips)
Seat 4: c883264a ($9.38 in chips)
Seat 5: 28846e83 ($5.78 in chips)
Seat 6: d50b3b7c ($5.98 in chips)
440a38cc: posts small blind $0.02
Hero: posts big blind $0.05
*** HOLE CARDS ***
Dealt to 834fcc3f 
Dealt to 440a38cc 
Dealt to Hero [7s 7d]
Dealt to c883264a 
Dealt to 28846e83 
Dealt to d50b3b7c 
c883264a: folds
28846e83: folds
d50b3b7c: folds
834fcc3f: raises $0.07 to $0.12
440a38cc: folds
Hero: calls $0.07
*** FLOP *** [Qh 3d 9s]
Hero: checks
834fcc3f: bets $0.13
Hero: calls $0.13
*** TURN *** [Qh 3d 9s] [Kh]
Hero: checks
834fcc3f: bets $0.39
Hero: calls $0.39
*** RIVER *** [Qh 3d 9s Kh] [Ks]
Hero: checks
834fcc3f: checks
Hero: shows [7s 7d] (Pair of Kings and Pair of Sevens)
834fcc3f: shows [Th 8h] (Pair of Kings)
*** SHOWDOWN ***
Hero collected $1.24 from pot
*** SUMMARY ***
Total pot $1.3 | Rake $0.06 | Jackpot $0 | Bingo $0 | Fortune $0 | Tax $0
Board [Qh 3d 9s Kh Ks]
Seat 1: 834fcc3f (button) showed [Th 8h] and lost with Pair of Kings
Seat 2: 440a38cc (small blind) folded before Flop
Seat 3: Hero (big blind) showed [7s 7d] and won ($1.24) with Pair of Kings and Pair of Sevens
Seat 4: c883264a folded before Flop (didn't bet)
Seat 5: 28846e83 folded before Flop (didn't bet)
Seat 6: d50b3b7c folded before Flop (didn't bet)


Poker Hand #RC2078585566: Hold'em No Limit ($0.02/$0.05) - 2023/12/22 22:04:44
Table 'RushAndCash806986' 6-max Seat #1 is the button
Seat 1: 90a9fad4 ($52.44 in chips)
Seat 2: 38e42730 ($9.32 in chips)
Seat 3: a78fec7d ($5 in chips)
Seat 4: 31dd0354 ($5.06 in chips)
Seat 5: 78624e82 ($5.07 in chips)
Seat 6: Hero ($5.14 in chips)
38e42730: posts small blind $0.02
a78fec7d: posts big blind $0.05
*** HOLE CARDS ***
Dealt to 90a9fad4 
Dealt to 38e42730 
Dealt to a78fec7d 
Dealt to 31dd0354 
Dealt to 78624e82 
Dealt to Hero [3h 3d]
31dd0354: folds
78624e82: folds
Hero: raises $0.05 to $0.1
90a9fad4: folds
38e42730: folds
a78fec7d: folds
Uncalled bet ($0.05) returned to Hero
*** SHOWDOWN ***
Hero collected $0.12 from pot
*** SUMMARY ***
Total pot $0.12 | Rake $0 | Jackpot $0 | Bingo $0 | Fortune $0 | Tax $0
Seat 1: 90a9fad4 (button) folded before Flop (didn't bet)
Seat 2: 38e42730 (small blind) folded before Flop
Seat 3: a78fec7d (big blind) folded before Flop
Seat 4: 31dd0354 folded before Flop (didn't bet)
Seat 5: 78624e82 folded before Flop (didn't bet)
Seat 6: Hero collected ($0.12)


Poker Hand #RC2078585289: Hold'em No Limit ($0.02/$0.05) - 2023/12/22 22:04:28
Table 'RushAndCash806854' 6-max Seat #1 is the button
Seat 1: Hero ($5.07 in chips)
Seat 2: 6ded132b ($16.55 in chips)
Seat 3: 8f266bd0 ($5.37 in chips)
Seat 4: 404f9df4 ($6.05 in chips)
Seat 5: d14ab6dc ($5 in chips)
Seat 6: 35a2a674 ($1.45 in chips)
6ded132b: posts small blind $0.02
8f266bd0: posts big blind $0.05
*** HOLE CARDS ***
Dealt to Hero [Kh Ac]
Dealt to 6ded132b 
Dealt to 8f266bd0 
Dealt to 404f9df4 
Dealt to d14ab6dc 
Dealt to 35a2a674 
404f9df4: folds
d14ab6dc: folds
35a2a674: folds
Hero: raises $0.08 to $0.13
6ded132b: folds
8f266bd0: folds
Uncalled bet ($0.08) returned to Hero
*** SHOWDOWN ***
Hero collected $0.12 from pot
*** SUMMARY ***
Total pot $0.12 | Rake $0 | Jackpot $0 | Bingo $0 | Fortune $0 | Tax $0
Seat 1: Hero (button) collected ($0.12)
Seat 2: 6ded132b (small blind) folded before Flop
Seat 3: 8f266bd0 (big blind) folded before Flop
Seat 4: 404f9df4 folded before Flop (didn't bet)
Seat 5: d14ab6dc folded before Flop (didn't bet)
Seat 6: 35a2a674 folded before Flop (didn't bet)


Poker Hand #RC2078585142: Hold'em No Limit ($0.02/$0.05) - 2023/12/22 22:04:20
Table 'RushAndCash806789' 6-max Seat #1 is the button
Seat 1: 9e0b201b ($4.73 in chips)
Seat 2: 8014c02 ($8.89 in chips)
Seat 3: 3a20c3a ($10.25 in chips)
Seat 4: Hero ($5 in chips)
Seat 5: ee19881a ($5 in chips)
Seat 6: 73557c98 ($5 in chips)
8014c02: posts small blind $0.02
3a20c3a: posts big blind $0.05
*** HOLE CARDS ***
Dealt to 9e0b201b 
Dealt to 8014c02 
Dealt to 3a20c3a 
Dealt to Hero [Tc Ad]
Dealt to ee19881a 
Dealt to 73557c98 
Hero: raises $0.05 to $0.1
ee19881a: folds
73557c98: folds
9e0b201b: folds
8014c02: folds
3a20c3a: folds
Uncalled bet ($0.05) returned to Hero
*** SHOWDOWN ***
Hero collected $0.12 from pot
*** SUMMARY ***
Total pot $0.12 | Rake $0 | Jackpot $0 | Bingo $0 | Fortune $0 | Tax $0
Seat 1: 9e0b201b (button) folded before Flop (didn't bet)
Seat 2: 8014c02 (small blind) folded before Flop
Seat 3: 3a20c3a (big blind) folded before Flop
Seat 4: Hero collected ($0.12)
Seat 5: ee19881a folded before Flop (didn't bet)
Seat 6: 73557c98 folded before Flop (didn't bet)


Poker Hand #RC2078584919: Hold'em No Limit ($0.02/$0.05) - 2023/12/22 22:04:07
Table 'RushAndCash806685' 6-max Seat #1 is the button
Seat 1: 3f112fc ($5.09 in chips)
Seat 2: bfc64a4a ($10.36 in chips)
Seat 3: Hero ($5 in chips)
Seat 4: 59846dec ($7.61 in chips)
Seat 5: f4c57a5 ($8.13 in chips)
Seat 6: c3adc948 ($16.93 in chips)
bfc64a4a: posts small blind $0.02
Hero: posts big blind $0.05
*** HOLE CARDS ***
Dealt to 3f112fc 
Dealt to bfc64a4a 
Dealt to Hero [Qc 4d]
Dealt to 59846dec 
Dealt to f4c57a5 
Dealt to c3adc948 
59846dec: raises $0.1 to $0.15
f4c57a5: folds
c3adc948: raises $0.25 to $0.4
3f112fc: folds
bfc64a4a: folds
Hero: folds
59846dec: calls $0.25
*** FLOP *** [6h 8c 3h]
59846dec: checks
c3adc948: bets $0.44
59846dec: calls $0.44
*** TURN *** [6h 8c 3h] [Qs]
59846dec: checks
c3adc948: checks
*** RIVER *** [6h 8c 3h Qs] [9d]
59846dec: checks
c3adc948: bets $1.42
59846dec: calls $1.42
c3adc948: shows [Tc Td] (Pair of Tens)
59846dec: shows [7s 7d] (Pair of Sevens)
*** SHOWDOWN ***
c3adc948 collected $4.37 from pot
*** SUMMARY ***
Total pot $4.59 | Rake $0.15 | Jackpot $0.07 | Bingo $0 | Fortune $0 | Tax $0
Board [6h 8c 3h Qs 9d]
Seat 1: 3f112fc (button) folded before Flop (didn't bet)
Seat 2: bfc64a4a (small blind) folded before Flop
Seat 3: Hero (big blind) folded before Flop
Seat 4: 59846dec showed [7s 7d] and lost with Pair of Sevens
Seat 5: f4c57a5 folded before Flop (didn't bet)
Seat 6: c3adc948 showed [Tc Td] and won ($4.37) with Pair of Tens


Poker Hand #RC2078584737: Hold'em No Limit ($0.02/$0.05) - 2023/12/22 22:03:57
Table 'RushAndCash806606' 6-max Seat #1 is the button
Seat 1: 9645061f ($5.09 in chips)
Seat 2: 31dd0354 ($5.21 in chips)
Seat 3: 5208eb88 ($5 in chips)
Seat 4: 354c4fad ($4.85 in chips)
Seat 5: c8ce633e ($7.15 in chips)
Seat 6: Hero ($5 in chips)
31dd0354: posts small blind $0.02
5208eb88: posts big blind $0.05
*** HOLE CARDS ***
Dealt to 9645061f 
Dealt to 31dd0354 
Dealt to 5208eb88 
Dealt to 354c4fad 
Dealt to c8ce633e 
Dealt to Hero [8d 7d]
354c4fad: raises $0.05 to $0.1
c8ce633e: folds
Hero: folds
9645061f: folds
31dd0354: folds
5208eb88: calls $0.05
*** FLOP *** [4h 3c 5d]
5208eb88: checks
354c4fad: bets $0.11
5208eb88: calls $0.11
*** TURN *** [4h 3c 5d] [Qs]
5208eb88: checks
354c4fad: bets $0.31
5208eb88: calls $0.31
*** RIVER *** [4h 3c 5d Qs] [As]
5208eb88: checks
354c4fad: checks
5208eb88: shows [Jh Js] (Pair of Jacks)
354c4fad: shows [7s 7h] (Pair of Sevens)
*** SHOWDOWN ***
5208eb88 collected $1.01 from pot
*** SUMMARY ***
Total pot $1.06 | Rake $0.05 | Jackpot $0 | Bingo $0 | Fortune $0 | Tax $0
Board [4h 3c 5d Qs As]
Seat 1: 9645061f (button) folded before Flop (didn't bet)
Seat 2: 31dd0354 (small blind) folded before Flop
Seat 3: 5208eb88 (big blind) showed [Jh Js] and won ($1.01) with Pair of Jacks
Seat 4: 354c4fad showed [7s 7h] and lost with Pair of Sevens
Seat 5: c8ce633e folded before Flop (didn't bet)
Seat 6: Hero folded before Flop (didn't bet)


Poker Hand #RC2078584674: Hold'em No Limit ($0.02/$0.05) - 2023/12/22 22:03:53
Table 'RushAndCash806576' 6-max Seat #1 is the button
Seat 1: c9414c7d ($10.09 in chips)
Seat 2: 9942b4df ($10.71 in chips)
Seat 3: 5473ac67 ($6 in chips)
Seat 4: 50e2e09e ($5.7 in chips)
Seat 5: 4a05593f ($5.42 in chips)
Seat 6: Hero ($5 in chips)
9942b4df: posts small blind $0.02
5473ac67: posts big blind $0.05
*** HOLE CARDS ***
Dealt to c9414c7d 
Dealt to 9942b4df 
Dealt to 5473ac67 
Dealt to 50e2e09e 
Dealt to 4a05593f 
Dealt to Hero [Jd 3c]
50e2e09e: folds
4a05593f: folds
Hero: folds
c9414c7d: raises $0.07 to $0.12
9942b4df: calls $0.1
5473ac67: calls $0.07
*** FLOP *** [Jc 6s Kd]
9942b4df: checks
5473ac67: checks
c9414c7d: bets $0.12
9942b4df: calls $0.12
5473ac67: calls $0.12
*** TURN *** [Jc 6s Kd] [Td]
9942b4df: checks
5473ac67: checks
c9414c7d: checks
*** RIVER *** [Jc 6s Kd Td] [9d]
9942b4df: checks
5473ac67: bets $0.9
c9414c7d: calls $0.9
9942b4df: folds
5473ac67: shows [Ts Qs] (Kings-High Straight)
c9414c7d: shows [4d 5d] (King High Flush)
*** SHOWDOWN ***
c9414c7d collected $2.33 from pot
*** SUMMARY ***
Total pot $2.52 | Rake $0.12 | Jackpot $0.07 | Bingo $0 | Fortune $0 | Tax $0
Board [Jc 6s Kd Td 9d]
Seat 1: c9414c7d (button) showed [4d 5d] and won ($2.33) with King High Flush
Seat 2: 9942b4df (small blind) folded on the River
Seat 3: 5473ac67 (big blind) showed [Ts Qs] and lost with Kings-High Straight
Seat 4: 50e2e09e folded before Flop (didn't bet)
Seat 5: 4a05593f folded before Flop (didn't bet)
Seat 6: Hero folded before Flop (didn't bet)


Poker Hand #RC2078584615: Hold'em No Limit ($0.02/$0.05) - 2023/12/22 22:03:49
Table 'RushAndCash806549' 6-max Seat #1 is the button
Seat 1: c550b71c ($6.34 in chips)
Seat 2: e7562cd9 ($8.08 in chips)
Seat 3: Hero ($5.05 in chips)
Seat 4: da6ead6f ($5.51 in chips)
Seat 5: fe92c523 ($5.75 in chips)
Seat 6: 6969351a ($10.69 in chips)
e7562cd9: posts small blind $0.02
Hero: posts big blind $0.05
*** HOLE CARDS ***
Dealt to c550b71c 
Dealt to e7562cd9 
Dealt to Hero [7d Th]
Dealt to da6ead6f 
Dealt to fe92c523 
Dealt to 6969351a 
da6ead6f: folds
fe92c523: raises $0.05 to $0.1
6969351a: folds
c550b71c: folds
e7562cd9: raises $0.45 to $0.55
Hero: folds
fe92c523: calls $0.45
*** FLOP *** [5s Js 4h]
e7562cd9: bets $0.87
fe92c523: folds
Uncalled bet ($0.87) returned to e7562cd9
*** SHOWDOWN ***
e7562cd9 collected $1.1 from pot
*** SUMMARY ***
Total pot $1.15 | Rake $0.05 | Jackpot $0 | Bingo $0 | Fortune $0 | Tax $0
Board [5s Js 4h]
Seat 1: c550b71c (button) folded before Flop (didn't bet)
Seat 2: e7562cd9 (small blind) won ($1.1)
Seat 3: Hero (big blind) folded before Flop
Seat 4: da6ead6f folded before Flop (didn't bet)
Seat 5: fe92c523 folded on the Flop
Seat 6: 6969351a folded before Flop (didn't bet)


Poker Hand #RC2078584552: Hold'em No Limit ($0.02/$0.05) - 2023/12/22 22:03:45
Table 'RushAndCash806520' 6-max Seat #1 is the button
Seat 1: d25e9ff3 ($6.04 in chips)
Seat 2: 32c92a7b ($5.33 in chips)
Seat 3: 471859f5 ($5.07 in chips)
Seat 4: Hero ($5.05 in chips)
Seat 5: 8014c02 ($8.91 in chips)
Seat 6: bfc64a4a ($10.41 in chips)
32c92a7b: posts small blind $0.02
471859f5: posts big blind $0.05
*** HOLE CARDS ***
Dealt to d25e9ff3 
Dealt to 32c92a7b 
Dealt to 471859f5 
Dealt to Hero [Jh Kd]
Dealt to 8014c02 
Dealt to bfc64a4a 
Hero: folds
8014c02: folds
bfc64a4a: folds
d25e9ff3: folds
32c92a7b: raises $0.1 to $0.15
471859f5: folds
Uncalled bet ($0.1) returned to 32c92a7b
*** SHOWDOWN ***
32c92a7b collected $0.1 from pot
*** SUMMARY ***
Total pot $0.1 | Rake $0 | Jackpot $0 | Bingo $0 | Fortune $0 | Tax $0
Seat 1: d25e9ff3 (button) folded before Flop (didn't bet)
Seat 2: 32c92a7b (small blind) collected ($0.1)
Seat 3: 471859f5 (big blind) folded before Flop
Seat 4: Hero folded before Flop (didn't bet)
Seat 5: 8014c02 folded before Flop (didn't bet)
Seat 6: bfc64a4a folded before Flop (didn't bet)


Poker Hand #RC2078584365: Hold'em No Limit ($0.02/$0.05) - 2023/12/22 22:03:34
Table 'RushAndCash806435' 6-max Seat #1 is the button
Seat 1: f9e33171 ($5 in chips)
Seat 2: Hero ($5.07 in chips)
Seat 3: 44ded10d ($5.07 in chips)
Seat 4: 6fc982d6 ($5.09 in chips)
Seat 5: c8adf5d ($7.42 in chips)
Seat 6: 77a2d2f ($4.51 in chips)
Hero: posts small blind $0.02
44ded10d: posts big blind $0.05
*** HOLE CARDS ***
Dealt to f9e33171 
Dealt to Hero [6d Kd]
Dealt to 44ded10d 
Dealt to 6fc982d6 
Dealt to c8adf5d 
Dealt to 77a2d2f 
6fc982d6: folds
c8adf5d: folds
77a2d2f: raises $0.1 to $0.15
f9e33171: folds
Hero: folds
44ded10d: folds
Uncalled bet ($0.1) returned to 77a2d2f
*** SHOWDOWN ***
77a2d2f collected $0.12 from pot
*** SUMMARY ***
Total pot $0.12 | Rake $0 | Jackpot $0 | Bingo $0 | Fortune $0 | Tax $0
Seat 1: f9e33171 (button) folded before Flop (didn't bet)
Seat 2: Hero (small blind) folded before Flop
Seat 3: 44ded10d (big blind) folded before Flop
Seat 4: 6fc982d6 folded before Flop (didn't bet)
Seat 5: c8adf5d folded before Flop (didn't bet)
Seat 6: 77a2d2f collected ($0.12)


Poker Hand #RC2078584305: Hold'em No Limit ($0.02/$0.05) - 2023/12/22 22:03:30
Table 'RushAndCash806408' 6-max Seat #1 is the button
Seat 1: b55e2f56 ($4.13 in chips)
Seat 2: eeb37e34 ($9.06 in chips)
Seat 3: 1c5ffeb9 ($6.08 in chips)
Seat 4: Hero ($5.07 in chips)
Seat 5: d23c04d ($10.99 in chips)
Seat 6: 28985ec8 ($7.12 in chips)
eeb37e34: posts small blind $0.02
1c5ffeb9: posts big blind $0.05
*** HOLE CARDS ***
Dealt to b55e2f56 
Dealt to eeb37e34 
Dealt to 1c5ffeb9 
Dealt to Hero [5s 2d]
Dealt to d23c04d 
Dealt to 28985ec8 
Hero: folds
d23c04d: folds
28985ec8: raises $0.08 to $0.13
b55e2f56: folds
eeb37e34: folds
1c5ffeb9: folds
Uncalled bet ($0.08) returned to 28985ec8
*** SHOWDOWN ***
28985ec8 collected $0.12 from pot
*** SUMMARY ***
Total pot $0.12 | Rake $0 | Jackpot $0 | Bingo $0 | Fortune $0 | Tax $0
Seat 1: b55e2f56 (button) folded before Flop (didn't bet)
Seat 2: eeb37e34 (small blind) folded before Flop
Seat 3: 1c5ffeb9 (big blind) folded before Flop
Seat 4: Hero folded before Flop (didn't bet)
Seat 5: d23c04d folded before Flop (didn't bet)
Seat 6: 28985ec8 collected ($0.12)


Poker Hand #RC2078584041: Hold'em No Limit ($0.02/$0.05) - 2023/12/22 22:03:14
Table 'RushAndCash806286' 6-max Seat #1 is the button
Seat 1: Hero ($5 in chips)
Seat 2: 3b322324 ($5.82 in chips)
Seat 3: b4aaf9de ($12 in chips)
Seat 4: 2df55086 ($8.88 in chips)
Seat 5: b6451f9b ($5.14 in chips)
Seat 6: 7a7585e4 ($4.93 in chips)
3b322324: posts small blind $0.02
b4aaf9de: posts big blind $0.05
*** HOLE CARDS ***
Dealt to Hero [Qs Ks]
Dealt to 3b322324 
Dealt to b4aaf9de 
Dealt to 2df55086 
Dealt to b6451f9b 
Dealt to 7a7585e4 
2df55086: folds
b6451f9b: folds
7a7585e4: folds
Hero: raises $0.08 to $0.13
3b322324: folds
b4aaf9de: folds
Uncalled bet ($0.08) returned to Hero
*** SHOWDOWN ***
Hero collected $0.12 from pot
*** SUMMARY ***
Total pot $0.12 | Rake $0 | Jackpot $0 | Bingo $0 | Fortune $0 | Tax $0
Seat 1: Hero (button) collected ($0.12)
Seat 2: 3b322324 (small blind) folded before Flop
Seat 3: b4aaf9de (big blind) folded before Flop
Seat 4: 2df55086 folded before Flop (didn't bet)
Seat 5: b6451f9b folded before Flop (didn't bet)
Seat 6: 7a7585e4 folded before Flop (didn't bet)


Poker Hand #RC2078583929: Hold'em No Limit ($0.02/$0.05) - 2023/12/22 22:03:08
Table 'RushAndCash806232' 6-max Seat #1 is the button
Seat 1: 129846c0 ($6.72 in chips)
Seat 2: Hero ($5.02 in chips)
Seat 3: cb9a7609 ($5.51 in chips)
Seat 4: 4520f334 ($3.95 in chips)
Seat 5: 9e9d954c ($5.72 in chips)
Seat 6: 3160ff3c ($17.19 in chips)
Hero: posts small blind $0.02
cb9a7609: posts big blind $0.05
*** HOLE CARDS ***
Dealt to 129846c0 
Dealt to Hero [Jd 7s]
Dealt to cb9a7609 
Dealt to 4520f334 
Dealt to 9e9d954c 
Dealt to 3160ff3c 
4520f334: folds
9e9d954c: raises $0.05 to $0.1
3160ff3c: folds
129846c0: folds
Hero: folds
cb9a7609: calls $0.05
*** FLOP *** [Td 6h 4d]
cb9a7609: checks
9e9d954c: bets $0.08
cb9a7609: folds
Uncalled bet ($0.08) returned to 9e9d954c
*** SHOWDOWN ***
9e9d954c collected $0.21 from pot
*** SUMMARY ***
Total pot $0.22 | Rake $0.01 | Jackpot $0 | Bingo $0 | Fortune $0 | Tax $0
Board [Td 6h 4d]
Seat 1: 129846c0 (button) folded before Flop (didn't bet)
Seat 2: Hero (small blind) folded before Flop
Seat 3: cb9a7609 (big blind) folded on the Flop
Seat 4: 4520f334 folded before Flop (didn't bet)
Seat 5: 9e9d954c won ($0.21)
Seat 6: 3160ff3c folded before Flop (didn't bet)


Poker Hand #RC2078583818: Hold'em No Limit ($0.02/$0.05) - 2023/12/22 22:03:01
Table 'RushAndCash806179' 6-max Seat #1 is the button
Seat 1: f7ea1894 ($7.94 in chips)
Seat 2: 153b1345 ($8.22 in chips)
Seat 3: 3fbf5f96 ($13.78 in chips)
Seat 4: 21a497ff ($5.37 in chips)
Seat 5: 5dc5e04c ($5 in chips)
Seat 6: Hero ($5.02 in chips)
153b1345: posts small blind $0.02
3fbf5f96: posts big blind $0.05
*** HOLE CARDS ***
Dealt to f7ea1894 
Dealt to 153b1345 
Dealt to 3fbf5f96 
Dealt to 21a497ff 
Dealt to 5dc5e04c 
Dealt to Hero [Jh Ts]
21a497ff: folds
5dc5e04c: folds
Hero: folds
f7ea1894: folds
153b1345: raises $0.1 to $0.15
3fbf5f96: calls $0.1
*** FLOP *** [Td 3s 4s]
153b1345: bets $0.1
3fbf5f96: calls $0.1
*** TURN *** [Td 3s 4s] [6h]
153b1345: checks
3fbf5f96: checks
*** RIVER *** [Td 3s 4s 6h] [3d]
153b1345: checks
3fbf5f96: bets $0.19
153b1345: folds
Uncalled bet ($0.19) returned to 3fbf5f96
*** SHOWDOWN ***
3fbf5f96 collected $0.48 from pot
*** SUMMARY ***
Total pot $0.5 | Rake $0.02 | Jackpot $0 | Bingo $0 | Fortune $0 | Tax $0
Board [Td 3s 4s 6h 3d]
Seat 1: f7ea1894 (button) folded before Flop (didn't bet)
Seat 2: 153b1345 (small blind) folded on the River
Seat 3: 3fbf5f96 (big blind) won ($0.48)
Seat 4: 21a497ff folded before Flop (didn't bet)
Seat 5: 5dc5e04c folded before Flop (didn't bet)
Seat 6: Hero folded before Flop (didn't bet)


Poker Hand #RC2078583735: Hold'em No Limit ($0.02/$0.05) - 2023/12/22 22:02:57
Table 'RushAndCash806138' 6-max Seat #1 is the button
Seat 1: Hero ($5.02 in chips)
Seat 2: b4951495 ($4 in chips)
Seat 3: c8adf5d ($7.54 in chips)
Seat 4: 2b33eb01 ($5.1 in chips)
Seat 5: 129846c0 ($6.77 in chips)
Seat 6: 20ec78d4 ($5.4 in chips)
b4951495: posts small blind $0.02
c8adf5d: posts big blind $0.05
*** HOLE CARDS ***
Dealt to Hero [5s Ah]
Dealt to b4951495 
Dealt to c8adf5d 
Dealt to 2b33eb01 
Dealt to 129846c0 
Dealt to 20ec78d4 
2b33eb01: folds
129846c0: folds
20ec78d4: folds
Hero: folds
b4951495: calls $0.03
c8adf5d: checks
*** FLOP *** [2d 4c 4d]
b4951495: checks
c8adf5d: checks
*** TURN *** [2d 4c 4d] [Ks]
b4951495: bets $0.05
c8adf5d: folds
Uncalled bet ($0.05) returned to b4951495
*** SHOWDOWN ***
b4951495 collected $0.1 from pot
*** SUMMARY ***
Total pot $0.1 | Rake $0 | Jackpot $0 | Bingo $0 | Fortune $0 | Tax $0
Board [2d 4c 4d Ks]
Seat 1: Hero (button) folded before Flop (didn't bet)
Seat 2: b4951495 (small blind) won ($0.1)
Seat 3: c8adf5d (big blind) folded on the Turn
Seat 4: 2b33eb01 folded before Flop (didn't bet)
Seat 5: 129846c0 folded before Flop (didn't bet)
Seat 6: 20ec78d4 folded before Flop (didn't bet)


Poker Hand #RC2078583525: Hold'em No Limit ($0.02/$0.05) - 2023/12/22 22:02:45
Table 'RushAndCash806036' 6-max Seat #1 is the button
Seat 1: 8d188907 ($5.07 in chips)
Seat 2: 37951557 ($5 in chips)
Seat 3: Hero ($5 in chips)
Seat 4: 2afe98d4 ($4.96 in chips)
Seat 5: 834fcc3f ($9.3 in chips)
Seat 6: bb8cf690 ($5 in chips)
37951557: posts small blind $0.02
Hero: posts big blind $0.05
*** HOLE CARDS ***
Dealt to 8d188907 
Dealt to 37951557 
Dealt to Hero [Qh 7s]
Dealt to 2afe98d4 
Dealt to 834fcc3f 
Dealt to bb8cf690 
2afe98d4: folds
834fcc3f: folds
bb8cf690: folds
8d188907: folds
37951557: folds
Uncalled bet ($0.03) returned to Hero
*** SHOWDOWN ***
Hero collected $0.04 from pot
*** SUMMARY ***
Total pot $0.04 | Rake $0 | Jackpot $0 | Bingo $0 | Fortune $0 | Tax $0
Seat 1: 8d188907 (button) folded before Flop (didn't bet)
Seat 2: 37951557 (small blind) folded before Flop
Seat 3: Hero (big blind) collected ($0.04)
Seat 4: 2afe98d4 folded before Flop (didn't bet)
Seat 5: 834fcc3f folded before Flop (didn't bet)
Seat 6: bb8cf690 folded before Flop (didn't bet)


Poker Hand #RC2078582724: Hold'em No Limit ($0.02/$0.05) - 2023/12/22 22:01:58
Table 'RushAndCash805661' 6-max Seat #1 is the button
Seat 1: 8f1a23de ($6.56 in chips)
Seat 2: Hero ($5.58 in chips)
Seat 3: d4d7018e ($6.13 in chips)
Seat 4: 7f067c94 ($45.16 in chips)
Seat 5: d198170b ($5.13 in chips)
Seat 6: d23c04d ($11.19 in chips)
Hero: posts small blind $0.02
d4d7018e: posts big blind $0.05
*** HOLE CARDS ***
Dealt to 8f1a23de 
Dealt to Hero [4d 5d]
Dealt to d4d7018e 
Dealt to 7f067c94 
Dealt to d198170b 
Dealt to d23c04d 
7f067c94: folds
d198170b: folds
d23c04d: folds
8f1a23de: raises $0.06 to $0.11
Hero: calls $0.09
d4d7018e: calls $0.06
*** FLOP *** [5c Ad Kh]
Hero: bets $0.15
d4d7018e: calls $0.15
8f1a23de: calls $0.15
*** TURN *** [5c Ad Kh] [7d]
Hero: bets $0.39
d4d7018e: calls $0.39
8f1a23de: folds
*** RIVER *** [5c Ad Kh 7d] [8s]
Hero: checks
d4d7018e: checks
Hero: shows [4d 5d] (Pair of Fives)
d4d7018e: shows [As Th] (Pair of Aces)
*** SHOWDOWN ***
d4d7018e collected $1.42 from pot
*** SUMMARY ***
Total pot $1.56 | Rake $0.07 | Jackpot $0.07 | Bingo $0 | Fortune $0 | Tax $0
Board [5c Ad Kh 7d 8s]
Seat 1: 8f1a23de (button) folded on the Turn
Seat 2: Hero (small blind) showed [4d 5d] and lost with Pair of Fives
Seat 3: d4d7018e (big blind) showed [As Th] and won ($1.42) with Pair of Aces
Seat 4: 7f067c94 folded before Flop (didn't bet)
Seat 5: d198170b folded before Flop (didn't bet)
Seat 6: d23c04d folded before Flop (didn't bet)


Poker Hand #RC2078582548: Hold'em No Limit ($0.02/$0.05) - 2023/12/22 22:01:48
Table 'RushAndCash805574' 6-max Seat #1 is the button
Seat 1: d50b3b7c ($6.24 in chips)
Seat 2: c7d7813b ($5.14 in chips)
Seat 3: 20b21409 ($5 in chips)
Seat 4: 4879e77e ($5.99 in chips)
Seat 5: Hero ($5.58 in chips)
Seat 6: 9c51ae09 ($5.67 in chips)
c7d7813b: posts small blind $0.02
20b21409: posts big blind $0.05
*** HOLE CARDS ***
Dealt to d50b3b7c 
Dealt to c7d7813b 
Dealt to 20b21409 
Dealt to 4879e77e 
Dealt to Hero [2c Kc]
Dealt to 9c51ae09 
4879e77e: raises $0.06 to $0.11
Hero: folds
9c51ae09: folds
d50b3b7c: raises $0.24 to $0.35
c7d7813b: folds
20b21409: folds
4879e77e: raises $0.63 to $0.98
d50b3b7c: calls $0.63
*** FLOP *** [6d Tc Ac]
4879e77e: bets $0.7
d50b3b7c: folds
Uncalled bet ($0.7) returned to 4879e77e
*** SHOWDOWN ***
4879e77e collected $1.87 from pot
*** SUMMARY ***
Total pot $2.03 | Rake $0.09 | Jackpot $0.07 | Bingo $0 | Fortune $0 | Tax $0
Board [6d Tc Ac]
Seat 1: d50b3b7c (button) folded on the Flop
Seat 2: c7d7813b (small blind) folded before Flop
Seat 3: 20b21409 (big blind) folded before Flop
Seat 4: 4879e77e won ($1.87)
Seat 5: Hero folded before Flop (didn't bet)
Seat 6: 9c51ae09 folded before Flop (didn't bet)


Poker Hand #RC2078582413: Hold'em No Limit ($0.02/$0.05) - 2023/12/22 22:01:40
Table 'RushAndCash805517' 6-max Seat #1 is the button
Seat 1: 3bf3ab5a ($3.35 in chips)
Seat 2: bba39737 ($6.9 in chips)
Seat 3: 6e0be8e1 ($5.78 in chips)
Seat 4: Hero ($5.58 in chips)
Seat 5: c4382072 ($6.05 in chips)
Seat 6: 25a36e51 ($0.75 in chips)
bba39737: posts small blind $0.02
6e0be8e1: posts big blind $0.05
*** HOLE CARDS ***
Dealt to 3bf3ab5a 
Dealt to bba39737 
Dealt to 6e0be8e1 
Dealt to Hero [3d 9c]
Dealt to c4382072 
Dealt to 25a36e51 
Hero: folds
c4382072: folds
25a36e51: raises $0.05 to $0.1
3bf3ab5a: folds
bba39737: folds
6e0be8e1: folds
Uncalled bet ($0.05) returned to 25a36e51
*** SHOWDOWN ***
25a36e51 collected $0.12 from pot
*** SUMMARY ***
Total pot $0.12 | Rake $0 | Jackpot $0 | Bingo $0 | Fortune $0 | Tax $0
Seat 1: 3bf3ab5a (button) folded before Flop (didn't bet)
Seat 2: bba39737 (small blind) folded before Flop
Seat 3: 6e0be8e1 (big blind) folded before Flop
Seat 4: Hero folded before Flop (didn't bet)
Seat 5: c4382072 folded before Flop (didn't bet)
Seat 6: 25a36e51 collected ($0.12)


Poker Hand #RC2078582317: Hold'em No Limit ($0.02/$0.05) - 2023/12/22 22:01:35
Table 'RushAndCash805474' 6-max Seat #1 is the button
Seat 1: Hero ($5.58 in chips)
Seat 2: 21adc60b ($5.18 in chips)
Seat 3: ed26e80a ($8.71 in chips)
Seat 4: 53ca81bf ($9.02 in chips)
Seat 5: 452fead6 ($5.21 in chips)
Seat 6: ea71423 ($5.28 in chips)
21adc60b: posts small blind $0.02
ed26e80a: posts big blind $0.05
*** HOLE CARDS ***
Dealt to Hero [5h 7s]
Dealt to 21adc60b 
Dealt to ed26e80a 
Dealt to 53ca81bf 
Dealt to 452fead6 
Dealt to ea71423 
53ca81bf: folds
452fead6: raises $0.06 to $0.11
ea71423: folds
Hero: folds
21adc60b: folds
ed26e80a: folds
Uncalled bet ($0.06) returned to 452fead6
*** SHOWDOWN ***
452fead6 collected $0.12 from pot
*** SUMMARY ***
Total pot $0.12 | Rake $0 | Jackpot $0 | Bingo $0 | Fortune $0 | Tax $0
Seat 1: Hero (button) folded before Flop (didn't bet)
Seat 2: 21adc60b (small blind) folded before Flop
Seat 3: ed26e80a (big blind) folded before Flop
Seat 4: 53ca81bf folded before Flop (didn't bet)
Seat 5: 452fead6 collected ($0.12)
Seat 6: ea71423 folded before Flop (didn't bet)


Poker Hand #RC2078582079: Hold'em No Limit ($0.02/$0.05) - 2023/12/22 22:01:21
Table 'RushAndCash805364' 6-max Seat #1 is the button
Seat 1: 88e57a08 ($15.17 in chips)
Seat 2: Hero ($5.6 in chips)
Seat 3: 50e2e09e ($5.14 in chips)
Seat 4: 846054b0 ($9.38 in chips)
Seat 5: 2afe98d4 ($5.62 in chips)
Seat 6: efbf8ee8 ($12.74 in chips)
Hero: posts small blind $0.02
50e2e09e: posts big blind $0.05
*** HOLE CARDS ***
Dealt to 88e57a08 
Dealt to Hero [6c 9c]
Dealt to 50e2e09e 
Dealt to 846054b0 
Dealt to 2afe98d4 
Dealt to efbf8ee8 
846054b0: folds
2afe98d4: folds
efbf8ee8: folds
88e57a08: folds
Hero: folds
Uncalled bet ($0.03) returned to 50e2e09e
*** SHOWDOWN ***
50e2e09e collected $0.04 from pot
*** SUMMARY ***
Total pot $0.04 | Rake $0 | Jackpot $0 | Bingo $0 | Fortune $0 | Tax $0
Seat 1: 88e57a08 (button) folded before Flop (didn't bet)
Seat 2: Hero (small blind) folded before Flop
Seat 3: 50e2e09e (big blind) collected ($0.04)
Seat 4: 846054b0 folded before Flop (didn't bet)
Seat 5: 2afe98d4 folded before Flop (didn't bet)
Seat 6: efbf8ee8 folded before Flop (didn't bet)


Poker Hand #RC2078581872: Hold'em No Limit ($0.02/$0.05) - 2023/12/22 22:01:09
Table 'RushAndCash805270' 6-max Seat #1 is the button
Seat 1: 34886d8c ($5 in chips)
Seat 2: c8adf5d ($7.07 in chips)
Seat 3: Hero ($5.65 in chips)
Seat 4: 84dda8d8 ($5.03 in chips)
Seat 5: cd02a153 ($6.34 in chips)
Seat 6: f71b25e9 ($7.58 in chips)
c8adf5d: posts small blind $0.02
Hero: posts big blind $0.05
*** HOLE CARDS ***
Dealt to 34886d8c 
Dealt to c8adf5d 
Dealt to Hero [8s 7d]
Dealt to 84dda8d8 
Dealt to cd02a153 
Dealt to f71b25e9 
84dda8d8: raises $0.05 to $0.1
cd02a153: folds
f71b25e9: folds
34886d8c: folds
c8adf5d: folds
Hero: folds
Uncalled bet ($0.05) returned to 84dda8d8
*** SHOWDOWN ***
84dda8d8 collected $0.12 from pot
*** SUMMARY ***
Total pot $0.12 | Rake $0 | Jackpot $0 | Bingo $0 | Fortune $0 | Tax $0
Seat 1: 34886d8c (button) folded before Flop (didn't bet)
Seat 2: c8adf5d (small blind) folded before Flop
Seat 3: Hero (big blind) folded before Flop
Seat 4: 84dda8d8 collected ($0.12)
Seat 5: cd02a153 folded before Flop (didn't bet)
Seat 6: f71b25e9 folded before Flop (didn't bet)


Poker Hand #RC2078581812: Hold'em No Limit ($0.02/$0.05) - 2023/12/22 22:01:05
Table 'RushAndCash805247' 6-max Seat #1 is the button
Seat 1: 3f7ed7e8 ($6.15 in chips)
Seat 2: abc633d7 ($6.65 in chips)
Seat 3: c4535555 ($4.74 in chips)
Seat 4: 5a7ccd94 ($5.53 in chips)
Seat 5: Hero ($5.65 in chips)
Seat 6: 1968b4b2 ($1.79 in chips)
abc633d7: posts small blind $0.02
c4535555: posts big blind $0.05
*** HOLE CARDS ***
Dealt to 3f7ed7e8 
Dealt to abc633d7 
Dealt to c4535555 
Dealt to 5a7ccd94 
Dealt to Hero [6c 4h]
Dealt to 1968b4b2 
5a7ccd94: raises $0.05 to $0.1
Hero: folds
1968b4b2: folds
3f7ed7e8: folds
abc633d7: folds
c4535555: calls $0.05
*** FLOP *** [5s 9s 7c]
c4535555: checks
5a7ccd94: bets $0.08
c4535555: calls $0.08
*** TURN *** [5s 9s 7c] [Qd]
c4535555: checks
5a7ccd94: bets $0.13
c4535555: calls $0.13
*** RIVER *** [5s 9s 7c Qd] [9d]
c4535555: checks
5a7ccd94: checks
c4535555: shows [Ad 6h] (Pair of Nines)
5a7ccd94: shows [8h Th] (Pair of Nines)
*** SHOWDOWN ***
c4535555 collected $0.61 from pot
*** SUMMARY ***
Total pot $0.64 | Rake $0.03 | Jackpot $0 | Bingo $0 | Fortune $0 | Tax $0
Board [5s 9s 7c Qd 9d]
Seat 1: 3f7ed7e8 (button) folded before Flop (didn't bet)
Seat 2: abc633d7 (small blind) folded before Flop
Seat 3: c4535555 (big blind) showed [Ad 6h] and won ($0.61) with Pair of Nines
Seat 4: 5a7ccd94 showed [8h Th] and lost with Pair of Nines
Seat 5: Hero folded before Flop (didn't bet)
Seat 6: 1968b4b2 folded before Flop (didn't bet)


Poker Hand #RC2078581748: Hold'em No Limit ($0.02/$0.05) - 2023/12/22 22:01:01
Table 'RushAndCash805219' 6-max Seat #1 is the button
Seat 1: aeeb0181 ($12.05 in chips)
Seat 2: 15b7de4f ($5.11 in chips)
Seat 3: 21adc60b ($5.28 in chips)
Seat 4: ea9bed4a ($7.7 in chips)
Seat 5: Hero ($5.65 in chips)
Seat 6: e527ebf4 ($5.69 in chips)
15b7de4f: posts small blind $0.02
21adc60b: posts big blind $0.05
*** HOLE CARDS ***
Dealt to aeeb0181 
Dealt to 15b7de4f 
Dealt to 21adc60b 
Dealt to ea9bed4a 
Dealt to Hero [Ts 6c]
Dealt to e527ebf4 
ea9bed4a: raises $0.08 to $0.13
Hero: folds
e527ebf4: folds
aeeb0181: folds
15b7de4f: folds
21adc60b: folds
Uncalled bet ($0.08) returned to ea9bed4a
*** SHOWDOWN ***
ea9bed4a collected $0.12 from pot
*** SUMMARY ***
Total pot $0.12 | Rake $0 | Jackpot $0 | Bingo $0 | Fortune $0 | Tax $0
Seat 1: aeeb0181 (button) folded before Flop (didn't bet)
Seat 2: 15b7de4f (small blind) folded before Flop
Seat 3: 21adc60b (big blind) folded before Flop
Seat 4: ea9bed4a collected ($0.12)
Seat 5: Hero folded before Flop (didn't bet)
Seat 6: e527ebf4 folded before Flop (didn't bet)


Poker Hand #RC2078581042: Hold'em No Limit ($0.02/$0.05) - 2023/12/22 22:00:21
Table 'RushAndCash804879' 6-max Seat #1 is the button
Seat 1: e527ebf4 ($5.99 in chips)
Seat 2: e0e4307b ($6.38 in chips)
Seat 3: e7ed98a7 ($5.07 in chips)
Seat 4: d8c6faef ($4.54 in chips)
Seat 5: 74a53cac ($20.08 in chips)
Seat 6: Hero ($5.31 in chips)
e0e4307b: posts small blind $0.02
e7ed98a7: posts big blind $0.05
*** HOLE CARDS ***
Dealt to e527ebf4 
Dealt to e0e4307b 
Dealt to e7ed98a7 
Dealt to d8c6faef 
Dealt to 74a53cac 
Dealt to Hero [9d 9s]
d8c6faef: folds
74a53cac: folds
Hero: raises $0.05 to $0.1
e527ebf4: raises $0.2 to $0.3
e0e4307b: folds
e7ed98a7: folds
Hero: raises $0.61 to $0.91
e527ebf4: folds
Uncalled bet ($0.61) returned to Hero
*** SHOWDOWN ***
Hero collected $0.64 from pot
*** SUMMARY ***
Total pot $0.67 | Rake $0.03 | Jackpot $0 | Bingo $0 | Fortune $0 | Tax $0
Seat 1: e527ebf4 (button) folded before Flop
Seat 2: e0e4307b (small blind) folded before Flop
Seat 3: e7ed98a7 (big blind) folded before Flop
Seat 4: d8c6faef folded before Flop (didn't bet)
Seat 5: 74a53cac folded before Flop (didn't bet)
Seat 6: Hero collected ($0.64)


Poker Hand #RC2078580912: Hold'em No Limit ($0.02/$0.05) - 2023/12/22 22:00:14
Table 'RushAndCash804821' 6-max Seat #1 is the button
Seat 1: 6ded132b ($13.46 in chips)
Seat 2: fafe49aa ($7.42 in chips)
Seat 3: 5cb14769 ($8.64 in chips)
Seat 4: Hero ($5.31 in chips)
Seat 5: 3f7ed7e8 ($6.13 in chips)
Seat 6: bf955ffb ($8.03 in chips)
fafe49aa: posts small blind $0.02
5cb14769: posts big blind $0.05
*** HOLE CARDS ***
Dealt to 6ded132b 
Dealt to fafe49aa 
Dealt to 5cb14769 
Dealt to Hero [Js 3s]
Dealt to 3f7ed7e8 
Dealt to bf955ffb 
Hero: folds
3f7ed7e8: folds
bf955ffb: folds
6ded132b: folds
fafe49aa: folds
Uncalled bet ($0.03) returned to 5cb14769
*** SHOWDOWN ***
5cb14769 collected $0.04 from pot
*** SUMMARY ***
Total pot $0.04 | Rake $0 | Jackpot $0 | Bingo $0 | Fortune $0 | Tax $0
Seat 1: 6ded132b (button) folded before Flop (didn't bet)
Seat 2: fafe49aa (small blind) folded before Flop
Seat 3: 5cb14769 (big blind) collected ($0.04)
Seat 4: Hero folded before Flop (didn't bet)
Seat 5: 3f7ed7e8 folded before Flop (didn't bet)
Seat 6: bf955ffb folded before Flop (didn't bet)


Poker Hand #RC2078580830: Hold'em No Limit ($0.02/$0.05) - 2023/12/22 22:00:09
Table 'RushAndCash804784' 6-max Seat #1 is the button
Seat 1: Hero ($5.31 in chips)
Seat 2: 5896c682 ($4.23 in chips)
Seat 3: dfd36278 ($5 in chips)
Seat 4: 5cb14769 ($8.64 in chips)
Seat 5: 9601129f ($8.81 in chips)
Seat 6: c71b7029 ($8.99 in chips)
5896c682: posts small blind $0.02
dfd36278: posts big blind $0.05
*** HOLE CARDS ***
Dealt to Hero [9c 8d]
Dealt to 5896c682 
Dealt to dfd36278 
Dealt to 5cb14769 
Dealt to 9601129f 
Dealt to c71b7029 
5cb14769: folds
9601129f: folds
c71b7029: folds
Hero: folds
5896c682: raises $0.08 to $0.13
dfd36278: folds
Uncalled bet ($0.08) returned to 5896c682
*** SHOWDOWN ***
5896c682 collected $0.1 from pot
*** SUMMARY ***
Total pot $0.1 | Rake $0 | Jackpot $0 | Bingo $0 | Fortune $0 | Tax $0
Seat 1: Hero (button) folded before Flop (didn't bet)
Seat 2: 5896c682 (small blind) collected ($0.1)
Seat 3: dfd36278 (big blind) folded before Flop
Seat 4: 5cb14769 folded before Flop (didn't bet)
Seat 5: 9601129f folded before Flop (didn't bet)
Seat 6: c71b7029 folded before Flop (didn't bet)


Poker Hand #RC2078580054: Hold'em No Limit ($0.02/$0.05) - 2023/12/22 21:59:23
Table 'RushAndCash804430' 6-max Seat #1 is the button
Seat 1: Hero ($5.77 in chips)
Seat 2: 765e7e9d ($8.72 in chips)
Seat 3: 521feab9 ($5 in chips)
Seat 4: 5896c682 ($3.75 in chips)
Seat 5: 7ae330b3 ($5 in chips)
Seat 6: 834fcc3f ($11.11 in chips)
765e7e9d: posts small blind $0.02
521feab9: posts big blind $0.05
*** HOLE CARDS ***
Dealt to Hero [Ah 5h]
Dealt to 765e7e9d 
Dealt to 521feab9 
Dealt to 5896c682 
Dealt to 7ae330b3 
Dealt to 834fcc3f 
5896c682: raises $0.08 to $0.13
7ae330b3: folds
834fcc3f: folds
Hero: raises $0.33 to $0.46
765e7e9d: folds
521feab9: folds
5896c682: raises $3.29 to $3.75 and is all-in
Hero: folds
Uncalled bet ($3.29) returned to 5896c682
*** SHOWDOWN ***
5896c682 collected $0.94 from pot
*** SUMMARY ***
Total pot $0.99 | Rake $0.05 | Jackpot $0 | Bingo $0 | Fortune $0 | Tax $0
Seat 1: Hero (button) folded before Flop
Seat 2: 765e7e9d (small blind) folded before Flop
Seat 3: 521feab9 (big blind) folded before Flop
Seat 4: 5896c682 collected ($0.94)
Seat 5: 7ae330b3 folded before Flop (didn't bet)
Seat 6: 834fcc3f folded before Flop (didn't bet)


Poker Hand #RC2078579704: Hold'em No Limit ($0.02/$0.05) - 2023/12/22 21:59:05
Table 'RushAndCash804265' 6-max Seat #1 is the button
Seat 1: 24cdb129 ($5.24 in chips)
Seat 2: 7093f460 ($4.99 in chips)
Seat 3: Hero ($5.82 in chips)
Seat 4: 19e231ae ($5.07 in chips)
Seat 5: 57ecfe0 ($4.53 in chips)
Seat 6: d4d7018e ($6.08 in chips)
7093f460: posts small blind $0.02
Hero: posts big blind $0.05
*** HOLE CARDS ***
Dealt to 24cdb129 
Dealt to 7093f460 
Dealt to Hero [5c Tc]
Dealt to 19e231ae 
Dealt to 57ecfe0 
Dealt to d4d7018e 
19e231ae: folds
57ecfe0: raises $0.1 to $0.15
d4d7018e: folds
24cdb129: raises $0.28 to $0.43
7093f460: folds
Hero: folds
57ecfe0: calls $0.28
*** FLOP *** [Kd 8s 6d]
57ecfe0: checks
24cdb129: checks
*** TURN *** [Kd 8s 6d] [Ts]
57ecfe0: checks
24cdb129: bets $0.7
57ecfe0: folds
Uncalled bet ($0.7) returned to 24cdb129
*** SHOWDOWN ***
24cdb129 collected $0.89 from pot
*** SUMMARY ***
Total pot $0.93 | Rake $0.04 | Jackpot $0 | Bingo $0 | Fortune $0 | Tax $0
Board [Kd 8s 6d Ts]
Seat 1: 24cdb129 (button) won ($0.89)
Seat 2: 7093f460 (small blind) folded before Flop
Seat 3: Hero (big blind) folded before Flop
Seat 4: 19e231ae folded before Flop (didn't bet)
Seat 5: 57ecfe0 folded on the Turn
Seat 6: d4d7018e folded before Flop (didn't bet)


Poker Hand #RC2078579087: Hold'em No Limit ($0.02/$0.05) - 2023/12/22 21:58:29
Table 'RushAndCash803982' 6-max Seat #1 is the button
Seat 1: c7726580 ($5 in chips)
Seat 2: Hero ($6.12 in chips)
Seat 3: d4d7018e ($5.81 in chips)
Seat 4: 59846dec ($7.36 in chips)
Seat 5: 37a644bb ($5 in chips)
Seat 6: f4e201f0 ($9.59 in chips)
Hero: posts small blind $0.02
d4d7018e: posts big blind $0.05
*** HOLE CARDS ***
Dealt to c7726580 
Dealt to Hero [Ad 7s]
Dealt to d4d7018e 
Dealt to 59846dec 
Dealt to 37a644bb 
Dealt to f4e201f0 
59846dec: folds
37a644bb: folds
f4e201f0: folds
c7726580: folds
Hero: raises $0.1 to $0.15
d4d7018e: calls $0.1
*** FLOP *** [Kc Qc 7h]
Hero: bets $0.15
d4d7018e: raises $0.45 to $0.6
Hero: folds
Uncalled bet ($0.45) returned to d4d7018e
*** SHOWDOWN ***
d4d7018e collected $0.57 from pot
*** SUMMARY ***
Total pot $0.6 | Rake $0.03 | Jackpot $0 | Bingo $0 | Fortune $0 | Tax $0
Board [Kc Qc 7h]
Seat 1: c7726580 (button) folded before Flop (didn't bet)
Seat 2: Hero (small blind) folded on the Flop
Seat 3: d4d7018e (big blind) won ($0.57)
Seat 4: 59846dec folded before Flop (didn't bet)
Seat 5: 37a644bb folded before Flop (didn't bet)
Seat 6: f4e201f0 folded before Flop (didn't bet)


Poker Hand #RC2078579032: Hold'em No Limit ($0.02/$0.05) - 2023/12/22 21:58:26
Table 'RushAndCash803957' 6-max Seat #1 is the button
Seat 1: d960fc1d ($5.39 in chips)
Seat 2: d6d8d23b ($5.97 in chips)
Seat 3: 7c2eba4e ($16.88 in chips)
Seat 4: 71519e57 ($5.24 in chips)
Seat 5: d4fe283f ($6.11 in chips)
Seat 6: Hero ($6.12 in chips)
d6d8d23b: posts small blind $0.02
7c2eba4e: posts big blind $0.05
*** HOLE CARDS ***
Dealt to d960fc1d 
Dealt to d6d8d23b 
Dealt to 7c2eba4e 
Dealt to 71519e57 
Dealt to d4fe283f 
Dealt to Hero [4h Td]
71519e57: raises $0.06 to $0.11
d4fe283f: folds
Hero: folds
d960fc1d: folds
d6d8d23b: folds
7c2eba4e: calls $0.06
*** FLOP *** [Ts 4s 3d]
7c2eba4e: checks
71519e57: bets $0.1
7c2eba4e: raises $0.2 to $0.3
71519e57: calls $0.2
*** TURN *** [Ts 4s 3d] [As]
7c2eba4e: checks
71519e57: bets $0.5
7c2eba4e: folds
Uncalled bet ($0.5) returned to 71519e57
*** SHOWDOWN ***
71519e57 collected $0.8 from pot
*** SUMMARY ***
Total pot $0.84 | Rake $0.04 | Jackpot $0 | Bingo $0 | Fortune $0 | Tax $0
Board [Ts 4s 3d As]
Seat 1: d960fc1d (button) folded before Flop (didn't bet)
Seat 2: d6d8d23b (small blind) folded before Flop
Seat 3: 7c2eba4e (big blind) folded on the Turn
Seat 4: 71519e57 won ($0.8)
Seat 5: d4fe283f folded before Flop (didn't bet)
Seat 6: Hero folded before Flop (didn't bet)


Poker Hand #RC2078578515: Hold'em No Limit ($0.02/$0.05) - 2023/12/22 21:57:56
Table 'RushAndCash803724' 6-max Seat #1 is the button
Seat 1: dded80af ($5 in chips)
Seat 2: 71519e57 ($5.69 in chips)
Seat 3: 60bb15f4 ($10.02 in chips)
Seat 4: 7016689e ($7.45 in chips)
Seat 5: 177da66b ($12.54 in chips)
Seat 6: Hero ($5.66 in chips)
71519e57: posts small blind $0.02
60bb15f4: posts big blind $0.05
*** HOLE CARDS ***
Dealt to dded80af 
Dealt to 71519e57 
Dealt to 60bb15f4 
Dealt to 7016689e 
Dealt to 177da66b 
Dealt to Hero [Kd Kc]
7016689e: folds
177da66b: folds
Hero: raises $0.05 to $0.1
dded80af: folds
71519e57: raises $0.35 to $0.45
60bb15f4: folds
Hero: raises $5.21 to $5.66 and is all-in
71519e57: folds
Uncalled bet ($5.21) returned to Hero
*** SHOWDOWN ***
Hero collected $0.91 from pot
*** SUMMARY ***
Total pot $0.95 | Rake $0.04 | Jackpot $0 | Bingo $0 | Fortune $0 | Tax $0
Seat 1: dded80af (button) folded before Flop (didn't bet)
Seat 2: 71519e57 (small blind) folded before Flop
Seat 3: 60bb15f4 (big blind) folded before Flop
Seat 4: 7016689e folded before Flop (didn't bet)
Seat 5: 177da66b folded before Flop (didn't bet)
Seat 6: Hero collected ($0.91)


Poker Hand #RC2078578429: Hold'em No Limit ($0.02/$0.05) - 2023/12/22 21:57:51
Table 'RushAndCash803682' 6-max Seat #1 is the button
Seat 1: 8d94440d ($5.17 in chips)
Seat 2: fe92c523 ($6.4 in chips)
Seat 3: 59846dec ($7.49 in chips)
Seat 4: e4d2f8b7 ($10.09 in chips)
Seat 5: 27026825 ($7.16 in chips)
Seat 6: Hero ($5.66 in chips)
fe92c523: posts small blind $0.02
59846dec: posts big blind $0.05
*** HOLE CARDS ***
Dealt to 8d94440d 
Dealt to fe92c523 
Dealt to 59846dec 
Dealt to e4d2f8b7 
Dealt to 27026825 
Dealt to Hero [5s 8s]
e4d2f8b7: folds
27026825: raises $0.08 to $0.13
Hero: folds
8d94440d: folds
fe92c523: calls $0.11
59846dec: calls $0.08
*** FLOP *** [9s 4h 7s]
fe92c523: checks
59846dec: checks
27026825: checks
*** TURN *** [9s 4h 7s] [4d]
fe92c523: checks
59846dec: checks
27026825: checks
*** RIVER *** [9s 4h 7s 4d] [As]
fe92c523: bets $0.13
59846dec: folds
27026825: calls $0.13
fe92c523: shows [Kc Jc] (Pair of Fours)
27026825: shows [3d 3h] (Pair of Fours and Pair of Treys)
*** SHOWDOWN ***
27026825 collected $0.62 from pot
*** SUMMARY ***
Total pot $0.65 | Rake $0.03 | Jackpot $0 | Bingo $0 | Fortune $0 | Tax $0
Board [9s 4h 7s 4d As]
Seat 1: 8d94440d (button) folded before Flop (didn't bet)
Seat 2: fe92c523 (small blind) showed [Kc Jc] and lost with Pair of Fours
Seat 3: 59846dec (big blind) folded on the River
Seat 4: e4d2f8b7 folded before Flop (didn't bet)
Seat 5: 27026825 showed [3d 3h] and won ($0.62) with Pair of Fours and Pair of Treys
Seat 6: Hero folded before Flop (didn't bet)


Poker Hand #RC2078578339: Hold'em No Limit ($0.02/$0.05) - 2023/12/22 21:57:46
Table 'RushAndCash803640' 6-max Seat #1 is the button
Seat 1: c266a12 ($5.37 in chips)
Seat 2: b01c40bf ($18.17 in chips)
Seat 3: e97b55e1 ($5.77 in chips)
Seat 4: Hero ($5.66 in chips)
Seat 5: 8488f57f ($3.45 in chips)
Seat 6: 558ffb3 ($6.88 in chips)
b01c40bf: posts small blind $0.02
e97b55e1: posts big blind $0.05
*** HOLE CARDS ***
Dealt to c266a12 
Dealt to b01c40bf 
Dealt to e97b55e1 
Dealt to Hero [2d 5s]
Dealt to 8488f57f 
Dealt to 558ffb3 
Hero: folds
8488f57f: folds
558ffb3: folds
c266a12: folds
b01c40bf: folds
Uncalled bet ($0.03) returned to e97b55e1
*** SHOWDOWN ***
e97b55e1 collected $0.04 from pot
*** SUMMARY ***
Total pot $0.04 | Rake $0 | Jackpot $0 | Bingo $0 | Fortune $0 | Tax $0
Seat 1: c266a12 (button) folded before Flop (didn't bet)
Seat 2: b01c40bf (small blind) folded before Flop
Seat 3: e97b55e1 (big blind) collected ($0.04)
Seat 4: Hero folded before Flop (didn't bet)
Seat 5: 8488f57f folded before Flop (didn't bet)
Seat 6: 558ffb3 folded before Flop (didn't bet)


Poker Hand #RC2078578083: Hold'em No Limit ($0.02/$0.05) - 2023/12/22 21:57:32
Table 'RushAndCash803517' 6-max Seat #1 is the button
Seat 1: 38e42730 ($9.31 in chips)
Seat 2: 8369fc6c ($6.29 in chips)
Seat 3: Hero ($5.71 in chips)
Seat 4: c7d7813b ($5.14 in chips)
Seat 5: dded80af ($5 in chips)
Seat 6: a809eadb ($5.17 in chips)
8369fc6c: posts small blind $0.02
Hero: posts big blind $0.05
*** HOLE CARDS ***
Dealt to 38e42730 
Dealt to 8369fc6c 
Dealt to Hero [5s Ts]
Dealt to c7d7813b 
Dealt to dded80af 
Dealt to a809eadb 
c7d7813b: folds
dded80af: folds
a809eadb: folds
38e42730: raises $0.1 to $0.15
8369fc6c: folds
Hero: folds
Uncalled bet ($0.1) returned to 38e42730
*** SHOWDOWN ***
38e42730 collected $0.12 from pot
*** SUMMARY ***
Total pot $0.12 | Rake $0 | Jackpot $0 | Bingo $0 | Fortune $0 | Tax $0
Seat 1: 38e42730 (button) collected ($0.12)
Seat 2: 8369fc6c (small blind) folded before Flop
Seat 3: Hero (big blind) folded before Flop
Seat 4: c7d7813b folded before Flop (didn't bet)
Seat 5: dded80af folded before Flop (didn't bet)
Seat 6: a809eadb folded before Flop (didn't bet)


Poker Hand #RC2078577873: Hold'em No Limit ($0.02/$0.05) - 2023/12/22 21:57:20
Table 'RushAndCash803418' 6-max Seat #1 is the button
Seat 1: b0755516 ($5 in chips)
Seat 2: Hero ($5.73 in chips)
Seat 3: a89c43c ($2.12 in chips)
Seat 4: 46a26f4c ($5.22 in chips)
Seat 5: e6f6623d ($5.71 in chips)
Seat 6: 4879e77e ($5.7 in chips)
Hero: posts small blind $0.02
a89c43c: posts big blind $0.05
*** HOLE CARDS ***
Dealt to b0755516 
Dealt to Hero [8s 7h]
Dealt to a89c43c 
Dealt to 46a26f4c 
Dealt to e6f6623d 
Dealt to 4879e77e 
46a26f4c: folds
e6f6623d: raises $0.1 to $0.15
4879e77e: calls $0.15
b0755516: folds
Hero: folds
a89c43c: folds
*** FLOP *** [6d Qd 3h]
e6f6623d: checks
4879e77e: bets $0.2
e6f6623d: calls $0.2
*** TURN *** [6d Qd 3h] [4d]
e6f6623d: checks
4879e77e: checks
*** RIVER *** [6d Qd 3h 4d] [Ks]
e6f6623d: checks
4879e77e: checks
e6f6623d: shows [As Js] (Ace-High)
4879e77e: shows [6c 5c] (Pair of Sixes)
*** SHOWDOWN ***
4879e77e collected $0.74 from pot
*** SUMMARY ***
Total pot $0.77 | Rake $0.03 | Jackpot $0 | Bingo $0 | Fortune $0 | Tax $0
Board [6d Qd 3h 4d Ks]
Seat 1: b0755516 (button) folded before Flop (didn't bet)
Seat 2: Hero (small blind) folded before Flop
Seat 3: a89c43c (big blind) folded before Flop
Seat 4: 46a26f4c folded before Flop (didn't bet)
Seat 5: e6f6623d showed [As Js] and lost with Ace-High
Seat 6: 4879e77e showed [6c 5c] and won ($0.74) with Pair of Sixes


Poker Hand #RC2078577798: Hold'em No Limit ($0.02/$0.05) - 2023/12/22 21:57:15
Table 'RushAndCash803380' 6-max Seat #1 is the button
Seat 1: 440a38cc ($5.21 in chips)
Seat 2: 10def899 ($5 in chips)
Seat 3: ea5a6534 ($5.3 in chips)
Seat 4: Hero ($5.73 in chips)
Seat 5: c8adf5d ($7.1 in chips)
Seat 6: 6c75362e ($10.6 in chips)
10def899: posts small blind $0.02
ea5a6534: posts big blind $0.05
*** HOLE CARDS ***
Dealt to 440a38cc 
Dealt to 10def899 
Dealt to ea5a6534 
Dealt to Hero [Qc 6d]
Dealt to c8adf5d 
Dealt to 6c75362e 
Hero: folds
c8adf5d: folds
6c75362e: folds
440a38cc: folds
10def899: folds
Uncalled bet ($0.03) returned to ea5a6534
*** SHOWDOWN ***
ea5a6534 collected $0.04 from pot
*** SUMMARY ***
Total pot $0.04 | Rake $0 | Jackpot $0 | Bingo $0 | Fortune $0 | Tax $0
Seat 1: 440a38cc (button) folded before Flop (didn't bet)
Seat 2: 10def899 (small blind) folded before Flop
Seat 3: ea5a6534 (big blind) collected ($0.04)
Seat 4: Hero folded before Flop (didn't bet)
Seat 5: c8adf5d folded before Flop (didn't bet)
Seat 6: 6c75362e folded before Flop (didn't bet)


Poker Hand #RC2078577697: Hold'em No Limit ($0.02/$0.05) - 2023/12/22 21:57:09
Table 'RushAndCash803333' 6-max Seat #1 is the button
Seat 1: ec5f3643 ($4.12 in chips)
Seat 2: 440a38cc ($5.23 in chips)
Seat 3: f4c57a5 ($7.76 in chips)
Seat 4: 6a898db1 ($8.91 in chips)
Seat 5: 311eeba4 ($18.33 in chips)
Seat 6: Hero ($5.73 in chips)
440a38cc: posts small blind $0.02
f4c57a5: posts big blind $0.05
*** HOLE CARDS ***
Dealt to ec5f3643 
Dealt to 440a38cc 
Dealt to f4c57a5 
Dealt to 6a898db1 
Dealt to 311eeba4 
Dealt to Hero [9h 6s]
6a898db1: folds
311eeba4: raises $0.1 to $0.15
Hero: folds
ec5f3643: folds
440a38cc: folds
f4c57a5: calls $0.1
*** FLOP *** [3c 8h 8s]
f4c57a5: checks
311eeba4: checks
*** TURN *** [3c 8h 8s] [7h]
f4c57a5: bets $0.26
311eeba4: folds
Uncalled bet ($0.26) returned to f4c57a5
*** SHOWDOWN ***
f4c57a5 collected $0.31 from pot
*** SUMMARY ***
Total pot $0.32 | Rake $0.01 | Jackpot $0 | Bingo $0 | Fortune $0 | Tax $0
Board [3c 8h 8s 7h]
Seat 1: ec5f3643 (button) folded before Flop (didn't bet)
Seat 2: 440a38cc (small blind) folded before Flop
Seat 3: f4c57a5 (big blind) won ($0.31)
Seat 4: 6a898db1 folded before Flop (didn't bet)
Seat 5: 311eeba4 folded on the Turn
Seat 6: Hero folded before Flop (didn't bet)


Poker Hand #RC2078577510: Hold'em No Limit ($0.02/$0.05) - 2023/12/22 21:56:59
Table 'RushAndCash803248' 6-max Seat #1 is the button
Seat 1: fc7e8623 ($24.49 in chips)
Seat 2: Hero ($5.75 in chips)
Seat 3: 14f02886 ($5.13 in chips)
Seat 4: a20c0bea ($5.09 in chips)
Seat 5: e19dee32 ($5 in chips)
Seat 6: 8d94440d ($5.08 in chips)
Hero: posts small blind $0.02
14f02886: posts big blind $0.05
*** HOLE CARDS ***
Dealt to fc7e8623 
Dealt to Hero [3h 6h]
Dealt to 14f02886 
Dealt to a20c0bea 
Dealt to e19dee32 
Dealt to 8d94440d 
a20c0bea: folds
e19dee32: folds
8d94440d: folds
fc7e8623: folds
Hero: folds
Uncalled bet ($0.03) returned to 14f02886
*** SHOWDOWN ***
14f02886 collected $0.04 from pot
*** SUMMARY ***
Total pot $0.04 | Rake $0 | Jackpot $0 | Bingo $0 | Fortune $0 | Tax $0
Seat 1: fc7e8623 (button) folded before Flop (didn't bet)
Seat 2: Hero (small blind) folded before Flop
Seat 3: 14f02886 (big blind) collected ($0.04)
Seat 4: a20c0bea folded before Flop (didn't bet)
Seat 5: e19dee32 folded before Flop (didn't bet)
Seat 6: 8d94440d folded before Flop (didn't bet)


Poker Hand #RC2078576541: Hold'em No Limit ($0.02/$0.05) - 2023/12/22 21:56:01
Table 'RushAndCash802798' 6-max Seat #1 is the button
Seat 1: 8d94440d ($5.47 in chips)
Seat 2: 4c3513b2 ($4.26 in chips)
Seat 3: 83815da3 ($5.58 in chips)
Seat 4: e97b55e1 ($5.7 in chips)
Seat 5: Hero ($5.33 in chips)
Seat 6: 29b0f5be ($6.91 in chips)
4c3513b2: posts small blind $0.02
83815da3: posts big blind $0.05
*** HOLE CARDS ***
Dealt to 8d94440d 
Dealt to 4c3513b2 
Dealt to 83815da3 
Dealt to e97b55e1 
Dealt to Hero [7c 7d]
Dealt to 29b0f5be 
e97b55e1: folds
Hero: raises $0.05 to $0.1
29b0f5be: folds
8d94440d: raises $0.14 to $0.24
4c3513b2: folds
83815da3: folds
Hero: calls $0.14
*** FLOP *** [7h Ks 4c]
Hero: checks
8d94440d: bets $0.15
Hero: calls $0.15
*** TURN *** [7h Ks 4c] [Kh]
Hero: checks
8d94440d: checks
*** RIVER *** [7h Ks 4c Kh] [6h]
Hero: bets $0.29
8d94440d: folds
Uncalled bet ($0.29) returned to Hero
*** SHOWDOWN ***
Hero collected $0.81 from pot
*** SUMMARY ***
Total pot $0.85 | Rake $0.04 | Jackpot $0 | Bingo $0 | Fortune $0 | Tax $0
Board [7h Ks 4c Kh 6h]
Seat 1: 8d94440d (button) folded on the River
Seat 2: 4c3513b2 (small blind) folded before Flop
Seat 3: 83815da3 (big blind) folded before Flop
Seat 4: e97b55e1 folded before Flop (didn't bet)
Seat 5: Hero won ($0.81)
Seat 6: 29b0f5be folded before Flop (didn't bet)


Poker Hand #RC2078575816: Hold'em No Limit ($0.02/$0.05) - 2023/12/22 21:55:16
Table 'RushAndCash802477' 6-max Seat #1 is the button
Seat 1: Hero ($5.02 in chips)
Seat 2: 8d94440d ($5.76 in chips)
Seat 3: 190cd877 ($5.37 in chips)
Seat 4: cbc963b8 ($5.38 in chips)
Seat 5: 177da66b ($7.72 in chips)
Seat 6: 8014c02 ($13.38 in chips)
8d94440d: posts small blind $0.02
190cd877: posts big blind $0.05
*** HOLE CARDS ***
Dealt to Hero [As Ac]
Dealt to 8d94440d 
Dealt to 190cd877 
Dealt to cbc963b8 
Dealt to 177da66b 
Dealt to 8014c02 
cbc963b8: folds
177da66b: folds
8014c02: folds
Hero: raises $0.08 to $0.13
8d94440d: calls $0.11
190cd877: folds
*** FLOP *** [9s 9c 8d]
8d94440d: checks
Hero: bets $0.16
8d94440d: calls $0.16
*** TURN *** [9s 9c 8d] [Kh]
8d94440d: checks
Hero: checks
*** RIVER *** [9s 9c 8d Kh] [8s]
8d94440d: checks
Hero: bets $0.21
8d94440d: folds
Uncalled bet ($0.21) returned to Hero
*** SHOWDOWN ***
Hero collected $0.6 from pot
*** SUMMARY ***
Total pot $0.63 | Rake $0.03 | Jackpot $0 | Bingo $0 | Fortune $0 | Tax $0
Board [9s 9c 8d Kh 8s]
Seat 1: Hero (button) won ($0.6)
Seat 2: 8d94440d (small blind) folded on the River
Seat 3: 190cd877 (big blind) folded before Flop
Seat 4: cbc963b8 folded before Flop (didn't bet)
Seat 5: 177da66b folded before Flop (didn't bet)
Seat 6: 8014c02 folded before Flop (didn't bet)


Poker Hand #RC2078575686: Hold'em No Limit ($0.02/$0.05) - 2023/12/22 21:55:08
Table 'RushAndCash802416' 6-max Seat #1 is the button
Seat 1: d71e9094 ($5.16 in chips)
Seat 2: e6f6623d ($5.33 in chips)
Seat 3: Hero ($5 in chips)
Seat 4: 8014c02 ($13.43 in chips)
Seat 5: 6e0be8e1 ($5.43 in chips)
Seat 6: c7d7813b ($5 in chips)
e6f6623d: posts small blind $0.02
Hero: posts big blind $0.05
*** HOLE CARDS ***
Dealt to d71e9094 
Dealt to e6f6623d 
Dealt to Hero [2d 5s]
Dealt to 8014c02 
Dealt to 6e0be8e1 
Dealt to c7d7813b 
8014c02: folds
6e0be8e1: folds
c7d7813b: folds
d71e9094: folds
e6f6623d: folds
Uncalled bet ($0.03) returned to Hero
*** SHOWDOWN ***
Hero collected $0.04 from pot
*** SUMMARY ***
Total pot $0.04 | Rake $0 | Jackpot $0 | Bingo $0 | Fortune $0 | Tax $0
Seat 1: d71e9094 (button) folded before Flop (didn't bet)
Seat 2: e6f6623d (small blind) folded before Flop
Seat 3: Hero (big blind) collected ($0.04)
Seat 4: 8014c02 folded before Flop (didn't bet)
Seat 5: 6e0be8e1 folded before Flop (didn't bet)
Seat 6: c7d7813b folded before Flop (didn't bet)


Poker Hand #RC2078575141: Hold'em No Limit ($0.02/$0.05) - 2023/12/22 21:54:38
Table 'RushAndCash802144' 6-max Seat #1 is the button
Seat 1: a7076373 ($5.62 in chips)
Seat 2: 242358f0 ($5.16 in chips)
Seat 3: 11612373 ($13.27 in chips)
Seat 4: Hero ($5.07 in chips)
Seat 5: 4520f334 ($3.95 in chips)
Seat 6: 4c3513b2 ($3.97 in chips)
242358f0: posts small blind $0.02
11612373: posts big blind $0.05
*** HOLE CARDS ***
Dealt to a7076373 
Dealt to 242358f0 
Dealt to 11612373 
Dealt to Hero [Kc Qc]
Dealt to 4520f334 
Dealt to 4c3513b2 
Hero: raises $0.05 to $0.1
4520f334: folds
4c3513b2: raises $0.2 to $0.3
a7076373: folds
242358f0: folds
11612373: folds
Hero: calls $0.2
*** FLOP *** [9h Js 6s]
Hero: checks
4c3513b2: bets $0.48
Hero: folds
Uncalled bet ($0.48) returned to 4c3513b2
*** SHOWDOWN ***
4c3513b2 collected $0.64 from pot
*** SUMMARY ***
Total pot $0.67 | Rake $0.03 | Jackpot $0 | Bingo $0 | Fortune $0 | Tax $0
Board [9h Js 6s]
Seat 1: a7076373 (button) folded before Flop (didn't bet)
Seat 2: 242358f0 (small blind) folded before Flop
Seat 3: 11612373 (big blind) folded before Flop
Seat 4: Hero folded on the Flop
Seat 5: 4520f334 folded before Flop (didn't bet)
Seat 6: 4c3513b2 won ($0.64)


Poker Hand #RC2078575068: Hold'em No Limit ($0.02/$0.05) - 2023/12/22 21:54:34
Table 'RushAndCash802109' 6-max Seat #1 is the button
Seat 1: bf955ffb ($8.7 in chips)
Seat 2: 1b4a662e ($5.08 in chips)
Seat 3: 1c28bbd5 ($5.22 in chips)
Seat 4: d0173848 ($5.07 in chips)
Seat 5: Hero ($5.07 in chips)
Seat 6: 525db62f ($5 in chips)
1b4a662e: posts small blind $0.02
1c28bbd5: posts big blind $0.05
*** HOLE CARDS ***
Dealt to bf955ffb 
Dealt to 1b4a662e 
Dealt to 1c28bbd5 
Dealt to d0173848 
Dealt to Hero [4d 3c]
Dealt to 525db62f 
d0173848: folds
Hero: folds
525db62f: folds
bf955ffb: folds
1b4a662e: raises $0.06 to $0.11
1c28bbd5: calls $0.06
*** FLOP *** [8c Kh 2d]
1b4a662e: bets $0.1
1c28bbd5: folds
Uncalled bet ($0.1) returned to 1b4a662e
*** SHOWDOWN ***
1b4a662e collected $0.21 from pot
*** SUMMARY ***
Total pot $0.22 | Rake $0.01 | Jackpot $0 | Bingo $0 | Fortune $0 | Tax $0
Board [8c Kh 2d]
Seat 1: bf955ffb (button) folded before Flop (didn't bet)
Seat 2: 1b4a662e (small blind) won ($0.21)
Seat 3: 1c28bbd5 (big blind) folded on the Flop
Seat 4: d0173848 folded before Flop (didn't bet)
Seat 5: Hero folded before Flop (didn't bet)
Seat 6: 525db62f folded before Flop (didn't bet)


Poker Hand #RC2078574994: Hold'em No Limit ($0.02/$0.05) - 2023/12/22 21:54:30
Table 'RushAndCash802072' 6-max Seat #1 is the button
Seat 1: Hero ($5.07 in chips)
Seat 2: e6f6623d ($5.4 in chips)
Seat 3: b61f5bde ($14.14 in chips)
Seat 4: b74b84be ($9.27 in chips)
Seat 5: cb9a7609 ($5.53 in chips)
Seat 6: 7e84e7dc ($13.75 in chips)
e6f6623d: posts small blind $0.02
b61f5bde: posts big blind $0.05
*** HOLE CARDS ***
Dealt to Hero [2d 5s]
Dealt to e6f6623d 
Dealt to b61f5bde 
Dealt to b74b84be 
Dealt to cb9a7609 
Dealt to 7e84e7dc 
b74b84be: folds
cb9a7609: folds
7e84e7dc: folds
Hero: folds
e6f6623d: folds
Uncalled bet ($0.03) returned to b61f5bde
*** SHOWDOWN ***
b61f5bde collected $0.04 from pot
*** SUMMARY ***
Total pot $0.04 | Rake $0 | Jackpot $0 | Bingo $0 | Fortune $0 | Tax $0
Seat 1: Hero (button) folded before Flop (didn't bet)
Seat 2: e6f6623d (small blind) folded before Flop
Seat 3: b61f5bde (big blind) collected ($0.04)
Seat 4: b74b84be folded before Flop (didn't bet)
Seat 5: cb9a7609 folded before Flop (didn't bet)
Seat 6: 7e84e7dc folded before Flop (didn't bet)


Poker Hand #RC2078574941: Hold'em No Limit ($0.02/$0.05) - 2023/12/22 21:54:27
Table 'RushAndCash802045' 6-max Seat #1 is the button
Seat 1: ea5a6534 ($5.58 in chips)
Seat 2: a75d4daa ($5.36 in chips)
Seat 3: b257878a ($5.41 in chips)
Seat 4: 5d55167a ($11.49 in chips)
Seat 5: 50e2e09e ($5.39 in chips)
Seat 6: Hero ($5.07 in chips)
a75d4daa: posts small blind $0.02
b257878a: posts big blind $0.05
*** HOLE CARDS ***
Dealt to ea5a6534 
Dealt to a75d4daa 
Dealt to b257878a 
Dealt to 5d55167a 
Dealt to 50e2e09e 
Dealt to Hero [5s 3s]
5d55167a: folds
50e2e09e: folds
Hero: folds
ea5a6534: raises $0.06 to $0.11
a75d4daa: folds
b257878a: folds
Uncalled bet ($0.06) returned to ea5a6534
*** SHOWDOWN ***
ea5a6534 collected $0.12 from pot
*** SUMMARY ***
Total pot $0.12 | Rake $0 | Jackpot $0 | Bingo $0 | Fortune $0 | Tax $0
Seat 1: ea5a6534 (button) collected ($0.12)
Seat 2: a75d4daa (small blind) folded before Flop
Seat 3: b257878a (big blind) folded before Flop
Seat 4: 5d55167a folded before Flop (didn't bet)
Seat 5: 50e2e09e folded before Flop (didn't bet)
Seat 6: Hero folded before Flop (didn't bet)


Poker Hand #RC2078574797: Hold'em No Limit ($0.02/$0.05) - 2023/12/22 21:54:18
Table 'RushAndCash801972' 6-max Seat #1 is the button
Seat 1: ba0591c5 ($4.76 in chips)
Seat 2: 3efee149 ($5 in chips)
Seat 3: d9ec3117 ($5 in chips)
Seat 4: e3e578eb ($5.02 in chips)
Seat 5: 1475b478 ($4.58 in chips)
Seat 6: Hero ($5.07 in chips)
3efee149: posts small blind $0.02
d9ec3117: posts big blind $0.05
*** HOLE CARDS ***
Dealt to ba0591c5 
Dealt to 3efee149 
Dealt to d9ec3117 
Dealt to e3e578eb 
Dealt to 1475b478 
Dealt to Hero [3d Jh]
e3e578eb: folds
1475b478: folds
Hero: folds
ba0591c5: raises $0.08 to $0.13
3efee149: folds
d9ec3117: calls $0.08
*** FLOP *** [7d 4h 8c]
d9ec3117: checks
ba0591c5: bets $0.14
d9ec3117: folds
Uncalled bet ($0.14) returned to ba0591c5
*** SHOWDOWN ***
ba0591c5 collected $0.27 from pot
*** SUMMARY ***
Total pot $0.28 | Rake $0.01 | Jackpot $0 | Bingo $0 | Fortune $0 | Tax $0
Board [7d 4h 8c]
Seat 1: ba0591c5 (button) won ($0.27)
Seat 2: 3efee149 (small blind) folded before Flop
Seat 3: d9ec3117 (big blind) folded on the Flop
Seat 4: e3e578eb folded before Flop (didn't bet)
Seat 5: 1475b478 folded before Flop (didn't bet)
Seat 6: Hero folded before Flop (didn't bet)


Poker Hand #RC2078544653: Hold'em No Limit ($0.02/$0.05) - 2023/12/22 21:54:10
Table 'RushAndCash801902' 6-max Seat #1 is the button
Seat 1: 9dc69999 ($6.37 in chips)
Seat 2: 31a55fda ($5.01 in chips)
Seat 3: Hero ($5.05 in chips)
Seat 4: 661ba238 ($5.14 in chips)
Seat 5: 8a1c58b7 ($13.64 in chips)
Seat 6: 5f9f6e5e ($5.31 in chips)
31a55fda: posts small blind $0.02
Hero: posts big blind $0.05
*** HOLE CARDS ***
Dealt to 9dc69999 
Dealt to 31a55fda 
Dealt to Hero [Qh Qc]
Dealt to 661ba238 
Dealt to 8a1c58b7 
Dealt to 5f9f6e5e 
661ba238: folds
8a1c58b7: folds
5f9f6e5e: folds
9dc69999: folds
31a55fda: folds
Uncalled bet ($0.03) returned to Hero
*** SHOWDOWN ***
Hero collected $0.04 from pot
*** SUMMARY ***
Total pot $0.04 | Rake $0 | Jackpot $0 | Bingo $0 | Fortune $0 | Tax $0
Seat 1: 9dc69999 (button) folded before Flop (didn't bet)
Seat 2: 31a55fda (small blind) folded before Flop
Seat 3: Hero (big blind) collected ($0.04)
Seat 4: 661ba238 folded before Flop (didn't bet)
Seat 5: 8a1c58b7 folded before Flop (didn't bet)
Seat 6: 5f9f6e5e folded before Flop (didn't bet)


Poker Hand #RC2078544344: Hold'em No Limit ($0.02/$0.05) - 2023/12/22 21:53:54
Table 'RushAndCash801757' 6-max Seat #1 is the button
Seat 1: ff34c3d1 ($5.33 in chips)
Seat 2: Hero ($5 in chips)
Seat 3: c2881b52 ($8.32 in chips)
Seat 4: 622d6af4 ($19.73 in chips)
Seat 5: 2e20f1d7 ($2.96 in chips)
Seat 6: bc26f2e1 ($5.2 in chips)
Hero: posts small blind $0.02
c2881b52: posts big blind $0.05
*** HOLE CARDS ***
Dealt to ff34c3d1 
Dealt to Hero [Jh Th]
Dealt to c2881b52 
Dealt to 622d6af4 
Dealt to 2e20f1d7 
Dealt to bc26f2e1 
622d6af4: folds
2e20f1d7: folds
bc26f2e1: folds
ff34c3d1: folds
Hero: raises $0.1 to $0.15
c2881b52: folds
Uncalled bet ($0.1) returned to Hero
*** SHOWDOWN ***
Hero collected $0.1 from pot
*** SUMMARY ***
Total pot $0.1 | Rake $0 | Jackpot $0 | Bingo $0 | Fortune $0 | Tax $0
Seat 1: ff34c3d1 (button) folded before Flop (didn't bet)
Seat 2: Hero (small blind) collected ($0.1)
Seat 3: c2881b52 (big blind) folded before Flop
Seat 4: 622d6af4 folded before Flop (didn't bet)
Seat 5: 2e20f1d7 folded before Flop (didn't bet)
Seat 6: bc26f2e1 folded before Flop (didn't bet)


Poker Hand #RC2078544255: Hold'em No Limit ($0.02/$0.05) - 2023/12/22 21:53:49
Table 'RushAndCash801711' 6-max Seat #1 is the button
Seat 1: 9b0ec3a ($16.08 in chips)
Seat 2: c7d7813b ($5 in chips)
Seat 3: ce803d2b ($5.66 in chips)
Seat 4: Hero ($5 in chips)
Seat 5: fc58b670 ($5 in chips)
Seat 6: 4c3513b2 ($4.79 in chips)
c7d7813b: posts small blind $0.02
ce803d2b: posts big blind $0.05
*** HOLE CARDS ***
Dealt to 9b0ec3a 
Dealt to c7d7813b 
Dealt to ce803d2b 
Dealt to Hero [Ad 9c]
Dealt to fc58b670 
Dealt to 4c3513b2 
Hero: folds
fc58b670: folds
4c3513b2: folds
9b0ec3a: raises $0.08 to $0.13
c7d7813b: folds
ce803d2b: calls $0.08
*** FLOP *** [4s Qd 3c]
ce803d2b: checks
9b0ec3a: checks
*** TURN *** [4s Qd 3c] [6s]
ce803d2b: checks
9b0ec3a: checks
*** RIVER *** [4s Qd 3c 6s] [5h]
ce803d2b: checks
9b0ec3a: checks
ce803d2b: shows [Kc Th] (King-High)
9b0ec3a: shows [9d Ac] (Ace-High)
*** SHOWDOWN ***
9b0ec3a collected $0.27 from pot
*** SUMMARY ***
Total pot $0.28 | Rake $0.01 | Jackpot $0 | Bingo $0 | Fortune $0 | Tax $0
Board [4s Qd 3c 6s 5h]
Seat 1: 9b0ec3a (button) showed [9d Ac] and won ($0.27) with Ace-High
Seat 2: c7d7813b (small blind) folded before Flop
Seat 3: ce803d2b (big blind) showed [Kc Th] and lost with King-High
Seat 4: Hero folded before Flop (didn't bet)
Seat 5: fc58b670 folded before Flop (didn't bet)
Seat 6: 4c3513b2 folded before Flop (didn't bet)


Poker Hand #RC2078543688: Hold'em No Limit ($0.02/$0.05) - 2023/12/22 21:53:15
Table 'RushAndCash801442' 6-max Seat #1 is the button
Seat 1: 4ef07903 ($9.36 in chips)
Seat 2: Hero ($5.02 in chips)
Seat 3: 34886d8c ($5 in chips)
Seat 4: 9601129f ($10.64 in chips)
Seat 5: 6ff1e240 ($7.38 in chips)
Seat 6: e789f462 ($3.29 in chips)
Hero: posts small blind $0.02
34886d8c: posts big blind $0.05
*** HOLE CARDS ***
Dealt to 4ef07903 
Dealt to Hero [Qc Td]
Dealt to 34886d8c 
Dealt to 9601129f 
Dealt to 6ff1e240 
Dealt to e789f462 
9601129f: folds
6ff1e240: folds
e789f462: raises $0.05 to $0.1
4ef07903: folds
Hero: calls $0.08
34886d8c: folds
*** FLOP *** [9d 8s Kh]
Hero: checks
e789f462: bets $0.11
Hero: calls $0.11
*** TURN *** [9d 8s Kh] [Ts]
Hero: checks
e789f462: bets $0.23
Hero: calls $0.23
*** RIVER *** [9d 8s Kh Ts] [3c]
Hero: checks
e789f462: checks
Hero: shows [Qc Td] (Pair of Tens)
e789f462: shows [Kd Ac] (Pair of Kings)
*** SHOWDOWN ***
e789f462 collected $0.89 from pot
*** SUMMARY ***
Total pot $0.93 | Rake $0.04 | Jackpot $0 | Bingo $0 | Fortune $0 | Tax $0
Board [9d 8s Kh Ts 3c]
Seat 1: 4ef07903 (button) folded before Flop (didn't bet)
Seat 2: Hero (small blind) showed [Qc Td] and lost with Pair of Tens
Seat 3: 34886d8c (big blind) folded before Flop
Seat 4: 9601129f folded before Flop (didn't bet)
Seat 5: 6ff1e240 folded before Flop (didn't bet)
Seat 6: e789f462 showed [Kd Ac] and won ($0.89) with Pair of Kings


Poker Hand #RC2078543601: Hold'em No Limit ($0.02/$0.05) - 2023/12/22 21:53:10
Table 'RushAndCash801403' 6-max Seat #1 is the button
Seat 1: Hero ($5.02 in chips)
Seat 2: ea9bed4a ($6.73 in chips)
Seat 3: e519a9e8 ($14.92 in chips)
Seat 4: 8eb71456 ($14.01 in chips)
Seat 5: a556b687 ($4.68 in chips)
Seat 6: f938f1e ($5 in chips)
ea9bed4a: posts small blind $0.02
e519a9e8: posts big blind $0.05
*** HOLE CARDS ***
Dealt to Hero [4c Kc]
Dealt to ea9bed4a 
Dealt to e519a9e8 
Dealt to 8eb71456 
Dealt to a556b687 
Dealt to f938f1e 
8eb71456: raises $0.1 to $0.15
a556b687: folds
f938f1e: folds
Hero: folds
ea9bed4a: calls $0.13
e519a9e8: folds
*** FLOP *** [5c Ac 8s]
ea9bed4a: checks
8eb71456: bets $0.12
ea9bed4a: folds
Uncalled bet ($0.12) returned to 8eb71456
*** SHOWDOWN ***
8eb71456 collected $0.34 from pot
*** SUMMARY ***
Total pot $0.35 | Rake $0.01 | Jackpot $0 | Bingo $0 | Fortune $0 | Tax $0
Board [5c Ac 8s]
Seat 1: Hero (button) folded before Flop (didn't bet)
Seat 2: ea9bed4a (small blind) folded on the Flop
Seat 3: e519a9e8 (big blind) folded before Flop
Seat 4: 8eb71456 won ($0.34)
Seat 5: a556b687 folded before Flop (didn't bet)
Seat 6: f938f1e folded before Flop (didn't bet)


Poker Hand #RC2078543462: Hold'em No Limit ($0.02/$0.05) - 2023/12/22 21:53:02
Table 'RushAndCash801339' 6-max Seat #1 is the button
Seat 1: 3288926 ($7.73 in chips)
Seat 2: 113aa2fd ($10.06 in chips)
Seat 3: Hero ($5 in chips)
Seat 4: 6f212319 ($10.12 in chips)
Seat 5: 25a36e51 ($1.77 in chips)
Seat 6: ab5dffec ($6.3 in chips)
113aa2fd: posts small blind $0.02
Hero: posts big blind $0.05
*** HOLE CARDS ***
Dealt to 3288926 
Dealt to 113aa2fd 
Dealt to Hero [Ad 9d]
Dealt to 6f212319 
Dealt to 25a36e51 
Dealt to ab5dffec 
6f212319: folds
25a36e51: folds
ab5dffec: folds
3288926: folds
113aa2fd: folds
Uncalled bet ($0.03) returned to Hero
*** SHOWDOWN ***
Hero collected $0.04 from pot
*** SUMMARY ***
Total pot $0.04 | Rake $0 | Jackpot $0 | Bingo $0 | Fortune $0 | Tax $0
Seat 1: 3288926 (button) folded before Flop (didn't bet)
Seat 2: 113aa2fd (small blind) folded before Flop
Seat 3: Hero (big blind) collected ($0.04)
Seat 4: 6f212319 folded before Flop (didn't bet)
Seat 5: 25a36e51 folded before Flop (didn't bet)
Seat 6: ab5dffec folded before Flop (didn't bet)


Poker Hand #RC2078543388: Hold'em No Limit ($0.02/$0.05) - 2023/12/22 21:52:58
Table 'RushAndCash801304' 6-max Seat #1 is the button
Seat 1: 32c92a7b ($5.27 in chips)
Seat 2: 3bb1f7cc ($6.01 in chips)
Seat 3: c1ddcbae ($5.26 in chips)
Seat 4: Hero ($5 in chips)
Seat 5: a2ebb3c7 ($6.69 in chips)
Seat 6: 9d93c43e ($5 in chips)
3bb1f7cc: posts small blind $0.02
c1ddcbae: posts big blind $0.05
*** HOLE CARDS ***
Dealt to 32c92a7b 
Dealt to 3bb1f7cc 
Dealt to c1ddcbae 
Dealt to Hero [3h 7c]
Dealt to a2ebb3c7 
Dealt to 9d93c43e 
Hero: folds
a2ebb3c7: raises $0.06 to $0.11
9d93c43e: folds
32c92a7b: folds
3bb1f7cc: raises $0.39 to $0.5
c1ddcbae: folds
a2ebb3c7: folds
Uncalled bet ($0.39) returned to 3bb1f7cc
*** SHOWDOWN ***
3bb1f7cc collected $0.26 from pot
*** SUMMARY ***
Total pot $0.27 | Rake $0.01 | Jackpot $0 | Bingo $0 | Fortune $0 | Tax $0
Seat 1: 32c92a7b (button) folded before Flop (didn't bet)
Seat 2: 3bb1f7cc (small blind) collected ($0.26)
Seat 3: c1ddcbae (big blind) folded before Flop
Seat 4: Hero folded before Flop (didn't bet)
Seat 5: a2ebb3c7 folded before Flop
Seat 6: 9d93c43e folded before Flop (didn't bet)


Poker Hand #RC2078543327: Hold'em No Limit ($0.02/$0.05) - 2023/12/22 21:52:54
Table 'RushAndCash801276' 6-max Seat #1 is the button
Seat 1: 1c28bbd5 ($5.23 in chips)
Seat 2: c8adf5d ($6.43 in chips)
Seat 3: 610bd7fc ($8.62 in chips)
Seat 4: Hero ($5 in chips)
Seat 5: f6b5f68e ($6.02 in chips)
Seat 6: 56d0ca9d ($8.34 in chips)
c8adf5d: posts small blind $0.02
610bd7fc: posts big blind $0.05
*** HOLE CARDS ***
Dealt to 1c28bbd5 
Dealt to c8adf5d 
Dealt to 610bd7fc 
Dealt to Hero [8h 9c]
Dealt to f6b5f68e 
Dealt to 56d0ca9d 
Hero: folds
f6b5f68e: folds
56d0ca9d: folds
1c28bbd5: raises $0.06 to $0.11
c8adf5d: calls $0.09
610bd7fc: folds
*** FLOP *** [Kd 6d 7h]
c8adf5d: checks
1c28bbd5: bets $0.22
c8adf5d: folds
Uncalled bet ($0.22) returned to 1c28bbd5
*** SHOWDOWN ***
1c28bbd5 collected $0.26 from pot
*** SUMMARY ***
Total pot $0.27 | Rake $0.01 | Jackpot $0 | Bingo $0 | Fortune $0 | Tax $0
Board [Kd 6d 7h]
Seat 1: 1c28bbd5 (button) won ($0.26)
Seat 2: c8adf5d (small blind) folded on the Flop
Seat 3: 610bd7fc (big blind) folded before Flop
Seat 4: Hero folded before Flop (didn't bet)
Seat 5: f6b5f68e folded before Flop (didn't bet)
Seat 6: 56d0ca9d folded before Flop (didn't bet)


Poker Hand #RC2078542906: Hold'em No Limit ($0.02/$0.05) - 2023/12/22 21:52:29
Table 'RushAndCash801090' 6-max Seat #1 is the button
Seat 1: d32741ba ($11.76 in chips)
Seat 2: 2e11c0b5 ($5.17 in chips)
Seat 3: da860ca0 ($5.46 in chips)
Seat 4: 8f1a23de ($7.66 in chips)
Seat 5: Hero ($5 in chips)
Seat 6: 1be6b9fd ($17.06 in chips)
2e11c0b5: posts small blind $0.02
da860ca0: posts big blind $0.05
*** HOLE CARDS ***
Dealt to d32741ba 
Dealt to 2e11c0b5 
Dealt to da860ca0 
Dealt to 8f1a23de 
Dealt to Hero [4s 4d]
Dealt to 1be6b9fd 
8f1a23de: folds
Hero: raises $0.05 to $0.1
1be6b9fd: folds
d32741ba: folds
2e11c0b5: folds
da860ca0: calls $0.05
*** FLOP *** [Js 8c Ts]
da860ca0: checks
Hero: checks
*** TURN *** [Js 8c Ts] [6c]
da860ca0: bets $0.11
Hero: folds
Uncalled bet ($0.11) returned to da860ca0
*** SHOWDOWN ***
da860ca0 collected $0.21 from pot
*** SUMMARY ***
Total pot $0.22 | Rake $0.01 | Jackpot $0 | Bingo $0 | Fortune $0 | Tax $0
Board [Js 8c Ts 6c]
Seat 1: d32741ba (button) folded before Flop (didn't bet)
Seat 2: 2e11c0b5 (small blind) folded before Flop
Seat 3: da860ca0 (big blind) won ($0.21)
Seat 4: 8f1a23de folded before Flop (didn't bet)
Seat 5: Hero folded on the Turn
Seat 6: 1be6b9fd folded before Flop (didn't bet)


Poker Hand #RC2078542841: Hold'em No Limit ($0.02/$0.05) - 2023/12/22 21:52:25
Table 'RushAndCash801060' 6-max Seat #1 is the button
Seat 1: Hero ($5 in chips)
Seat 2: 18e88213 ($6.68 in chips)
Seat 3: 558ffb3 ($6.14 in chips)
Seat 4: 661ba238 ($5.6 in chips)
Seat 5: fab544c8 ($5 in chips)
Seat 6: f1ad1775 ($4.93 in chips)
18e88213: posts small blind $0.02
558ffb3: posts big blind $0.05
*** HOLE CARDS ***
Dealt to Hero [2h 5c]
Dealt to 18e88213 
Dealt to 558ffb3 
Dealt to 661ba238 
Dealt to fab544c8 
Dealt to f1ad1775 
661ba238: folds
fab544c8: folds
f1ad1775: folds
Hero: folds
18e88213: folds
Uncalled bet ($0.03) returned to 558ffb3
*** SHOWDOWN ***
558ffb3 collected $0.04 from pot
*** SUMMARY ***
Total pot $0.04 | Rake $0 | Jackpot $0 | Bingo $0 | Fortune $0 | Tax $0
Seat 1: Hero (button) folded before Flop (didn't bet)
Seat 2: 18e88213 (small blind) folded before Flop
Seat 3: 558ffb3 (big blind) collected ($0.04)
Seat 4: 661ba238 folded before Flop (didn't bet)
Seat 5: fab544c8 folded before Flop (didn't bet)
Seat 6: f1ad1775 folded before Flop (didn't bet)


Poker Hand #RC2078542780: Hold'em No Limit ($0.02/$0.05) - 2023/12/22 21:52:21
Table 'RushAndCash801034' 6-max Seat #1 is the button
Seat 1: cd02a153 ($5 in chips)
Seat 2: 1b4a662e ($4.87 in chips)
Seat 3: d2739eda ($6.75 in chips)
Seat 4: 4f704fa2 ($5.44 in chips)
Seat 5: 963f3a1f ($3.46 in chips)
Seat 6: Hero ($5 in chips)
1b4a662e: posts small blind $0.02
d2739eda: posts big blind $0.05
*** HOLE CARDS ***
Dealt to cd02a153 
Dealt to 1b4a662e 
Dealt to d2739eda 
Dealt to 4f704fa2 
Dealt to 963f3a1f 
Dealt to Hero [4h 8h]
4f704fa2: folds
963f3a1f: folds
Hero: folds
cd02a153: folds
1b4a662e: raises $0.05 to $0.1
d2739eda: calls $0.05
*** FLOP *** [Jd 6c 4s]
1b4a662e: bets $0.07
d2739eda: folds
Uncalled bet ($0.07) returned to 1b4a662e
*** SHOWDOWN ***
1b4a662e collected $0.19 from pot
*** SUMMARY ***
Total pot $0.2 | Rake $0.01 | Jackpot $0 | Bingo $0 | Fortune $0 | Tax $0
Board [Jd 6c 4s]
Seat 1: cd02a153 (button) folded before Flop (didn't bet)
Seat 2: 1b4a662e (small blind) won ($0.19)
Seat 3: d2739eda (big blind) folded on the Flop
Seat 4: 4f704fa2 folded before Flop (didn't bet)
Seat 5: 963f3a1f folded before Flop (didn't bet)
Seat 6: Hero folded before Flop (didn't bet)


Poker Hand #RC2078542654: Hold'em No Limit ($0.02/$0.05) - 2023/12/22 21:52:14
Table 'RushAndCash800974' 6-max Seat #1 is the button
Seat 1: c4382072 ($9.73 in chips)
Seat 2: Hero ($5.02 in chips)
Seat 3: 993ccadb ($14.65 in chips)
Seat 4: 6c75362e ($11.16 in chips)
Seat 5: c84db7d6 ($4.42 in chips)
Seat 6: 8642862c ($5.51 in chips)
Hero: posts small blind $0.02
993ccadb: posts big blind $0.05
*** HOLE CARDS ***
Dealt to c4382072 
Dealt to Hero [Td 4d]
Dealt to 993ccadb 
Dealt to 6c75362e 
Dealt to c84db7d6 
Dealt to 8642862c 
6c75362e: folds
c84db7d6: folds
8642862c: raises $0.08 to $0.13
c4382072: folds
Hero: folds
993ccadb: calls $0.08
*** FLOP *** [Js Ad Ts]
993ccadb: checks
8642862c: checks
*** TURN *** [Js Ad Ts] [7c]
993ccadb: checks
8642862c: bets $0.1
993ccadb: folds
Uncalled bet ($0.1) returned to 8642862c
*** SHOWDOWN ***
8642862c collected $0.27 from pot
*** SUMMARY ***
Total pot $0.28 | Rake $0.01 | Jackpot $0 | Bingo $0 | Fortune $0 | Tax $0
Board [Js Ad Ts 7c]
Seat 1: c4382072 (button) folded before Flop (didn't bet)
Seat 2: Hero (small blind) folded before Flop
Seat 3: 993ccadb (big blind) folded on the Turn
Seat 4: 6c75362e folded before Flop (didn't bet)
Seat 5: c84db7d6 folded before Flop (didn't bet)
Seat 6: 8642862c won ($0.27)


Poker Hand #RC2078542526: Hold'em No Limit ($0.02/$0.05) - 2023/12/22 21:52:07
Table 'RushAndCash800910' 6-max Seat #1 is the button
Seat 1: 566b7ee3 ($5.59 in chips)
Seat 2: 3056048f ($5.64 in chips)
Seat 3: Hero ($5 in chips)
Seat 4: 9d5d55a2 ($5 in chips)
Seat 5: cc277349 ($3.79 in chips)
Seat 6: efbf8ee8 ($6.69 in chips)
3056048f: posts small blind $0.02
Hero: posts big blind $0.05
*** HOLE CARDS ***
Dealt to 566b7ee3 
Dealt to 3056048f 
Dealt to Hero [Qd 4d]
Dealt to 9d5d55a2 
Dealt to cc277349 
Dealt to efbf8ee8 
9d5d55a2: folds
cc277349: folds
efbf8ee8: folds
566b7ee3: folds
3056048f: folds
Uncalled bet ($0.03) returned to Hero
*** SHOWDOWN ***
Hero collected $0.04 from pot
*** SUMMARY ***
Total pot $0.04 | Rake $0 | Jackpot $0 | Bingo $0 | Fortune $0 | Tax $0
Seat 1: 566b7ee3 (button) folded before Flop (didn't bet)
Seat 2: 3056048f (small blind) folded before Flop
Seat 3: Hero (big blind) collected ($0.04)
Seat 4: 9d5d55a2 folded before Flop (didn't bet)
Seat 5: cc277349 folded before Flop (didn't bet)
Seat 6: efbf8ee8 folded before Flop (didn't bet)


Poker Hand #RC2078542459: Hold'em No Limit ($0.02/$0.05) - 2023/12/22 21:52:04
Table 'RushAndCash800880' 6-max Seat #1 is the button
Seat 1: b61f5bde ($12.27 in chips)
Seat 2: 1968b4b2 ($2.66 in chips)
Seat 3: 36acf706 ($5.82 in chips)
Seat 4: Hero ($5 in chips)
Seat 5: 875f34a0 ($23.32 in chips)
Seat 6: 3056048f ($5.64 in chips)
1968b4b2: posts small blind $0.02
36acf706: posts big blind $0.05
*** HOLE CARDS ***
Dealt to b61f5bde 
Dealt to 1968b4b2 
Dealt to 36acf706 
Dealt to Hero [Kh 7s]
Dealt to 875f34a0 
Dealt to 3056048f 
Hero: folds
875f34a0: folds
3056048f: folds
b61f5bde: folds
1968b4b2: calls $0.03
36acf706: raises $0.07 to $0.12
1968b4b2: calls $0.07
*** FLOP *** [5s 4d Qh]
1968b4b2: checks
36acf706: bets $0.08
1968b4b2: folds
Uncalled bet ($0.08) returned to 36acf706
*** SHOWDOWN ***
36acf706 collected $0.23 from pot
*** SUMMARY ***
Total pot $0.24 | Rake $0.01 | Jackpot $0 | Bingo $0 | Fortune $0 | Tax $0
Board [5s 4d Qh]
Seat 1: b61f5bde (button) folded before Flop (didn't bet)
Seat 2: 1968b4b2 (small blind) folded on the Flop
Seat 3: 36acf706 (big blind) won ($0.23)
Seat 4: Hero folded before Flop (didn't bet)
Seat 5: 875f34a0 folded before Flop (didn't bet)
Seat 6: 3056048f folded before Flop (didn't bet)


Poker Hand #RC2078542294: Hold'em No Limit ($0.02/$0.05) - 2023/12/22 21:51:54
Table 'RushAndCash800800' 6-max Seat #1 is the button
Seat 1: 6d50e434 ($3.7 in chips)
Seat 2: c6b00fb7 ($5 in chips)
Seat 3: f938f1e ($5.1 in chips)
Seat 4: fa7bd554 ($6.09 in chips)
Seat 5: Hero ($5 in chips)
Seat 6: 4879e77e ($4.93 in chips)
c6b00fb7: posts small blind $0.02
f938f1e: posts big blind $0.05
*** HOLE CARDS ***
Dealt to 6d50e434 
Dealt to c6b00fb7 
Dealt to f938f1e 
Dealt to fa7bd554 
Dealt to Hero [8c Jc]
Dealt to 4879e77e 
fa7bd554: folds
Hero: folds
4879e77e: raises $0.06 to $0.11
6d50e434: folds
c6b00fb7: folds
f938f1e: folds
Uncalled bet ($0.06) returned to 4879e77e
*** SHOWDOWN ***
4879e77e collected $0.12 from pot
*** SUMMARY ***
Total pot $0.12 | Rake $0 | Jackpot $0 | Bingo $0 | Fortune $0 | Tax $0
Seat 1: 6d50e434 (button) folded before Flop (didn't bet)
Seat 2: c6b00fb7 (small blind) folded before Flop
Seat 3: f938f1e (big blind) folded before Flop
Seat 4: fa7bd554 folded before Flop (didn't bet)
Seat 5: Hero folded before Flop (didn't bet)
Seat 6: 4879e77e collected ($0.12)


Poker Hand #RC2078542221: Hold'em No Limit ($0.02/$0.05) - 2023/12/22 21:51:51
Table 'RushAndCash800764' 6-max Seat #1 is the button
Seat 1: 93d5c821 ($6.1 in chips)
Seat 2: 38e42730 ($7.75 in chips)
Seat 3: f94de4b0 ($6.18 in chips)
Seat 4: 697fb04a ($52.17 in chips)
Seat 5: Hero ($5 in chips)
Seat 6: 141790ab ($4.58 in chips)
38e42730: posts small blind $0.02
f94de4b0: posts big blind $0.05
*** HOLE CARDS ***
Dealt to 93d5c821 
Dealt to 38e42730 
Dealt to f94de4b0 
Dealt to 697fb04a 
Dealt to Hero [3h 5h]
Dealt to 141790ab 
697fb04a: folds
Hero: folds
141790ab: folds
93d5c821: raises $0.05 to $0.1
38e42730: raises $0.3 to $0.4
f94de4b0: folds
93d5c821: folds
Uncalled bet ($0.3) returned to 38e42730
*** SHOWDOWN ***
38e42730 collected $0.24 from pot
*** SUMMARY ***
Total pot $0.25 | Rake $0.01 | Jackpot $0 | Bingo $0 | Fortune $0 | Tax $0
Seat 1: 93d5c821 (button) folded before Flop
Seat 2: 38e42730 (small blind) collected ($0.24)
Seat 3: f94de4b0 (big blind) folded before Flop
Seat 4: 697fb04a folded before Flop (didn't bet)
Seat 5: Hero folded before Flop (didn't bet)
Seat 6: 141790ab folded before Flop (didn't bet)


Poker Hand #RC2078542150: Hold'em No Limit ($0.02/$0.05) - 2023/12/22 21:51:47
Table 'RushAndCash800728' 6-max Seat #1 is the button
Seat 1: ec5f3643 ($4.48 in chips)
Seat 2: 93d5c821 ($6.12 in chips)
Seat 3: deb19c7 ($11.28 in chips)
Seat 4: Hero ($5 in chips)
Seat 5: ee1691f8 ($8.46 in chips)
Seat 6: 129846c0 ($5 in chips)
93d5c821: posts small blind $0.02
deb19c7: posts big blind $0.05
*** HOLE CARDS ***
Dealt to ec5f3643 
Dealt to 93d5c821 
Dealt to deb19c7 
Dealt to Hero [6c 7h]
Dealt to ee1691f8 
Dealt to 129846c0 
Hero: folds
ee1691f8: folds
129846c0: folds
ec5f3643: raises $0.08 to $0.13
93d5c821: folds
deb19c7: folds
Uncalled bet ($0.08) returned to ec5f3643
*** SHOWDOWN ***
ec5f3643 collected $0.12 from pot
*** SUMMARY ***
Total pot $0.12 | Rake $0 | Jackpot $0 | Bingo $0 | Fortune $0 | Tax $0
Seat 1: ec5f3643 (button) collected ($0.12)
Seat 2: 93d5c821 (small blind) folded before Flop
Seat 3: deb19c7 (big blind) folded before Flop
Seat 4: Hero folded before Flop (didn't bet)
Seat 5: ee1691f8 folded before Flop (didn't bet)
Seat 6: 129846c0 folded before Flop (didn't bet)


Poker Hand #RC2078542082: Hold'em No Limit ($0.02/$0.05) - 2023/12/22 21:51:43
Table 'RushAndCash800694' 6-max Seat #1 is the button
Seat 1: 49a9584 ($5.74 in chips)
Seat 2: Hero ($5 in chips)
Seat 3: d9ec3117 ($5 in chips)
Seat 4: f93190a6 ($8.63 in chips)
Seat 5: 11612373 ($13.47 in chips)
Seat 6: f30308e3 ($5.24 in chips)
Hero: posts small blind $0.02
d9ec3117: posts big blind $0.05
*** HOLE CARDS ***
Dealt to 49a9584 
Dealt to Hero [Ks 7c]
Dealt to d9ec3117 
Dealt to f93190a6 
Dealt to 11612373 
Dealt to f30308e3 
f93190a6: folds
11612373: folds
f30308e3: raises $0.06 to $0.11
49a9584: folds
Hero: folds
d9ec3117: calls $0.06
*** FLOP *** [8h 5d 4d]
d9ec3117: bets $0.05
f30308e3: calls $0.05
*** TURN *** [8h 5d 4d] [3d]
d9ec3117: checks
f30308e3: checks
*** RIVER *** [8h 5d 4d 3d] [9h]
d9ec3117: checks
f30308e3: checks
d9ec3117: shows [6s As] (Ace-High)
f30308e3: shows [Th Qd] (Queen-High)
*** SHOWDOWN ***
d9ec3117 collected $0.33 from pot
*** SUMMARY ***
Total pot $0.34 | Rake $0.01 | Jackpot $0 | Bingo $0 | Fortune $0 | Tax $0
Board [8h 5d 4d 3d 9h]
Seat 1: 49a9584 (button) folded before Flop (didn't bet)
Seat 2: Hero (small blind) folded before Flop
Seat 3: d9ec3117 (big blind) showed [6s As] and won ($0.33) with Ace-High
Seat 4: f93190a6 folded before Flop (didn't bet)
Seat 5: 11612373 folded before Flop (didn't bet)
Seat 6: f30308e3 showed [Th Qd] and lost with Queen-High


Poker Hand #RC2078542013: Hold'em No Limit ($0.02/$0.05) - 2023/12/22 21:51:39
Table 'RushAndCash800660' 6-max Seat #1 is the button
Seat 1: Hero ($5 in chips)
Seat 2: 725fcf25 ($5.61 in chips)
Seat 3: 39956d46 ($5.14 in chips)
Seat 4: f57c6794 ($6.45 in chips)
Seat 5: 8ff4ca07 ($6.11 in chips)
Seat 6: f229c31b ($5.07 in chips)
725fcf25: posts small blind $0.02
39956d46: posts big blind $0.05
*** HOLE CARDS ***
Dealt to Hero [Td 9h]
Dealt to 725fcf25 
Dealt to 39956d46 
Dealt to f57c6794 
Dealt to 8ff4ca07 
Dealt to f229c31b 
f57c6794: folds
8ff4ca07: folds
f229c31b: folds
Hero: folds
725fcf25: folds
Uncalled bet ($0.03) returned to 39956d46
*** SHOWDOWN ***
39956d46 collected $0.04 from pot
*** SUMMARY ***
Total pot $0.04 | Rake $0 | Jackpot $0 | Bingo $0 | Fortune $0 | Tax $0
Seat 1: Hero (button) folded before Flop (didn't bet)
Seat 2: 725fcf25 (small blind) folded before Flop
Seat 3: 39956d46 (big blind) collected ($0.04)
Seat 4: f57c6794 folded before Flop (didn't bet)
Seat 5: 8ff4ca07 folded before Flop (didn't bet)
Seat 6: f229c31b folded before Flop (didn't bet)


Poker Hand #RC2078541902: Hold'em No Limit ($0.02/$0.05) - 2023/12/22 21:51:33
Table 'RushAndCash800604' 6-max Seat #1 is the button
Seat 1: 8e4ad426 ($7.57 in chips)
Seat 2: 784b6733 ($5 in chips)
Seat 3: ff34c3d1 ($5 in chips)
Seat 4: 2d4acc60 ($2.72 in chips)
Seat 5: Hero ($5 in chips)
Seat 6: 2588276e ($11.17 in chips)
784b6733: posts small blind $0.02
ff34c3d1: posts big blind $0.05
*** HOLE CARDS ***
Dealt to 8e4ad426 
Dealt to 784b6733 
Dealt to ff34c3d1 
Dealt to 2d4acc60 
Dealt to Hero [2c 6h]
Dealt to 2588276e 
2d4acc60: raises $0.05 to $0.1
Hero: folds
2588276e: folds
8e4ad426: calls $0.1
784b6733: folds
ff34c3d1: folds
*** FLOP *** [2s Qd Ac]
2d4acc60: checks
8e4ad426: checks
*** TURN *** [2s Qd Ac] [Qc]
2d4acc60: checks
8e4ad426: checks
*** RIVER *** [2s Qd Ac Qc] [2h]
2d4acc60: checks
8e4ad426: checks
2d4acc60: shows [Kd 8d] (Pair of Queens and Pair of Twos)
8e4ad426: shows [9s 9h] (Pair of Queens and Pair of Nines)
*** SHOWDOWN ***
8e4ad426 collected $0.26 from pot
*** SUMMARY ***
Total pot $0.27 | Rake $0.01 | Jackpot $0 | Bingo $0 | Fortune $0 | Tax $0
Board [2s Qd Ac Qc 2h]
Seat 1: 8e4ad426 (button) showed [9s 9h] and won ($0.26) with Pair of Queens and Pair of Nines
Seat 2: 784b6733 (small blind) folded before Flop
Seat 3: ff34c3d1 (big blind) folded before Flop
Seat 4: 2d4acc60 showed [Kd 8d] and lost with Pair of Queens and Pair of Twos
Seat 5: Hero folded before Flop (didn't bet)
Seat 6: 2588276e folded before Flop (didn't bet)


Poker Hand #RC2078540366: Hold'em No Limit ($0.02/$0.05) - 2023/12/22 21:50:04
Table 'RushAndCash799853' 6-max Seat #1 is the button
Seat 1: 1c1fc2a1 ($8.52 in chips)
Seat 2: c71b7029 ($9.93 in chips)
Seat 3: Hero ($5.04 in chips)
Seat 4: 74f0610b ($4.35 in chips)
Seat 5: d71ab80c ($5.04 in chips)
Seat 6: 8d94440d ($5.14 in chips)
c71b7029: posts small blind $0.02
Hero: posts big blind $0.05
*** HOLE CARDS ***
Dealt to 1c1fc2a1 
Dealt to c71b7029 
Dealt to Hero [Qh Qs]
Dealt to 74f0610b 
Dealt to d71ab80c 
Dealt to 8d94440d 
74f0610b: calls $0.05
d71ab80c: raises $0.13 to $0.18
8d94440d: folds
1c1fc2a1: folds
c71b7029: folds
Hero: raises $0.38 to $0.56
74f0610b: folds
d71ab80c: calls $0.38
*** FLOP *** [4s 4d Jc]
Hero: bets $0.6
d71ab80c: calls $0.6
*** TURN *** [4s 4d Jc] [7c]
Hero: bets $0.79
d71ab80c: calls $0.79
*** RIVER *** [4s 4d Jc 7c] [9c]
Hero: bets $1.32
d71ab80c: calls $1.32
Hero: shows [Qh Qs] (Pair of Queens and Pair of Fours)
d71ab80c: shows [Qc Qd] (Pair of Queens and Pair of Fours)
*** SHOWDOWN ***
Hero collected $3.2 from pot
d71ab80c collected $3.2 from pot
*** SUMMARY ***
Total pot $6.61 | Rake $0.14 | Jackpot $0.07 | Bingo $0 | Fortune $0 | Tax $0
Board [4s 4d Jc 7c 9c]
Seat 1: 1c1fc2a1 (button) folded before Flop (didn't bet)
Seat 2: c71b7029 (small blind) folded before Flop
Seat 3: Hero (big blind) showed [Qh Qs] and won ($3.2) with Pair of Queens and Pair of Fours
Seat 4: 74f0610b folded before Flop
Seat 5: d71ab80c showed [Qc Qd] and won ($3.2) with Pair of Queens and Pair of Fours
Seat 6: 8d94440d folded before Flop (didn't bet)


Poker Hand #RC2078540298: Hold'em No Limit ($0.02/$0.05) - 2023/12/22 21:50:00
Table 'RushAndCash799817' 6-max Seat #1 is the button
Seat 1: eac1a90f ($5.89 in chips)
Seat 2: 91e6539a ($5.2 in chips)
Seat 3: f30308e3 ($5.68 in chips)
Seat 4: Hero ($5.04 in chips)
Seat 5: 8a94bd25 ($5.39 in chips)
Seat 6: ca0b098f ($5 in chips)
91e6539a: posts small blind $0.02
f30308e3: posts big blind $0.05
*** HOLE CARDS ***
Dealt to eac1a90f 
Dealt to 91e6539a 
Dealt to f30308e3 
Dealt to Hero [7h 3c]
Dealt to 8a94bd25 
Dealt to ca0b098f 
Hero: folds
8a94bd25: folds
ca0b098f: raises $0.1 to $0.15
eac1a90f: folds
91e6539a: folds
f30308e3: calls $0.1
*** FLOP *** [7d Jd Qs]
f30308e3: checks
ca0b098f: checks
*** TURN *** [7d Jd Qs] [As]
f30308e3: checks
ca0b098f: bets $0.24
f30308e3: folds
Uncalled bet ($0.24) returned to ca0b098f
*** SHOWDOWN ***
ca0b098f collected $0.31 from pot
*** SUMMARY ***
Total pot $0.32 | Rake $0.01 | Jackpot $0 | Bingo $0 | Fortune $0 | Tax $0
Board [7d Jd Qs As]
Seat 1: eac1a90f (button) folded before Flop (didn't bet)
Seat 2: 91e6539a (small blind) folded before Flop
Seat 3: f30308e3 (big blind) folded on the Turn
Seat 4: Hero folded before Flop (didn't bet)
Seat 5: 8a94bd25 folded before Flop (didn't bet)
Seat 6: ca0b098f won ($0.31)


Poker Hand #RC2078539468: Hold'em No Limit ($0.02/$0.05) - 2023/12/22 21:49:11
Table 'RushAndCash799433' 6-max Seat #1 is the button
Seat 1: 64a4f489 ($6.04 in chips)
Seat 2: Hero ($5.29 in chips)
Seat 3: e4d2f8b7 ($9.54 in chips)
Seat 4: e49e39a2 ($13.97 in chips)
Seat 5: 13187061 ($5.07 in chips)
Seat 6: 1c1fc2a1 ($8.52 in chips)
Hero: posts small blind $0.02
e4d2f8b7: posts big blind $0.05
*** HOLE CARDS ***
Dealt to 64a4f489 
Dealt to Hero [7d 7h]
Dealt to e4d2f8b7 
Dealt to e49e39a2 
Dealt to 13187061 
Dealt to 1c1fc2a1 
e49e39a2: folds
13187061: folds
1c1fc2a1: folds
64a4f489: raises $0.09 to $0.14
Hero: calls $0.12
e4d2f8b7: folds
*** FLOP *** [Td Qh Jd]
Hero: checks
64a4f489: bets $0.11
Hero: calls $0.11
*** TURN *** [Td Qh Jd] [6c]
Hero: checks
64a4f489: bets $0.28
Hero: folds
Uncalled bet ($0.28) returned to 64a4f489
*** SHOWDOWN ***
64a4f489 collected $0.53 from pot
*** SUMMARY ***
Total pot $0.55 | Rake $0.02 | Jackpot $0 | Bingo $0 | Fortune $0 | Tax $0
Board [Td Qh Jd 6c]
Seat 1: 64a4f489 (button) won ($0.53)
Seat 2: Hero (small blind) folded on the Turn
Seat 3: e4d2f8b7 (big blind) folded before Flop
Seat 4: e49e39a2 folded before Flop (didn't bet)
Seat 5: 13187061 folded before Flop (didn't bet)
Seat 6: 1c1fc2a1 folded before Flop (didn't bet)


Poker Hand #RC2078539389: Hold'em No Limit ($0.02/$0.05) - 2023/12/22 21:49:06
Table 'RushAndCash799397' 6-max Seat #1 is the button
Seat 1: fc7e8623 ($15.18 in chips)
Seat 2: f283b60 ($5.56 in chips)
Seat 3: e97b55e1 ($5 in chips)
Seat 4: Hero ($5.29 in chips)
Seat 5: c8389234 ($12.33 in chips)
Seat 6: e8886428 ($39.94 in chips)
f283b60: posts small blind $0.02
e97b55e1: posts big blind $0.05
*** HOLE CARDS ***
Dealt to fc7e8623 
Dealt to f283b60 
Dealt to e97b55e1 
Dealt to Hero [3d 9d]
Dealt to c8389234 
Dealt to e8886428 
Hero: folds
c8389234: folds
e8886428: folds
fc7e8623: raises $0.1 to $0.15
f283b60: folds
e97b55e1: folds
Uncalled bet ($0.1) returned to fc7e8623
*** SHOWDOWN ***
fc7e8623 collected $0.12 from pot
*** SUMMARY ***
Total pot $0.12 | Rake $0 | Jackpot $0 | Bingo $0 | Fortune $0 | Tax $0
Seat 1: fc7e8623 (button) collected ($0.12)
Seat 2: f283b60 (small blind) folded before Flop
Seat 3: e97b55e1 (big blind) folded before Flop
Seat 4: Hero folded before Flop (didn't bet)
Seat 5: c8389234 folded before Flop (didn't bet)
Seat 6: e8886428 folded before Flop (didn't bet)


Poker Hand #RC2078539236: Hold'em No Limit ($0.02/$0.05) - 2023/12/22 21:48:59
Table 'RushAndCash799320' 6-max Seat #1 is the button
Seat 1: f9df797f ($5.49 in chips)
Seat 2: 5916f023 ($5 in chips)
Seat 3: Hero ($5.27 in chips)
Seat 4: 570cf06f ($4.19 in chips)
Seat 5: 532b7af3 ($8.6 in chips)
Seat 6: 930a109a ($2.23 in chips)
5916f023: posts small blind $0.02
Hero: posts big blind $0.05
*** HOLE CARDS ***
Dealt to f9df797f 
Dealt to 5916f023 
Dealt to Hero [8c As]
Dealt to 570cf06f 
Dealt to 532b7af3 
Dealt to 930a109a 
570cf06f: folds
532b7af3: folds
930a109a: folds
f9df797f: folds
5916f023: folds
Uncalled bet ($0.03) returned to Hero
*** SHOWDOWN ***
Hero collected $0.04 from pot
*** SUMMARY ***
Total pot $0.04 | Rake $0 | Jackpot $0 | Bingo $0 | Fortune $0 | Tax $0
Seat 1: f9df797f (button) folded before Flop (didn't bet)
Seat 2: 5916f023 (small blind) folded before Flop
Seat 3: Hero (big blind) collected ($0.04)
Seat 4: 570cf06f folded before Flop (didn't bet)
Seat 5: 532b7af3 folded before Flop (didn't bet)
Seat 6: 930a109a folded before Flop (didn't bet)


Poker Hand #RC2078539132: Hold'em No Limit ($0.02/$0.05) - 2023/12/22 21:48:52
Table 'RushAndCash799270' 6-max Seat #1 is the button
Seat 1: Hero ($5.27 in chips)
Seat 2: 8014c02 ($13.9 in chips)
Seat 3: 58864a6e ($16.83 in chips)
Seat 4: 3d929f9f ($9.47 in chips)
Seat 5: 6fefb285 ($5.51 in chips)
Seat 6: 354a07bb ($8.21 in chips)
8014c02: posts small blind $0.02
58864a6e: posts big blind $0.05
*** HOLE CARDS ***
Dealt to Hero [Qd Th]
Dealt to 8014c02 
Dealt to 58864a6e 
Dealt to 3d929f9f 
Dealt to 6fefb285 
Dealt to 354a07bb 
3d929f9f: folds
6fefb285: raises $0.08 to $0.13
354a07bb: folds
Hero: folds
8014c02: folds
58864a6e: calls $0.08
*** FLOP *** [2h 7s 4h]
58864a6e: checks
6fefb285: bets $0.14
58864a6e: raises $0.28 to $0.42
6fefb285: calls $0.28
*** TURN *** [2h 7s 4h] [6s]
58864a6e: checks
6fefb285: bets $0.37
58864a6e: calls $0.37
*** RIVER *** [2h 7s 4h 6s] [Kh]
58864a6e: checks
6fefb285: checks
58864a6e: shows [6c Jc] (Pair of Sixes)
6fefb285: shows [5s 5d] (Pair of Fives)
*** SHOWDOWN ***
58864a6e collected $1.7 from pot
*** SUMMARY ***
Total pot $1.86 | Rake $0.09 | Jackpot $0.07 | Bingo $0 | Fortune $0 | Tax $0
Board [2h 7s 4h 6s Kh]
Seat 1: Hero (button) folded before Flop (didn't bet)
Seat 2: 8014c02 (small blind) folded before Flop
Seat 3: 58864a6e (big blind) showed [6c Jc] and won ($1.7) with Pair of Sixes
Seat 4: 3d929f9f folded before Flop (didn't bet)
Seat 5: 6fefb285 showed [5s 5d] and lost with Pair of Fives
Seat 6: 354a07bb folded before Flop (didn't bet)


Poker Hand #RC2078539065: Hold'em No Limit ($0.02/$0.05) - 2023/12/22 21:48:49
Table 'RushAndCash799238' 6-max Seat #1 is the button
Seat 1: c11c43d0 ($4.93 in chips)
Seat 2: 7095bc76 ($5.12 in chips)
Seat 3: b6052383 ($4.88 in chips)
Seat 4: Hero ($5.27 in chips)
Seat 5: 1968b4b2 ($3.3 in chips)
Seat 6: 4df86067 ($6.21 in chips)
7095bc76: posts small blind $0.02
b6052383: posts big blind $0.05
*** HOLE CARDS ***
Dealt to c11c43d0 
Dealt to 7095bc76 
Dealt to b6052383 
Dealt to Hero [7h Ks]
Dealt to 1968b4b2 
Dealt to 4df86067 
Hero: folds
1968b4b2: folds
4df86067: raises $0.1 to $0.15
c11c43d0: folds
7095bc76: folds
b6052383: folds
Uncalled bet ($0.1) returned to 4df86067
*** SHOWDOWN ***
4df86067 collected $0.12 from pot
*** SUMMARY ***
Total pot $0.12 | Rake $0 | Jackpot $0 | Bingo $0 | Fortune $0 | Tax $0
Seat 1: c11c43d0 (button) folded before Flop (didn't bet)
Seat 2: 7095bc76 (small blind) folded before Flop
Seat 3: b6052383 (big blind) folded before Flop
Seat 4: Hero folded before Flop (didn't bet)
Seat 5: 1968b4b2 folded before Flop (didn't bet)
Seat 6: 4df86067 collected ($0.12)


Poker Hand #RC2078539003: Hold'em No Limit ($0.02/$0.05) - 2023/12/22 21:48:45
Table 'RushAndCash799208' 6-max Seat #1 is the button
Seat 1: cc0e5af8 ($6.11 in chips)
Seat 2: 67175993 ($5.02 in chips)
Seat 3: e17307eb ($7.99 in chips)
Seat 4: Hero ($5.27 in chips)
Seat 5: 8d15f06b ($11.84 in chips)
Seat 6: 6a898db1 ($5.58 in chips)
67175993: posts small blind $0.02
e17307eb: posts big blind $0.05
*** HOLE CARDS ***
Dealt to cc0e5af8 
Dealt to 67175993 
Dealt to e17307eb 
Dealt to Hero [9d 2d]
Dealt to 8d15f06b 
Dealt to 6a898db1 
Hero: folds
8d15f06b: folds
6a898db1: folds
cc0e5af8: folds
67175993: folds
Uncalled bet ($0.03) returned to e17307eb
*** SHOWDOWN ***
e17307eb collected $0.04 from pot
*** SUMMARY ***
Total pot $0.04 | Rake $0 | Jackpot $0 | Bingo $0 | Fortune $0 | Tax $0
Seat 1: cc0e5af8 (button) folded before Flop (didn't bet)
Seat 2: 67175993 (small blind) folded before Flop
Seat 3: e17307eb (big blind) collected ($0.04)
Seat 4: Hero folded before Flop (didn't bet)
Seat 5: 8d15f06b folded before Flop (didn't bet)
Seat 6: 6a898db1 folded before Flop (didn't bet)


Poker Hand #RC2078538755: Hold'em No Limit ($0.02/$0.05) - 2023/12/22 21:48:31
Table 'RushAndCash799084' 6-max Seat #1 is the button
Seat 1: 566b7ee3 ($5.05 in chips)
Seat 2: c883264a ($13.36 in chips)
Seat 3: d4d7018e ($6.6 in chips)
Seat 4: c3c9a58d ($6.31 in chips)
Seat 5: 2afe98d4 ($5.23 in chips)
Seat 6: Hero ($5.27 in chips)
c883264a: posts small blind $0.02
d4d7018e: posts big blind $0.05
*** HOLE CARDS ***
Dealt to 566b7ee3 
Dealt to c883264a 
Dealt to d4d7018e 
Dealt to c3c9a58d 
Dealt to 2afe98d4 
Dealt to Hero [6d 7h]
c3c9a58d: folds
2afe98d4: folds
Hero: folds
566b7ee3: raises $0.08 to $0.13
c883264a: folds
d4d7018e: folds
Uncalled bet ($0.08) returned to 566b7ee3
*** SHOWDOWN ***
566b7ee3 collected $0.12 from pot
*** SUMMARY ***
Total pot $0.12 | Rake $0 | Jackpot $0 | Bingo $0 | Fortune $0 | Tax $0
Seat 1: 566b7ee3 (button) collected ($0.12)
Seat 2: c883264a (small blind) folded before Flop
Seat 3: d4d7018e (big blind) folded before Flop
Seat 4: c3c9a58d folded before Flop (didn't bet)
Seat 5: 2afe98d4 folded before Flop (didn't bet)
Seat 6: Hero folded before Flop (didn't bet)


Poker Hand #RC2078538695: Hold'em No Limit ($0.02/$0.05) - 2023/12/22 21:48:27
Table 'RushAndCash799058' 6-max Seat #1 is the button
Seat 1: 39b51503 ($5.09 in chips)
Seat 2: 89dad04f ($9.25 in chips)
Seat 3: 9afe0027 ($2.25 in chips)
Seat 4: 360d3b25 ($5.07 in chips)
Seat 5: Hero ($5.27 in chips)
Seat 6: 463feb61 ($11.06 in chips)
89dad04f: posts small blind $0.02
9afe0027: posts big blind $0.05
*** HOLE CARDS ***
Dealt to 39b51503 
Dealt to 89dad04f 
Dealt to 9afe0027 
Dealt to 360d3b25 
Dealt to Hero [6c 3d]
Dealt to 463feb61 
360d3b25: raises $0.07 to $0.12
Hero: folds
463feb61: calls $0.12
39b51503: folds
89dad04f: folds
9afe0027: folds
*** FLOP *** [Js 5d Ad]
360d3b25: checks
463feb61: checks
*** TURN *** [Js 5d Ad] [Kd]
360d3b25: bets $0.19
463feb61: folds
Uncalled bet ($0.19) returned to 360d3b25
*** SHOWDOWN ***
360d3b25 collected $0.3 from pot
*** SUMMARY ***
Total pot $0.31 | Rake $0.01 | Jackpot $0 | Bingo $0 | Fortune $0 | Tax $0
Board [Js 5d Ad Kd]
Seat 1: 39b51503 (button) folded before Flop (didn't bet)
Seat 2: 89dad04f (small blind) folded before Flop
Seat 3: 9afe0027 (big blind) folded before Flop
Seat 4: 360d3b25 won ($0.3)
Seat 5: Hero folded before Flop (didn't bet)
Seat 6: 463feb61 folded on the Turn


Poker Hand #RC2078537976: Hold'em No Limit ($0.02/$0.05) - 2023/12/22 21:47:44
Table 'RushAndCash798699' 6-max Seat #1 is the button
Seat 1: 956b2f28 ($4.11 in chips)
Seat 2: Hero ($5 in chips)
Seat 3: 641f40f7 ($5 in chips)
Seat 4: 2c867a7e ($11.4 in chips)
Seat 5: 45bb3f0f ($5.05 in chips)
Seat 6: 89dad04f ($9.49 in chips)
Hero: posts small blind $0.02
641f40f7: posts big blind $0.05
*** HOLE CARDS ***
Dealt to 956b2f28 
Dealt to Hero [2s As]
Dealt to 641f40f7 
Dealt to 2c867a7e 
Dealt to 45bb3f0f 
Dealt to 89dad04f 
2c867a7e: folds
45bb3f0f: folds
89dad04f: raises $0.08 to $0.13
956b2f28: folds
Hero: calls $0.11
641f40f7: folds
*** FLOP *** [6d 7h 5s]
Hero: checks
89dad04f: bets $0.11
Hero: calls $0.11
*** TURN *** [6d 7h 5s] [2c]
Hero: checks
89dad04f: checks
*** RIVER *** [6d 7h 5s 2c] [7c]
Hero: checks
89dad04f: checks
Hero: shows [2s As] (Pair of Sevens and Pair of Twos)
89dad04f: shows [Kc Td] (Pair of Sevens)
*** SHOWDOWN ***
Hero collected $0.51 from pot
*** SUMMARY ***
Total pot $0.53 | Rake $0.02 | Jackpot $0 | Bingo $0 | Fortune $0 | Tax $0
Board [6d 7h 5s 2c 7c]
Seat 1: 956b2f28 (button) folded before Flop (didn't bet)
Seat 2: Hero (small blind) showed [2s As] and won ($0.51) with Pair of Sevens and Pair of Twos
Seat 3: 641f40f7 (big blind) folded before Flop
Seat 4: 2c867a7e folded before Flop (didn't bet)
Seat 5: 45bb3f0f folded before Flop (didn't bet)
Seat 6: 89dad04f showed [Kc Td] and lost with Pair of Sevens


Poker Hand #RC2078537907: Hold'em No Limit ($0.02/$0.05) - 2023/12/22 21:47:39
Table 'RushAndCash798665' 6-max Seat #1 is the button
Seat 1: beea6e5f ($5 in chips)
Seat 2: 30a2950b ($5.25 in chips)
Seat 3: Hero ($5 in chips)
Seat 4: c444ec1 ($5.77 in chips)
Seat 5: 74f0610b ($5.43 in chips)
Seat 6: d0f6c873 ($6.56 in chips)
30a2950b: posts small blind $0.02
Hero: posts big blind $0.05
*** HOLE CARDS ***
Dealt to beea6e5f 
Dealt to 30a2950b 
Dealt to Hero [8d 5s]
Dealt to c444ec1 
Dealt to 74f0610b 
Dealt to d0f6c873 
c444ec1: folds
74f0610b: raises $0.05 to $0.1
d0f6c873: folds
beea6e5f: folds
30a2950b: folds
Hero: folds
Uncalled bet ($0.05) returned to 74f0610b
*** SHOWDOWN ***
74f0610b collected $0.12 from pot
*** SUMMARY ***
Total pot $0.12 | Rake $0 | Jackpot $0 | Bingo $0 | Fortune $0 | Tax $0
Seat 1: beea6e5f (button) folded before Flop (didn't bet)
Seat 2: 30a2950b (small blind) folded before Flop
Seat 3: Hero (big blind) folded before Flop
Seat 4: c444ec1 folded before Flop (didn't bet)
Seat 5: 74f0610b collected ($0.12)
Seat 6: d0f6c873 folded before Flop (didn't bet)


Poker Hand #RC2078537220: Hold'em No Limit ($0.02/$0.05) - 2023/12/22 21:46:54
Table 'RushAndCash798330' 6-max Seat #1 is the button
Seat 1: 59846dec ($10.98 in chips)
Seat 2: 37863cfe ($5.72 in chips)
Seat 3: 3580bebf ($11.17 in chips)
Seat 4: Hero ($5.14 in chips)
Seat 5: a411db6 ($2.15 in chips)
Seat 6: 8aaa95a5 ($4.69 in chips)
37863cfe: posts small blind $0.02
3580bebf: posts big blind $0.05
*** HOLE CARDS ***
Dealt to 59846dec 
Dealt to 37863cfe 
Dealt to 3580bebf 
Dealt to Hero [Jd Jh]
Dealt to a411db6 
Dealt to 8aaa95a5 
Hero: raises $0.05 to $0.1
a411db6: folds
8aaa95a5: folds
59846dec: folds
37863cfe: folds
3580bebf: calls $0.05
*** FLOP *** [7s Ah 9s]
3580bebf: checks
Hero: bets $0.11
3580bebf: calls $0.11
*** TURN *** [7s Ah 9s] [Kd]
3580bebf: checks
Hero: checks
*** RIVER *** [7s Ah 9s Kd] [4s]
3580bebf: bets $0.1
Hero: folds
Uncalled bet ($0.1) returned to 3580bebf
*** SHOWDOWN ***
3580bebf collected $0.42 from pot
*** SUMMARY ***
Total pot $0.44 | Rake $0.02 | Jackpot $0 | Bingo $0 | Fortune $0 | Tax $0
Board [7s Ah 9s Kd 4s]
Seat 1: 59846dec (button) folded before Flop (didn't bet)
Seat 2: 37863cfe (small blind) folded before Flop
Seat 3: 3580bebf (big blind) won ($0.42)
Seat 4: Hero folded on the River
Seat 5: a411db6 folded before Flop (didn't bet)
Seat 6: 8aaa95a5 folded before Flop (didn't bet)


Poker Hand #RC2078537157: Hold'em No Limit ($0.02/$0.05) - 2023/12/22 21:46:51
Table 'RushAndCash798298' 6-max Seat #1 is the button
Seat 1: Hero ($5.14 in chips)
Seat 2: 277673c ($4.83 in chips)
Seat 3: 7f067c94 ($42 in chips)
Seat 4: ce05a1d5 ($5 in chips)
Seat 5: 18c8fa56 ($13.13 in chips)
Seat 6: cddd79e8 ($5.17 in chips)
277673c: posts small blind $0.02
7f067c94: posts big blind $0.05
*** HOLE CARDS ***
Dealt to Hero [2h As]
Dealt to 277673c 
Dealt to 7f067c94 
Dealt to ce05a1d5 
Dealt to 18c8fa56 
Dealt to cddd79e8 
ce05a1d5: folds
18c8fa56: folds
cddd79e8: folds
Hero: folds
277673c: folds
Uncalled bet ($0.03) returned to 7f067c94
*** SHOWDOWN ***
7f067c94 collected $0.04 from pot
*** SUMMARY ***
Total pot $0.04 | Rake $0 | Jackpot $0 | Bingo $0 | Fortune $0 | Tax $0
Seat 1: Hero (button) folded before Flop (didn't bet)
Seat 2: 277673c (small blind) folded before Flop
Seat 3: 7f067c94 (big blind) collected ($0.04)
Seat 4: ce05a1d5 folded before Flop (didn't bet)
Seat 5: 18c8fa56 folded before Flop (didn't bet)
Seat 6: cddd79e8 folded before Flop (didn't bet)


Poker Hand #RC2078537086: Hold'em No Limit ($0.02/$0.05) - 2023/12/22 21:46:47
Table 'RushAndCash798264' 6-max Seat #1 is the button
Seat 1: 30035928 ($4.86 in chips)
Seat 2: 6c293a7d ($4.9 in chips)
Seat 3: b6052383 ($3.92 in chips)
Seat 4: 9e4b1c03 ($7.25 in chips)
Seat 5: Hero ($5.14 in chips)
Seat 6: f0e3b048 ($4.91 in chips)
6c293a7d: posts small blind $0.02
b6052383: posts big blind $0.05
*** HOLE CARDS ***
Dealt to 30035928 
Dealt to 6c293a7d 
Dealt to b6052383 
Dealt to 9e4b1c03 
Dealt to Hero [7c Jh]
Dealt to f0e3b048 
9e4b1c03: folds
Hero: folds
f0e3b048: raises $0.05 to $0.1
30035928: folds
6c293a7d: raises $0.25 to $0.35
b6052383: folds
f0e3b048: calls $0.25
*** FLOP *** [7s 6c Ad]
6c293a7d: bets $0.38
f0e3b048: raises $0.6 to $0.98
6c293a7d: calls $0.6
*** TURN *** [7s 6c Ad] [Js]
6c293a7d: checks
f0e3b048: bets $3.58 and is all-in
6c293a7d: folds
Uncalled bet ($3.58) returned to f0e3b048
*** SHOWDOWN ***
f0e3b048 collected $2.51 from pot
*** SUMMARY ***
Total pot $2.71 | Rake $0.13 | Jackpot $0.07 | Bingo $0 | Fortune $0 | Tax $0
Board [7s 6c Ad Js]
Seat 1: 30035928 (button) folded before Flop (didn't bet)
Seat 2: 6c293a7d (small blind) folded on the Turn
Seat 3: b6052383 (big blind) folded before Flop
Seat 4: 9e4b1c03 folded before Flop (didn't bet)
Seat 5: Hero folded before Flop (didn't bet)
Seat 6: f0e3b048 won ($2.51)


Poker Hand #RC2078536714: Hold'em No Limit ($0.02/$0.05) - 2023/12/22 21:46:26
Table 'RushAndCash798084' 6-max Seat #1 is the button
Seat 1: 9b0ec3a ($16.42 in chips)
Seat 2: Hero ($5.16 in chips)
Seat 3: 6c88f65e ($3.18 in chips)
Seat 4: 7faa6e20 ($7.22 in chips)
Seat 5: edb6154b ($6.06 in chips)
Seat 6: ed75fdbb ($5.04 in chips)
Hero: posts small blind $0.02
6c88f65e: posts big blind $0.05
*** HOLE CARDS ***
Dealt to 9b0ec3a 
Dealt to Hero [2s 2d]
Dealt to 6c88f65e 
Dealt to 7faa6e20 
Dealt to edb6154b 
Dealt to ed75fdbb 
7faa6e20: raises $0.05 to $0.1
edb6154b: folds
ed75fdbb: raises $0.22 to $0.32
9b0ec3a: folds
Hero: folds
6c88f65e: calls $0.27
7faa6e20: calls $0.22
*** FLOP *** [8c Qc 4c]
6c88f65e: checks
7faa6e20: checks
ed75fdbb: bets $0.49
6c88f65e: folds
7faa6e20: calls $0.49
*** TURN *** [8c Qc 4c] [Ad]
7faa6e20: checks
ed75fdbb: checks
*** RIVER *** [8c Qc 4c Ad] [6c]
7faa6e20: checks
ed75fdbb: checks
7faa6e20: shows [Qd Kh] (Pair of Queens)
ed75fdbb: shows [Kc Jd] (King High Flush)
*** SHOWDOWN ***
ed75fdbb collected $1.8 from pot
*** SUMMARY ***
Total pot $1.96 | Rake $0.09 | Jackpot $0.07 | Bingo $0 | Fortune $0 | Tax $0
Board [8c Qc 4c Ad 6c]
Seat 1: 9b0ec3a (button) folded before Flop (didn't bet)
Seat 2: Hero (small blind) folded before Flop
Seat 3: 6c88f65e (big blind) folded on the Flop
Seat 4: 7faa6e20 showed [Qd Kh] and lost with Pair of Queens
Seat 5: edb6154b folded before Flop (didn't bet)
Seat 6: ed75fdbb showed [Kc Jd] and won ($1.8) with King High Flush


Poker Hand #RC2078536653: Hold'em No Limit ($0.02/$0.05) - 2023/12/22 21:46:22
Table 'RushAndCash798054' 6-max Seat #1 is the button
Seat 1: c4c1c89a ($5.85 in chips)
Seat 2: 424d372d ($8.23 in chips)
Seat 3: Hero ($5.21 in chips)
Seat 4: c7be9492 ($5 in chips)
Seat 5: 6c88f65e ($3.18 in chips)
Seat 6: 1dead1e2 ($5.61 in chips)
424d372d: posts small blind $0.02
Hero: posts big blind $0.05
*** HOLE CARDS ***
Dealt to c4c1c89a 
Dealt to 424d372d 
Dealt to Hero [2h 3d]
Dealt to c7be9492 
Dealt to 6c88f65e 
Dealt to 1dead1e2 
c7be9492: folds
6c88f65e: folds
1dead1e2: folds
c4c1c89a: folds
424d372d: raises $0.1 to $0.15
Hero: folds
Uncalled bet ($0.1) returned to 424d372d
*** SHOWDOWN ***
424d372d collected $0.1 from pot
*** SUMMARY ***
Total pot $0.1 | Rake $0 | Jackpot $0 | Bingo $0 | Fortune $0 | Tax $0
Seat 1: c4c1c89a (button) folded before Flop (didn't bet)
Seat 2: 424d372d (small blind) collected ($0.1)
Seat 3: Hero (big blind) folded before Flop
Seat 4: c7be9492 folded before Flop (didn't bet)
Seat 5: 6c88f65e folded before Flop (didn't bet)
Seat 6: 1dead1e2 folded before Flop (didn't bet)


Poker Hand #RC2078536592: Hold'em No Limit ($0.02/$0.05) - 2023/12/22 21:46:18
Table 'RushAndCash798027' 6-max Seat #1 is the button
Seat 1: 95bbee71 ($5 in chips)
Seat 2: 2df55086 ($8.47 in chips)
Seat 3: a2fed278 ($5.51 in chips)
Seat 4: 52f74b76 ($6.05 in chips)
Seat 5: Hero ($5.21 in chips)
Seat 6: 373bc096 ($8 in chips)
2df55086: posts small blind $0.02
a2fed278: posts big blind $0.05
*** HOLE CARDS ***
Dealt to 95bbee71 
Dealt to 2df55086 
Dealt to a2fed278 
Dealt to 52f74b76 
Dealt to Hero [3c 6s]
Dealt to 373bc096 
52f74b76: folds
Hero: folds
373bc096: folds
95bbee71: folds
2df55086: folds
Uncalled bet ($0.03) returned to a2fed278
*** SHOWDOWN ***
a2fed278 collected $0.04 from pot
*** SUMMARY ***
Total pot $0.04 | Rake $0 | Jackpot $0 | Bingo $0 | Fortune $0 | Tax $0
Seat 1: 95bbee71 (button) folded before Flop (didn't bet)
Seat 2: 2df55086 (small blind) folded before Flop
Seat 3: a2fed278 (big blind) collected ($0.04)
Seat 4: 52f74b76 folded before Flop (didn't bet)
Seat 5: Hero folded before Flop (didn't bet)
Seat 6: 373bc096 folded before Flop (didn't bet)


Poker Hand #RC2078536513: Hold'em No Limit ($0.02/$0.05) - 2023/12/22 21:46:14
Table 'RushAndCash797990' 6-max Seat #1 is the button
Seat 1: Hero ($5.21 in chips)
Seat 2: 41abc790 ($4.69 in chips)
Seat 3: a774641b ($5 in chips)
Seat 4: 7e84e7dc ($13.77 in chips)
Seat 5: a2fed278 ($5.51 in chips)
Seat 6: bc7afeb2 ($5.42 in chips)
41abc790: posts small blind $0.02
a774641b: posts big blind $0.05
*** HOLE CARDS ***
Dealt to Hero [6d 2d]
Dealt to 41abc790 
Dealt to a774641b 
Dealt to 7e84e7dc 
Dealt to a2fed278 
Dealt to bc7afeb2 
7e84e7dc: folds
a2fed278: folds
bc7afeb2: folds
Hero: folds
41abc790: raises $0.08 to $0.13
a774641b: folds
Uncalled bet ($0.08) returned to 41abc790
*** SHOWDOWN ***
41abc790 collected $0.1 from pot
*** SUMMARY ***
Total pot $0.1 | Rake $0 | Jackpot $0 | Bingo $0 | Fortune $0 | Tax $0
Seat 1: Hero (button) folded before Flop (didn't bet)
Seat 2: 41abc790 (small blind) collected ($0.1)
Seat 3: a774641b (big blind) folded before Flop
Seat 4: 7e84e7dc folded before Flop (didn't bet)
Seat 5: a2fed278 folded before Flop (didn't bet)
Seat 6: bc7afeb2 folded before Flop (didn't bet)


Poker Hand #RC2078536451: Hold'em No Limit ($0.02/$0.05) - 2023/12/22 21:46:10
Table 'RushAndCash797958' 6-max Seat #1 is the button
Seat 1: 9c51ae09 ($5 in chips)
Seat 2: d0b2d784 ($8.45 in chips)
Seat 3: 91e6539a ($7.28 in chips)
Seat 4: a2fed278 ($5.51 in chips)
Seat 5: 68c6c5e7 ($27.77 in chips)
Seat 6: Hero ($5.21 in chips)
d0b2d784: posts small blind $0.02
91e6539a: posts big blind $0.05
*** HOLE CARDS ***
Dealt to 9c51ae09 
Dealt to d0b2d784 
Dealt to 91e6539a 
Dealt to a2fed278 
Dealt to 68c6c5e7 
Dealt to Hero [5s 2d]
a2fed278: folds
68c6c5e7: folds
Hero: folds
9c51ae09: raises $0.08 to $0.13
d0b2d784: folds
91e6539a: folds
Uncalled bet ($0.08) returned to 9c51ae09
*** SHOWDOWN ***
9c51ae09 collected $0.12 from pot
*** SUMMARY ***
Total pot $0.12 | Rake $0 | Jackpot $0 | Bingo $0 | Fortune $0 | Tax $0
Seat 1: 9c51ae09 (button) collected ($0.12)
Seat 2: d0b2d784 (small blind) folded before Flop
Seat 3: 91e6539a (big blind) folded before Flop
Seat 4: a2fed278 folded before Flop (didn't bet)
Seat 5: 68c6c5e7 folded before Flop (didn't bet)
Seat 6: Hero folded before Flop (didn't bet)


Poker Hand #RC2078535948: Hold'em No Limit ($0.02/$0.05) - 2023/12/22 21:45:41
Table 'RushAndCash797713' 6-max Seat #1 is the button
Seat 1: 1c28bbd5 ($5 in chips)
Seat 2: 2075befd ($5 in chips)
Seat 3: c9414c7d ($9.99 in chips)
Seat 4: 9d93c43e ($5 in chips)
Seat 5: Hero ($5 in chips)
Seat 6: bba39737 ($5.12 in chips)
2075befd: posts small blind $0.02
c9414c7d: posts big blind $0.05
*** HOLE CARDS ***
Dealt to 1c28bbd5 
Dealt to 2075befd 
Dealt to c9414c7d 
Dealt to 9d93c43e 
Dealt to Hero [As 2s]
Dealt to bba39737 
9d93c43e: folds
Hero: raises $0.05 to $0.1
bba39737: folds
1c28bbd5: folds
2075befd: calls $0.08
c9414c7d: folds
*** FLOP *** [Ah Ks 6s]
2075befd: checks
Hero: bets $0.1
2075befd: folds
Uncalled bet ($0.1) returned to Hero
*** SHOWDOWN ***
Hero collected $0.24 from pot
*** SUMMARY ***
Total pot $0.25 | Rake $0.01 | Jackpot $0 | Bingo $0 | Fortune $0 | Tax $0
Board [Ah Ks 6s]
Seat 1: 1c28bbd5 (button) folded before Flop (didn't bet)
Seat 2: 2075befd (small blind) folded on the Flop
Seat 3: c9414c7d (big blind) folded before Flop
Seat 4: 9d93c43e folded before Flop (didn't bet)
Seat 5: Hero won ($0.24)
Seat 6: bba39737 folded before Flop (didn't bet)


Poker Hand #RC2078535873: Hold'em No Limit ($0.02/$0.05) - 2023/12/22 21:45:38
Table 'RushAndCash797676' 6-max Seat #1 is the button
Seat 1: Hero ($5 in chips)
Seat 2: 6a898db1 ($4.9 in chips)
Seat 3: 8d15f06b ($11.42 in chips)
Seat 4: 1f9b16cf ($7.6 in chips)
Seat 5: 924de653 ($0.47 in chips)
Seat 6: f704f14d ($2.92 in chips)
6a898db1: posts small blind $0.02
8d15f06b: posts big blind $0.05
*** HOLE CARDS ***
Dealt to Hero [Qh 6c]
Dealt to 6a898db1 
Dealt to 8d15f06b 
Dealt to 1f9b16cf 
Dealt to 924de653 
Dealt to f704f14d 
1f9b16cf: raises $0.06 to $0.11
924de653: folds
f704f14d: folds
Hero: folds
6a898db1: folds
8d15f06b: folds
Uncalled bet ($0.06) returned to 1f9b16cf
*** SHOWDOWN ***
1f9b16cf collected $0.12 from pot
*** SUMMARY ***
Total pot $0.12 | Rake $0 | Jackpot $0 | Bingo $0 | Fortune $0 | Tax $0
Seat 1: Hero (button) folded before Flop (didn't bet)
Seat 2: 6a898db1 (small blind) folded before Flop
Seat 3: 8d15f06b (big blind) folded before Flop
Seat 4: 1f9b16cf collected ($0.12)
Seat 5: 924de653 folded before Flop (didn't bet)
Seat 6: f704f14d folded before Flop (didn't bet)


Poker Hand #RC2078535796: Hold'em No Limit ($0.02/$0.05) - 2023/12/22 21:45:33
Table 'RushAndCash797638' 6-max Seat #1 is the button
Seat 1: 4f704fa2 ($5.1 in chips)
Seat 2: ea71423 ($6.24 in chips)
Seat 3: Hero ($5 in chips)
Seat 4: 3d292096 ($8.75 in chips)
Seat 5: 7b437e57 ($5.78 in chips)
Seat 6: 90a9fad4 ($52.69 in chips)
ea71423: posts small blind $0.02
Hero: posts big blind $0.05
*** HOLE CARDS ***
Dealt to 4f704fa2 
Dealt to ea71423 
Dealt to Hero [5d 9c]
Dealt to 3d292096 
Dealt to 7b437e57 
Dealt to 90a9fad4 
3d292096: folds
7b437e57: folds
90a9fad4: folds
4f704fa2: folds
ea71423: folds
Uncalled bet ($0.03) returned to Hero
*** SHOWDOWN ***
Hero collected $0.04 from pot
*** SUMMARY ***
Total pot $0.04 | Rake $0 | Jackpot $0 | Bingo $0 | Fortune $0 | Tax $0
Seat 1: 4f704fa2 (button) folded before Flop (didn't bet)
Seat 2: ea71423 (small blind) folded before Flop
Seat 3: Hero (big blind) collected ($0.04)
Seat 4: 3d292096 folded before Flop (didn't bet)
Seat 5: 7b437e57 folded before Flop (didn't bet)
Seat 6: 90a9fad4 folded before Flop (didn't bet)


Poker Hand #RC2078535658: Hold'em No Limit ($0.02/$0.05) - 2023/12/22 21:45:25
Table 'RushAndCash797571' 6-max Seat #1 is the button
Seat 1: b61f5bde ($8.51 in chips)
Seat 2: Hero ($5 in chips)
Seat 3: 354a07bb ($9.16 in chips)
Seat 4: 7b437e57 ($5.83 in chips)
Seat 5: 661ba238 ($5 in chips)
Seat 6: c79ac44f ($5.21 in chips)
Hero: posts small blind $0.02
354a07bb: posts big blind $0.05
*** HOLE CARDS ***
Dealt to b61f5bde 
Dealt to Hero [2h Kc]
Dealt to 354a07bb 
Dealt to 7b437e57 
Dealt to 661ba238 
Dealt to c79ac44f 
7b437e57: folds
661ba238: folds
c79ac44f: folds
b61f5bde: raises $0.07 to $0.12
Hero: folds
354a07bb: calls $0.07
*** FLOP *** [8h 6d 5d]
354a07bb: checks
b61f5bde: bets $0.13
354a07bb: calls $0.13
*** TURN *** [8h 6d 5d] [As]
354a07bb: checks
b61f5bde: bets $0.6
354a07bb: folds
Uncalled bet ($0.6) returned to b61f5bde
*** SHOWDOWN ***
b61f5bde collected $0.5 from pot
*** SUMMARY ***
Total pot $0.52 | Rake $0.02 | Jackpot $0 | Bingo $0 | Fortune $0 | Tax $0
Board [8h 6d 5d As]
Seat 1: b61f5bde (button) won ($0.5)
Seat 2: Hero (small blind) folded before Flop
Seat 3: 354a07bb (big blind) folded on the Turn
Seat 4: 7b437e57 folded before Flop (didn't bet)
Seat 5: 661ba238 folded before Flop (didn't bet)
Seat 6: c79ac44f folded before Flop (didn't bet)


Poker Hand #RC2078535561: Hold'em No Limit ($0.02/$0.05) - 2023/12/22 21:45:20
Table 'RushAndCash797522' 6-max Seat #1 is the button
Seat 1: 6ef00a1b ($14.55 in chips)
Seat 2: 2075befd ($5.02 in chips)
Seat 3: 9e4b1c03 ($7.19 in chips)
Seat 4: 98124327 ($6.93 in chips)
Seat 5: 45bb3f0f ($5.07 in chips)
Seat 6: Hero ($5 in chips)
2075befd: posts small blind $0.02
9e4b1c03: posts big blind $0.05
*** HOLE CARDS ***
Dealt to 6ef00a1b 
Dealt to 2075befd 
Dealt to 9e4b1c03 
Dealt to 98124327 
Dealt to 45bb3f0f 
Dealt to Hero [6c 2c]
98124327: folds
45bb3f0f: folds
Hero: folds
6ef00a1b: raises $0.08 to $0.13
2075befd: folds
9e4b1c03: folds
Uncalled bet ($0.08) returned to 6ef00a1b
*** SHOWDOWN ***
6ef00a1b collected $0.12 from pot
*** SUMMARY ***
Total pot $0.12 | Rake $0 | Jackpot $0 | Bingo $0 | Fortune $0 | Tax $0
Seat 1: 6ef00a1b (button) collected ($0.12)
Seat 2: 2075befd (small blind) folded before Flop
Seat 3: 9e4b1c03 (big blind) folded before Flop
Seat 4: 98124327 folded before Flop (didn't bet)
Seat 5: 45bb3f0f folded before Flop (didn't bet)
Seat 6: Hero folded before Flop (didn't bet)


Poker Hand #RC2078534809: Hold'em No Limit ($0.02/$0.05) - 2023/12/22 21:44:39
Table 'RushAndCash797158' 6-max Seat #1 is the button
Seat 1: f2c162d4 ($3.09 in chips)
Seat 2: d82e5b20 ($5.3 in chips)
Seat 3: e0e4307b ($5 in chips)
Seat 4: ce803d2b ($5.16 in chips)
Seat 5: Hero ($5 in chips)
Seat 6: 3bfed236 ($4.85 in chips)
d82e5b20: posts small blind $0.02
e0e4307b: posts big blind $0.05
*** HOLE CARDS ***
Dealt to f2c162d4 
Dealt to d82e5b20 
Dealt to e0e4307b 
Dealt to ce803d2b 
Dealt to Hero [Qc Ks]
Dealt to 3bfed236 
ce803d2b: folds
Hero: raises $0.05 to $0.1
3bfed236: folds
f2c162d4: folds
d82e5b20: folds
e0e4307b: calls $0.05
*** FLOP *** [4c Kc Qh]
e0e4307b: checks
Hero: bets $0.11
e0e4307b: calls $0.11
*** TURN *** [4c Kc Qh] [7d]
e0e4307b: checks
Hero: bets $0.32
e0e4307b: calls $0.32
*** RIVER *** [4c Kc Qh 7d] [7c]
e0e4307b: checks
Hero: checks
e0e4307b: shows [8c Ac] (Ace High Flush)
Hero: shows [Qc Ks] (Pair of Kings and Pair of Queens)
*** SHOWDOWN ***
e0e4307b collected $1.03 from pot
*** SUMMARY ***
Total pot $1.08 | Rake $0.05 | Jackpot $0 | Bingo $0 | Fortune $0 | Tax $0
Board [4c Kc Qh 7d 7c]
Seat 1: f2c162d4 (button) folded before Flop (didn't bet)
Seat 2: d82e5b20 (small blind) folded before Flop
Seat 3: e0e4307b (big blind) showed [8c Ac] and won ($1.03) with Ace High Flush
Seat 4: ce803d2b folded before Flop (didn't bet)
Seat 5: Hero showed [Qc Ks] and lost with Pair of Kings and Pair of Queens
Seat 6: 3bfed236 folded before Flop (didn't bet)


Poker Hand #RC2078534742: Hold'em No Limit ($0.02/$0.05) - 2023/12/22 21:44:36
Table 'RushAndCash797124' 6-max Seat #1 is the button
Seat 1: b4439dda ($6.73 in chips)
Seat 2: b49a0d77 ($5 in chips)
Seat 3: 8a94bd25 ($5.05 in chips)
Seat 4: 89a27c2 ($4.91 in chips)
Seat 5: d6363be2 ($8.6 in chips)
Seat 6: Hero ($5 in chips)
b49a0d77: posts small blind $0.02
8a94bd25: posts big blind $0.05
*** HOLE CARDS ***
Dealt to b4439dda 
Dealt to b49a0d77 
Dealt to 8a94bd25 
Dealt to 89a27c2 
Dealt to d6363be2 
Dealt to Hero [8s Kd]
89a27c2: folds
d6363be2: folds
Hero: folds
b4439dda: folds
b49a0d77: raises $0.1 to $0.15
8a94bd25: folds
Uncalled bet ($0.1) returned to b49a0d77
*** SHOWDOWN ***
b49a0d77 collected $0.1 from pot
*** SUMMARY ***
Total pot $0.1 | Rake $0 | Jackpot $0 | Bingo $0 | Fortune $0 | Tax $0
Seat 1: b4439dda (button) folded before Flop (didn't bet)
Seat 2: b49a0d77 (small blind) collected ($0.1)
Seat 3: 8a94bd25 (big blind) folded before Flop
Seat 4: 89a27c2 folded before Flop (didn't bet)
Seat 5: d6363be2 folded before Flop (didn't bet)
Seat 6: Hero folded before Flop (didn't bet)


Poker Hand #RC2078524676: Hold'em No Limit ($0.02/$0.05) - 2023/12/22 21:44:32
Table 'RushAndCash797090' 6-max Seat #1 is the button
Seat 1: Hero ($5 in chips)
Seat 2: 34ce5e3 ($6.02 in chips)
Seat 3: efbf8ee8 ($5 in chips)
Seat 4: d79b0c6a ($5.41 in chips)
Seat 5: 8642862c ($5.29 in chips)
Seat 6: b4439dda ($6.73 in chips)
34ce5e3: posts small blind $0.02
efbf8ee8: posts big blind $0.05
*** HOLE CARDS ***
Dealt to Hero [9h 2d]
Dealt to 34ce5e3 
Dealt to efbf8ee8 
Dealt to d79b0c6a 
Dealt to 8642862c 
Dealt to b4439dda 
d79b0c6a: folds
8642862c: folds
b4439dda: folds
Hero: folds
34ce5e3: folds
Uncalled bet ($0.03) returned to efbf8ee8
*** SHOWDOWN ***
efbf8ee8 collected $0.04 from pot
*** SUMMARY ***
Total pot $0.04 | Rake $0 | Jackpot $0 | Bingo $0 | Fortune $0 | Tax $0
Seat 1: Hero (button) folded before Flop (didn't bet)
Seat 2: 34ce5e3 (small blind) folded before Flop
Seat 3: efbf8ee8 (big blind) collected ($0.04)
Seat 4: d79b0c6a folded before Flop (didn't bet)
Seat 5: 8642862c folded before Flop (didn't bet)
Seat 6: b4439dda folded before Flop (didn't bet)


Poker Hand #RC2078524530: Hold'em No Limit ($0.02/$0.05) - 2023/12/22 21:44:23
Table 'RushAndCash797018' 6-max Seat #1 is the button
Seat 1: 4fcbfbdc ($8.43 in chips)
Seat 2: Hero ($5 in chips)
Seat 3: 25941725 ($4.81 in chips)
Seat 4: 9db3bc7b ($10.32 in chips)
Seat 5: 8802c225 ($5.4 in chips)
Seat 6: 90a9fad4 ($52.79 in chips)
Hero: posts small blind $0.02
25941725: posts big blind $0.05
*** HOLE CARDS ***
Dealt to 4fcbfbdc 
Dealt to Hero [7c 2d]
Dealt to 25941725 
Dealt to 9db3bc7b 
Dealt to 8802c225 
Dealt to 90a9fad4 
9db3bc7b: folds
8802c225: folds
90a9fad4: folds
4fcbfbdc: calls $0.05
Hero: folds
25941725: checks
*** FLOP *** [3c 5c 7h]
25941725: checks
4fcbfbdc: bets $0.09
25941725: folds
Uncalled bet ($0.09) returned to 4fcbfbdc
*** SHOWDOWN ***
4fcbfbdc collected $0.12 from pot
*** SUMMARY ***
Total pot $0.12 | Rake $0 | Jackpot $0 | Bingo $0 | Fortune $0 | Tax $0
Board [3c 5c 7h]
Seat 1: 4fcbfbdc (button) won ($0.12)
Seat 2: Hero (small blind) folded before Flop
Seat 3: 25941725 (big blind) folded on the Flop
Seat 4: 9db3bc7b folded before Flop (didn't bet)
Seat 5: 8802c225 folded before Flop (didn't bet)
Seat 6: 90a9fad4 folded before Flop (didn't bet)


Poker Hand #RC2078523631: Hold'em No Limit ($0.02/$0.05) - 2023/12/22 21:43:32
Table 'RushAndCash796575' 6-max Seat #1 is the button
Seat 1: ee1f67f7 ($5.93 in chips)
Seat 2: edb6154b ($5.54 in chips)
Seat 3: Hero ($5 in chips)
Seat 4: 4069ada7 ($4.86 in chips)
Seat 5: 79ed61c1 ($2.81 in chips)
Seat 6: 6ded132b ($13.75 in chips)
edb6154b: posts small blind $0.02
Hero: posts big blind $0.05
*** HOLE CARDS ***
Dealt to ee1f67f7 
Dealt to edb6154b 
Dealt to Hero [Jc Kd]
Dealt to 4069ada7 
Dealt to 79ed61c1 
Dealt to 6ded132b 
4069ada7: folds
79ed61c1: raises $0.1 to $0.15
6ded132b: calls $0.15
ee1f67f7: folds
edb6154b: folds
Hero: calls $0.1
*** FLOP *** [As Tc Ks]
Hero: checks
79ed61c1: bets $0.21
6ded132b: folds
Hero: calls $0.21
*** TURN *** [As Tc Ks] [9s]
Hero: checks
79ed61c1: bets $0.4
Hero: folds
Uncalled bet ($0.4) returned to 79ed61c1
*** SHOWDOWN ***
79ed61c1 collected $0.85 from pot
*** SUMMARY ***
Total pot $0.89 | Rake $0.04 | Jackpot $0 | Bingo $0 | Fortune $0 | Tax $0
Board [As Tc Ks 9s]
Seat 1: ee1f67f7 (button) folded before Flop (didn't bet)
Seat 2: edb6154b (small blind) folded before Flop
Seat 3: Hero (big blind) folded on the Turn
Seat 4: 4069ada7 folded before Flop (didn't bet)
Seat 5: 79ed61c1 won ($0.85)
Seat 6: 6ded132b folded on the Flop


Poker Hand #RC2078523571: Hold'em No Limit ($0.02/$0.05) - 2023/12/22 21:43:28
Table 'RushAndCash796546' 6-max Seat #1 is the button
Seat 1: 5a946c5b ($5 in chips)
Seat 2: e7053968 ($4.18 in chips)
Seat 3: 220b0aae ($14.19 in chips)
Seat 4: 37e2503b ($7.27 in chips)
Seat 5: 360d3b25 ($5 in chips)
Seat 6: Hero ($5 in chips)
e7053968: posts small blind $0.02
220b0aae: posts big blind $0.05
*** HOLE CARDS ***
Dealt to 5a946c5b 
Dealt to e7053968 
Dealt to 220b0aae 
Dealt to 37e2503b 
Dealt to 360d3b25 
Dealt to Hero [Kd 9s]
37e2503b: raises $0.05 to $0.1
360d3b25: folds
Hero: folds
5a946c5b: folds
e7053968: folds
220b0aae: folds
Uncalled bet ($0.05) returned to 37e2503b
*** SHOWDOWN ***
37e2503b collected $0.12 from pot
*** SUMMARY ***
Total pot $0.12 | Rake $0 | Jackpot $0 | Bingo $0 | Fortune $0 | Tax $0
Seat 1: 5a946c5b (button) folded before Flop (didn't bet)
Seat 2: e7053968 (small blind) folded before Flop
Seat 3: 220b0aae (big blind) folded before Flop
Seat 4: 37e2503b collected ($0.12)
Seat 5: 360d3b25 folded before Flop (didn't bet)
Seat 6: Hero folded before Flop (didn't bet)


Poker Hand #RC2078523421: Hold'em No Limit ($0.02/$0.05) - 2023/12/22 21:43:20
Table 'RushAndCash796473' 6-max Seat #1 is the button
Seat 1: f0040865 ($6.29 in chips)
Seat 2: cb9a7609 ($5 in chips)
Seat 3: 75daa184 ($8.81 in chips)
Seat 4: Hero ($5 in chips)
Seat 5: 5d17419b ($5.86 in chips)
Seat 6: 130f7150 ($3.89 in chips)
cb9a7609: posts small blind $0.02
75daa184: posts big blind $0.05
*** HOLE CARDS ***
Dealt to f0040865 
Dealt to cb9a7609 
Dealt to 75daa184 
Dealt to Hero [2h 3d]
Dealt to 5d17419b 
Dealt to 130f7150 
Hero: folds
5d17419b: folds
130f7150: folds
f0040865: raises $0.07 to $0.12
cb9a7609: folds
75daa184: folds
Uncalled bet ($0.07) returned to f0040865
*** SHOWDOWN ***
f0040865 collected $0.12 from pot
*** SUMMARY ***
Total pot $0.12 | Rake $0 | Jackpot $0 | Bingo $0 | Fortune $0 | Tax $0
Seat 1: f0040865 (button) collected ($0.12)
Seat 2: cb9a7609 (small blind) folded before Flop
Seat 3: 75daa184 (big blind) folded before Flop
Seat 4: Hero folded before Flop (didn't bet)
Seat 5: 5d17419b folded before Flop (didn't bet)
Seat 6: 130f7150 folded before Flop (didn't bet)


Poker Hand #RC2078522937: Hold'em No Limit ($0.02/$0.05) - 2023/12/22 21:42:53
Table 'RushAndCash796244' 6-max Seat #1 is the button
Seat 1: c9414c7d ($9.64 in chips)
Seat 2: de3b84bb ($29.86 in chips)
Seat 3: 61343ab7 ($5 in chips)
Seat 4: Hero ($5.06 in chips)
Seat 5: a61e93fb ($10.05 in chips)
Seat 6: 51c82b66 ($5.17 in chips)
de3b84bb: posts small blind $0.02
61343ab7: posts big blind $0.05
*** HOLE CARDS ***
Dealt to c9414c7d 
Dealt to de3b84bb 
Dealt to 61343ab7 
Dealt to Hero [7c 7s]
Dealt to a61e93fb 
Dealt to 51c82b66 
Hero: raises $0.05 to $0.1
a61e93fb: folds
51c82b66: folds
c9414c7d: folds
de3b84bb: raises $0.28 to $0.38
61343ab7: folds
Hero: calls $0.28
*** FLOP *** [Td Qs 9h]
de3b84bb: bets $29.48 and is all-in
Hero: folds
Uncalled bet ($29.48) returned to de3b84bb
*** SHOWDOWN ***
de3b84bb collected $0.77 from pot
*** SUMMARY ***
Total pot $0.81 | Rake $0.04 | Jackpot $0 | Bingo $0 | Fortune $0 | Tax $0
Board [Td Qs 9h]
Seat 1: c9414c7d (button) folded before Flop (didn't bet)
Seat 2: de3b84bb (small blind) won ($0.77)
Seat 3: 61343ab7 (big blind) folded before Flop
Seat 4: Hero folded on the Flop
Seat 5: a61e93fb folded before Flop (didn't bet)
Seat 6: 51c82b66 folded before Flop (didn't bet)


Poker Hand #RC2078522756: Hold'em No Limit ($0.02/$0.05) - 2023/12/22 21:42:43
Table 'RushAndCash796155' 6-max Seat #1 is the button
Seat 1: 51c82b66 ($5.17 in chips)
Seat 2: Hero ($5.08 in chips)
Seat 3: d71ab80c ($5 in chips)
Seat 4: cddd79e8 ($5 in chips)
Seat 5: ea9bed4a ($5.07 in chips)
Seat 6: b75c858f ($5 in chips)
Hero: posts small blind $0.02
d71ab80c: posts big blind $0.05
*** HOLE CARDS ***
Dealt to 51c82b66 
Dealt to Hero [3d 5h]
Dealt to d71ab80c 
Dealt to cddd79e8 
Dealt to ea9bed4a 
Dealt to b75c858f 
cddd79e8: folds
ea9bed4a: folds
b75c858f: folds
51c82b66: folds
Hero: folds
Uncalled bet ($0.03) returned to d71ab80c
*** SHOWDOWN ***
d71ab80c collected $0.04 from pot
*** SUMMARY ***
Total pot $0.04 | Rake $0 | Jackpot $0 | Bingo $0 | Fortune $0 | Tax $0
Seat 1: 51c82b66 (button) folded before Flop (didn't bet)
Seat 2: Hero (small blind) folded before Flop
Seat 3: d71ab80c (big blind) collected ($0.04)
Seat 4: cddd79e8 folded before Flop (didn't bet)
Seat 5: ea9bed4a folded before Flop (didn't bet)
Seat 6: b75c858f folded before Flop (didn't bet)


Poker Hand #RC2078522549: Hold'em No Limit ($0.02/$0.05) - 2023/12/22 21:42:31
Table 'RushAndCash796053' 6-max Seat #1 is the button
Seat 1: 391fe85a ($5.58 in chips)
Seat 2: 4520f334 ($5.44 in chips)
Seat 3: Hero ($5.06 in chips)
Seat 4: 89a27c2 ($5.18 in chips)
Seat 5: dee599cb ($5.96 in chips)
Seat 6: 6ff1e240 ($8.59 in chips)
4520f334: posts small blind $0.02
Hero: posts big blind $0.05
*** HOLE CARDS ***
Dealt to 391fe85a 
Dealt to 4520f334 
Dealt to Hero [Ad 6h]
Dealt to 89a27c2 
Dealt to dee599cb 
Dealt to 6ff1e240 
89a27c2: folds
dee599cb: folds
6ff1e240: folds
391fe85a: folds
4520f334: folds
Uncalled bet ($0.03) returned to Hero
*** SHOWDOWN ***
Hero collected $0.04 from pot
*** SUMMARY ***
Total pot $0.04 | Rake $0 | Jackpot $0 | Bingo $0 | Fortune $0 | Tax $0
Seat 1: 391fe85a (button) folded before Flop (didn't bet)
Seat 2: 4520f334 (small blind) folded before Flop
Seat 3: Hero (big blind) collected ($0.04)
Seat 4: 89a27c2 folded before Flop (didn't bet)
Seat 5: dee599cb folded before Flop (didn't bet)
Seat 6: 6ff1e240 folded before Flop (didn't bet)


Poker Hand #RC2078522110: Hold'em No Limit ($0.02/$0.05) - 2023/12/22 21:42:07
Table 'RushAndCash795850' 6-max Seat #1 is the button
Seat 1: Hero ($5.19 in chips)
Seat 2: 391fe85a ($5.41 in chips)
Seat 3: df439f39 ($5.95 in chips)
Seat 4: 42e18915 ($7.3 in chips)
Seat 5: 558ffb3 ($5 in chips)
Seat 6: ff6f425f ($4.98 in chips)
391fe85a: posts small blind $0.02
df439f39: posts big blind $0.05
*** HOLE CARDS ***
Dealt to Hero [4d 4h]
Dealt to 391fe85a 
Dealt to df439f39 
Dealt to 42e18915 
Dealt to 558ffb3 
Dealt to ff6f425f 
42e18915: folds
558ffb3: folds
ff6f425f: folds
Hero: raises $0.08 to $0.13
391fe85a: raises $0.47 to $0.6
df439f39: folds
Hero: folds
Uncalled bet ($0.47) returned to 391fe85a
*** SHOWDOWN ***
391fe85a collected $0.3 from pot
*** SUMMARY ***
Total pot $0.31 | Rake $0.01 | Jackpot $0 | Bingo $0 | Fortune $0 | Tax $0
Seat 1: Hero (button) folded before Flop
Seat 2: 391fe85a (small blind) collected ($0.3)
Seat 3: df439f39 (big blind) folded before Flop
Seat 4: 42e18915 folded before Flop (didn't bet)
Seat 5: 558ffb3 folded before Flop (didn't bet)
Seat 6: ff6f425f folded before Flop (didn't bet)


Poker Hand #RC2078522035: Hold'em No Limit ($0.02/$0.05) - 2023/12/22 21:42:02
Table 'RushAndCash795815' 6-max Seat #1 is the button
Seat 1: 3160ff3c ($12.32 in chips)
Seat 2: 9601129f ($5.33 in chips)
Seat 3: 16ecd29a ($6.06 in chips)
Seat 4: 1e89bda1 ($5.22 in chips)
Seat 5: Hero ($5.19 in chips)
Seat 6: d31038ce ($5.25 in chips)
9601129f: posts small blind $0.02
16ecd29a: posts big blind $0.05
*** HOLE CARDS ***
Dealt to 3160ff3c 
Dealt to 9601129f 
Dealt to 16ecd29a 
Dealt to 1e89bda1 
Dealt to Hero [4c 6c]
Dealt to d31038ce 
1e89bda1: folds
Hero: folds
d31038ce: folds
3160ff3c: raises $0.07 to $0.12
9601129f: raises $0.29 to $0.41
16ecd29a: folds
3160ff3c: folds
Uncalled bet ($0.29) returned to 9601129f
*** SHOWDOWN ***
9601129f collected $0.28 from pot
*** SUMMARY ***
Total pot $0.29 | Rake $0.01 | Jackpot $0 | Bingo $0 | Fortune $0 | Tax $0
Seat 1: 3160ff3c (button) folded before Flop
Seat 2: 9601129f (small blind) collected ($0.28)
Seat 3: 16ecd29a (big blind) folded before Flop
Seat 4: 1e89bda1 folded before Flop (didn't bet)
Seat 5: Hero folded before Flop (didn't bet)
Seat 6: d31038ce folded before Flop (didn't bet)


Poker Hand #RC2078521971: Hold'em No Limit ($0.02/$0.05) - 2023/12/22 21:41:59
Table 'RushAndCash795786' 6-max Seat #1 is the button
Seat 1: cddd79e8 ($5.06 in chips)
Seat 2: 8f1a23de ($5.02 in chips)
Seat 3: 7d751650 ($8.78 in chips)
Seat 4: ff6f425f ($5 in chips)
Seat 5: Hero ($5.19 in chips)
Seat 6: 9601129f ($5.33 in chips)
8f1a23de: posts small blind $0.02
7d751650: posts big blind $0.05
*** HOLE CARDS ***
Dealt to cddd79e8 
Dealt to 8f1a23de 
Dealt to 7d751650 
Dealt to ff6f425f 
Dealt to Hero [Td 4h]
Dealt to 9601129f 
ff6f425f: folds
Hero: folds
9601129f: folds
cddd79e8: folds
8f1a23de: folds
Uncalled bet ($0.03) returned to 7d751650
*** SHOWDOWN ***
7d751650 collected $0.04 from pot
*** SUMMARY ***
Total pot $0.04 | Rake $0 | Jackpot $0 | Bingo $0 | Fortune $0 | Tax $0
Seat 1: cddd79e8 (button) folded before Flop (didn't bet)
Seat 2: 8f1a23de (small blind) folded before Flop
Seat 3: 7d751650 (big blind) collected ($0.04)
Seat 4: ff6f425f folded before Flop (didn't bet)
Seat 5: Hero folded before Flop (didn't bet)
Seat 6: 9601129f folded before Flop (didn't bet)


Poker Hand #RC2078521875: Hold'em No Limit ($0.02/$0.05) - 2023/12/22 21:41:53
Table 'RushAndCash795741' 6-max Seat #1 is the button
Seat 1: Hero ($5.19 in chips)
Seat 2: 7157dd36 ($7.29 in chips)
Seat 3: c9dcc850 ($6.39 in chips)
Seat 4: f64c1e66 ($7.8 in chips)
Seat 5: 1e89bda1 ($5.22 in chips)
Seat 6: 28e8fd4 ($4.09 in chips)
7157dd36: posts small blind $0.02
c9dcc850: posts big blind $0.05
*** HOLE CARDS ***
Dealt to Hero [5s Jd]
Dealt to 7157dd36 
Dealt to c9dcc850 
Dealt to f64c1e66 
Dealt to 1e89bda1 
Dealt to 28e8fd4 
f64c1e66: folds
1e89bda1: folds
28e8fd4: folds
Hero: folds
7157dd36: raises $0.05 to $0.1
c9dcc850: folds
Uncalled bet ($0.05) returned to 7157dd36
*** SHOWDOWN ***
7157dd36 collected $0.1 from pot
*** SUMMARY ***
Total pot $0.1 | Rake $0 | Jackpot $0 | Bingo $0 | Fortune $0 | Tax $0
Seat 1: Hero (button) folded before Flop (didn't bet)
Seat 2: 7157dd36 (small blind) collected ($0.1)
Seat 3: c9dcc850 (big blind) folded before Flop
Seat 4: f64c1e66 folded before Flop (didn't bet)
Seat 5: 1e89bda1 folded before Flop (didn't bet)
Seat 6: 28e8fd4 folded before Flop (didn't bet)


Poker Hand #RC2078521794: Hold'em No Limit ($0.02/$0.05) - 2023/12/22 21:41:49
Table 'RushAndCash795704' 6-max Seat #1 is the button
Seat 1: 2b3cf2e3 ($2.49 in chips)
Seat 2: 1594e0b ($5.7 in chips)
Seat 3: f283b60 ($5.07 in chips)
Seat 4: Hero ($5.19 in chips)
Seat 5: 221172f3 ($6.98 in chips)
Seat 6: bf955ffb ($5.05 in chips)
1594e0b: posts small blind $0.02
f283b60: posts big blind $0.05
*** HOLE CARDS ***
Dealt to 2b3cf2e3 
Dealt to 1594e0b 
Dealt to f283b60 
Dealt to Hero [7s 6d]
Dealt to 221172f3 
Dealt to bf955ffb 
Hero: folds
221172f3: folds
bf955ffb: folds
2b3cf2e3: raises $0.05 to $0.1
1594e0b: calls $0.08
f283b60: folds
*** FLOP *** [Js 2h 6s]
1594e0b: checks
2b3cf2e3: bets $0.13
1594e0b: calls $0.13
*** TURN *** [Js 2h 6s] [4c]
1594e0b: checks
2b3cf2e3: bets $0.39
1594e0b: calls $0.39
*** RIVER *** [Js 2h 6s 4c] [7c]
1594e0b: checks
2b3cf2e3: checks
1594e0b: shows [2s 2d] (Three Twos)
2b3cf2e3: shows [Qc Jd] (Pair of Jacks)
*** SHOWDOWN ***
1594e0b collected $1.23 from pot
*** SUMMARY ***
Total pot $1.29 | Rake $0.06 | Jackpot $0 | Bingo $0 | Fortune $0 | Tax $0
Board [Js 2h 6s 4c 7c]
Seat 1: 2b3cf2e3 (button) showed [Qc Jd] and lost with Pair of Jacks
Seat 2: 1594e0b (small blind) showed [2s 2d] and won ($1.23) with Three Twos
Seat 3: f283b60 (big blind) folded before Flop
Seat 4: Hero folded before Flop (didn't bet)
Seat 5: 221172f3 folded before Flop (didn't bet)
Seat 6: bf955ffb folded before Flop (didn't bet)


Poker Hand #RC2078521635: Hold'em No Limit ($0.02/$0.05) - 2023/12/22 21:41:40
Table 'RushAndCash795623' 6-max Seat #1 is the button
Seat 1: aa667d33 ($3.71 in chips)
Seat 2: Hero ($5.21 in chips)
Seat 3: 834fcc3f ($7.72 in chips)
Seat 4: 71b06e6c ($4.99 in chips)
Seat 5: 12b83e85 ($5 in chips)
Seat 6: 8e74fca6 ($4.49 in chips)
Hero: posts small blind $0.02
834fcc3f: posts big blind $0.05
*** HOLE CARDS ***
Dealt to aa667d33 
Dealt to Hero [Kc 8h]
Dealt to 834fcc3f 
Dealt to 71b06e6c 
Dealt to 12b83e85 
Dealt to 8e74fca6 
71b06e6c: raises $0.05 to $0.1
12b83e85: folds
8e74fca6: folds
aa667d33: raises $0.18 to $0.28
Hero: folds
834fcc3f: folds
71b06e6c: calls $0.18
*** FLOP *** [Ad 8s 7c]
71b06e6c: checks
aa667d33: bets $0.42
71b06e6c: folds
Uncalled bet ($0.42) returned to aa667d33
*** SHOWDOWN ***
aa667d33 collected $0.6 from pot
*** SUMMARY ***
Total pot $0.63 | Rake $0.03 | Jackpot $0 | Bingo $0 | Fortune $0 | Tax $0
Board [Ad 8s 7c]
Seat 1: aa667d33 (button) won ($0.6)
Seat 2: Hero (small blind) folded before Flop
Seat 3: 834fcc3f (big blind) folded before Flop
Seat 4: 71b06e6c folded on the Flop
Seat 5: 12b83e85 folded before Flop (didn't bet)
Seat 6: 8e74fca6 folded before Flop (didn't bet)


Poker Hand #RC2078521388: Hold'em No Limit ($0.02/$0.05) - 2023/12/22 21:41:26
Table 'RushAndCash795508' 6-max Seat #1 is the button
Seat 1: d960fc1d ($4.93 in chips)
Seat 2: 81ecaac5 ($5.88 in chips)
Seat 3: Hero ($5.19 in chips)
Seat 4: 341cb855 ($5.06 in chips)
Seat 5: 6bc8336e ($5.26 in chips)
Seat 6: c9edf932 ($5.34 in chips)
81ecaac5: posts small blind $0.02
Hero: posts big blind $0.05
*** HOLE CARDS ***
Dealt to d960fc1d 
Dealt to 81ecaac5 
Dealt to Hero [Td 2c]
Dealt to 341cb855 
Dealt to 6bc8336e 
Dealt to c9edf932 
341cb855: folds
6bc8336e: folds
c9edf932: folds
d960fc1d: folds
81ecaac5: folds
Uncalled bet ($0.03) returned to Hero
*** SHOWDOWN ***
Hero collected $0.04 from pot
*** SUMMARY ***
Total pot $0.04 | Rake $0 | Jackpot $0 | Bingo $0 | Fortune $0 | Tax $0
Seat 1: d960fc1d (button) folded before Flop (didn't bet)
Seat 2: 81ecaac5 (small blind) folded before Flop
Seat 3: Hero (big blind) collected ($0.04)
Seat 4: 341cb855 folded before Flop (didn't bet)
Seat 5: 6bc8336e folded before Flop (didn't bet)
Seat 6: c9edf932 folded before Flop (didn't bet)


Poker Hand #RC2078520900: Hold'em No Limit ($0.02/$0.05) - 2023/12/22 21:41:00
Table 'RushAndCash795273' 6-max Seat #1 is the button
Seat 1: 77534cd ($5 in chips)
Seat 2: 376e9d31 ($5.02 in chips)
Seat 3: e49e39a2 ($15.04 in chips)
Seat 4: cf8a8e96 ($7.97 in chips)
Seat 5: Hero ($5.02 in chips)
Seat 6: 1e6e058c ($5.07 in chips)
376e9d31: posts small blind $0.02
e49e39a2: posts big blind $0.05
*** HOLE CARDS ***
Dealt to 77534cd 
Dealt to 376e9d31 
Dealt to e49e39a2 
Dealt to cf8a8e96 
Dealt to Hero [Ad Qd]
Dealt to 1e6e058c 
cf8a8e96: raises $0.06 to $0.11
Hero: raises $0.34 to $0.45
1e6e058c: folds
77534cd: folds
376e9d31: folds
e49e39a2: folds
cf8a8e96: folds
Uncalled bet ($0.34) returned to Hero
*** SHOWDOWN ***
Hero collected $0.28 from pot
*** SUMMARY ***
Total pot $0.29 | Rake $0.01 | Jackpot $0 | Bingo $0 | Fortune $0 | Tax $0
Seat 1: 77534cd (button) folded before Flop (didn't bet)
Seat 2: 376e9d31 (small blind) folded before Flop
Seat 3: e49e39a2 (big blind) folded before Flop
Seat 4: cf8a8e96 folded before Flop
Seat 5: Hero collected ($0.28)
Seat 6: 1e6e058c folded before Flop (didn't bet)


Poker Hand #RC2078520825: Hold'em No Limit ($0.02/$0.05) - 2023/12/22 21:40:56
Table 'RushAndCash795238' 6-max Seat #1 is the button
Seat 1: 9386dd90 ($4.3 in chips)
Seat 2: 4d43d419 ($5.67 in chips)
Seat 3: f71b25e9 ($7.73 in chips)
Seat 4: 1a2ba0b4 ($5.07 in chips)
Seat 5: 254bcf9e ($9.91 in chips)
Seat 6: Hero ($5.02 in chips)
4d43d419: posts small blind $0.02
f71b25e9: posts big blind $0.05
*** HOLE CARDS ***
Dealt to 9386dd90 
Dealt to 4d43d419 
Dealt to f71b25e9 
Dealt to 1a2ba0b4 
Dealt to 254bcf9e 
Dealt to Hero [3s 7h]
1a2ba0b4: folds
254bcf9e: folds
Hero: folds
9386dd90: folds
4d43d419: folds
Uncalled bet ($0.03) returned to f71b25e9
*** SHOWDOWN ***
f71b25e9 collected $0.04 from pot
*** SUMMARY ***
Total pot $0.04 | Rake $0 | Jackpot $0 | Bingo $0 | Fortune $0 | Tax $0
Seat 1: 9386dd90 (button) folded before Flop (didn't bet)
Seat 2: 4d43d419 (small blind) folded before Flop
Seat 3: f71b25e9 (big blind) collected ($0.04)
Seat 4: 1a2ba0b4 folded before Flop (didn't bet)
Seat 5: 254bcf9e folded before Flop (didn't bet)
Seat 6: Hero folded before Flop (didn't bet)


Poker Hand #RC2078520760: Hold'em No Limit ($0.02/$0.05) - 2023/12/22 21:40:52
Table 'RushAndCash795206' 6-max Seat #1 is the button
Seat 1: d198170b ($7.25 in chips)
Seat 2: 37e2503b ($5.62 in chips)
Seat 3: fa93749b ($9.25 in chips)
Seat 4: 71871718 ($2.46 in chips)
Seat 5: Hero ($5.02 in chips)
Seat 6: f64c1e66 ($7.8 in chips)
37e2503b: posts small blind $0.02
fa93749b: posts big blind $0.05
*** HOLE CARDS ***
Dealt to d198170b 
Dealt to 37e2503b 
Dealt to fa93749b 
Dealt to 71871718 
Dealt to Hero [Jh 7s]
Dealt to f64c1e66 
71871718: folds
Hero: folds
f64c1e66: folds
d198170b: folds
37e2503b: folds
Uncalled bet ($0.03) returned to fa93749b
*** SHOWDOWN ***
fa93749b collected $0.04 from pot
*** SUMMARY ***
Total pot $0.04 | Rake $0 | Jackpot $0 | Bingo $0 | Fortune $0 | Tax $0
Seat 1: d198170b (button) folded before Flop (didn't bet)
Seat 2: 37e2503b (small blind) folded before Flop
Seat 3: fa93749b (big blind) collected ($0.04)
Seat 4: 71871718 folded before Flop (didn't bet)
Seat 5: Hero folded before Flop (didn't bet)
Seat 6: f64c1e66 folded before Flop (didn't bet)


Poker Hand #RC2078520698: Hold'em No Limit ($0.02/$0.05) - 2023/12/22 21:40:49
Table 'RushAndCash795176' 6-max Seat #1 is the button
Seat 1: ac89ef05 ($4.69 in chips)
Seat 2: 72f7386e ($16.49 in chips)
Seat 3: 56a5ef7f ($5.29 in chips)
Seat 4: ae47b4ce ($5.07 in chips)
Seat 5: Hero ($5.02 in chips)
Seat 6: 91937678 ($5.15 in chips)
72f7386e: posts small blind $0.02
56a5ef7f: posts big blind $0.05
*** HOLE CARDS ***
Dealt to ac89ef05 
Dealt to 72f7386e 
Dealt to 56a5ef7f 
Dealt to ae47b4ce 
Dealt to Hero [Ah 5s]
Dealt to 91937678 
ae47b4ce: raises $0.06 to $0.11
Hero: folds
91937678: folds
ac89ef05: folds
72f7386e: folds
56a5ef7f: calls $0.06
*** FLOP *** [Qd Th 9d]
56a5ef7f: checks
ae47b4ce: checks
*** TURN *** [Qd Th 9d] [4s]
56a5ef7f: bets $0.18
ae47b4ce: folds
Uncalled bet ($0.18) returned to 56a5ef7f
*** SHOWDOWN ***
56a5ef7f collected $0.23 from pot
*** SUMMARY ***
Total pot $0.24 | Rake $0.01 | Jackpot $0 | Bingo $0 | Fortune $0 | Tax $0
Board [Qd Th 9d 4s]
Seat 1: ac89ef05 (button) folded before Flop (didn't bet)
Seat 2: 72f7386e (small blind) folded before Flop
Seat 3: 56a5ef7f (big blind) won ($0.23)
Seat 4: ae47b4ce folded on the Turn
Seat 5: Hero folded before Flop (didn't bet)
Seat 6: 91937678 folded before Flop (didn't bet)


Poker Hand #RC2078520553: Hold'em No Limit ($0.02/$0.05) - 2023/12/22 21:40:40
Table 'RushAndCash795108' 6-max Seat #1 is the button
Seat 1: f704f14d ($2.75 in chips)
Seat 2: 6e609dc6 ($6.23 in chips)
Seat 3: Hero ($5.07 in chips)
Seat 4: 89a27c2 ($4.86 in chips)
Seat 5: eb76e6da ($5 in chips)
Seat 6: 63c93090 ($7.22 in chips)
6e609dc6: posts small blind $0.02
Hero: posts big blind $0.05
*** HOLE CARDS ***
Dealt to f704f14d 
Dealt to 6e609dc6 
Dealt to Hero [Js 5h]
Dealt to 89a27c2 
Dealt to eb76e6da 
Dealt to 63c93090 
89a27c2: folds
eb76e6da: folds
63c93090: raises $0.1 to $0.15
f704f14d: raises $0.37 to $0.52
6e609dc6: folds
Hero: folds
63c93090: calls $0.37
*** FLOP *** [6c 8c 2h]
63c93090: checks
f704f14d: bets $0.56
63c93090: folds
Uncalled bet ($0.56) returned to f704f14d
*** SHOWDOWN ***
f704f14d collected $1.06 from pot
*** SUMMARY ***
Total pot $1.11 | Rake $0.05 | Jackpot $0 | Bingo $0 | Fortune $0 | Tax $0
Board [6c 8c 2h]
Seat 1: f704f14d (button) won ($1.06)
Seat 2: 6e609dc6 (small blind) folded before Flop
Seat 3: Hero (big blind) folded before Flop
Seat 4: 89a27c2 folded before Flop (didn't bet)
Seat 5: eb76e6da folded before Flop (didn't bet)
Seat 6: 63c93090 folded on the Flop


Poker Hand #RC2078520215: Hold'em No Limit ($0.02/$0.05) - 2023/12/22 21:40:21
Table 'RushAndCash794945' 6-max Seat #1 is the button
Seat 1: Hero ($5 in chips)
Seat 2: bf955ffb ($5.8 in chips)
Seat 3: 779c14aa ($5.14 in chips)
Seat 4: ff5dd678 ($1.31 in chips)
Seat 5: e3e578eb ($5 in chips)
Seat 6: f0b0a5f9 ($15.68 in chips)
bf955ffb: posts small blind $0.02
779c14aa: posts big blind $0.05
*** HOLE CARDS ***
Dealt to Hero [Jh Th]
Dealt to bf955ffb 
Dealt to 779c14aa 
Dealt to ff5dd678 
Dealt to e3e578eb 
Dealt to f0b0a5f9 
ff5dd678: folds
e3e578eb: folds
f0b0a5f9: folds
Hero: raises $0.08 to $0.13
bf955ffb: folds
779c14aa: folds
Uncalled bet ($0.08) returned to Hero
*** SHOWDOWN ***
Hero collected $0.12 from pot
*** SUMMARY ***
Total pot $0.12 | Rake $0 | Jackpot $0 | Bingo $0 | Fortune $0 | Tax $0
Seat 1: Hero (button) collected ($0.12)
Seat 2: bf955ffb (small blind) folded before Flop
Seat 3: 779c14aa (big blind) folded before Flop
Seat 4: ff5dd678 folded before Flop (didn't bet)
Seat 5: e3e578eb folded before Flop (didn't bet)
Seat 6: f0b0a5f9 folded before Flop (didn't bet)


Poker Hand #RC2078520149: Hold'em No Limit ($0.02/$0.05) - 2023/12/22 21:40:18
Table 'RushAndCash794916' 6-max Seat #1 is the button
Seat 1: 6ff1e240 ($9.02 in chips)
Seat 2: Hero ($5 in chips)
Seat 3: 2e20f1d7 ($3.98 in chips)
Seat 4: 8cdcab26 ($6.27 in chips)
Seat 5: 765e7e9d ($7.53 in chips)
Seat 6: 52749f9e ($5.14 in chips)
Hero: posts small blind $0.02
2e20f1d7: posts big blind $0.05
*** HOLE CARDS ***
Dealt to 6ff1e240 
Dealt to Hero [Jh Kc]
Dealt to 2e20f1d7 
Dealt to 8cdcab26 
Dealt to 765e7e9d 
Dealt to 52749f9e 
8cdcab26: raises $0.06 to $0.11
765e7e9d: folds
52749f9e: calls $0.11
6ff1e240: folds
Hero: folds
2e20f1d7: folds
*** FLOP *** [5d Js 9c]
8cdcab26: checks
52749f9e: checks
*** TURN *** [5d Js 9c] [7h]
8cdcab26: checks
52749f9e: bets $0.15
8cdcab26: folds
Uncalled bet ($0.15) returned to 52749f9e
*** SHOWDOWN ***
52749f9e collected $0.28 from pot
*** SUMMARY ***
Total pot $0.29 | Rake $0.01 | Jackpot $0 | Bingo $0 | Fortune $0 | Tax $0
Board [5d Js 9c 7h]
Seat 1: 6ff1e240 (button) folded before Flop (didn't bet)
Seat 2: Hero (small blind) folded before Flop
Seat 3: 2e20f1d7 (big blind) folded before Flop
Seat 4: 8cdcab26 folded on the Turn
Seat 5: 765e7e9d folded before Flop (didn't bet)
Seat 6: 52749f9e won ($0.28)


Poker Hand #RC2078520083: Hold'em No Limit ($0.02/$0.05) - 2023/12/22 21:40:14
Table 'RushAndCash794884' 6-max Seat #1 is the button
Seat 1: 7016689e ($5.66 in chips)
Seat 2: e527ebf4 ($7.33 in chips)
Seat 3: 82275b51 ($2 in chips)
Seat 4: a7076373 ($9.87 in chips)
Seat 5: Hero ($5 in chips)
Seat 6: 8cdcab26 ($6.27 in chips)
e527ebf4: posts small blind $0.02
82275b51: posts big blind $0.05
*** HOLE CARDS ***
Dealt to 7016689e 
Dealt to e527ebf4 
Dealt to 82275b51 
Dealt to a7076373 
Dealt to Hero [Jc 9h]
Dealt to 8cdcab26 
a7076373: folds
Hero: folds
8cdcab26: folds
7016689e: raises $0.08 to $0.13
e527ebf4: calls $0.11
82275b51: raises $0.39 to $0.52
7016689e: folds
e527ebf4: folds
Uncalled bet ($0.39) returned to 82275b51
*** SHOWDOWN ***
82275b51 collected $0.37 from pot
*** SUMMARY ***
Total pot $0.39 | Rake $0.02 | Jackpot $0 | Bingo $0 | Fortune $0 | Tax $0
Seat 1: 7016689e (button) folded before Flop
Seat 2: e527ebf4 (small blind) folded before Flop
Seat 3: 82275b51 (big blind) collected ($0.37)
Seat 4: a7076373 folded before Flop (didn't bet)
Seat 5: Hero folded before Flop (didn't bet)
Seat 6: 8cdcab26 folded before Flop (didn't bet)


Poker Hand #RC2078520009: Hold'em No Limit ($0.02/$0.05) - 2023/12/22 21:40:10
Table 'RushAndCash794850' 6-max Seat #1 is the button
Seat 1: df439f39 ($5.14 in chips)
Seat 2: 38e42730 ($9.12 in chips)
Seat 3: f9c8784e ($11.94 in chips)
Seat 4: f43dd94b ($5.61 in chips)
Seat 5: Hero ($5 in chips)
Seat 6: 3402e890 ($5.7 in chips)
38e42730: posts small blind $0.02
f9c8784e: posts big blind $0.05
*** HOLE CARDS ***
Dealt to df439f39 
Dealt to 38e42730 
Dealt to f9c8784e 
Dealt to f43dd94b 
Dealt to Hero [Qc 5d]
Dealt to 3402e890 
f43dd94b: folds
Hero: folds
3402e890: folds
df439f39: folds
38e42730: raises $0.1 to $0.15
f9c8784e: calls $0.1
*** FLOP *** [Ks 9d 6h]
38e42730: checks
f9c8784e: bets $0.1
38e42730: calls $0.1
*** TURN *** [Ks 9d 6h] [Js]
38e42730: checks
f9c8784e: checks
*** RIVER *** [Ks 9d 6h Js] [2d]
38e42730: checks
f9c8784e: bets $0.17
38e42730: calls $0.17
f9c8784e: shows [8c Kd] (Pair of Kings)
38e42730: shows [Kh Td] (Pair of Kings)
*** SHOWDOWN ***
38e42730 collected $0.8 from pot
*** SUMMARY ***
Total pot $0.84 | Rake $0.04 | Jackpot $0 | Bingo $0 | Fortune $0 | Tax $0
Board [Ks 9d 6h Js 2d]
Seat 1: df439f39 (button) folded before Flop (didn't bet)
Seat 2: 38e42730 (small blind) showed [Kh Td] and won ($0.8) with Pair of Kings
Seat 3: f9c8784e (big blind) showed [8c Kd] and lost with Pair of Kings
Seat 4: f43dd94b folded before Flop (didn't bet)
Seat 5: Hero folded before Flop (didn't bet)
Seat 6: 3402e890 folded before Flop (didn't bet)


Poker Hand #RC2078519933: Hold'em No Limit ($0.02/$0.05) - 2023/12/22 21:40:06
Table 'RushAndCash794812' 6-max Seat #1 is the button
Seat 1: Hero ($5 in chips)
Seat 2: 9dc69999 ($8.02 in chips)
Seat 3: 9942b4df ($6.15 in chips)
Seat 4: 74a53cac ($10.06 in chips)
Seat 5: 3580bebf ($13.75 in chips)
Seat 6: 3e2e2010 ($6.16 in chips)
9dc69999: posts small blind $0.02
9942b4df: posts big blind $0.05
*** HOLE CARDS ***
Dealt to Hero [9d 5h]
Dealt to 9dc69999 
Dealt to 9942b4df 
Dealt to 74a53cac 
Dealt to 3580bebf 
Dealt to 3e2e2010 
74a53cac: raises $0.05 to $0.1
3580bebf: raises $0.21 to $0.31
3e2e2010: folds
Hero: folds
9dc69999: calls $0.29
9942b4df: folds
74a53cac: calls $0.21
*** FLOP *** [3h Ad 8s]
9dc69999: checks
74a53cac: checks
3580bebf: bets $0.35
9dc69999: folds
74a53cac: calls $0.35
*** TURN *** [3h Ad 8s] [4h]
74a53cac: checks
3580bebf: checks
*** RIVER *** [3h Ad 8s 4h] [8c]
74a53cac: bets $0.99
3580bebf: calls $0.99
74a53cac: shows [8h 8d] (Four Eights)
3580bebf: shows [Kd As] (Pair of Aces and Pair of Eights)
*** SHOWDOWN ***
74a53cac collected $3.44 from pot
*** SUMMARY ***
Total pot $3.66 | Rake $0.15 | Jackpot $0.07 | Bingo $0 | Fortune $0 | Tax $0
Board [3h Ad 8s 4h 8c]
Seat 1: Hero (button) folded before Flop (didn't bet)
Seat 2: 9dc69999 (small blind) folded on the Flop
Seat 3: 9942b4df (big blind) folded before Flop
Seat 4: 74a53cac showed [8h 8d] and won ($3.44) with Four Eights
Seat 5: 3580bebf showed [Kd As] and lost with Pair of Aces and Pair of Eights
Seat 6: 3e2e2010 folded before Flop (didn't bet)


Poker Hand #RC2078519798: Hold'em No Limit ($0.02/$0.05) - 2023/12/22 21:39:58
Table 'RushAndCash794745' 6-max Seat #1 is the button
Seat 1: 59846dec ($10.07 in chips)
Seat 2: Hero ($5 in chips)
Seat 3: 5cb14769 ($9.27 in chips)
Seat 4: 69eae1f2 ($6.8 in chips)
Seat 5: 11612373 ($11.61 in chips)
Seat 6: 2b3cf2e3 ($2.54 in chips)
Hero: posts small blind $0.02
5cb14769: posts big blind $0.05
*** HOLE CARDS ***
Dealt to 59846dec 
Dealt to Hero [Qs 4c]
Dealt to 5cb14769 
Dealt to 69eae1f2 
Dealt to 11612373 
Dealt to 2b3cf2e3 
69eae1f2: folds
11612373: folds
2b3cf2e3: folds
59846dec: raises $0.1 to $0.15
Hero: folds
5cb14769: folds
Uncalled bet ($0.1) returned to 59846dec
*** SHOWDOWN ***
59846dec collected $0.12 from pot
*** SUMMARY ***
Total pot $0.12 | Rake $0 | Jackpot $0 | Bingo $0 | Fortune $0 | Tax $0
Seat 1: 59846dec (button) collected ($0.12)
Seat 2: Hero (small blind) folded before Flop
Seat 3: 5cb14769 (big blind) folded before Flop
Seat 4: 69eae1f2 folded before Flop (didn't bet)
Seat 5: 11612373 folded before Flop (didn't bet)
Seat 6: 2b3cf2e3 folded before Flop (didn't bet)


Poker Hand #RC2078519543: Hold'em No Limit ($0.02/$0.05) - 2023/12/22 21:39:44
Table 'RushAndCash794616' 6-max Seat #1 is the button
Seat 1: 354a07bb ($5 in chips)
Seat 2: 2c2cc68d ($11.08 in chips)
Seat 3: Hero ($5 in chips)
Seat 4: 254bcf9e ($9.98 in chips)
Seat 5: af85def9 ($4.85 in chips)
Seat 6: 56a5ef7f ($5.42 in chips)
2c2cc68d: posts small blind $0.02
Hero: posts big blind $0.05
*** HOLE CARDS ***
Dealt to 354a07bb 
Dealt to 2c2cc68d 
Dealt to Hero [8s 9d]
Dealt to 254bcf9e 
Dealt to af85def9 
Dealt to 56a5ef7f 
254bcf9e: folds
af85def9: folds
56a5ef7f: raises $0.08 to $0.13
354a07bb: raises $0.28 to $0.41
2c2cc68d: raises $0.8 to $1.21
Hero: folds
56a5ef7f: folds
354a07bb: calls $0.8
*** FLOP *** [9s Kh Qs]
2c2cc68d: bets $1.3
354a07bb: calls $1.3
*** TURN *** [9s Kh Qs] [4h]
2c2cc68d: bets $8.57 and is all-in
354a07bb: calls $2.49 and is all-in
Uncalled bet ($6.08) returned to 2c2cc68d
2c2cc68d: shows [Ad Kc] (Pair of Kings)
354a07bb: shows [Ah Jh] (Ace-High)
*** RIVER *** [9s Kh Qs 4h] [8h]
*** SHOWDOWN ***
354a07bb collected $9.96 from pot
*** SUMMARY ***
Total pot $10.18 | Rake $0.15 | Jackpot $0.07 | Bingo $0 | Fortune $0 | Tax $0
Board [9s Kh Qs 4h 8h]
Seat 1: 354a07bb (button) showed [Ah Jh] and won ($9.96) with Ace High Flush
Seat 2: 2c2cc68d (small blind) showed [Ad Kc] and lost with Pair of Kings
Seat 3: Hero (big blind) folded before Flop
Seat 4: 254bcf9e folded before Flop (didn't bet)
Seat 5: af85def9 folded before Flop (didn't bet)
Seat 6: 56a5ef7f folded before Flop


Poker Hand #RC2078519365: Hold'em No Limit ($0.02/$0.05) - 2023/12/22 21:39:35
Table 'RushAndCash794528' 6-max Seat #1 is the button
Seat 1: 3288926 ($7.55 in chips)
Seat 2: edac6d16 ($5.66 in chips)
Seat 3: fafe49aa ($5 in chips)
Seat 4: Hero ($5 in chips)
Seat 5: c0d3508b ($4.63 in chips)
Seat 6: 8f240b5e ($9.86 in chips)
edac6d16: posts small blind $0.02
fafe49aa: posts big blind $0.05
*** HOLE CARDS ***
Dealt to 3288926 
Dealt to edac6d16 
Dealt to fafe49aa 
Dealt to Hero [6s 9h]
Dealt to c0d3508b 
Dealt to 8f240b5e 
Hero: folds
c0d3508b: raises $0.1 to $0.15
8f240b5e: folds
3288926: folds
edac6d16: folds
fafe49aa: calls $0.1
*** FLOP *** [4d Jd 3d]
fafe49aa: checks
c0d3508b: checks
*** TURN *** [4d Jd 3d] [2s]
fafe49aa: bets $0.46
c0d3508b: folds
Uncalled bet ($0.46) returned to fafe49aa
*** SHOWDOWN ***
fafe49aa collected $0.31 from pot
*** SUMMARY ***
Total pot $0.32 | Rake $0.01 | Jackpot $0 | Bingo $0 | Fortune $0 | Tax $0
Board [4d Jd 3d 2s]
Seat 1: 3288926 (button) folded before Flop (didn't bet)
Seat 2: edac6d16 (small blind) folded before Flop
Seat 3: fafe49aa (big blind) won ($0.31)
Seat 4: Hero folded before Flop (didn't bet)
Seat 5: c0d3508b folded on the Turn
Seat 6: 8f240b5e folded before Flop (didn't bet)


Poker Hand #RC2078519294: Hold'em No Limit ($0.02/$0.05) - 2023/12/22 21:39:30
Table 'RushAndCash794494' 6-max Seat #1 is the button
Seat 1: 67297113 ($6.66 in chips)
Seat 2: eb76e6da ($5.02 in chips)
Seat 3: 4df86067 ($9.55 in chips)
Seat 4: 521feab9 ($5.17 in chips)
Seat 5: Hero ($5 in chips)
Seat 6: dc851cb6 ($5.93 in chips)
eb76e6da: posts small blind $0.02
4df86067: posts big blind $0.05
*** HOLE CARDS ***
Dealt to 67297113 
Dealt to eb76e6da 
Dealt to 4df86067 
Dealt to 521feab9 
Dealt to Hero [7d 5c]
Dealt to dc851cb6 
521feab9: raises $0.08 to $0.13
Hero: folds
dc851cb6: folds
67297113: folds
eb76e6da: folds
4df86067: folds
Uncalled bet ($0.08) returned to 521feab9
*** SHOWDOWN ***
521feab9 collected $0.12 from pot
*** SUMMARY ***
Total pot $0.12 | Rake $0 | Jackpot $0 | Bingo $0 | Fortune $0 | Tax $0
Seat 1: 67297113 (button) folded before Flop (didn't bet)
Seat 2: eb76e6da (small blind) folded before Flop
Seat 3: 4df86067 (big blind) folded before Flop
Seat 4: 521feab9 collected ($0.12)
Seat 5: Hero folded before Flop (didn't bet)
Seat 6: dc851cb6 folded before Flop (didn't bet)


Poker Hand #RC2078519216: Hold'em No Limit ($0.02/$0.05) - 2023/12/22 21:39:27
Table 'RushAndCash794455' 6-max Seat #1 is the button
Seat 1: 98124327 ($5.19 in chips)
Seat 2: Hero ($5 in chips)
Seat 3: 59da0131 ($17.7 in chips)
Seat 4: d74d8525 ($5.07 in chips)
Seat 5: c4382072 ($5.56 in chips)
Seat 6: 7732abf7 ($21.69 in chips)
Hero: posts small blind $0.02
59da0131: posts big blind $0.05
*** HOLE CARDS ***
Dealt to 98124327 
Dealt to Hero [Kd Ts]
Dealt to 59da0131 
Dealt to d74d8525 
Dealt to c4382072 
Dealt to 7732abf7 
d74d8525: folds
c4382072: folds
7732abf7: folds
98124327: raises $0.05 to $0.1
Hero: folds
59da0131: folds
Uncalled bet ($0.05) returned to 98124327
*** SHOWDOWN ***
98124327 collected $0.12 from pot
*** SUMMARY ***
Total pot $0.12 | Rake $0 | Jackpot $0 | Bingo $0 | Fortune $0 | Tax $0
Seat 1: 98124327 (button) collected ($0.12)
Seat 2: Hero (small blind) folded before Flop
Seat 3: 59da0131 (big blind) folded before Flop
Seat 4: d74d8525 folded before Flop (didn't bet)
Seat 5: c4382072 folded before Flop (didn't bet)
Seat 6: 7732abf7 folded before Flop (didn't bet)


Poker Hand #RC2078518980: Hold'em No Limit ($0.02/$0.05) - 2023/12/22 21:39:15
Table 'RushAndCash794343' 6-max Seat #1 is the button
Seat 1: 23e461b0 ($6.47 in chips)
Seat 2: f3e4b0ce ($1.57 in chips)
Seat 3: f94de4b0 ($5.47 in chips)
Seat 4: cf8a8e96 ($7.89 in chips)
Seat 5: Hero ($5 in chips)
Seat 6: 5d317abf ($14.72 in chips)
f3e4b0ce: posts small blind $0.02
f94de4b0: posts big blind $0.05
*** HOLE CARDS ***
Dealt to 23e461b0 
Dealt to f3e4b0ce 
Dealt to f94de4b0 
Dealt to cf8a8e96 
Dealt to Hero [Kc Qd]
Dealt to 5d317abf 
cf8a8e96: folds
Hero: raises $0.05 to $0.1
5d317abf: folds
23e461b0: folds
f3e4b0ce: raises $0.19 to $0.29
f94de4b0: folds
Hero: folds
Uncalled bet ($0.19) returned to f3e4b0ce
*** SHOWDOWN ***
f3e4b0ce collected $0.24 from pot
*** SUMMARY ***
Total pot $0.25 | Rake $0.01 | Jackpot $0 | Bingo $0 | Fortune $0 | Tax $0
Seat 1: 23e461b0 (button) folded before Flop (didn't bet)
Seat 2: f3e4b0ce (small blind) collected ($0.24)
Seat 3: f94de4b0 (big blind) folded before Flop
Seat 4: cf8a8e96 folded before Flop (didn't bet)
Seat 5: Hero folded before Flop
Seat 6: 5d317abf folded before Flop (didn't bet)


Poker Hand #RC2078518199: Hold'em No Limit ($0.02/$0.05) - 2023/12/22 21:38:32
Table 'RushAndCash793983' 6-max Seat #1 is the button
Seat 1: 6d679d40 ($6.06 in chips)
Seat 2: f94de4b0 ($5.56 in chips)
Seat 3: Hero ($5.07 in chips)
Seat 4: e1380a89 ($4.69 in chips)
Seat 5: eeb37e34 ($9.84 in chips)
Seat 6: b36a4d43 ($5.64 in chips)
f94de4b0: posts small blind $0.02
Hero: posts big blind $0.05
*** HOLE CARDS ***
Dealt to 6d679d40 
Dealt to f94de4b0 
Dealt to Hero [9c Ad]
Dealt to e1380a89 
Dealt to eeb37e34 
Dealt to b36a4d43 
e1380a89: folds
eeb37e34: raises $0.08 to $0.13
b36a4d43: folds
6d679d40: folds
f94de4b0: folds
Hero: calls $0.08
*** FLOP *** [Jd 3s Th]
Hero: checks
eeb37e34: checks
*** TURN *** [Jd 3s Th] [6d]
Hero: checks
eeb37e34: checks
*** RIVER *** [Jd 3s Th 6d] [Jc]
Hero: checks
eeb37e34: checks
Hero: shows [9c Ad] (Pair of Jacks)
eeb37e34: shows [Ac Kh] (Pair of Jacks)
*** SHOWDOWN ***
eeb37e34 collected $0.27 from pot
*** SUMMARY ***
Total pot $0.28 | Rake $0.01 | Jackpot $0 | Bingo $0 | Fortune $0 | Tax $0
Board [Jd 3s Th 6d Jc]
Seat 1: 6d679d40 (button) folded before Flop (didn't bet)
Seat 2: f94de4b0 (small blind) folded before Flop
Seat 3: Hero (big blind) showed [9c Ad] and lost with Pair of Jacks
Seat 4: e1380a89 folded before Flop (didn't bet)
Seat 5: eeb37e34 showed [Ac Kh] and won ($0.27) with Pair of Jacks
Seat 6: b36a4d43 folded before Flop (didn't bet)


Poker Hand #RC2078518137: Hold'em No Limit ($0.02/$0.05) - 2023/12/22 21:38:28
Table 'RushAndCash793952' 6-max Seat #1 is the button
Seat 1: Hero ($5.07 in chips)
Seat 2: 60bb15f4 ($6.2 in chips)
Seat 3: ed53cde8 ($6.31 in chips)
Seat 4: f6f7aa18 ($6.31 in chips)
Seat 5: 9c71d64c ($2.12 in chips)
Seat 6: 1fc1f571 ($13.61 in chips)
60bb15f4: posts small blind $0.02
ed53cde8: posts big blind $0.05
*** HOLE CARDS ***
Dealt to Hero [4s 2c]
Dealt to 60bb15f4 
Dealt to ed53cde8 
Dealt to f6f7aa18 
Dealt to 9c71d64c 
Dealt to 1fc1f571 
f6f7aa18: folds
9c71d64c: folds
1fc1f571: folds
Hero: folds
60bb15f4: folds
Uncalled bet ($0.03) returned to ed53cde8
*** SHOWDOWN ***
ed53cde8 collected $0.04 from pot
*** SUMMARY ***
Total pot $0.04 | Rake $0 | Jackpot $0 | Bingo $0 | Fortune $0 | Tax $0
Seat 1: Hero (button) folded before Flop (didn't bet)
Seat 2: 60bb15f4 (small blind) folded before Flop
Seat 3: ed53cde8 (big blind) collected ($0.04)
Seat 4: f6f7aa18 folded before Flop (didn't bet)
Seat 5: 9c71d64c folded before Flop (didn't bet)
Seat 6: 1fc1f571 folded before Flop (didn't bet)


Poker Hand #RC2078518076: Hold'em No Limit ($0.02/$0.05) - 2023/12/22 21:38:25
Table 'RushAndCash793923' 6-max Seat #1 is the button
Seat 1: b6052383 ($5.67 in chips)
Seat 2: a51bf3f3 ($2.22 in chips)
Seat 3: c9edf932 ($5.41 in chips)
Seat 4: 6d3488f1 ($3.38 in chips)
Seat 5: 59da0131 ($17.92 in chips)
Seat 6: Hero ($5.07 in chips)
a51bf3f3: posts small blind $0.02
c9edf932: posts big blind $0.05
*** HOLE CARDS ***
Dealt to b6052383 
Dealt to a51bf3f3 
Dealt to c9edf932 
Dealt to 6d3488f1 
Dealt to 59da0131 
Dealt to Hero [Jc 2h]
6d3488f1: folds
59da0131: raises $0.07 to $0.12
Hero: folds
b6052383: folds
a51bf3f3: calls $0.1
c9edf932: folds
*** FLOP *** [Qh 6s 3d]
a51bf3f3: checks
59da0131: bets $0.1
a51bf3f3: calls $0.1
*** TURN *** [Qh 6s 3d] [9h]
a51bf3f3: checks
59da0131: checks
*** RIVER *** [Qh 6s 3d 9h] [Jh]
a51bf3f3: bets $0.39
59da0131: folds
Uncalled bet ($0.39) returned to a51bf3f3
*** SHOWDOWN ***
a51bf3f3 collected $0.47 from pot
*** SUMMARY ***
Total pot $0.49 | Rake $0.02 | Jackpot $0 | Bingo $0 | Fortune $0 | Tax $0
Board [Qh 6s 3d 9h Jh]
Seat 1: b6052383 (button) folded before Flop (didn't bet)
Seat 2: a51bf3f3 (small blind) won ($0.47)
Seat 3: c9edf932 (big blind) folded before Flop
Seat 4: 6d3488f1 folded before Flop (didn't bet)
Seat 5: 59da0131 folded on the River
Seat 6: Hero folded before Flop (didn't bet)


Poker Hand #RC2078517986: Hold'em No Limit ($0.02/$0.05) - 2023/12/22 21:38:20
Table 'RushAndCash793879' 6-max Seat #1 is the button
Seat 1: fab544c8 ($5 in chips)
Seat 2: bacb0059 ($4.2 in chips)
Seat 3: b61f5bde ($10.33 in chips)
Seat 4: 5945e592 ($2.44 in chips)
Seat 5: 5b05e7c ($2.18 in chips)
Seat 6: Hero ($5.07 in chips)
bacb0059: posts small blind $0.02
b61f5bde: posts big blind $0.05
*** HOLE CARDS ***
Dealt to fab544c8 
Dealt to bacb0059 
Dealt to b61f5bde 
Dealt to 5945e592 
Dealt to 5b05e7c 
Dealt to Hero [2c Kc]
5945e592: folds
5b05e7c: folds
Hero: folds
fab544c8: raises $0.08 to $0.13
bacb0059: folds
b61f5bde: folds
Uncalled bet ($0.08) returned to fab544c8
*** SHOWDOWN ***
fab544c8 collected $0.12 from pot
*** SUMMARY ***
Total pot $0.12 | Rake $0 | Jackpot $0 | Bingo $0 | Fortune $0 | Tax $0
Seat 1: fab544c8 (button) collected ($0.12)
Seat 2: bacb0059 (small blind) folded before Flop
Seat 3: b61f5bde (big blind) folded before Flop
Seat 4: 5945e592 folded before Flop (didn't bet)
Seat 5: 5b05e7c folded before Flop (didn't bet)
Seat 6: Hero folded before Flop (didn't bet)


Poker Hand #RC2078517856: Hold'em No Limit ($0.02/$0.05) - 2023/12/22 21:38:13
Table 'RushAndCash793817' 6-max Seat #1 is the button
Seat 1: 62357227 ($5.09 in chips)
Seat 2: 4520f334 ($4.95 in chips)
Seat 3: d74d8525 ($5 in chips)
Seat 4: a51bf3f3 ($2.22 in chips)
Seat 5: 51c82b66 ($5.14 in chips)
Seat 6: Hero ($5.07 in chips)
4520f334: posts small blind $0.02
d74d8525: posts big blind $0.05
*** HOLE CARDS ***
Dealt to 62357227 
Dealt to 4520f334 
Dealt to d74d8525 
Dealt to a51bf3f3 
Dealt to 51c82b66 
Dealt to Hero [Kd 9d]
a51bf3f3: folds
51c82b66: raises $0.08 to $0.13
Hero: folds
62357227: folds
4520f334: folds
d74d8525: folds
Uncalled bet ($0.08) returned to 51c82b66
*** SHOWDOWN ***
51c82b66 collected $0.12 from pot
*** SUMMARY ***
Total pot $0.12 | Rake $0 | Jackpot $0 | Bingo $0 | Fortune $0 | Tax $0
Seat 1: 62357227 (button) folded before Flop (didn't bet)
Seat 2: 4520f334 (small blind) folded before Flop
Seat 3: d74d8525 (big blind) folded before Flop
Seat 4: a51bf3f3 folded before Flop (didn't bet)
Seat 5: 51c82b66 collected ($0.12)
Seat 6: Hero folded before Flop (didn't bet)


Poker Hand #RC2078517751: Hold'em No Limit ($0.02/$0.05) - 2023/12/22 21:38:08
Table 'RushAndCash793764' 6-max Seat #1 is the button
Seat 1: 525db62f ($16.26 in chips)
Seat 2: 4c691fe1 ($3.32 in chips)
Seat 3: 9b0ec3a ($13.11 in chips)
Seat 4: 4fcbfbdc ($8.7 in chips)
Seat 5: Hero ($5.07 in chips)
Seat 6: 7466ff6a ($19.5 in chips)
4c691fe1: posts small blind $0.02
9b0ec3a: posts big blind $0.05
*** HOLE CARDS ***
Dealt to 525db62f 
Dealt to 4c691fe1 
Dealt to 9b0ec3a 
Dealt to 4fcbfbdc 
Dealt to Hero [3s Ad]
Dealt to 7466ff6a 
4fcbfbdc: folds
Hero: folds
7466ff6a: raises $0.1 to $0.15
525db62f: folds
4c691fe1: folds
9b0ec3a: calls $0.1
*** FLOP *** [7s 2c Kd]
9b0ec3a: checks
7466ff6a: checks
*** TURN *** [7s 2c Kd] [Jd]
9b0ec3a: bets $0.16
7466ff6a: calls $0.16
*** RIVER *** [7s 2c Kd Jd] [5d]
9b0ec3a: checks
7466ff6a: checks
9b0ec3a: shows [7d 7h] (Three Sevens)
7466ff6a: shows [Qs Qc] (Pair of Queens)
*** SHOWDOWN ***
9b0ec3a collected $0.61 from pot
*** SUMMARY ***
Total pot $0.64 | Rake $0.03 | Jackpot $0 | Bingo $0 | Fortune $0 | Tax $0
Board [7s 2c Kd Jd 5d]
Seat 1: 525db62f (button) folded before Flop (didn't bet)
Seat 2: 4c691fe1 (small blind) folded before Flop
Seat 3: 9b0ec3a (big blind) showed [7d 7h] and won ($0.61) with Three Sevens
Seat 4: 4fcbfbdc folded before Flop (didn't bet)
Seat 5: Hero folded before Flop (didn't bet)
Seat 6: 7466ff6a showed [Qs Qc] and lost with Pair of Queens


Poker Hand #RC2078517558: Hold'em No Limit ($0.02/$0.05) - 2023/12/22 21:37:57
Table 'RushAndCash793672' 6-max Seat #1 is the button
Seat 1: Hero ($5 in chips)
Seat 2: c3adc948 ($10.22 in chips)
Seat 3: 38eafb19 ($5 in chips)
Seat 4: b4439dda ($6.82 in chips)
Seat 5: dc851cb6 ($5.82 in chips)
Seat 6: c5b816d3 ($5.27 in chips)
c3adc948: posts small blind $0.02
38eafb19: posts big blind $0.05
*** HOLE CARDS ***
Dealt to Hero [Ac 8c]
Dealt to c3adc948 
Dealt to 38eafb19 
Dealt to b4439dda 
Dealt to dc851cb6 
Dealt to c5b816d3 
b4439dda: folds
dc851cb6: folds
c5b816d3: folds
Hero: raises $0.08 to $0.13
c3adc948: folds
38eafb19: folds
Uncalled bet ($0.08) returned to Hero
*** SHOWDOWN ***
Hero collected $0.12 from pot
*** SUMMARY ***
Total pot $0.12 | Rake $0 | Jackpot $0 | Bingo $0 | Fortune $0 | Tax $0
Seat 1: Hero (button) collected ($0.12)
Seat 2: c3adc948 (small blind) folded before Flop
Seat 3: 38eafb19 (big blind) folded before Flop
Seat 4: b4439dda folded before Flop (didn't bet)
Seat 5: dc851cb6 folded before Flop (didn't bet)
Seat 6: c5b816d3 folded before Flop (didn't bet)


Poker Hand #RC2078517492: Hold'em No Limit ($0.02/$0.05) - 2023/12/22 21:37:54
Table 'RushAndCash793641' 6-max Seat #1 is the button
Seat 1: ccecbdd ($1.99 in chips)
Seat 2: d6d8d23b ($9.21 in chips)
Seat 3: Hero ($5 in chips)
Seat 4: c3adc948 ($10.22 in chips)
Seat 5: 59da0131 ($17.94 in chips)
Seat 6: 30a2950b ($5 in chips)
d6d8d23b: posts small blind $0.02
Hero: posts big blind $0.05
*** HOLE CARDS ***
Dealt to ccecbdd 
Dealt to d6d8d23b 
Dealt to Hero [8s 5h]
Dealt to c3adc948 
Dealt to 59da0131 
Dealt to 30a2950b 
c3adc948: folds
59da0131: raises $0.07 to $0.12
30a2950b: folds
ccecbdd: folds
d6d8d23b: folds
Hero: folds
Uncalled bet ($0.07) returned to 59da0131
*** SHOWDOWN ***
59da0131 collected $0.12 from pot
*** SUMMARY ***
Total pot $0.12 | Rake $0 | Jackpot $0 | Bingo $0 | Fortune $0 | Tax $0
Seat 1: ccecbdd (button) folded before Flop (didn't bet)
Seat 2: d6d8d23b (small blind) folded before Flop
Seat 3: Hero (big blind) folded before Flop
Seat 4: c3adc948 folded before Flop (didn't bet)
Seat 5: 59da0131 collected ($0.12)
Seat 6: 30a2950b folded before Flop (didn't bet)


Poker Hand #RC2078517426: Hold'em No Limit ($0.02/$0.05) - 2023/12/22 21:37:50
Table 'RushAndCash793609' 6-max Seat #1 is the button
Seat 1: 40810c68 ($5 in chips)
Seat 2: Hero ($5 in chips)
Seat 3: d2e52b8d ($31.33 in chips)
Seat 4: f3d3c9ba ($10.01 in chips)
Seat 5: b37d4c72 ($10.25 in chips)
Seat 6: 517da49 ($9.94 in chips)
Hero: posts small blind $0.02
d2e52b8d: posts big blind $0.05
*** HOLE CARDS ***
Dealt to 40810c68 
Dealt to Hero [9d 5s]
Dealt to d2e52b8d 
Dealt to f3d3c9ba 
Dealt to b37d4c72 
Dealt to 517da49 
f3d3c9ba: folds
b37d4c72: folds
517da49: folds
40810c68: raises $0.1 to $0.15
Hero: folds
d2e52b8d: folds
Uncalled bet ($0.1) returned to 40810c68
*** SHOWDOWN ***
40810c68 collected $0.12 from pot
*** SUMMARY ***
Total pot $0.12 | Rake $0 | Jackpot $0 | Bingo $0 | Fortune $0 | Tax $0
Seat 1: 40810c68 (button) collected ($0.12)
Seat 2: Hero (small blind) folded before Flop
Seat 3: d2e52b8d (big blind) folded before Flop
Seat 4: f3d3c9ba folded before Flop (didn't bet)
Seat 5: b37d4c72 folded before Flop (didn't bet)
Seat 6: 517da49 folded before Flop (didn't bet)


Poker Hand #RC2078517321: Hold'em No Limit ($0.02/$0.05) - 2023/12/22 21:37:44
Table 'RushAndCash793555' 6-max Seat #1 is the button
Seat 1: 993ccadb ($14.51 in chips)
Seat 2: ad0bb92a ($4.59 in chips)
Seat 3: 409f5cad ($6.05 in chips)
Seat 4: Hero ($5 in chips)
Seat 5: 1e6e058c ($5 in chips)
Seat 6: 55f8abbc ($10.48 in chips)
ad0bb92a: posts small blind $0.02
409f5cad: posts big blind $0.05
*** HOLE CARDS ***
Dealt to 993ccadb 
Dealt to ad0bb92a 
Dealt to 409f5cad 
Dealt to Hero [8c 7d]
Dealt to 1e6e058c 
Dealt to 55f8abbc 
Hero: folds
1e6e058c: folds
55f8abbc: folds
993ccadb: folds
ad0bb92a: raises $0.08 to $0.13
409f5cad: folds
Uncalled bet ($0.08) returned to ad0bb92a
*** SHOWDOWN ***
ad0bb92a collected $0.1 from pot
*** SUMMARY ***
Total pot $0.1 | Rake $0 | Jackpot $0 | Bingo $0 | Fortune $0 | Tax $0
Seat 1: 993ccadb (button) folded before Flop (didn't bet)
Seat 2: ad0bb92a (small blind) collected ($0.1)
Seat 3: 409f5cad (big blind) folded before Flop
Seat 4: Hero folded before Flop (didn't bet)
Seat 5: 1e6e058c folded before Flop (didn't bet)
Seat 6: 55f8abbc folded before Flop (didn't bet)


Poker Hand #RC2078517198: Hold'em No Limit ($0.02/$0.05) - 2023/12/22 21:37:37
Table 'RushAndCash793493' 6-max Seat #1 is the button
Seat 1: c320c189 ($9.34 in chips)
Seat 2: 81ecaac5 ($5.5 in chips)
Seat 3: 6bc8336e ($5.07 in chips)
Seat 4: 4cfc823 ($5.21 in chips)
Seat 5: b976716a ($18.79 in chips)
Seat 6: Hero ($5 in chips)
81ecaac5: posts small blind $0.02
6bc8336e: posts big blind $0.05
*** HOLE CARDS ***
Dealt to c320c189 
Dealt to 81ecaac5 
Dealt to 6bc8336e 
Dealt to 4cfc823 
Dealt to b976716a 
Dealt to Hero [9h 7s]
4cfc823: folds
b976716a: folds
Hero: folds
c320c189: folds
81ecaac5: raises $0.1 to $0.15
6bc8336e: folds
Uncalled bet ($0.1) returned to 81ecaac5
*** SHOWDOWN ***
81ecaac5 collected $0.1 from pot
*** SUMMARY ***
Total pot $0.1 | Rake $0 | Jackpot $0 | Bingo $0 | Fortune $0 | Tax $0
Seat 1: c320c189 (button) folded before Flop (didn't bet)
Seat 2: 81ecaac5 (small blind) collected ($0.1)
Seat 3: 6bc8336e (big blind) folded before Flop
Seat 4: 4cfc823 folded before Flop (didn't bet)
Seat 5: b976716a folded before Flop (didn't bet)
Seat 6: Hero folded before Flop (didn't bet)


Poker Hand #RC2078516995: Hold'em No Limit ($0.02/$0.05) - 2023/12/22 21:37:27
Table 'RushAndCash793390' 6-max Seat #1 is the button
Seat 1: cddd79e8 ($5 in chips)
Seat 2: 9bd4cbdf ($5.4 in chips)
Seat 3: Hero ($5 in chips)
Seat 4: 2994a563 ($4.57 in chips)
Seat 5: b2bf2645 ($5 in chips)
Seat 6: 8802c225 ($6.52 in chips)
9bd4cbdf: posts small blind $0.02
Hero: posts big blind $0.05
*** HOLE CARDS ***
Dealt to cddd79e8 
Dealt to 9bd4cbdf 
Dealt to Hero [7h 8s]
Dealt to 2994a563 
Dealt to b2bf2645 
Dealt to 8802c225 
2994a563: folds
b2bf2645: folds
8802c225: folds
cddd79e8: raises $0.1 to $0.15
9bd4cbdf: calls $0.13
Hero: folds
*** FLOP *** [7d 8d Qd]
9bd4cbdf: checks
cddd79e8: checks
*** TURN *** [7d 8d Qd] [3s]
9bd4cbdf: bets $0.14
cddd79e8: calls $0.14
*** RIVER *** [7d 8d Qd 3s] [Jc]
9bd4cbdf: bets $0.32
cddd79e8: folds
Uncalled bet ($0.32) returned to 9bd4cbdf
*** SHOWDOWN ***
9bd4cbdf collected $0.6 from pot
*** SUMMARY ***
Total pot $0.63 | Rake $0.03 | Jackpot $0 | Bingo $0 | Fortune $0 | Tax $0
Board [7d 8d Qd 3s Jc]
Seat 1: cddd79e8 (button) folded on the River
Seat 2: 9bd4cbdf (small blind) won ($0.6)
Seat 3: Hero (big blind) folded before Flop
Seat 4: 2994a563 folded before Flop (didn't bet)
Seat 5: b2bf2645 folded before Flop (didn't bet)
Seat 6: 8802c225 folded before Flop (didn't bet)


Poker Hand #RC2078516931: Hold'em No Limit ($0.02/$0.05) - 2023/12/22 21:37:23
Table 'RushAndCash793360' 6-max Seat #1 is the button
Seat 1: Hero ($5 in chips)
Seat 2: 2d19d9d1 ($5 in chips)
Seat 3: 78c7aa39 ($5 in chips)
Seat 4: a69f279d ($7.21 in chips)
Seat 5: 517da49 ($10.09 in chips)
Seat 6: 6bc8336e ($5 in chips)
2d19d9d1: posts small blind $0.02
78c7aa39: posts big blind $0.05
*** HOLE CARDS ***
Dealt to Hero [2s 5c]
Dealt to 2d19d9d1 
Dealt to 78c7aa39 
Dealt to a69f279d 
Dealt to 517da49 
Dealt to 6bc8336e 
a69f279d: folds
517da49: folds
6bc8336e: raises $0.07 to $0.12
Hero: folds
2d19d9d1: folds
78c7aa39: folds
Uncalled bet ($0.07) returned to 6bc8336e
*** SHOWDOWN ***
6bc8336e collected $0.12 from pot
*** SUMMARY ***
Total pot $0.12 | Rake $0 | Jackpot $0 | Bingo $0 | Fortune $0 | Tax $0
Seat 1: Hero (button) folded before Flop (didn't bet)
Seat 2: 2d19d9d1 (small blind) folded before Flop
Seat 3: 78c7aa39 (big blind) folded before Flop
Seat 4: a69f279d folded before Flop (didn't bet)
Seat 5: 517da49 folded before Flop (didn't bet)
Seat 6: 6bc8336e collected ($0.12)


Poker Hand #RC2078516704: Hold'em No Limit ($0.02/$0.05) - 2023/12/22 21:37:10
Table 'RushAndCash793258' 6-max Seat #1 is the button
Seat 1: cb16bb03 ($5.53 in chips)
Seat 2: Hero ($5.02 in chips)
Seat 3: 6f212319 ($5.27 in chips)
Seat 4: 822842b3 ($10.19 in chips)
Seat 5: c71b7029 ($9.58 in chips)
Seat 6: 1ccf03f8 ($1.51 in chips)
Hero: posts small blind $0.02
6f212319: posts big blind $0.05
*** HOLE CARDS ***
Dealt to cb16bb03 
Dealt to Hero [Qc 9d]
Dealt to 6f212319 
Dealt to 822842b3 
Dealt to c71b7029 
Dealt to 1ccf03f8 
822842b3: raises $0.15 to $0.2
c71b7029: folds
1ccf03f8: calls $0.2
cb16bb03: folds
Hero: folds
6f212319: folds
*** FLOP *** [2c Jc 9s]
822842b3: bets $0.36
1ccf03f8: raises $0.95 to $1.31 and is all-in
822842b3: calls $0.95
1ccf03f8: shows [9h Ah] (Pair of Nines)
822842b3: shows [Td Tc] (Pair of Tens)
*** TURN *** [2c Jc 9s] [3s]
*** RIVER *** [2c Jc 9s 3s] [7d]
*** SHOWDOWN ***
822842b3 collected $2.87 from pot
*** SUMMARY ***
Total pot $3.09 | Rake $0.15 | Jackpot $0.07 | Bingo $0 | Fortune $0 | Tax $0
Board [2c Jc 9s 3s 7d]
Seat 1: cb16bb03 (button) folded before Flop (didn't bet)
Seat 2: Hero (small blind) folded before Flop
Seat 3: 6f212319 (big blind) folded before Flop
Seat 4: 822842b3 showed [Td Tc] and won ($2.87) with Pair of Tens
Seat 5: c71b7029 folded before Flop (didn't bet)
Seat 6: 1ccf03f8 showed [9h Ah] and lost with Pair of Nines


Poker Hand #RC2078516638: Hold'em No Limit ($0.02/$0.05) - 2023/12/22 21:37:06
Table 'RushAndCash793229' 6-max Seat #1 is the button
Seat 1: f4b75c57 ($4.91 in chips)
Seat 2: 80af7fe3 ($5.38 in chips)
Seat 3: 3a20c3a ($9.74 in chips)
Seat 4: 1ccf03f8 ($1.51 in chips)
Seat 5: Hero ($5.02 in chips)
Seat 6: 4ab8a557 ($5.05 in chips)
80af7fe3: posts small blind $0.02
3a20c3a: posts big blind $0.05
*** HOLE CARDS ***
Dealt to f4b75c57 
Dealt to 80af7fe3 
Dealt to 3a20c3a 
Dealt to 1ccf03f8 
Dealt to Hero [4c Ah]
Dealt to 4ab8a557 
1ccf03f8: folds
Hero: folds
4ab8a557: folds
f4b75c57: folds
80af7fe3: folds
Uncalled bet ($0.03) returned to 3a20c3a
*** SHOWDOWN ***
3a20c3a collected $0.04 from pot
*** SUMMARY ***
Total pot $0.04 | Rake $0 | Jackpot $0 | Bingo $0 | Fortune $0 | Tax $0
Seat 1: f4b75c57 (button) folded before Flop (didn't bet)
Seat 2: 80af7fe3 (small blind) folded before Flop
Seat 3: 3a20c3a (big blind) collected ($0.04)
Seat 4: 1ccf03f8 folded before Flop (didn't bet)
Seat 5: Hero folded before Flop (didn't bet)
Seat 6: 4ab8a557 folded before Flop (didn't bet)


Poker Hand #RC2078516575: Hold'em No Limit ($0.02/$0.05) - 2023/12/22 21:37:02
Table 'RushAndCash793199' 6-max Seat #1 is the button
Seat 1: f938f1e ($5.46 in chips)
Seat 2: 30a2950b ($5.37 in chips)
Seat 3: 59a39874 ($11.1 in chips)
Seat 4: bf955ffb ($5 in chips)
Seat 5: Hero ($5.02 in chips)
Seat 6: 1c1fc2a1 ($4.58 in chips)
30a2950b: posts small blind $0.02
59a39874: posts big blind $0.05
*** HOLE CARDS ***
Dealt to f938f1e 
Dealt to 30a2950b 
Dealt to 59a39874 
Dealt to bf955ffb 
Dealt to Hero [4c 9h]
Dealt to 1c1fc2a1 
bf955ffb: folds
Hero: folds
1c1fc2a1: folds
f938f1e: folds
30a2950b: raises $0.07 to $0.12
59a39874: folds
Uncalled bet ($0.07) returned to 30a2950b
*** SHOWDOWN ***
30a2950b collected $0.1 from pot
*** SUMMARY ***
Total pot $0.1 | Rake $0 | Jackpot $0 | Bingo $0 | Fortune $0 | Tax $0
Seat 1: f938f1e (button) folded before Flop (didn't bet)
Seat 2: 30a2950b (small blind) collected ($0.1)
Seat 3: 59a39874 (big blind) folded before Flop
Seat 4: bf955ffb folded before Flop (didn't bet)
Seat 5: Hero folded before Flop (didn't bet)
Seat 6: 1c1fc2a1 folded before Flop (didn't bet)


Poker Hand #RC2078515539: Hold'em No Limit ($0.02/$0.05) - 2023/12/22 21:36:05
Table 'RushAndCash792740' 6-max Seat #1 is the button
Seat 1: Hero ($5.28 in chips)
Seat 2: 8802c225 ($5.81 in chips)
Seat 3: 4df86067 ($10.08 in chips)
Seat 4: 1c1fc2a1 ($4.28 in chips)
Seat 5: 89dad04f ($8.8 in chips)
Seat 6: 5d55167a ($7.81 in chips)
8802c225: posts small blind $0.02
4df86067: posts big blind $0.05
*** HOLE CARDS ***
Dealt to Hero [Qh Ks]
Dealt to 8802c225 
Dealt to 4df86067 
Dealt to 1c1fc2a1 
Dealt to 89dad04f 
Dealt to 5d55167a 
1c1fc2a1: raises $0.06 to $0.11
89dad04f: folds
5d55167a: folds
Hero: calls $0.11
8802c225: folds
4df86067: folds
*** FLOP *** [2c 7s Ah]
1c1fc2a1: checks
Hero: checks
*** TURN *** [2c 7s Ah] [Kh]
1c1fc2a1: checks
Hero: checks
*** RIVER *** [2c 7s Ah Kh] [8c]
1c1fc2a1: bets $0.15
Hero: calls $0.15
1c1fc2a1: shows [6s As] (Pair of Aces)
Hero: shows [Qh Ks] (Pair of Kings)
*** SHOWDOWN ***
1c1fc2a1 collected $0.56 from pot
*** SUMMARY ***
Total pot $0.59 | Rake $0.03 | Jackpot $0 | Bingo $0 | Fortune $0 | Tax $0
Board [2c 7s Ah Kh 8c]
Seat 1: Hero (button) showed [Qh Ks] and lost with Pair of Kings
Seat 2: 8802c225 (small blind) folded before Flop
Seat 3: 4df86067 (big blind) folded before Flop
Seat 4: 1c1fc2a1 showed [6s As] and won ($0.56) with Pair of Aces
Seat 5: 89dad04f folded before Flop (didn't bet)
Seat 6: 5d55167a folded before Flop (didn't bet)


Poker Hand #RC2078515214: Hold'em No Limit ($0.02/$0.05) - 2023/12/22 21:35:46
Table 'RushAndCash792597' 6-max Seat #1 is the button
Seat 1: 59846dec ($5.15 in chips)
Seat 2: Hero ($5.12 in chips)
Seat 3: b4439dda ($6.66 in chips)
Seat 4: 9e4b1c03 ($5.06 in chips)
Seat 5: bc7afeb2 ($5.54 in chips)
Seat 6: d9ec3117 ($5.23 in chips)
Hero: posts small blind $0.02
b4439dda: posts big blind $0.05
*** HOLE CARDS ***
Dealt to 59846dec 
Dealt to Hero [Kh Ah]
Dealt to b4439dda 
Dealt to 9e4b1c03 
Dealt to bc7afeb2 
Dealt to d9ec3117 
9e4b1c03: raises $0.07 to $0.12
bc7afeb2: folds
d9ec3117: folds
59846dec: folds
Hero: raises $0.34 to $0.46
b4439dda: folds
9e4b1c03: folds
Uncalled bet ($0.34) returned to Hero
*** SHOWDOWN ***
Hero collected $0.28 from pot
*** SUMMARY ***
Total pot $0.29 | Rake $0.01 | Jackpot $0 | Bingo $0 | Fortune $0 | Tax $0
Seat 1: 59846dec (button) folded before Flop (didn't bet)
Seat 2: Hero (small blind) collected ($0.28)
Seat 3: b4439dda (big blind) folded before Flop
Seat 4: 9e4b1c03 folded before Flop
Seat 5: bc7afeb2 folded before Flop (didn't bet)
Seat 6: d9ec3117 folded before Flop (didn't bet)


Poker Hand #RC2078514363: Hold'em No Limit ($0.02/$0.05) - 2023/12/22 21:34:59
Table 'RushAndCash792200' 6-max Seat #1 is the button
Seat 1: b88dbe00 ($6.39 in chips)
Seat 2: 6c424f5a ($6.07 in chips)
Seat 3: bc7afeb2 ($5.43 in chips)
Seat 4: 391fe85a ($5.26 in chips)
Seat 5: Hero ($5.22 in chips)
Seat 6: 7732abf7 ($23.67 in chips)
6c424f5a: posts small blind $0.02
bc7afeb2: posts big blind $0.05
*** HOLE CARDS ***
Dealt to b88dbe00 
Dealt to 6c424f5a 
Dealt to bc7afeb2 
Dealt to 391fe85a 
Dealt to Hero [5c 5s]
Dealt to 7732abf7 
391fe85a: folds
Hero: raises $0.05 to $0.1
7732abf7: folds
b88dbe00: folds
6c424f5a: folds
bc7afeb2: calls $0.05
*** FLOP *** [Qc As 4s]
bc7afeb2: checks
Hero: checks
*** TURN *** [Qc As 4s] [3d]
bc7afeb2: bets $0.38
Hero: folds
Uncalled bet ($0.38) returned to bc7afeb2
*** SHOWDOWN ***
bc7afeb2 collected $0.21 from pot
*** SUMMARY ***
Total pot $0.22 | Rake $0.01 | Jackpot $0 | Bingo $0 | Fortune $0 | Tax $0
Board [Qc As 4s 3d]
Seat 1: b88dbe00 (button) folded before Flop (didn't bet)
Seat 2: 6c424f5a (small blind) folded before Flop
Seat 3: bc7afeb2 (big blind) won ($0.21)
Seat 4: 391fe85a folded before Flop (didn't bet)
Seat 5: Hero folded on the Turn
Seat 6: 7732abf7 folded before Flop (didn't bet)


Poker Hand #RC2078514229: Hold'em No Limit ($0.02/$0.05) - 2023/12/22 21:34:51
Table 'RushAndCash792137' 6-max Seat #1 is the button
Seat 1: 3721b8cb ($6.91 in chips)
Seat 2: f2c162d4 ($5.64 in chips)
Seat 3: Hero ($5.27 in chips)
Seat 4: 956b2f28 ($4.85 in chips)
Seat 5: 7c10f852 ($29.96 in chips)
Seat 6: 72e47b5b ($3.56 in chips)
f2c162d4: posts small blind $0.02
Hero: posts big blind $0.05
*** HOLE CARDS ***
Dealt to 3721b8cb 
Dealt to f2c162d4 
Dealt to Hero [9c 5s]
Dealt to 956b2f28 
Dealt to 7c10f852 
Dealt to 72e47b5b 
956b2f28: folds
7c10f852: raises $0.05 to $0.1
72e47b5b: folds
3721b8cb: folds
f2c162d4: folds
Hero: folds
Uncalled bet ($0.05) returned to 7c10f852
*** SHOWDOWN ***
7c10f852 collected $0.12 from pot
*** SUMMARY ***
Total pot $0.12 | Rake $0 | Jackpot $0 | Bingo $0 | Fortune $0 | Tax $0
Seat 1: 3721b8cb (button) folded before Flop (didn't bet)
Seat 2: f2c162d4 (small blind) folded before Flop
Seat 3: Hero (big blind) folded before Flop
Seat 4: 956b2f28 folded before Flop (didn't bet)
Seat 5: 7c10f852 collected ($0.12)
Seat 6: 72e47b5b folded before Flop (didn't bet)


Poker Hand #RC2078514062: Hold'em No Limit ($0.02/$0.05) - 2023/12/22 21:34:42
Table 'RushAndCash792061' 6-max Seat #1 is the button
Seat 1: c6813ed5 ($5.27 in chips)
Seat 2: d6d8d23b ($11.12 in chips)
Seat 3: 875f34a0 ($29.55 in chips)
Seat 4: Hero ($5.2 in chips)
Seat 5: 6fa2f7f1 ($1.62 in chips)
Seat 6: 8e52c782 ($12.69 in chips)
d6d8d23b: posts small blind $0.02
875f34a0: posts big blind $0.05
*** HOLE CARDS ***
Dealt to c6813ed5 
Dealt to d6d8d23b 
Dealt to 875f34a0 
Dealt to Hero [8d Ad]
Dealt to 6fa2f7f1 
Dealt to 8e52c782 
Hero: raises $0.05 to $0.1
6fa2f7f1: folds
8e52c782: folds
c6813ed5: folds
d6d8d23b: folds
875f34a0: folds
Uncalled bet ($0.05) returned to Hero
*** SHOWDOWN ***
Hero collected $0.12 from pot
*** SUMMARY ***
Total pot $0.12 | Rake $0 | Jackpot $0 | Bingo $0 | Fortune $0 | Tax $0
Seat 1: c6813ed5 (button) folded before Flop (didn't bet)
Seat 2: d6d8d23b (small blind) folded before Flop
Seat 3: 875f34a0 (big blind) folded before Flop
Seat 4: Hero collected ($0.12)
Seat 5: 6fa2f7f1 folded before Flop (didn't bet)
Seat 6: 8e52c782 folded before Flop (didn't bet)


Poker Hand #RC2078513731: Hold'em No Limit ($0.02/$0.05) - 2023/12/22 21:34:22
Table 'RushAndCash791903' 6-max Seat #1 is the button
Seat 1: 76a1de63 ($4.46 in chips)
Seat 2: 67297113 ($4.78 in chips)
Seat 3: 7961accb ($5.52 in chips)
Seat 4: 4e20b85a ($5.34 in chips)
Seat 5: 5861f243 ($5 in chips)
Seat 6: Hero ($5.13 in chips)
67297113: posts small blind $0.02
7961accb: posts big blind $0.05
*** HOLE CARDS ***
Dealt to 76a1de63 
Dealt to 67297113 
Dealt to 7961accb 
Dealt to 4e20b85a 
Dealt to 5861f243 
Dealt to Hero [Kd Ks]
4e20b85a: folds
5861f243: folds
Hero: raises $0.05 to $0.1
76a1de63: folds
67297113: folds
7961accb: folds
Uncalled bet ($0.05) returned to Hero
*** SHOWDOWN ***
Hero collected $0.12 from pot
*** SUMMARY ***
Total pot $0.12 | Rake $0 | Jackpot $0 | Bingo $0 | Fortune $0 | Tax $0
Seat 1: 76a1de63 (button) folded before Flop (didn't bet)
Seat 2: 67297113 (small blind) folded before Flop
Seat 3: 7961accb (big blind) folded before Flop
Seat 4: 4e20b85a folded before Flop (didn't bet)
Seat 5: 5861f243 folded before Flop (didn't bet)
Seat 6: Hero collected ($0.12)


Poker Hand #RC2078513616: Hold'em No Limit ($0.02/$0.05) - 2023/12/22 21:34:16
Table 'RushAndCash791847' 6-max Seat #1 is the button
Seat 1: fe1e0829 ($5.54 in chips)
Seat 2: dee599cb ($7.1 in chips)
Seat 3: d23c04d ($7.67 in chips)
Seat 4: 9fd86997 ($21.62 in chips)
Seat 5: bacb0059 ($2.27 in chips)
Seat 6: Hero ($5.13 in chips)
dee599cb: posts small blind $0.02
d23c04d: posts big blind $0.05
*** HOLE CARDS ***
Dealt to fe1e0829 
Dealt to dee599cb 
Dealt to d23c04d 
Dealt to 9fd86997 
Dealt to bacb0059 
Dealt to Hero [4h 9s]
9fd86997: folds
bacb0059: folds
Hero: folds
fe1e0829: folds
dee599cb: raises $0.1 to $0.15
d23c04d: folds
Uncalled bet ($0.1) returned to dee599cb
*** SHOWDOWN ***
dee599cb collected $0.1 from pot
*** SUMMARY ***
Total pot $0.1 | Rake $0 | Jackpot $0 | Bingo $0 | Fortune $0 | Tax $0
Seat 1: fe1e0829 (button) folded before Flop (didn't bet)
Seat 2: dee599cb (small blind) collected ($0.1)
Seat 3: d23c04d (big blind) folded before Flop
Seat 4: 9fd86997 folded before Flop (didn't bet)
Seat 5: bacb0059 folded before Flop (didn't bet)
Seat 6: Hero folded before Flop (didn't bet)


Poker Hand #RC2078513415: Hold'em No Limit ($0.02/$0.05) - 2023/12/22 21:34:04
Table 'RushAndCash791752' 6-max Seat #1 is the button
Seat 1: 8f80311 ($4.27 in chips)
Seat 2: Hero ($5.15 in chips)
Seat 3: b01c40bf ($20.8 in chips)
Seat 4: e194bfc6 ($8.63 in chips)
Seat 5: 3a26c05c ($7.19 in chips)
Seat 6: c15106a4 ($5.02 in chips)
Hero: posts small blind $0.02
b01c40bf: posts big blind $0.05
*** HOLE CARDS ***
Dealt to 8f80311 
Dealt to Hero [Js 5h]
Dealt to b01c40bf 
Dealt to e194bfc6 
Dealt to 3a26c05c 
Dealt to c15106a4 
e194bfc6: raises $0.06 to $0.11
3a26c05c: folds
c15106a4: folds
8f80311: raises $0.22 to $0.33
Hero: folds
b01c40bf: folds
e194bfc6: calls $0.22
*** FLOP *** [2h 8s Ks]
e194bfc6: checks
8f80311: bets $0.25
e194bfc6: calls $0.25
*** TURN *** [2h 8s Ks] [4s]
e194bfc6: checks
8f80311: bets $0.62
e194bfc6: calls $0.62
*** RIVER *** [2h 8s Ks 4s] [Ad]
e194bfc6: checks
8f80311: checks
e194bfc6: shows [Kc Jc] (Pair of Kings)
8f80311: shows [Qh Qs] (Pair of Queens)
*** SHOWDOWN ***
e194bfc6 collected $2.28 from pot
*** SUMMARY ***
Total pot $2.47 | Rake $0.12 | Jackpot $0.07 | Bingo $0 | Fortune $0 | Tax $0
Board [2h 8s Ks 4s Ad]
Seat 1: 8f80311 (button) showed [Qh Qs] and lost with Pair of Queens
Seat 2: Hero (small blind) folded before Flop
Seat 3: b01c40bf (big blind) folded before Flop
Seat 4: e194bfc6 showed [Kc Jc] and won ($2.28) with Pair of Kings
Seat 5: 3a26c05c folded before Flop (didn't bet)
Seat 6: c15106a4 folded before Flop (didn't bet)


Poker Hand #RC2078513211: Hold'em No Limit ($0.02/$0.05) - 2023/12/22 21:33:52
Table 'RushAndCash791652' 6-max Seat #1 is the button
Seat 1: 40c4a4f ($10.28 in chips)
Seat 2: 59a39874 ($10.19 in chips)
Seat 3: Hero ($5.2 in chips)
Seat 4: 3bfed236 ($5.18 in chips)
Seat 5: df439f39 ($6.82 in chips)
Seat 6: bb096a6e ($6.23 in chips)
59a39874: posts small blind $0.02
Hero: posts big blind $0.05
*** HOLE CARDS ***
Dealt to 40c4a4f 
Dealt to 59a39874 
Dealt to Hero [5c Ts]
Dealt to 3bfed236 
Dealt to df439f39 
Dealt to bb096a6e 
3bfed236: folds
df439f39: raises $0.06 to $0.11
bb096a6e: folds
40c4a4f: folds
59a39874: folds
Hero: folds
Uncalled bet ($0.06) returned to df439f39
*** SHOWDOWN ***
df439f39 collected $0.12 from pot
*** SUMMARY ***
Total pot $0.12 | Rake $0 | Jackpot $0 | Bingo $0 | Fortune $0 | Tax $0
Seat 1: 40c4a4f (button) folded before Flop (didn't bet)
Seat 2: 59a39874 (small blind) folded before Flop
Seat 3: Hero (big blind) folded before Flop
Seat 4: 3bfed236 folded before Flop (didn't bet)
Seat 5: df439f39 collected ($0.12)
Seat 6: bb096a6e folded before Flop (didn't bet)


Poker Hand #RC2078513138: Hold'em No Limit ($0.02/$0.05) - 2023/12/22 21:33:48
Table 'RushAndCash791616' 6-max Seat #1 is the button
Seat 1: Hero ($5.2 in chips)
Seat 2: cb45aeb2 ($5.12 in chips)
Seat 3: e1e8cbd0 ($5 in chips)
Seat 4: f0571dd4 ($5.66 in chips)
Seat 5: 806c9c64 ($2.78 in chips)
Seat 6: 37863cfe ($5.89 in chips)
cb45aeb2: posts small blind $0.02
e1e8cbd0: posts big blind $0.05
*** HOLE CARDS ***
Dealt to Hero [4c Kh]
Dealt to cb45aeb2 
Dealt to e1e8cbd0 
Dealt to f0571dd4 
Dealt to 806c9c64 
Dealt to 37863cfe 
f0571dd4: folds
806c9c64: folds
37863cfe: folds
Hero: folds
cb45aeb2: raises $0.1 to $0.15
e1e8cbd0: calls $0.1
*** FLOP *** [Js 9c 2d]
cb45aeb2: bets $0.11
e1e8cbd0: raises $0.22 to $0.33
cb45aeb2: folds
Uncalled bet ($0.22) returned to e1e8cbd0
*** SHOWDOWN ***
e1e8cbd0 collected $0.5 from pot
*** SUMMARY ***
Total pot $0.52 | Rake $0.02 | Jackpot $0 | Bingo $0 | Fortune $0 | Tax $0
Board [Js 9c 2d]
Seat 1: Hero (button) folded before Flop (didn't bet)
Seat 2: cb45aeb2 (small blind) folded on the Flop
Seat 3: e1e8cbd0 (big blind) won ($0.5)
Seat 4: f0571dd4 folded before Flop (didn't bet)
Seat 5: 806c9c64 folded before Flop (didn't bet)
Seat 6: 37863cfe folded before Flop (didn't bet)


Poker Hand #RC2078513081: Hold'em No Limit ($0.02/$0.05) - 2023/12/22 21:33:44
Table 'RushAndCash791587' 6-max Seat #1 is the button
Seat 1: b0446474 ($7.72 in chips)
Seat 2: 220b0aae ($13.79 in chips)
Seat 3: 19915c5a ($8.35 in chips)
Seat 4: Hero ($5.2 in chips)
Seat 5: f1f11b26 ($11.02 in chips)
Seat 6: f2833e42 ($5 in chips)
220b0aae: posts small blind $0.02
19915c5a: posts big blind $0.05
*** HOLE CARDS ***
Dealt to b0446474 
Dealt to 220b0aae 
Dealt to 19915c5a 
Dealt to Hero [4s 9d]
Dealt to f1f11b26 
Dealt to f2833e42 
Hero: folds
f1f11b26: folds
f2833e42: folds
b0446474: raises $0.1 to $0.15
220b0aae: folds
19915c5a: folds
Uncalled bet ($0.1) returned to b0446474
*** SHOWDOWN ***
b0446474 collected $0.12 from pot
*** SUMMARY ***
Total pot $0.12 | Rake $0 | Jackpot $0 | Bingo $0 | Fortune $0 | Tax $0
Seat 1: b0446474 (button) collected ($0.12)
Seat 2: 220b0aae (small blind) folded before Flop
Seat 3: 19915c5a (big blind) folded before Flop
Seat 4: Hero folded before Flop (didn't bet)
Seat 5: f1f11b26 folded before Flop (didn't bet)
Seat 6: f2833e42 folded before Flop (didn't bet)


Poker Hand #RC2078512936: Hold'em No Limit ($0.02/$0.05) - 2023/12/22 21:33:37
Table 'RushAndCash791515' 6-max Seat #1 is the button
Seat 1: fdc2d3ba ($13.86 in chips)
Seat 2: 8f80311 ($4.22 in chips)
Seat 3: 102e4185 ($5 in chips)
Seat 4: a2a6891 ($5.14 in chips)
Seat 5: f2833e42 ($5 in chips)
Seat 6: Hero ($5.2 in chips)
8f80311: posts small blind $0.02
102e4185: posts big blind $0.05
*** HOLE CARDS ***
Dealt to fdc2d3ba 
Dealt to 8f80311 
Dealt to 102e4185 
Dealt to a2a6891 
Dealt to f2833e42 
Dealt to Hero [Jh 3d]
a2a6891: folds
f2833e42: folds
Hero: folds
fdc2d3ba: raises $0.1 to $0.15
8f80311: folds
102e4185: raises $0.45 to $0.6
fdc2d3ba: folds
Uncalled bet ($0.45) returned to 102e4185
*** SHOWDOWN ***
102e4185 collected $0.31 from pot
*** SUMMARY ***
Total pot $0.32 | Rake $0.01 | Jackpot $0 | Bingo $0 | Fortune $0 | Tax $0
Seat 1: fdc2d3ba (button) folded before Flop
Seat 2: 8f80311 (small blind) folded before Flop
Seat 3: 102e4185 (big blind) collected ($0.31)
Seat 4: a2a6891 folded before Flop (didn't bet)
Seat 5: f2833e42 folded before Flop (didn't bet)
Seat 6: Hero folded before Flop (didn't bet)


Poker Hand #RC2078512752: Hold'em No Limit ($0.02/$0.05) - 2023/12/22 21:33:27
Table 'RushAndCash791435' 6-max Seat #1 is the button
Seat 1: 7016689e ($5.1 in chips)
Seat 2: 34668455 ($4.95 in chips)
Seat 3: f6f7aa18 ($5.84 in chips)
Seat 4: Hero ($5.2 in chips)
Seat 5: 11676b65 ($8.25 in chips)
Seat 6: 21f1ca58 ($10.3 in chips)
34668455: posts small blind $0.02
f6f7aa18: posts big blind $0.05
*** HOLE CARDS ***
Dealt to 7016689e 
Dealt to 34668455 
Dealt to f6f7aa18 
Dealt to Hero [3c 7c]
Dealt to 11676b65 
Dealt to 21f1ca58 
Hero: folds
11676b65: folds
21f1ca58: folds
7016689e: folds
34668455: folds
Uncalled bet ($0.03) returned to f6f7aa18
*** SHOWDOWN ***
f6f7aa18 collected $0.04 from pot
*** SUMMARY ***
Total pot $0.04 | Rake $0 | Jackpot $0 | Bingo $0 | Fortune $0 | Tax $0
Seat 1: 7016689e (button) folded before Flop (didn't bet)
Seat 2: 34668455 (small blind) folded before Flop
Seat 3: f6f7aa18 (big blind) collected ($0.04)
Seat 4: Hero folded before Flop (didn't bet)
Seat 5: 11676b65 folded before Flop (didn't bet)
Seat 6: 21f1ca58 folded before Flop (didn't bet)


Poker Hand #RC2078512163: Hold'em No Limit ($0.02/$0.05) - 2023/12/22 21:32:52
Table 'RushAndCash791160' 6-max Seat #1 is the button
Seat 1: 11676b65 ($8.22 in chips)
Seat 2: 2bb677ff ($4.22 in chips)
Seat 3: ed26e80a ($10.69 in chips)
Seat 4: Hero ($5.16 in chips)
Seat 5: 7016689e ($5.17 in chips)
Seat 6: 72f7386e ($12.34 in chips)
2bb677ff: posts small blind $0.02
ed26e80a: posts big blind $0.05
*** HOLE CARDS ***
Dealt to 11676b65 
Dealt to 2bb677ff 
Dealt to ed26e80a 
Dealt to Hero [Ad 2d]
Dealt to 7016689e 
Dealt to 72f7386e 
Hero: raises $0.05 to $0.1
7016689e: folds
72f7386e: folds
11676b65: calls $0.1
2bb677ff: folds
ed26e80a: folds
*** FLOP *** [7s Td 3h]
Hero: checks
11676b65: checks
*** TURN *** [7s Td 3h] [2s]
Hero: checks
11676b65: checks
*** RIVER *** [7s Td 3h 2s] [5h]
Hero: checks
11676b65: checks
Hero: shows [Ad 2d] (Pair of Twos)
11676b65: shows [Ac 2c] (Pair of Twos)
*** SHOWDOWN ***
Hero collected $0.14 from pot
11676b65 collected $0.13 from pot
*** SUMMARY ***
Total pot $0.27 | Rake $0 | Jackpot $0 | Bingo $0 | Fortune $0 | Tax $0
Board [7s Td 3h 2s 5h]
Seat 1: 11676b65 (button) showed [Ac 2c] and won ($0.13) with Pair of Twos
Seat 2: 2bb677ff (small blind) folded before Flop
Seat 3: ed26e80a (big blind) folded before Flop
Seat 4: Hero showed [Ad 2d] and won ($0.14) with Pair of Twos
Seat 5: 7016689e folded before Flop (didn't bet)
Seat 6: 72f7386e folded before Flop (didn't bet)


Poker Hand #RC2078512079: Hold'em No Limit ($0.02/$0.05) - 2023/12/22 21:32:48
Table 'RushAndCash791119' 6-max Seat #1 is the button
Seat 1: aba41704 ($1.71 in chips)
Seat 2: Hero ($5.18 in chips)
Seat 3: 921e997e ($7.93 in chips)
Seat 4: ea1839a2 ($2.1 in chips)
Seat 5: 71871718 ($2.46 in chips)
Seat 6: f3d3c9ba ($10.57 in chips)
Hero: posts small blind $0.02
921e997e: posts big blind $0.05
*** HOLE CARDS ***
Dealt to aba41704 
Dealt to Hero [Jd 7h]
Dealt to 921e997e 
Dealt to ea1839a2 
Dealt to 71871718 
Dealt to f3d3c9ba 
ea1839a2: folds
71871718: folds
f3d3c9ba: folds
aba41704: folds
Hero: folds
Uncalled bet ($0.03) returned to 921e997e
*** SHOWDOWN ***
921e997e collected $0.04 from pot
*** SUMMARY ***
Total pot $0.04 | Rake $0 | Jackpot $0 | Bingo $0 | Fortune $0 | Tax $0
Seat 1: aba41704 (button) folded before Flop (didn't bet)
Seat 2: Hero (small blind) folded before Flop
Seat 3: 921e997e (big blind) collected ($0.04)
Seat 4: ea1839a2 folded before Flop (didn't bet)
Seat 5: 71871718 folded before Flop (didn't bet)
Seat 6: f3d3c9ba folded before Flop (didn't bet)


Poker Hand #RC2078511338: Hold'em No Limit ($0.02/$0.05) - 2023/12/22 21:32:06
Table 'RushAndCash790766' 6-max Seat #1 is the button
Seat 1: e194bfc6 ($10.57 in chips)
Seat 2: 71871718 ($2.66 in chips)
Seat 3: Hero ($5 in chips)
Seat 4: d3456569 ($7.17 in chips)
Seat 5: 7c10f852 ($23.74 in chips)
Seat 6: 37863cfe ($5.84 in chips)
71871718: posts small blind $0.02
Hero: posts big blind $0.05
*** HOLE CARDS ***
Dealt to e194bfc6 
Dealt to 71871718 
Dealt to Hero [5h 6h]
Dealt to d3456569 
Dealt to 7c10f852 
Dealt to 37863cfe 
d3456569: folds
7c10f852: folds
37863cfe: folds
e194bfc6: folds
71871718: raises $0.07 to $0.12
Hero: calls $0.07
*** FLOP *** [Ad 7d Jh]
71871718: bets $0.08
Hero: calls $0.08
*** TURN *** [Ad 7d Jh] [Qh]
71871718: checks
Hero: checks
*** RIVER *** [Ad 7d Jh Qh] [Ks]
71871718: checks
Hero: bets $0.2
71871718: folds
Uncalled bet ($0.2) returned to Hero
*** SHOWDOWN ***
Hero collected $0.38 from pot
*** SUMMARY ***
Total pot $0.4 | Rake $0.02 | Jackpot $0 | Bingo $0 | Fortune $0 | Tax $0
Board [Ad 7d Jh Qh Ks]
Seat 1: e194bfc6 (button) folded before Flop (didn't bet)
Seat 2: 71871718 (small blind) folded on the River
Seat 3: Hero (big blind) won ($0.38)
Seat 4: d3456569 folded before Flop (didn't bet)
Seat 5: 7c10f852 folded before Flop (didn't bet)
Seat 6: 37863cfe folded before Flop (didn't bet)


Poker Hand #RC2078511260: Hold'em No Limit ($0.02/$0.05) - 2023/12/22 21:32:01
Table 'RushAndCash790729' 6-max Seat #1 is the button
Seat 1: Hero ($5 in chips)
Seat 2: 5f11c3da ($15.28 in chips)
Seat 3: 4b57c53e ($10.32 in chips)
Seat 4: e19dee32 ($5.23 in chips)
Seat 5: 673162b7 ($14.2 in chips)
Seat 6: c3c9a58d ($11.1 in chips)
5f11c3da: posts small blind $0.02
4b57c53e: posts big blind $0.05
*** HOLE CARDS ***
Dealt to Hero [Kd 5c]
Dealt to 5f11c3da 
Dealt to 4b57c53e 
Dealt to e19dee32 
Dealt to 673162b7 
Dealt to c3c9a58d 
e19dee32: raises $0.05 to $0.1
673162b7: folds
c3c9a58d: raises $0.27 to $0.37
Hero: folds
5f11c3da: folds
4b57c53e: folds
e19dee32: calls $0.27
*** FLOP *** [Qh Tc 9h]
e19dee32: checks
c3c9a58d: bets $0.61
e19dee32: raises $0.67 to $1.28
c3c9a58d: calls $0.67
*** TURN *** [Qh Tc 9h] [7s]
e19dee32: bets $1.69
c3c9a58d: calls $1.69
*** RIVER *** [Qh Tc 9h 7s] [8c]
e19dee32: checks
c3c9a58d: bets $2.23
e19dee32: calls $1.89 and is all-in
Uncalled bet ($0.34) returned to c3c9a58d
c3c9a58d: shows [As Ks] (Ace-High)
e19dee32: shows [Td Th] (Three Tens)
*** SHOWDOWN ***
e19dee32 collected $10.31 from pot
*** SUMMARY ***
Total pot $10.53 | Rake $0.15 | Jackpot $0.07 | Bingo $0 | Fortune $0 | Tax $0
Board [Qh Tc 9h 7s 8c]
Seat 1: Hero (button) folded before Flop (didn't bet)
Seat 2: 5f11c3da (small blind) folded before Flop
Seat 3: 4b57c53e (big blind) folded before Flop
Seat 4: e19dee32 showed [Td Th] and won ($10.31) with Three Tens
Seat 5: 673162b7 folded before Flop (didn't bet)
Seat 6: c3c9a58d showed [As Ks] and lost with Ace-High


Poker Hand #RC2078510773: Hold'em No Limit ($0.02/$0.05) - 2023/12/22 21:31:34
Table 'RushAndCash790495' 6-max Seat #1 is the button
Seat 1: f9adeea ($5.06 in chips)
Seat 2: c7bcf41c ($5 in chips)
Seat 3: 44681c1f ($5.07 in chips)
Seat 4: Hero ($5.05 in chips)
Seat 5: f2c162d4 ($5.62 in chips)
Seat 6: 88e57a08 ($7.52 in chips)
c7bcf41c: posts small blind $0.02
44681c1f: posts big blind $0.05
*** HOLE CARDS ***
Dealt to f9adeea 
Dealt to c7bcf41c 
Dealt to 44681c1f 
Dealt to Hero [Ac Td]
Dealt to f2c162d4 
Dealt to 88e57a08 
Hero: raises $0.05 to $0.1
f2c162d4: folds
88e57a08: folds
f9adeea: folds
c7bcf41c: folds
44681c1f: raises $0.22 to $0.32
Hero: calls $0.22
*** FLOP *** [8d 4s Jc]
44681c1f: bets $0.33
Hero: folds
Uncalled bet ($0.33) returned to 44681c1f
*** SHOWDOWN ***
44681c1f collected $0.63 from pot
*** SUMMARY ***
Total pot $0.66 | Rake $0.03 | Jackpot $0 | Bingo $0 | Fortune $0 | Tax $0
Board [8d 4s Jc]
Seat 1: f9adeea (button) folded before Flop (didn't bet)
Seat 2: c7bcf41c (small blind) folded before Flop
Seat 3: 44681c1f (big blind) won ($0.63)
Seat 4: Hero folded on the Flop
Seat 5: f2c162d4 folded before Flop (didn't bet)
Seat 6: 88e57a08 folded before Flop (didn't bet)


Poker Hand #RC2078510420: Hold'em No Limit ($0.02/$0.05) - 2023/12/22 21:31:13
Table 'RushAndCash790326' 6-max Seat #1 is the button
Seat 1: Hero ($5.05 in chips)
Seat 2: 55f8abbc ($10.65 in chips)
Seat 3: 956b2f28 ($5.42 in chips)
Seat 4: bfa2268f ($2.64 in chips)
Seat 5: 8014c02 ($16.03 in chips)
Seat 6: 5da5ce8d ($19.88 in chips)
55f8abbc: posts small blind $0.02
956b2f28: posts big blind $0.05
*** HOLE CARDS ***
Dealt to Hero [9d Qd]
Dealt to 55f8abbc 
Dealt to 956b2f28 
Dealt to bfa2268f 
Dealt to 8014c02 
Dealt to 5da5ce8d 
bfa2268f: raises $0.08 to $0.13
8014c02: folds
5da5ce8d: folds
Hero: folds
55f8abbc: folds
956b2f28: raises $0.28 to $0.41
bfa2268f: raises $0.59 to $1
956b2f28: folds
Uncalled bet ($0.59) returned to bfa2268f
*** SHOWDOWN ***
bfa2268f collected $0.8 from pot
*** SUMMARY ***
Total pot $0.84 | Rake $0.04 | Jackpot $0 | Bingo $0 | Fortune $0 | Tax $0
Seat 1: Hero (button) folded before Flop (didn't bet)
Seat 2: 55f8abbc (small blind) folded before Flop
Seat 3: 956b2f28 (big blind) folded before Flop
Seat 4: bfa2268f collected ($0.8)
Seat 5: 8014c02 folded before Flop (didn't bet)
Seat 6: 5da5ce8d folded before Flop (didn't bet)


Poker Hand #RC2078510247: Hold'em No Limit ($0.02/$0.05) - 2023/12/22 21:31:03
Table 'RushAndCash790248' 6-max Seat #1 is the button
Seat 1: 2075befd ($5 in chips)
Seat 2: Hero ($5.07 in chips)
Seat 3: 41270a9a ($5 in chips)
Seat 4: 9d480ff ($5.2 in chips)
Seat 5: 1c28bbd5 ($4.77 in chips)
Seat 6: c4c1c89a ($5.14 in chips)
Hero: posts small blind $0.02
41270a9a: posts big blind $0.05
*** HOLE CARDS ***
Dealt to 2075befd 
Dealt to Hero [5c Jh]
Dealt to 41270a9a 
Dealt to 9d480ff 
Dealt to 1c28bbd5 
Dealt to c4c1c89a 
9d480ff: folds
1c28bbd5: raises $0.07 to $0.12
c4c1c89a: folds
2075befd: folds
Hero: folds
41270a9a: folds
Uncalled bet ($0.07) returned to 1c28bbd5
*** SHOWDOWN ***
1c28bbd5 collected $0.12 from pot
*** SUMMARY ***
Total pot $0.12 | Rake $0 | Jackpot $0 | Bingo $0 | Fortune $0 | Tax $0
Seat 1: 2075befd (button) folded before Flop (didn't bet)
Seat 2: Hero (small blind) folded before Flop
Seat 3: 41270a9a (big blind) folded before Flop
Seat 4: 9d480ff folded before Flop (didn't bet)
Seat 5: 1c28bbd5 collected ($0.12)
Seat 6: c4c1c89a folded before Flop (didn't bet)


Poker Hand #RC2078510017: Hold'em No Limit ($0.02/$0.05) - 2023/12/22 21:30:50
Table 'RushAndCash790132' 6-max Seat #1 is the button
Seat 1: 824c2e76 ($5.24 in chips)
Seat 2: 6ca5f777 ($5 in chips)
Seat 3: b2b4173f ($2.83 in chips)
Seat 4: 2489a5a9 ($5.31 in chips)
Seat 5: 61dc9b78 ($4.53 in chips)
Seat 6: Hero ($5 in chips)
6ca5f777: posts small blind $0.02
b2b4173f: posts big blind $0.05
*** HOLE CARDS ***
Dealt to 824c2e76 
Dealt to 6ca5f777 
Dealt to b2b4173f 
Dealt to 2489a5a9 
Dealt to 61dc9b78 
Dealt to Hero [Ac Td]
2489a5a9: folds
61dc9b78: folds
Hero: raises $0.05 to $0.1
824c2e76: folds
6ca5f777: folds
b2b4173f: folds
Uncalled bet ($0.05) returned to Hero
*** SHOWDOWN ***
Hero collected $0.12 from pot
*** SUMMARY ***
Total pot $0.12 | Rake $0 | Jackpot $0 | Bingo $0 | Fortune $0 | Tax $0
Seat 1: 824c2e76 (button) folded before Flop (didn't bet)
Seat 2: 6ca5f777 (small blind) folded before Flop
Seat 3: b2b4173f (big blind) folded before Flop
Seat 4: 2489a5a9 folded before Flop (didn't bet)
Seat 5: 61dc9b78 folded before Flop (didn't bet)
Seat 6: Hero collected ($0.12)


Poker Hand #RC2078509434: Hold'em No Limit ($0.02/$0.05) - 2023/12/22 21:30:17
Table 'RushAndCash789836' 6-max Seat #1 is the button
Seat 1: 6e872e9c ($17.17 in chips)
Seat 2: ee954510 ($5 in chips)
Seat 3: Hero ($5.11 in chips)
Seat 4: 7ab29bd ($6.07 in chips)
Seat 5: 82e9c1ba ($18.96 in chips)
Seat 6: 2ed46053 ($10.15 in chips)
ee954510: posts small blind $0.02
Hero: posts big blind $0.05
*** HOLE CARDS ***
Dealt to 6e872e9c 
Dealt to ee954510 
Dealt to Hero [Kc 5c]
Dealt to 7ab29bd 
Dealt to 82e9c1ba 
Dealt to 2ed46053 
7ab29bd: folds
82e9c1ba: raises $0.08 to $0.13
2ed46053: folds
6e872e9c: folds
ee954510: folds
Hero: calls $0.08
*** FLOP *** [Qh 9h Jh]
Hero: checks
82e9c1ba: bets $0.07
Hero: folds
Uncalled bet ($0.07) returned to 82e9c1ba
*** SHOWDOWN ***
82e9c1ba collected $0.27 from pot
*** SUMMARY ***
Total pot $0.28 | Rake $0.01 | Jackpot $0 | Bingo $0 | Fortune $0 | Tax $0
Board [Qh 9h Jh]
Seat 1: 6e872e9c (button) folded before Flop (didn't bet)
Seat 2: ee954510 (small blind) folded before Flop
Seat 3: Hero (big blind) folded on the Flop
Seat 4: 7ab29bd folded before Flop (didn't bet)
Seat 5: 82e9c1ba won ($0.27)
Seat 6: 2ed46053 folded before Flop (didn't bet)


Poker Hand #RC2078508547: Hold'em No Limit ($0.02/$0.05) - 2023/12/22 21:29:26
Table 'RushAndCash789404' 6-max Seat #1 is the button
Seat 1: 5da5ce8d ($19.89 in chips)
Seat 2: c8389234 ($10.2 in chips)
Seat 3: 2ed46053 ($10.25 in chips)
Seat 4: e49e39a2 ($14.5 in chips)
Seat 5: Hero ($5 in chips)
Seat 6: 373bc096 ($5.05 in chips)
c8389234: posts small blind $0.02
2ed46053: posts big blind $0.05
*** HOLE CARDS ***
Dealt to 5da5ce8d 
Dealt to c8389234 
Dealt to 2ed46053 
Dealt to e49e39a2 
Dealt to Hero [9h Ah]
Dealt to 373bc096 
e49e39a2: folds
Hero: raises $0.05 to $0.1
373bc096: folds
5da5ce8d: folds
c8389234: folds
2ed46053: calls $0.05
*** FLOP *** [Ks 5c 8s]
2ed46053: checks
Hero: checks
*** TURN *** [Ks 5c 8s] [As]
2ed46053: checks
Hero: bets $0.11
2ed46053: folds
Uncalled bet ($0.11) returned to Hero
*** SHOWDOWN ***
Hero collected $0.21 from pot
*** SUMMARY ***
Total pot $0.22 | Rake $0.01 | Jackpot $0 | Bingo $0 | Fortune $0 | Tax $0
Board [Ks 5c 8s As]
Seat 1: 5da5ce8d (button) folded before Flop (didn't bet)
Seat 2: c8389234 (small blind) folded before Flop
Seat 3: 2ed46053 (big blind) folded on the Turn
Seat 4: e49e39a2 folded before Flop (didn't bet)
Seat 5: Hero won ($0.21)
Seat 6: 373bc096 folded before Flop (didn't bet)


Poker Hand #RC2078508478: Hold'em No Limit ($0.02/$0.05) - 2023/12/22 21:29:22
Table 'RushAndCash789371' 6-max Seat #1 is the button
Seat 1: bf955ffb ($5.36 in chips)
Seat 2: a75d4daa ($5.45 in chips)
Seat 3: a4acbc26 ($4.9 in chips)
Seat 4: Hero ($5 in chips)
Seat 5: 189da7f1 ($10.32 in chips)
Seat 6: 102e4185 ($6.1 in chips)
a75d4daa: posts small blind $0.02
a4acbc26: posts big blind $0.05
*** HOLE CARDS ***
Dealt to bf955ffb 
Dealt to a75d4daa 
Dealt to a4acbc26 
Dealt to Hero [3h 4c]
Dealt to 189da7f1 
Dealt to 102e4185 
Hero: folds
189da7f1: folds
102e4185: folds
bf955ffb: folds
a75d4daa: raises $0.1 to $0.15
a4acbc26: folds
Uncalled bet ($0.1) returned to a75d4daa
*** SHOWDOWN ***
a75d4daa collected $0.1 from pot
*** SUMMARY ***
Total pot $0.1 | Rake $0 | Jackpot $0 | Bingo $0 | Fortune $0 | Tax $0
Seat 1: bf955ffb (button) folded before Flop (didn't bet)
Seat 2: a75d4daa (small blind) collected ($0.1)
Seat 3: a4acbc26 (big blind) folded before Flop
Seat 4: Hero folded before Flop (didn't bet)
Seat 5: 189da7f1 folded before Flop (didn't bet)
Seat 6: 102e4185 folded before Flop (didn't bet)


Poker Hand #RC2078508407: Hold'em No Limit ($0.02/$0.05) - 2023/12/22 21:29:18
Table 'RushAndCash789337' 6-max Seat #1 is the button
Seat 1: fdc2d3ba ($14.98 in chips)
Seat 2: 3580bebf ($13.12 in chips)
Seat 3: 3a9b3c34 ($3.1 in chips)
Seat 4: e65ad772 ($13.68 in chips)
Seat 5: af92dfc8 ($5.98 in chips)
Seat 6: Hero ($5 in chips)
3580bebf: posts small blind $0.02
3a9b3c34: posts big blind $0.05
*** HOLE CARDS ***
Dealt to fdc2d3ba 
Dealt to 3580bebf 
Dealt to 3a9b3c34 
Dealt to e65ad772 
Dealt to af92dfc8 
Dealt to Hero [8h 2c]
e65ad772: folds
af92dfc8: folds
Hero: folds
fdc2d3ba: folds
3580bebf: raises $0.1 to $0.15
3a9b3c34: calls $0.1
*** FLOP *** [4h 6h 2s]
3580bebf: checks
3a9b3c34: bets $0.15
3580bebf: folds
Uncalled bet ($0.15) returned to 3a9b3c34
*** SHOWDOWN ***
3a9b3c34 collected $0.29 from pot
*** SUMMARY ***
Total pot $0.3 | Rake $0.01 | Jackpot $0 | Bingo $0 | Fortune $0 | Tax $0
Board [4h 6h 2s]
Seat 1: fdc2d3ba (button) folded before Flop (didn't bet)
Seat 2: 3580bebf (small blind) folded on the Flop
Seat 3: 3a9b3c34 (big blind) won ($0.29)
Seat 4: e65ad772 folded before Flop (didn't bet)
Seat 5: af92dfc8 folded before Flop (didn't bet)
Seat 6: Hero folded before Flop (didn't bet)


Poker Hand #RC2078508298: Hold'em No Limit ($0.02/$0.05) - 2023/12/22 21:29:12
Table 'RushAndCash789283' 6-max Seat #1 is the button
Seat 1: Hero ($5 in chips)
Seat 2: 80af7fe3 ($4.89 in chips)
Seat 3: 8e52c782 ($12.87 in chips)
Seat 4: 9b2d2337 ($20.26 in chips)
Seat 5: 8aaa95a5 ($3.72 in chips)
Seat 6: 47ecc871 ($4.45 in chips)
80af7fe3: posts small blind $0.02
8e52c782: posts big blind $0.05
*** HOLE CARDS ***
Dealt to Hero [As 5d]
Dealt to 80af7fe3 
Dealt to 8e52c782 
Dealt to 9b2d2337 
Dealt to 8aaa95a5 
Dealt to 47ecc871 
9b2d2337: folds
8aaa95a5: folds
47ecc871: raises $0.05 to $0.1
Hero: folds
80af7fe3: folds
8e52c782: folds
Uncalled bet ($0.05) returned to 47ecc871
*** SHOWDOWN ***
47ecc871 collected $0.12 from pot
*** SUMMARY ***
Total pot $0.12 | Rake $0 | Jackpot $0 | Bingo $0 | Fortune $0 | Tax $0
Seat 1: Hero (button) folded before Flop (didn't bet)
Seat 2: 80af7fe3 (small blind) folded before Flop
Seat 3: 8e52c782 (big blind) folded before Flop
Seat 4: 9b2d2337 folded before Flop (didn't bet)
Seat 5: 8aaa95a5 folded before Flop (didn't bet)
Seat 6: 47ecc871 collected ($0.12)


Poker Hand #RC2078508142: Hold'em No Limit ($0.02/$0.05) - 2023/12/22 21:29:03
Table 'RushAndCash789212' 6-max Seat #1 is the button
Seat 1: 3402e890 ($6.13 in chips)
Seat 2: Hero ($5 in chips)
Seat 3: 2b9f6a0 ($5 in chips)
Seat 4: a4441de9 ($5.88 in chips)
Seat 5: d3456569 ($7.41 in chips)
Seat 6: 3e455537 ($5.15 in chips)
Hero: posts small blind $0.02
2b9f6a0: posts big blind $0.05
*** HOLE CARDS ***
Dealt to 3402e890 
Dealt to Hero [7s 9d]
Dealt to 2b9f6a0 
Dealt to a4441de9 
Dealt to d3456569 
Dealt to 3e455537 
a4441de9: folds
d3456569: folds
3e455537: raises $0.08 to $0.13
3402e890: folds
Hero: folds
2b9f6a0: folds
Uncalled bet ($0.08) returned to 3e455537
*** SHOWDOWN ***
3e455537 collected $0.12 from pot
*** SUMMARY ***
Total pot $0.12 | Rake $0 | Jackpot $0 | Bingo $0 | Fortune $0 | Tax $0
Seat 1: 3402e890 (button) folded before Flop (didn't bet)
Seat 2: Hero (small blind) folded before Flop
Seat 3: 2b9f6a0 (big blind) folded before Flop
Seat 4: a4441de9 folded before Flop (didn't bet)
Seat 5: d3456569 folded before Flop (didn't bet)
Seat 6: 3e455537 collected ($0.12)


Poker Hand #RC2078507781: Hold'em No Limit ($0.02/$0.05) - 2023/12/22 21:28:41
Table 'RushAndCash789047' 6-max Seat #1 is the button
Seat 1: 3a20c3a ($10.93 in chips)
Seat 2: 8a6d1b ($5.35 in chips)
Seat 3: Hero ($5 in chips)
Seat 4: 59a39874 ($10.12 in chips)
Seat 5: 44795538 ($4.39 in chips)
Seat 6: beea6e5f ($5.04 in chips)
8a6d1b: posts small blind $0.02
Hero: posts big blind $0.05
*** HOLE CARDS ***
Dealt to 3a20c3a 
Dealt to 8a6d1b 
Dealt to Hero [3h 3c]
Dealt to 59a39874 
Dealt to 44795538 
Dealt to beea6e5f 
59a39874: folds
44795538: folds
beea6e5f: raises $0.08 to $0.13
3a20c3a: folds
8a6d1b: raises $0.28 to $0.41
Hero: folds
beea6e5f: calls $0.28
*** FLOP *** [3d Ac Ah]
8a6d1b: bets $0.29
beea6e5f: folds
Uncalled bet ($0.29) returned to 8a6d1b
*** SHOWDOWN ***
8a6d1b collected $0.83 from pot
*** SUMMARY ***
Total pot $0.87 | Rake $0.04 | Jackpot $0 | Bingo $0 | Fortune $0 | Tax $0
Board [3d Ac Ah]
Seat 1: 3a20c3a (button) folded before Flop (didn't bet)
Seat 2: 8a6d1b (small blind) won ($0.83)
Seat 3: Hero (big blind) folded before Flop
Seat 4: 59a39874 folded before Flop (didn't bet)
Seat 5: 44795538 folded before Flop (didn't bet)
Seat 6: beea6e5f folded on the Flop


Poker Hand #RC2078507721: Hold'em No Limit ($0.02/$0.05) - 2023/12/22 21:28:38
Table 'RushAndCash789019' 6-max Seat #1 is the button
Seat 1: 2df55086 ($8.46 in chips)
Seat 2: e8df5901 ($8.35 in chips)
Seat 3: ac89ef05 ($5.14 in chips)
Seat 4: 8927103f ($4.78 in chips)
Seat 5: aa667d33 ($5.01 in chips)
Seat 6: Hero ($5 in chips)
e8df5901: posts small blind $0.02
ac89ef05: posts big blind $0.05
*** HOLE CARDS ***
Dealt to 2df55086 
Dealt to e8df5901 
Dealt to ac89ef05 
Dealt to 8927103f 
Dealt to aa667d33 
Dealt to Hero [3c Ad]
8927103f: raises $0.08 to $0.13
aa667d33: folds
Hero: folds
2df55086: folds
e8df5901: folds
ac89ef05: folds
Uncalled bet ($0.08) returned to 8927103f
*** SHOWDOWN ***
8927103f collected $0.12 from pot
*** SUMMARY ***
Total pot $0.12 | Rake $0 | Jackpot $0 | Bingo $0 | Fortune $0 | Tax $0
Seat 1: 2df55086 (button) folded before Flop (didn't bet)
Seat 2: e8df5901 (small blind) folded before Flop
Seat 3: ac89ef05 (big blind) folded before Flop
Seat 4: 8927103f collected ($0.12)
Seat 5: aa667d33 folded before Flop (didn't bet)
Seat 6: Hero folded before Flop (didn't bet)


Poker Hand #RC2078507648: Hold'em No Limit ($0.02/$0.05) - 2023/12/22 21:28:33
Table 'RushAndCash788984' 6-max Seat #1 is the button
Seat 1: b599e449 ($8.81 in chips)
Seat 2: cbfe1acc ($5 in chips)
Seat 3: d05a7d3c ($5 in chips)
Seat 4: 4c81be2e ($8.61 in chips)
Seat 5: Hero ($5 in chips)
Seat 6: ac89ef05 ($5.14 in chips)
cbfe1acc: posts small blind $0.02
d05a7d3c: posts big blind $0.05
*** HOLE CARDS ***
Dealt to b599e449 
Dealt to cbfe1acc 
Dealt to d05a7d3c 
Dealt to 4c81be2e 
Dealt to Hero [Jd 7s]
Dealt to ac89ef05 
4c81be2e: folds
Hero: folds
ac89ef05: folds
b599e449: folds
cbfe1acc: folds
Uncalled bet ($0.03) returned to d05a7d3c
*** SHOWDOWN ***
d05a7d3c collected $0.04 from pot
*** SUMMARY ***
Total pot $0.04 | Rake $0 | Jackpot $0 | Bingo $0 | Fortune $0 | Tax $0
Seat 1: b599e449 (button) folded before Flop (didn't bet)
Seat 2: cbfe1acc (small blind) folded before Flop
Seat 3: d05a7d3c (big blind) collected ($0.04)
Seat 4: 4c81be2e folded before Flop (didn't bet)
Seat 5: Hero folded before Flop (didn't bet)
Seat 6: ac89ef05 folded before Flop (didn't bet)


Poker Hand #RC2078507576: Hold'em No Limit ($0.02/$0.05) - 2023/12/22 21:28:29
Table 'RushAndCash788949' 6-max Seat #1 is the button
Seat 1: 89a27c2 ($5.04 in chips)
Seat 2: c3adc948 ($5.34 in chips)
Seat 3: 18a5c767 ($4.65 in chips)
Seat 4: ea71423 ($5.28 in chips)
Seat 5: 4c81be2e ($8.61 in chips)
Seat 6: Hero ($5 in chips)
c3adc948: posts small blind $0.02
18a5c767: posts big blind $0.05
*** HOLE CARDS ***
Dealt to 89a27c2 
Dealt to c3adc948 
Dealt to 18a5c767 
Dealt to ea71423 
Dealt to 4c81be2e 
Dealt to Hero [Th 6s]
ea71423: raises $0.05 to $0.1
4c81be2e: folds
Hero: folds
89a27c2: folds
c3adc948: folds
18a5c767: calls $0.05
*** FLOP *** [Js 9d 4s]
18a5c767: checks
ea71423: bets $0.17
18a5c767: calls $0.17
*** TURN *** [Js 9d 4s] [3h]
18a5c767: checks
ea71423: bets $0.42
18a5c767: calls $0.42
*** RIVER *** [Js 9d 4s 3h] [Ks]
18a5c767: checks
ea71423: checks
18a5c767: shows [Jc 6c] (Pair of Jacks)
ea71423: shows [Td 8d] (King-High)
*** SHOWDOWN ***
18a5c767 collected $1.33 from pot
*** SUMMARY ***
Total pot $1.4 | Rake $0.07 | Jackpot $0 | Bingo $0 | Fortune $0 | Tax $0
Board [Js 9d 4s 3h Ks]
Seat 1: 89a27c2 (button) folded before Flop (didn't bet)
Seat 2: c3adc948 (small blind) folded before Flop
Seat 3: 18a5c767 (big blind) showed [Jc 6c] and won ($1.33) with Pair of Jacks
Seat 4: ea71423 showed [Td 8d] and lost with King-High
Seat 5: 4c81be2e folded before Flop (didn't bet)
Seat 6: Hero folded before Flop (didn't bet)


Poker Hand #RC2078507515: Hold'em No Limit ($0.02/$0.05) - 2023/12/22 21:28:25
Table 'RushAndCash788921' 6-max Seat #1 is the button
Seat 1: ceb10c49 ($4.95 in chips)
Seat 2: 59a39874 ($10.14 in chips)
Seat 3: 509e9488 ($7.06 in chips)
Seat 4: c4382072 ($6.57 in chips)
Seat 5: c7adbd3b ($5 in chips)
Seat 6: Hero ($5 in chips)
59a39874: posts small blind $0.02
509e9488: posts big blind $0.05
*** HOLE CARDS ***
Dealt to ceb10c49 
Dealt to 59a39874 
Dealt to 509e9488 
Dealt to c4382072 
Dealt to c7adbd3b 
Dealt to Hero [3s Td]
c4382072: raises $0.06 to $0.11
c7adbd3b: folds
Hero: folds
ceb10c49: calls $0.11
59a39874: folds
509e9488: calls $0.06
*** FLOP *** [6h 3c 2d]
509e9488: checks
c4382072: checks
ceb10c49: bets $0.12
509e9488: raises $0.3 to $0.42
c4382072: folds
ceb10c49: calls $0.3
*** TURN *** [6h 3c 2d] [4c]
509e9488: checks
ceb10c49: bets $0.8
509e9488: raises $1.4 to $2.2
ceb10c49: calls $1.4
*** RIVER *** [6h 3c 2d 4c] [2c]
509e9488: bets $4.33 and is all-in
ceb10c49: calls $2.22 and is all-in
Uncalled bet ($2.11) returned to 509e9488
509e9488: shows [2h 6d] (Twos Full over Sixes)
ceb10c49: shows [8d 5d] (Sixes-High Straight)
*** SHOWDOWN ***
509e9488 collected $9.81 from pot
*** SUMMARY ***
Total pot $10.03 | Rake $0.15 | Jackpot $0.07 | Bingo $0 | Fortune $0 | Tax $0
Board [6h 3c 2d 4c 2c]
Seat 1: ceb10c49 (button) showed [8d 5d] and lost with Sixes-High Straight
Seat 2: 59a39874 (small blind) folded before Flop
Seat 3: 509e9488 (big blind) showed [2h 6d] and won ($9.81) with Twos Full over Sixes
Seat 4: c4382072 folded on the Flop
Seat 5: c7adbd3b folded before Flop (didn't bet)
Seat 6: Hero folded before Flop (didn't bet)


Poker Hand #RC2078507423: Hold'em No Limit ($0.02/$0.05) - 2023/12/22 21:28:20
Table 'RushAndCash788878' 6-max Seat #1 is the button
Seat 1: Hero ($5 in chips)
Seat 2: 3160ff3c ($13.03 in chips)
Seat 3: d23c04d ($6.66 in chips)
Seat 4: 960a23e5 ($7.36 in chips)
Seat 5: 7728b936 ($5.25 in chips)
Seat 6: 869465ff ($17.58 in chips)
3160ff3c: posts small blind $0.02
d23c04d: posts big blind $0.05
*** HOLE CARDS ***
Dealt to Hero [2h 4c]
Dealt to 3160ff3c 
Dealt to d23c04d 
Dealt to 960a23e5 
Dealt to 7728b936 
Dealt to 869465ff 
960a23e5: folds
7728b936: folds
869465ff: folds
Hero: folds
3160ff3c: folds
Uncalled bet ($0.03) returned to d23c04d
*** SHOWDOWN ***
d23c04d collected $0.04 from pot
*** SUMMARY ***
Total pot $0.04 | Rake $0 | Jackpot $0 | Bingo $0 | Fortune $0 | Tax $0
Seat 1: Hero (button) folded before Flop (didn't bet)
Seat 2: 3160ff3c (small blind) folded before Flop
Seat 3: d23c04d (big blind) collected ($0.04)
Seat 4: 960a23e5 folded before Flop (didn't bet)
Seat 5: 7728b936 folded before Flop (didn't bet)
Seat 6: 869465ff folded before Flop (didn't bet)


Poker Hand #RC2078506844: Hold'em No Limit ($0.02/$0.05) - 2023/12/22 21:27:46
Table 'RushAndCash788622' 6-max Seat #1 is the button
Seat 1: a90771fe ($7.51 in chips)
Seat 2: 960a23e5 ($7.38 in chips)
Seat 3: Hero ($5.16 in chips)
Seat 4: 3c028e9 ($7.02 in chips)
Seat 5: 3a35e9f5 ($19.7 in chips)
Seat 6: 2bb677ff ($4.86 in chips)
960a23e5: posts small blind $0.02
Hero: posts big blind $0.05
*** HOLE CARDS ***
Dealt to a90771fe 
Dealt to 960a23e5 
Dealt to Hero [8h 8s]
Dealt to 3c028e9 
Dealt to 3a35e9f5 
Dealt to 2bb677ff 
3c028e9: folds
3a35e9f5: raises $0.06 to $0.11
2bb677ff: folds
a90771fe: folds
960a23e5: folds
Hero: calls $0.06
*** FLOP *** [5c 4c 2c]
Hero: checks
3a35e9f5: bets $0.08
Hero: calls $0.08
*** TURN *** [5c 4c 2c] [Ac]
Hero: checks
3a35e9f5: checks
*** RIVER *** [5c 4c 2c Ac] [Kc]
Hero: checks
3a35e9f5: bets $0.2
Hero: folds
Uncalled bet ($0.2) returned to 3a35e9f5
*** SHOWDOWN ***
3a35e9f5 collected $0.38 from pot
*** SUMMARY ***
Total pot $0.4 | Rake $0.02 | Jackpot $0 | Bingo $0 | Fortune $0 | Tax $0
Board [5c 4c 2c Ac Kc]
Seat 1: a90771fe (button) folded before Flop (didn't bet)
Seat 2: 960a23e5 (small blind) folded before Flop
Seat 3: Hero (big blind) folded on the River
Seat 4: 3c028e9 folded before Flop (didn't bet)
Seat 5: 3a35e9f5 won ($0.38)
Seat 6: 2bb677ff folded before Flop (didn't bet)


Poker Hand #RC2078506769: Hold'em No Limit ($0.02/$0.05) - 2023/12/22 21:27:42
Table 'RushAndCash788589' 6-max Seat #1 is the button
Seat 1: e1380a89 ($4.76 in chips)
Seat 2: Hero ($5.18 in chips)
Seat 3: 189da7f1 ($10.49 in chips)
Seat 4: f4b75c57 ($5.05 in chips)
Seat 5: 1adb19a8 ($4.81 in chips)
Seat 6: 954d1f7b ($6.59 in chips)
Hero: posts small blind $0.02
189da7f1: posts big blind $0.05
*** HOLE CARDS ***
Dealt to e1380a89 
Dealt to Hero [Jh 5d]
Dealt to 189da7f1 
Dealt to f4b75c57 
Dealt to 1adb19a8 
Dealt to 954d1f7b 
f4b75c57: folds
1adb19a8: raises $0.08 to $0.13
954d1f7b: calls $0.13
e1380a89: folds
Hero: folds
189da7f1: calls $0.08
*** FLOP *** [9s Jd 3h]
189da7f1: checks
1adb19a8: bets $0.13
954d1f7b: calls $0.13
189da7f1: folds
*** TURN *** [9s Jd 3h] [Th]
1adb19a8: bets $0.52
954d1f7b: calls $0.52
*** RIVER *** [9s Jd 3h Th] [Ah]
1adb19a8: checks
954d1f7b: bets $0.86
1adb19a8: folds
Uncalled bet ($0.86) returned to 954d1f7b
*** SHOWDOWN ***
954d1f7b collected $1.56 from pot
*** SUMMARY ***
Total pot $1.71 | Rake $0.08 | Jackpot $0.07 | Bingo $0 | Fortune $0 | Tax $0
Board [9s Jd 3h Th Ah]
Seat 1: e1380a89 (button) folded before Flop (didn't bet)
Seat 2: Hero (small blind) folded before Flop
Seat 3: 189da7f1 (big blind) folded on the Flop
Seat 4: f4b75c57 folded before Flop (didn't bet)
Seat 5: 1adb19a8 folded on the River
Seat 6: 954d1f7b won ($1.56)


Poker Hand #RC2078506714: Hold'em No Limit ($0.02/$0.05) - 2023/12/22 21:27:38
Table 'RushAndCash788563' 6-max Seat #1 is the button
Seat 1: 21f1ca58 ($4.98 in chips)
Seat 2: 6ffefba2 ($6.04 in chips)
Seat 3: c444ec1 ($5.07 in chips)
Seat 4: b8d8e3a7 ($3.11 in chips)
Seat 5: 1adb19a8 ($4.81 in chips)
Seat 6: Hero ($5.18 in chips)
6ffefba2: posts small blind $0.02
c444ec1: posts big blind $0.05
*** HOLE CARDS ***
Dealt to 21f1ca58 
Dealt to 6ffefba2 
Dealt to c444ec1 
Dealt to b8d8e3a7 
Dealt to 1adb19a8 
Dealt to Hero [7c Th]
b8d8e3a7: folds
1adb19a8: folds
Hero: folds
21f1ca58: folds
6ffefba2: raises $0.1 to $0.15
c444ec1: calls $0.1
*** FLOP *** [9s As 8d]
6ffefba2: bets $0.09
c444ec1: calls $0.09
*** TURN *** [9s As 8d] [7h]
6ffefba2: checks
c444ec1: checks
*** RIVER *** [9s As 8d 7h] [Tc]
6ffefba2: checks
c444ec1: checks
6ffefba2: shows [9c 4h] (Pair of Nines)
c444ec1: shows [4c Ac] (Pair of Aces)
*** SHOWDOWN ***
c444ec1 collected $0.46 from pot
*** SUMMARY ***
Total pot $0.48 | Rake $0.02 | Jackpot $0 | Bingo $0 | Fortune $0 | Tax $0
Board [9s As 8d 7h Tc]
Seat 1: 21f1ca58 (button) folded before Flop (didn't bet)
Seat 2: 6ffefba2 (small blind) showed [9c 4h] and lost with Pair of Nines
Seat 3: c444ec1 (big blind) showed [4c Ac] and won ($0.46) with Pair of Aces
Seat 4: b8d8e3a7 folded before Flop (didn't bet)
Seat 5: 1adb19a8 folded before Flop (didn't bet)
Seat 6: Hero folded before Flop (didn't bet)


Poker Hand #RC2078506653: Hold'em No Limit ($0.02/$0.05) - 2023/12/22 21:27:35
Table 'RushAndCash788536' 6-max Seat #1 is the button
Seat 1: 3e455537 ($4.87 in chips)
Seat 2: a20c0bea ($5.18 in chips)
Seat 3: 6ffefba2 ($6.09 in chips)
Seat 4: f94de4b0 ($7.24 in chips)
Seat 5: 17bc2562 ($1.93 in chips)
Seat 6: Hero ($5.18 in chips)
a20c0bea: posts small blind $0.02
6ffefba2: posts big blind $0.05
*** HOLE CARDS ***
Dealt to 3e455537 
Dealt to a20c0bea 
Dealt to 6ffefba2 
Dealt to f94de4b0 
Dealt to 17bc2562 
Dealt to Hero [6s Ts]
f94de4b0: folds
17bc2562: folds
Hero: folds
3e455537: folds
a20c0bea: folds
Uncalled bet ($0.03) returned to 6ffefba2
*** SHOWDOWN ***
6ffefba2 collected $0.04 from pot
*** SUMMARY ***
Total pot $0.04 | Rake $0 | Jackpot $0 | Bingo $0 | Fortune $0 | Tax $0
Seat 1: 3e455537 (button) folded before Flop (didn't bet)
Seat 2: a20c0bea (small blind) folded before Flop
Seat 3: 6ffefba2 (big blind) collected ($0.04)
Seat 4: f94de4b0 folded before Flop (didn't bet)
Seat 5: 17bc2562 folded before Flop (didn't bet)
Seat 6: Hero folded before Flop (didn't bet)


Poker Hand #RC2078506553: Hold'em No Limit ($0.02/$0.05) - 2023/12/22 21:27:29
Table 'RushAndCash788488' 6-max Seat #1 is the button
Seat 1: a20c0bea ($5.18 in chips)
Seat 2: Hero ($5.2 in chips)
Seat 3: 55f8abbc ($8.17 in chips)
Seat 4: 1ab06c8f ($5 in chips)
Seat 5: a615a9f6 ($12.93 in chips)
Seat 6: 1259a422 ($5.5 in chips)
Hero: posts small blind $0.02
55f8abbc: posts big blind $0.05
*** HOLE CARDS ***
Dealt to a20c0bea 
Dealt to Hero [9h 8s]
Dealt to 55f8abbc 
Dealt to 1ab06c8f 
Dealt to a615a9f6 
Dealt to 1259a422 
1ab06c8f: folds
a615a9f6: folds
1259a422: raises $0.05 to $0.1
a20c0bea: folds
Hero: folds
55f8abbc: raises $0.25 to $0.35
1259a422: folds
Uncalled bet ($0.25) returned to 55f8abbc
*** SHOWDOWN ***
55f8abbc collected $0.21 from pot
*** SUMMARY ***
Total pot $0.22 | Rake $0.01 | Jackpot $0 | Bingo $0 | Fortune $0 | Tax $0
Seat 1: a20c0bea (button) folded before Flop (didn't bet)
Seat 2: Hero (small blind) folded before Flop
Seat 3: 55f8abbc (big blind) collected ($0.21)
Seat 4: 1ab06c8f folded before Flop (didn't bet)
Seat 5: a615a9f6 folded before Flop (didn't bet)
Seat 6: 1259a422 folded before Flop


Poker Hand #RC2078506352: Hold'em No Limit ($0.02/$0.05) - 2023/12/22 21:27:17
Table 'RushAndCash788392' 6-max Seat #1 is the button
Seat 1: Hero ($5.13 in chips)
Seat 2: f0040865 ($5 in chips)
Seat 3: e4d2f8b7 ($9.91 in chips)
Seat 4: dcd1ce07 ($20.18 in chips)
Seat 5: 4c81be2e ($8.8 in chips)
Seat 6: 53b6f5a9 ($6.29 in chips)
f0040865: posts small blind $0.02
e4d2f8b7: posts big blind $0.05
*** HOLE CARDS ***
Dealt to Hero [Ts Ks]
Dealt to f0040865 
Dealt to e4d2f8b7 
Dealt to dcd1ce07 
Dealt to 4c81be2e 
Dealt to 53b6f5a9 
dcd1ce07: folds
4c81be2e: folds
53b6f5a9: folds
Hero: raises $0.08 to $0.13
f0040865: folds
e4d2f8b7: folds
Uncalled bet ($0.08) returned to Hero
*** SHOWDOWN ***
Hero collected $0.12 from pot
*** SUMMARY ***
Total pot $0.12 | Rake $0 | Jackpot $0 | Bingo $0 | Fortune $0 | Tax $0
Seat 1: Hero (button) collected ($0.12)
Seat 2: f0040865 (small blind) folded before Flop
Seat 3: e4d2f8b7 (big blind) folded before Flop
Seat 4: dcd1ce07 folded before Flop (didn't bet)
Seat 5: 4c81be2e folded before Flop (didn't bet)
Seat 6: 53b6f5a9 folded before Flop (didn't bet)


Poker Hand #RC2078506266: Hold'em No Limit ($0.02/$0.05) - 2023/12/22 21:27:12
Table 'RushAndCash788353' 6-max Seat #1 is the button
Seat 1: c54f63b8 ($6.3 in chips)
Seat 2: 2588276e ($10.51 in chips)
Seat 3: Hero ($5.18 in chips)
Seat 4: 23800d75 ($7.17 in chips)
Seat 5: f9c6a467 ($22.78 in chips)
Seat 6: fa93749b ($5 in chips)
2588276e: posts small blind $0.02
Hero: posts big blind $0.05
*** HOLE CARDS ***
Dealt to c54f63b8 
Dealt to 2588276e 
Dealt to Hero [5h Ts]
Dealt to 23800d75 
Dealt to f9c6a467 
Dealt to fa93749b 
23800d75: folds
f9c6a467: folds
fa93749b: folds
c54f63b8: folds
2588276e: raises $0.1 to $0.15
Hero: folds
Uncalled bet ($0.1) returned to 2588276e
*** SHOWDOWN ***
2588276e collected $0.1 from pot
*** SUMMARY ***
Total pot $0.1 | Rake $0 | Jackpot $0 | Bingo $0 | Fortune $0 | Tax $0
Seat 1: c54f63b8 (button) folded before Flop (didn't bet)
Seat 2: 2588276e (small blind) collected ($0.1)
Seat 3: Hero (big blind) folded before Flop
Seat 4: 23800d75 folded before Flop (didn't bet)
Seat 5: f9c6a467 folded before Flop (didn't bet)
Seat 6: fa93749b folded before Flop (didn't bet)


Poker Hand #RC2078505858: Hold'em No Limit ($0.02/$0.05) - 2023/12/22 21:26:48
Table 'RushAndCash788161' 6-max Seat #1 is the button
Seat 1: 26ab7735 ($5.07 in chips)
Seat 2: 8e0f056d ($7.61 in chips)
Seat 3: 548ecbec ($5.05 in chips)
Seat 4: 23800d75 ($6.93 in chips)
Seat 5: Hero ($5.28 in chips)
Seat 6: 4c81be2e ($8.87 in chips)
8e0f056d: posts small blind $0.02
548ecbec: posts big blind $0.05
*** HOLE CARDS ***
Dealt to 26ab7735 
Dealt to 8e0f056d 
Dealt to 548ecbec 
Dealt to 23800d75 
Dealt to Hero [Ah 4h]
Dealt to 4c81be2e 
23800d75: calls $0.05
Hero: raises $0.05 to $0.1
4c81be2e: folds
26ab7735: folds
8e0f056d: calls $0.08
548ecbec: folds
23800d75: raises $0.45 to $0.55
Hero: folds
8e0f056d: folds
Uncalled bet ($0.45) returned to 23800d75
*** SHOWDOWN ***
23800d75 collected $0.34 from pot
*** SUMMARY ***
Total pot $0.35 | Rake $0.01 | Jackpot $0 | Bingo $0 | Fortune $0 | Tax $0
Seat 1: 26ab7735 (button) folded before Flop (didn't bet)
Seat 2: 8e0f056d (small blind) folded before Flop
Seat 3: 548ecbec (big blind) folded before Flop
Seat 4: 23800d75 collected ($0.34)
Seat 5: Hero folded before Flop
Seat 6: 4c81be2e folded before Flop (didn't bet)


Poker Hand #RC2078505738: Hold'em No Limit ($0.02/$0.05) - 2023/12/22 21:26:41
Table 'RushAndCash788106' 6-max Seat #1 is the button
Seat 1: fb13494d ($2.57 in chips)
Seat 2: 8da33d79 ($13.89 in chips)
Seat 3: 893f08ec ($5 in chips)
Seat 4: Hero ($5.28 in chips)
Seat 5: f60e42f0 ($9.08 in chips)
Seat 6: 84d4f92c ($6 in chips)
8da33d79: posts small blind $0.02
893f08ec: posts big blind $0.05
*** HOLE CARDS ***
Dealt to fb13494d 
Dealt to 8da33d79 
Dealt to 893f08ec 
Dealt to Hero [Ts Kc]
Dealt to f60e42f0 
Dealt to 84d4f92c 
Hero: folds
f60e42f0: folds
84d4f92c: raises $0.08 to $0.13
fb13494d: calls $0.13
8da33d79: folds
893f08ec: folds
*** FLOP *** [Td Qc 2d]
84d4f92c: bets $0.09
fb13494d: calls $0.09
*** TURN *** [Td Qc 2d] [5h]
84d4f92c: bets $0.26
fb13494d: folds
Uncalled bet ($0.26) returned to 84d4f92c
*** SHOWDOWN ***
84d4f92c collected $0.49 from pot
*** SUMMARY ***
Total pot $0.51 | Rake $0.02 | Jackpot $0 | Bingo $0 | Fortune $0 | Tax $0
Board [Td Qc 2d 5h]
Seat 1: fb13494d (button) folded on the Turn
Seat 2: 8da33d79 (small blind) folded before Flop
Seat 3: 893f08ec (big blind) folded before Flop
Seat 4: Hero folded before Flop (didn't bet)
Seat 5: f60e42f0 folded before Flop (didn't bet)
Seat 6: 84d4f92c won ($0.49)


Poker Hand #RC2078505643: Hold'em No Limit ($0.02/$0.05) - 2023/12/22 21:26:36
Table 'RushAndCash788064' 6-max Seat #1 is the button
Seat 1: aa667d33 ($4.62 in chips)
Seat 2: 365a060c ($4.35 in chips)
Seat 3: 73c8f8b5 ($5.07 in chips)
Seat 4: Hero ($5.28 in chips)
Seat 5: 360d3b25 ($6.39 in chips)
Seat 6: cd339031 ($7.95 in chips)
365a060c: posts small blind $0.02
73c8f8b5: posts big blind $0.05
*** HOLE CARDS ***
Dealt to aa667d33 
Dealt to 365a060c 
Dealt to 73c8f8b5 
Dealt to Hero [7c 6c]
Dealt to 360d3b25 
Dealt to cd339031 
Hero: folds
360d3b25: folds
cd339031: raises $0.07 to $0.12
aa667d33: raises $0.31 to $0.43
365a060c: folds
73c8f8b5: folds
cd339031: folds
Uncalled bet ($0.31) returned to aa667d33
cd339031: shows [8c Tc]
aa667d33: shows [As]
*** SHOWDOWN ***
aa667d33 collected $0.3 from pot
*** SUMMARY ***
Total pot $0.31 | Rake $0.01 | Jackpot $0 | Bingo $0 | Fortune $0 | Tax $0
Seat 1: aa667d33 (button) showed [As] and collected ($0.3)
Seat 2: 365a060c (small blind) folded before Flop
Seat 3: 73c8f8b5 (big blind) folded before Flop
Seat 4: Hero folded before Flop (didn't bet)
Seat 5: 360d3b25 folded before Flop (didn't bet)
Seat 6: cd339031 folded before Flop


Poker Hand #RC2078505567: Hold'em No Limit ($0.02/$0.05) - 2023/12/22 21:26:32
Table 'RushAndCash788029' 6-max Seat #1 is the button
Seat 1: 8d94440d ($5 in chips)
Seat 2: ce1aa7a ($5.09 in chips)
Seat 3: dbcee38b ($5 in chips)
Seat 4: Hero ($5.28 in chips)
Seat 5: 35f7fbd3 ($9.64 in chips)
Seat 6: a638a3a8 ($7.59 in chips)
ce1aa7a: posts small blind $0.02
dbcee38b: posts big blind $0.05
*** HOLE CARDS ***
Dealt to 8d94440d 
Dealt to ce1aa7a 
Dealt to dbcee38b 
Dealt to Hero [Tc Jd]
Dealt to 35f7fbd3 
Dealt to a638a3a8 
Hero: folds
35f7fbd3: folds
a638a3a8: folds
8d94440d: folds
ce1aa7a: folds
Uncalled bet ($0.03) returned to dbcee38b
*** SHOWDOWN ***
dbcee38b collected $0.04 from pot
*** SUMMARY ***
Total pot $0.04 | Rake $0 | Jackpot $0 | Bingo $0 | Fortune $0 | Tax $0
Seat 1: 8d94440d (button) folded before Flop (didn't bet)
Seat 2: ce1aa7a (small blind) folded before Flop
Seat 3: dbcee38b (big blind) collected ($0.04)
Seat 4: Hero folded before Flop (didn't bet)
Seat 5: 35f7fbd3 folded before Flop (didn't bet)
Seat 6: a638a3a8 folded before Flop (didn't bet)


Poker Hand #RC2078505501: Hold'em No Limit ($0.02/$0.05) - 2023/12/22 21:26:28
Table 'RushAndCash787997' 6-max Seat #1 is the button
Seat 1: Hero ($5.28 in chips)
Seat 2: 4b60b73d ($7.25 in chips)
Seat 3: 9dcfc86d ($2.84 in chips)
Seat 4: e734080a ($16.06 in chips)
Seat 5: 587c07c3 ($5.07 in chips)
Seat 6: 50cbc258 ($4.14 in chips)
4b60b73d: posts small blind $0.02
9dcfc86d: posts big blind $0.05
*** HOLE CARDS ***
Dealt to Hero [5s 9h]
Dealt to 4b60b73d 
Dealt to 9dcfc86d 
Dealt to e734080a 
Dealt to 587c07c3 
Dealt to 50cbc258 
e734080a: folds
587c07c3: folds
50cbc258: folds
Hero: folds
4b60b73d: folds
Uncalled bet ($0.03) returned to 9dcfc86d
*** SHOWDOWN ***
9dcfc86d collected $0.04 from pot
*** SUMMARY ***
Total pot $0.04 | Rake $0 | Jackpot $0 | Bingo $0 | Fortune $0 | Tax $0
Seat 1: Hero (button) folded before Flop (didn't bet)
Seat 2: 4b60b73d (small blind) folded before Flop
Seat 3: 9dcfc86d (big blind) collected ($0.04)
Seat 4: e734080a folded before Flop (didn't bet)
Seat 5: 587c07c3 folded before Flop (didn't bet)
Seat 6: 50cbc258 folded before Flop (didn't bet)


Poker Hand #RC2078505425: Hold'em No Limit ($0.02/$0.05) - 2023/12/22 21:26:24
Table 'RushAndCash787962' 6-max Seat #1 is the button
Seat 1: abe64b92 ($5.05 in chips)
Seat 2: Hero ($5.3 in chips)
Seat 3: 59c7f4b1 ($5.97 in chips)
Seat 4: 3da5ed9c ($7.09 in chips)
Seat 5: cb9a7609 ($5.02 in chips)
Seat 6: 610bd7fc ($11.76 in chips)
Hero: posts small blind $0.02
59c7f4b1: posts big blind $0.05
*** HOLE CARDS ***
Dealt to abe64b92 
Dealt to Hero [Jc 9d]
Dealt to 59c7f4b1 
Dealt to 3da5ed9c 
Dealt to cb9a7609 
Dealt to 610bd7fc 
3da5ed9c: folds
cb9a7609: folds
610bd7fc: folds
abe64b92: calls $0.05
Hero: folds
59c7f4b1: checks
*** FLOP *** [Jd 5d 3s]
59c7f4b1: checks
abe64b92: checks
*** TURN *** [Jd 5d 3s] [2d]
59c7f4b1: checks
abe64b92: checks
*** RIVER *** [Jd 5d 3s 2d] [Td]
59c7f4b1: checks
abe64b92: bets $0.12
59c7f4b1: calls $0.12
abe64b92: shows [6s Ad] (Ace High Flush)
59c7f4b1: shows [Kh Ts] (Pair of Tens)
*** SHOWDOWN ***
abe64b92 collected $0.35 from pot
*** SUMMARY ***
Total pot $0.36 | Rake $0.01 | Jackpot $0 | Bingo $0 | Fortune $0 | Tax $0
Board [Jd 5d 3s 2d Td]
Seat 1: abe64b92 (button) showed [6s Ad] and won ($0.35) with Ace High Flush
Seat 2: Hero (small blind) folded before Flop
Seat 3: 59c7f4b1 (big blind) showed [Kh Ts] and lost with Pair of Tens
Seat 4: 3da5ed9c folded before Flop (didn't bet)
Seat 5: cb9a7609 folded before Flop (didn't bet)
Seat 6: 610bd7fc folded before Flop (didn't bet)


Poker Hand #RC2078484388: Hold'em No Limit ($0.02/$0.05) - 2023/12/22 21:25:26
Table 'RushAndCash787474' 6-max Seat #1 is the button
Seat 1: e24a2fed ($5 in chips)
Seat 2: 38eafb19 ($5 in chips)
Seat 3: Hero ($5 in chips)
Seat 4: 29b0f5be ($5.46 in chips)
Seat 5: 6b8a648f ($7.81 in chips)
Seat 6: e49e39a2 ($15.58 in chips)
38eafb19: posts small blind $0.02
Hero: posts big blind $0.05
*** HOLE CARDS ***
Dealt to e24a2fed 
Dealt to 38eafb19 
Dealt to Hero [Jd Jc]
Dealt to 29b0f5be 
Dealt to 6b8a648f 
Dealt to e49e39a2 
29b0f5be: folds
6b8a648f: folds
e49e39a2: raises $0.1 to $0.15
e24a2fed: folds
38eafb19: folds
Hero: calls $0.1
*** FLOP *** [3s 9h Qc]
Hero: checks
e49e39a2: checks
*** TURN *** [3s 9h Qc] [3h]
Hero: checks
e49e39a2: bets $0.16
Hero: calls $0.16
*** RIVER *** [3s 9h Qc 3h] [5c]
Hero: checks
e49e39a2: checks
Hero: shows [Jd Jc] (Pair of Jacks and Pair of Treys)
e49e39a2: shows [Ad 9c] (Pair of Nines and Pair of Treys)
*** SHOWDOWN ***
Hero collected $0.61 from pot
*** SUMMARY ***
Total pot $0.64 | Rake $0.03 | Jackpot $0 | Bingo $0 | Fortune $0 | Tax $0
Board [3s 9h Qc 3h 5c]
Seat 1: e24a2fed (button) folded before Flop (didn't bet)
Seat 2: 38eafb19 (small blind) folded before Flop
Seat 3: Hero (big blind) showed [Jd Jc] and won ($0.61) with Pair of Jacks and Pair of Treys
Seat 4: 29b0f5be folded before Flop (didn't bet)
Seat 5: 6b8a648f folded before Flop (didn't bet)
Seat 6: e49e39a2 showed [Ad 9c] and lost with Pair of Nines and Pair of Treys


