Poker Hand #RC2075602996: Hold'em No Limit ($0.05/$0.1) - 2023/12/21 23:42:19
Table 'RushAndCash302222' 6-max Seat #1 is the button
Seat 1: 3583197b ($12.76 in chips)
Seat 2: d379457a ($14.45 in chips)
Seat 3: cbc7bd10 ($10.75 in chips)
Seat 4: Hero ($15.22 in chips)
Seat 5: b695b6df ($44.91 in chips)
Seat 6: cb6e8f90 ($19.87 in chips)
d379457a: posts small blind $0.05
cbc7bd10: posts big blind $0.1
*** HOLE CARDS ***
Dealt to 3583197b 
Dealt to d379457a 
Dealt to cbc7bd10 
Dealt to Hero [9d 7c]
Dealt to b695b6df 
Dealt to cb6e8f90 
Hero: folds
b695b6df: folds
cb6e8f90: folds
3583197b: folds
d379457a: raises $0.12 to $0.22
cbc7bd10: folds
Uncalled bet ($0.12) returned to d379457a
*** SHOWDOWN ***
d379457a collected $0.2 from pot
*** SUMMARY ***
Total pot $0.2 | Rake $0 | Jackpot $0 | Bingo $0 | Fortune $0 | Tax $0
Seat 1: 3583197b (button) folded before Flop (didn't bet)
Seat 2: d379457a (small blind) collected ($0.2)
Seat 3: cbc7bd10 (big blind) folded before Flop
Seat 4: Hero folded before Flop (didn't bet)
Seat 5: b695b6df folded before Flop (didn't bet)
Seat 6: cb6e8f90 folded before Flop (didn't bet)


Poker Hand #RC2075602336: Hold'em No Limit ($0.05/$0.1) - 2023/12/21 23:41:50
Table 'RushAndCash301876' 6-max Seat #1 is the button
Seat 1: b559a00a ($10.58 in chips)
Seat 2: cf69763e ($9.94 in chips)
Seat 3: 5e919d66 ($10.39 in chips)
Seat 4: Hero ($15.42 in chips)
Seat 5: d7fea7e5 ($19.94 in chips)
Seat 6: b19c1e03 ($10.68 in chips)
cf69763e: posts small blind $0.05
5e919d66: posts big blind $0.1
*** HOLE CARDS ***
Dealt to b559a00a 
Dealt to cf69763e 
Dealt to 5e919d66 
Dealt to Hero [Ad Ks]
Dealt to d7fea7e5 
Dealt to b19c1e03 
Hero: raises $0.1 to $0.2
d7fea7e5: raises $0.28 to $0.48
b19c1e03: folds
b559a00a: raises $1.12 to $1.6
cf69763e: folds
5e919d66: folds
Hero: folds
d7fea7e5: calls $1.12
*** FLOP *** [9c 6s 7d]
d7fea7e5: checks
b559a00a: bets $2
d7fea7e5: folds
Uncalled bet ($2) returned to b559a00a
*** SHOWDOWN ***
b559a00a collected $3.23 from pot
*** SUMMARY ***
Total pot $3.55 | Rake $0.17 | Jackpot $0.15 | Bingo $0 | Fortune $0 | Tax $0
Board [9c 6s 7d]
Seat 1: b559a00a (button) won ($3.23)
Seat 2: cf69763e (small blind) folded before Flop
Seat 3: 5e919d66 (big blind) folded before Flop
Seat 4: Hero folded before Flop
Seat 5: d7fea7e5 folded on the Flop
Seat 6: b19c1e03 folded before Flop (didn't bet)


Poker Hand #RC2075601012: Hold'em No Limit ($0.05/$0.1) - 2023/12/21 23:40:53
Table 'RushAndCash301129' 6-max Seat #1 is the button
Seat 1: c373bc25 ($10.25 in chips)
Seat 2: Hero ($14.73 in chips)
Seat 3: 2d7523aa ($11.27 in chips)
Seat 4: db45a1dd ($10 in chips)
Seat 5: 2d569436 ($22.88 in chips)
Seat 6: c1be2837 ($10.4 in chips)
Hero: posts small blind $0.05
2d7523aa: posts big blind $0.1
*** HOLE CARDS ***
Dealt to c373bc25 
Dealt to Hero [4d 6d]
Dealt to 2d7523aa 
Dealt to db45a1dd 
Dealt to 2d569436 
Dealt to c1be2837 
db45a1dd: folds
2d569436: folds
c1be2837: raises $0.15 to $0.25
c373bc25: folds
Hero: calls $0.2
2d7523aa: calls $0.15
*** FLOP *** [7d 7h 8d]
Hero: checks
2d7523aa: checks
c1be2837: bets $0.25
Hero: calls $0.25
2d7523aa: folds
*** TURN *** [7d 7h 8d] [5d]
Hero: checks
c1be2837: checks
*** RIVER *** [7d 7h 8d 5d] [2s]
Hero: bets $0.63
c1be2837: folds
Uncalled bet ($0.63) returned to Hero
*** SHOWDOWN ***
Hero collected $1.19 from pot
*** SUMMARY ***
Total pot $1.25 | Rake $0.06 | Jackpot $0 | Bingo $0 | Fortune $0 | Tax $0
Board [7d 7h 8d 5d 2s]
Seat 1: c373bc25 (button) folded before Flop (didn't bet)
Seat 2: Hero (small blind) won ($1.19)
Seat 3: 2d7523aa (big blind) folded on the Flop
Seat 4: db45a1dd folded before Flop (didn't bet)
Seat 5: 2d569436 folded before Flop (didn't bet)
Seat 6: c1be2837 folded on the River


Poker Hand #RC2075600437: Hold'em No Limit ($0.05/$0.1) - 2023/12/21 23:40:28
Table 'RushAndCash300802' 6-max Seat #1 is the button
Seat 1: ef34ccbe ($10.93 in chips)
Seat 2: f7ed97c8 ($9.9 in chips)
Seat 3: Hero ($15.03 in chips)
Seat 4: 320aaa96 ($9.45 in chips)
Seat 5: 73ced8be ($56.96 in chips)
Seat 6: 3769126d ($10 in chips)
f7ed97c8: posts small blind $0.05
Hero: posts big blind $0.1
*** HOLE CARDS ***
Dealt to ef34ccbe 
Dealt to f7ed97c8 
Dealt to Hero [3h 4h]
Dealt to 320aaa96 
Dealt to 73ced8be 
Dealt to 3769126d 
320aaa96: folds
73ced8be: folds
3769126d: folds
ef34ccbe: raises $0.2 to $0.3
f7ed97c8: folds
Hero: calls $0.2
*** FLOP *** [7h As Kd]
Hero: checks
ef34ccbe: bets $0.49
Hero: folds
Uncalled bet ($0.49) returned to ef34ccbe
*** SHOWDOWN ***
ef34ccbe collected $0.62 from pot
*** SUMMARY ***
Total pot $0.65 | Rake $0.03 | Jackpot $0 | Bingo $0 | Fortune $0 | Tax $0
Board [7h As Kd]
Seat 1: ef34ccbe (button) won ($0.62)
Seat 2: f7ed97c8 (small blind) folded before Flop
Seat 3: Hero (big blind) folded on the Flop
Seat 4: 320aaa96 folded before Flop (didn't bet)
Seat 5: 73ced8be folded before Flop (didn't bet)
Seat 6: 3769126d folded before Flop (didn't bet)


Poker Hand #RC2075600325: Hold'em No Limit ($0.05/$0.1) - 2023/12/21 23:40:23
Table 'RushAndCash300741' 6-max Seat #1 is the button
Seat 1: Hero ($15.03 in chips)
Seat 2: b95ef50d ($10.75 in chips)
Seat 3: 9c562155 ($6.93 in chips)
Seat 4: 8b0cfb4a ($4.83 in chips)
Seat 5: 5eff6f8e ($12 in chips)
Seat 6: 72b6a9a0 ($3.43 in chips)
b95ef50d: posts small blind $0.05
9c562155: posts big blind $0.1
*** HOLE CARDS ***
Dealt to Hero [8d Js]
Dealt to b95ef50d 
Dealt to 9c562155 
Dealt to 8b0cfb4a 
Dealt to 5eff6f8e 
Dealt to 72b6a9a0 
8b0cfb4a: raises $0.2 to $0.3
5eff6f8e: folds
72b6a9a0: folds
Hero: folds
b95ef50d: folds
9c562155: calls $0.2
*** FLOP *** [Qs Ts 9c]
9c562155: checks
8b0cfb4a: checks
*** TURN *** [Qs Ts 9c] [9h]
9c562155: bets $0.33
8b0cfb4a: calls $0.33
*** RIVER *** [Qs Ts 9c 9h] [Kd]
9c562155: bets $0.66
8b0cfb4a: folds
Uncalled bet ($0.66) returned to 9c562155
*** SHOWDOWN ***
9c562155 collected $1.25 from pot
*** SUMMARY ***
Total pot $1.31 | Rake $0.06 | Jackpot $0 | Bingo $0 | Fortune $0 | Tax $0
Board [Qs Ts 9c 9h Kd]
Seat 1: Hero (button) folded before Flop (didn't bet)
Seat 2: b95ef50d (small blind) folded before Flop
Seat 3: 9c562155 (big blind) won ($1.25)
Seat 4: 8b0cfb4a folded on the River
Seat 5: 5eff6f8e folded before Flop (didn't bet)
Seat 6: 72b6a9a0 folded before Flop (didn't bet)


Poker Hand #RC2075600218: Hold'em No Limit ($0.05/$0.1) - 2023/12/21 23:40:18
Table 'RushAndCash300683' 6-max Seat #1 is the button
Seat 1: 51436930 ($10.93 in chips)
Seat 2: 904d4419 ($2.68 in chips)
Seat 3: bd3b2870 ($18.58 in chips)
Seat 4: 32e4434f ($10.4 in chips)
Seat 5: Hero ($15.03 in chips)
Seat 6: 83b1f5f9 ($10 in chips)
904d4419: posts small blind $0.05
bd3b2870: posts big blind $0.1
*** HOLE CARDS ***
Dealt to 51436930 
Dealt to 904d4419 
Dealt to bd3b2870 
Dealt to 32e4434f 
Dealt to Hero [8h Th]
Dealt to 83b1f5f9 
32e4434f: folds
Hero: folds
83b1f5f9: folds
51436930: raises $0.2 to $0.3
904d4419: calls $0.25
bd3b2870: calls $0.2
*** FLOP *** [2c Js 5c]
904d4419: checks
bd3b2870: checks
51436930: checks
*** TURN *** [2c Js 5c] [9h]
904d4419: checks
bd3b2870: bets $0.65
51436930: folds
904d4419: folds
Uncalled bet ($0.65) returned to bd3b2870
*** SHOWDOWN ***
bd3b2870 collected $0.86 from pot
*** SUMMARY ***
Total pot $0.9 | Rake $0.04 | Jackpot $0 | Bingo $0 | Fortune $0 | Tax $0
Board [2c Js 5c 9h]
Seat 1: 51436930 (button) folded on the Turn
Seat 2: 904d4419 (small blind) folded on the Turn
Seat 3: bd3b2870 (big blind) won ($0.86)
Seat 4: 32e4434f folded before Flop (didn't bet)
Seat 5: Hero folded before Flop (didn't bet)
Seat 6: 83b1f5f9 folded before Flop (didn't bet)


Poker Hand #RC2075599918: Hold'em No Limit ($0.05/$0.1) - 2023/12/21 23:40:06
Table 'RushAndCash300507' 6-max Seat #1 is the button
Seat 1: c92e79df ($12 in chips)
Seat 2: Hero ($15.08 in chips)
Seat 3: d3d63fec ($20.18 in chips)
Seat 4: c150c1ee ($9.7 in chips)
Seat 5: ae042f12 ($10.52 in chips)
Seat 6: a837aa46 ($50.53 in chips)
Hero: posts small blind $0.05
d3d63fec: posts big blind $0.1
*** HOLE CARDS ***
Dealt to c92e79df 
Dealt to Hero [Qh 5d]
Dealt to d3d63fec 
Dealt to c150c1ee 
Dealt to ae042f12 
Dealt to a837aa46 
c150c1ee: folds
ae042f12: folds
a837aa46: raises $0.15 to $0.25
c92e79df: folds
Hero: folds
d3d63fec: folds
Uncalled bet ($0.15) returned to a837aa46
*** SHOWDOWN ***
a837aa46 collected $0.25 from pot
*** SUMMARY ***
Total pot $0.25 | Rake $0 | Jackpot $0 | Bingo $0 | Fortune $0 | Tax $0
Seat 1: c92e79df (button) folded before Flop (didn't bet)
Seat 2: Hero (small blind) folded before Flop
Seat 3: d3d63fec (big blind) folded before Flop
Seat 4: c150c1ee folded before Flop (didn't bet)
Seat 5: ae042f12 folded before Flop (didn't bet)
Seat 6: a837aa46 collected ($0.25)


Poker Hand #RC2075599698: Hold'em No Limit ($0.05/$0.1) - 2023/12/21 23:39:56
Table 'RushAndCash300373' 6-max Seat #1 is the button
Seat 1: 98191a40 ($1.36 in chips)
Seat 2: Hero ($15.13 in chips)
Seat 3: 822a4a20 ($28.58 in chips)
Seat 4: fb7746e2 ($14.17 in chips)
Seat 5: 234913b5 ($12.7 in chips)
Seat 6: 12515800 ($11.32 in chips)
Hero: posts small blind $0.05
822a4a20: posts big blind $0.1
*** HOLE CARDS ***
Dealt to 98191a40 
Dealt to Hero [6d 3s]
Dealt to 822a4a20 
Dealt to fb7746e2 
Dealt to 234913b5 
Dealt to 12515800 
fb7746e2: folds
234913b5: folds
12515800: raises $0.1 to $0.2
98191a40: raises $1.16 to $1.36 and is all-in
Hero: folds
822a4a20: folds
12515800: folds
Uncalled bet ($1.16) returned to 98191a40
*** SHOWDOWN ***
98191a40 collected $0.53 from pot
*** SUMMARY ***
Total pot $0.55 | Rake $0.02 | Jackpot $0 | Bingo $0 | Fortune $0 | Tax $0
Seat 1: 98191a40 (button) collected ($0.53)
Seat 2: Hero (small blind) folded before Flop
Seat 3: 822a4a20 (big blind) folded before Flop
Seat 4: fb7746e2 folded before Flop (didn't bet)
Seat 5: 234913b5 folded before Flop (didn't bet)
Seat 6: 12515800 folded before Flop


Poker Hand #RC2075599453: Hold'em No Limit ($0.05/$0.1) - 2023/12/21 23:39:45
Table 'RushAndCash300230' 6-max Seat #1 is the button
Seat 1: e3a45106 ($17.59 in chips)
Seat 2: 291fe735 ($11.96 in chips)
Seat 3: Hero ($15.08 in chips)
Seat 4: d8f508bf ($26.76 in chips)
Seat 5: fc0a3af9 ($28.47 in chips)
Seat 6: a4d488b5 ($14.18 in chips)
291fe735: posts small blind $0.05
Hero: posts big blind $0.1
*** HOLE CARDS ***
Dealt to e3a45106 
Dealt to 291fe735 
Dealt to Hero [Qh Js]
Dealt to d8f508bf 
Dealt to fc0a3af9 
Dealt to a4d488b5 
d8f508bf: folds
fc0a3af9: folds
a4d488b5: folds
e3a45106: folds
291fe735: folds
Uncalled bet ($0.05) returned to Hero
*** SHOWDOWN ***
Hero collected $0.1 from pot
*** SUMMARY ***
Total pot $0.1 | Rake $0 | Jackpot $0 | Bingo $0 | Fortune $0 | Tax $0
Seat 1: e3a45106 (button) folded before Flop (didn't bet)
Seat 2: 291fe735 (small blind) folded before Flop
Seat 3: Hero (big blind) collected ($0.1)
Seat 4: d8f508bf folded before Flop (didn't bet)
Seat 5: fc0a3af9 folded before Flop (didn't bet)
Seat 6: a4d488b5 folded before Flop (didn't bet)


Poker Hand #RC2075599362: Hold'em No Limit ($0.05/$0.1) - 2023/12/21 23:39:42
Table 'RushAndCash300176' 6-max Seat #1 is the button
Seat 1: e8d5c5ad ($10.34 in chips)
Seat 2: b5b101c5 ($4.9 in chips)
Seat 3: 1a09d062 ($16.15 in chips)
Seat 4: Hero ($15.08 in chips)
Seat 5: 2f339df3 ($10.19 in chips)
Seat 6: fe8e9d75 ($12.24 in chips)
b5b101c5: posts small blind $0.05
1a09d062: posts big blind $0.1
*** HOLE CARDS ***
Dealt to e8d5c5ad 
Dealt to b5b101c5 
Dealt to 1a09d062 
Dealt to Hero [3d Jh]
Dealt to 2f339df3 
Dealt to fe8e9d75 
Hero: folds
2f339df3: folds
fe8e9d75: folds
e8d5c5ad: folds
b5b101c5: folds
Uncalled bet ($0.05) returned to 1a09d062
*** SHOWDOWN ***
1a09d062 collected $0.1 from pot
*** SUMMARY ***
Total pot $0.1 | Rake $0 | Jackpot $0 | Bingo $0 | Fortune $0 | Tax $0
Seat 1: e8d5c5ad (button) folded before Flop (didn't bet)
Seat 2: b5b101c5 (small blind) folded before Flop
Seat 3: 1a09d062 (big blind) collected ($0.1)
Seat 4: Hero folded before Flop (didn't bet)
Seat 5: 2f339df3 folded before Flop (didn't bet)
Seat 6: fe8e9d75 folded before Flop (didn't bet)


Poker Hand #RC2075599263: Hold'em No Limit ($0.05/$0.1) - 2023/12/21 23:39:38
Table 'RushAndCash300121' 6-max Seat #1 is the button
Seat 1: 33623df8 ($14.62 in chips)
Seat 2: 2f57f136 ($11.84 in chips)
Seat 3: bfed6b68 ($1.91 in chips)
Seat 4: a0c90946 ($20.96 in chips)
Seat 5: f4f320ca ($14.6 in chips)
Seat 6: Hero ($15.08 in chips)
2f57f136: posts small blind $0.05
bfed6b68: posts big blind $0.1
*** HOLE CARDS ***
Dealt to 33623df8 
Dealt to 2f57f136 
Dealt to bfed6b68 
Dealt to a0c90946 
Dealt to f4f320ca 
Dealt to Hero [9h 4h]
a0c90946: folds
f4f320ca: folds
Hero: folds
33623df8: folds
2f57f136: folds
Uncalled bet ($0.05) returned to bfed6b68
*** SHOWDOWN ***
bfed6b68 collected $0.1 from pot
*** SUMMARY ***
Total pot $0.1 | Rake $0 | Jackpot $0 | Bingo $0 | Fortune $0 | Tax $0
Seat 1: 33623df8 (button) folded before Flop (didn't bet)
Seat 2: 2f57f136 (small blind) folded before Flop
Seat 3: bfed6b68 (big blind) collected ($0.1)
Seat 4: a0c90946 folded before Flop (didn't bet)
Seat 5: f4f320ca folded before Flop (didn't bet)
Seat 6: Hero folded before Flop (didn't bet)


Poker Hand #RC2075599166: Hold'em No Limit ($0.05/$0.1) - 2023/12/21 23:39:33
Table 'RushAndCash300067' 6-max Seat #1 is the button
Seat 1: 5c16ab41 ($10.25 in chips)
Seat 2: a2db45ef ($3.72 in chips)
Seat 3: 8ab6cdf3 ($13.94 in chips)
Seat 4: 2e307fba ($16.4 in chips)
Seat 5: 3892cf8a ($12.08 in chips)
Seat 6: Hero ($15.08 in chips)
a2db45ef: posts small blind $0.05
8ab6cdf3: posts big blind $0.1
*** HOLE CARDS ***
Dealt to 5c16ab41 
Dealt to a2db45ef 
Dealt to 8ab6cdf3 
Dealt to 2e307fba 
Dealt to 3892cf8a 
Dealt to Hero [8h 2h]
2e307fba: folds
3892cf8a: raises $0.15 to $0.25
Hero: folds
5c16ab41: folds
a2db45ef: calls $0.2
8ab6cdf3: calls $0.15
*** FLOP *** [9d As 4s]
a2db45ef: checks
8ab6cdf3: checks
3892cf8a: bets $0.25
a2db45ef: folds
8ab6cdf3: folds
Uncalled bet ($0.25) returned to 3892cf8a
*** SHOWDOWN ***
3892cf8a collected $0.72 from pot
*** SUMMARY ***
Total pot $0.75 | Rake $0.03 | Jackpot $0 | Bingo $0 | Fortune $0 | Tax $0
Board [9d As 4s]
Seat 1: 5c16ab41 (button) folded before Flop (didn't bet)
Seat 2: a2db45ef (small blind) folded on the Flop
Seat 3: 8ab6cdf3 (big blind) folded on the Flop
Seat 4: 2e307fba folded before Flop (didn't bet)
Seat 5: 3892cf8a won ($0.72)
Seat 6: Hero folded before Flop (didn't bet)


Poker Hand #RC2075599075: Hold'em No Limit ($0.05/$0.1) - 2023/12/21 23:39:30
Table 'RushAndCash300015' 6-max Seat #1 is the button
Seat 1: a37412e9 ($14.77 in chips)
Seat 2: c2dd4474 ($10.94 in chips)
Seat 3: bd3b2870 ($18.32 in chips)
Seat 4: Hero ($15.08 in chips)
Seat 5: a8210420 ($4.3 in chips)
Seat 6: 2e9f052c ($14.88 in chips)
c2dd4474: posts small blind $0.05
bd3b2870: posts big blind $0.1
*** HOLE CARDS ***
Dealt to a37412e9 
Dealt to c2dd4474 
Dealt to bd3b2870 
Dealt to Hero [Qs 5c]
Dealt to a8210420 
Dealt to 2e9f052c 
Hero: folds
a8210420: folds
2e9f052c: folds
a37412e9: folds
c2dd4474: raises $0.15 to $0.25
bd3b2870: calls $0.15
*** FLOP *** [8h 2h 3s]
c2dd4474: bets $0.15
bd3b2870: raises $0.45 to $0.6
c2dd4474: folds
Uncalled bet ($0.45) returned to bd3b2870
*** SHOWDOWN ***
bd3b2870 collected $0.76 from pot
*** SUMMARY ***
Total pot $0.8 | Rake $0.04 | Jackpot $0 | Bingo $0 | Fortune $0 | Tax $0
Board [8h 2h 3s]
Seat 1: a37412e9 (button) folded before Flop (didn't bet)
Seat 2: c2dd4474 (small blind) folded on the Flop
Seat 3: bd3b2870 (big blind) won ($0.76)
Seat 4: Hero folded before Flop (didn't bet)
Seat 5: a8210420 folded before Flop (didn't bet)
Seat 6: 2e9f052c folded before Flop (didn't bet)


Poker Hand #RC2075598347: Hold'em No Limit ($0.05/$0.1) - 2023/12/21 23:38:58
Table 'RushAndCash299598' 6-max Seat #1 is the button
Seat 1: 190b572b ($10 in chips)
Seat 2: b5be1827 ($13.12 in chips)
Seat 3: Hero ($15.28 in chips)
Seat 4: ef7c0e05 ($7.82 in chips)
Seat 5: b25008d6 ($12.72 in chips)
Seat 6: 197cd9e6 ($47.26 in chips)
b5be1827: posts small blind $0.05
Hero: posts big blind $0.1
*** HOLE CARDS ***
Dealt to 190b572b 
Dealt to b5be1827 
Dealt to Hero [3d Ac]
Dealt to ef7c0e05 
Dealt to b25008d6 
Dealt to 197cd9e6 
ef7c0e05: folds
b25008d6: folds
197cd9e6: folds
190b572b: folds
b5be1827: raises $0.1 to $0.2
Hero: calls $0.1
*** FLOP *** [4c Qs Qh]
b5be1827: checks
Hero: checks
*** TURN *** [4c Qs Qh] [2d]
b5be1827: checks
Hero: checks
*** RIVER *** [4c Qs Qh 2d] [9c]
b5be1827: checks
Hero: checks
b5be1827: shows [Ad Tc] (Pair of Queens)
Hero: shows [3d Ac] (Pair of Queens)
*** SHOWDOWN ***
b5be1827 collected $0.38 from pot
*** SUMMARY ***
Total pot $0.4 | Rake $0.02 | Jackpot $0 | Bingo $0 | Fortune $0 | Tax $0
Board [4c Qs Qh 2d 9c]
Seat 1: 190b572b (button) folded before Flop (didn't bet)
Seat 2: b5be1827 (small blind) showed [Ad Tc] and won ($0.38) with Pair of Queens
Seat 3: Hero (big blind) showed [3d Ac] and lost with Pair of Queens
Seat 4: ef7c0e05 folded before Flop (didn't bet)
Seat 5: b25008d6 folded before Flop (didn't bet)
Seat 6: 197cd9e6 folded before Flop (didn't bet)


Poker Hand #RC2075598258: Hold'em No Limit ($0.05/$0.1) - 2023/12/21 23:38:54
Table 'RushAndCash299547' 6-max Seat #1 is the button
Seat 1: 50d5f1f7 ($16.57 in chips)
Seat 2: a837aa46 ($50.63 in chips)
Seat 3: 11b7a8bd ($10 in chips)
Seat 4: Hero ($15.28 in chips)
Seat 5: 76f4ebd9 ($25.7 in chips)
Seat 6: bcadb0b7 ($8.26 in chips)
a837aa46: posts small blind $0.05
11b7a8bd: posts big blind $0.1
*** HOLE CARDS ***
Dealt to 50d5f1f7 
Dealt to a837aa46 
Dealt to 11b7a8bd 
Dealt to Hero [7s 3c]
Dealt to 76f4ebd9 
Dealt to bcadb0b7 
Hero: folds
76f4ebd9: raises $0.2 to $0.3
bcadb0b7: calls $0.3
50d5f1f7: folds
a837aa46: folds
11b7a8bd: folds
*** FLOP *** [8d 2d 6d]
76f4ebd9: checks
bcadb0b7: checks
*** TURN *** [8d 2d 6d] [Td]
76f4ebd9: checks
bcadb0b7: bets $0.15
76f4ebd9: folds
Uncalled bet ($0.15) returned to bcadb0b7
*** SHOWDOWN ***
bcadb0b7 collected $0.72 from pot
*** SUMMARY ***
Total pot $0.75 | Rake $0.03 | Jackpot $0 | Bingo $0 | Fortune $0 | Tax $0
Board [8d 2d 6d Td]
Seat 1: 50d5f1f7 (button) folded before Flop (didn't bet)
Seat 2: a837aa46 (small blind) folded before Flop
Seat 3: 11b7a8bd (big blind) folded before Flop
Seat 4: Hero folded before Flop (didn't bet)
Seat 5: 76f4ebd9 folded on the Turn
Seat 6: bcadb0b7 won ($0.72)


Poker Hand #RC2075598143: Hold'em No Limit ($0.05/$0.1) - 2023/12/21 23:38:49
Table 'RushAndCash299480' 6-max Seat #1 is the button
Seat 1: f06f155f ($19.87 in chips)
Seat 2: 19490bbd ($11.81 in chips)
Seat 3: 918f2e2e ($10.79 in chips)
Seat 4: 4a1ee628 ($5.98 in chips)
Seat 5: f616323e ($14.67 in chips)
Seat 6: Hero ($15.28 in chips)
19490bbd: posts small blind $0.05
918f2e2e: posts big blind $0.1
*** HOLE CARDS ***
Dealt to f06f155f 
Dealt to 19490bbd 
Dealt to 918f2e2e 
Dealt to 4a1ee628 
Dealt to f616323e 
Dealt to Hero [6h 3d]
4a1ee628: raises $0.12 to $0.22
f616323e: folds
Hero: folds
f06f155f: folds
19490bbd: calls $0.17
918f2e2e: raises $0.53 to $0.75
4a1ee628: raises $5.23 to $5.98 and is all-in
19490bbd: folds
918f2e2e: calls $5.23
4a1ee628: shows [Qd Qc]
918f2e2e: shows [As Kc]
*** FLOP *** [4c Qs 3s]
*** TURN *** [4c Qs 3s] [5c]
*** RIVER *** [4c Qs 3s 5c] [Jh]
*** SHOWDOWN ***
4a1ee628 collected $11.73 from pot
*** SUMMARY ***
Total pot $12.18 | Rake $0.3 | Jackpot $0.15 | Bingo $0 | Fortune $0 | Tax $0
Board [4c Qs 3s 5c Jh]
Seat 1: f06f155f (button) folded before Flop (didn't bet)
Seat 2: 19490bbd (small blind) folded before Flop
Seat 3: 918f2e2e (big blind) showed [As Kc] and lost with Ace-High
Seat 4: 4a1ee628 showed [Qd Qc] and won ($11.73) with Three Queens
Seat 5: f616323e folded before Flop (didn't bet)
Seat 6: Hero folded before Flop (didn't bet)


Poker Hand #RC2075597897: Hold'em No Limit ($0.05/$0.1) - 2023/12/21 23:38:38
Table 'RushAndCash299339' 6-max Seat #1 is the button
Seat 1: Hero ($15.28 in chips)
Seat 2: d52f5dce ($23.66 in chips)
Seat 3: 6e20c9c3 ($12.2 in chips)
Seat 4: 15103267 ($10.25 in chips)
Seat 5: 68807e0f ($9.94 in chips)
Seat 6: 62f53d13 ($7.94 in chips)
d52f5dce: posts small blind $0.05
6e20c9c3: posts big blind $0.1
*** HOLE CARDS ***
Dealt to Hero [Kh 5h]
Dealt to d52f5dce 
Dealt to 6e20c9c3 
Dealt to 15103267 
Dealt to 68807e0f 
Dealt to 62f53d13 
15103267: raises $0.12 to $0.22
68807e0f: folds
62f53d13: raises $0.48 to $0.7
Hero: folds
d52f5dce: folds
6e20c9c3: folds
15103267: folds
Uncalled bet ($0.48) returned to 62f53d13
*** SHOWDOWN ***
62f53d13 collected $0.56 from pot
*** SUMMARY ***
Total pot $0.59 | Rake $0.03 | Jackpot $0 | Bingo $0 | Fortune $0 | Tax $0
Seat 1: Hero (button) folded before Flop (didn't bet)
Seat 2: d52f5dce (small blind) folded before Flop
Seat 3: 6e20c9c3 (big blind) folded before Flop
Seat 4: 15103267 folded before Flop
Seat 5: 68807e0f folded before Flop (didn't bet)
Seat 6: 62f53d13 collected ($0.56)


Poker Hand #RC2075596879: Hold'em No Limit ($0.05/$0.1) - 2023/12/21 23:37:54
Table 'RushAndCash298763' 6-max Seat #1 is the button
Seat 1: c2dd4474 ($12.79 in chips)
Seat 2: e4426deb ($16.68 in chips)
Seat 3: f1892fb5 ($11.55 in chips)
Seat 4: Hero ($15.48 in chips)
Seat 5: f89a8725 ($15.32 in chips)
Seat 6: 2ef1f7c4 ($11.12 in chips)
e4426deb: posts small blind $0.05
f1892fb5: posts big blind $0.1
*** HOLE CARDS ***
Dealt to c2dd4474 
Dealt to e4426deb 
Dealt to f1892fb5 
Dealt to Hero [2d 2c]
Dealt to f89a8725 
Dealt to 2ef1f7c4 
Hero: raises $0.1 to $0.2
f89a8725: folds
2ef1f7c4: folds
c2dd4474: calls $0.2
e4426deb: calls $0.15
f1892fb5: calls $0.1
*** FLOP *** [3c 9c Qd]
e4426deb: checks
f1892fb5: checks
Hero: checks
c2dd4474: bets $0.3
e4426deb: calls $0.3
f1892fb5: folds
Hero: folds
*** TURN *** [3c 9c Qd] [Kh]
e4426deb: checks
c2dd4474: bets $1.4
e4426deb: raises $2.6 to $4
c2dd4474: folds
Uncalled bet ($2.6) returned to e4426deb
*** SHOWDOWN ***
e4426deb collected $3.85 from pot
*** SUMMARY ***
Total pot $4.2 | Rake $0.2 | Jackpot $0.15 | Bingo $0 | Fortune $0 | Tax $0
Board [3c 9c Qd Kh]
Seat 1: c2dd4474 (button) folded on the Turn
Seat 2: e4426deb (small blind) won ($3.85)
Seat 3: f1892fb5 (big blind) folded on the Flop
Seat 4: Hero folded on the Flop
Seat 5: f89a8725 folded before Flop (didn't bet)
Seat 6: 2ef1f7c4 folded before Flop (didn't bet)


Poker Hand #RC2075596750: Hold'em No Limit ($0.05/$0.1) - 2023/12/21 23:37:48
Table 'RushAndCash298691' 6-max Seat #1 is the button
Seat 1: 5e9b034b ($13.36 in chips)
Seat 2: Hero ($15.53 in chips)
Seat 3: b25008d6 ($12.69 in chips)
Seat 4: 46b22a80 ($18.64 in chips)
Seat 5: c92e79df ($12.3 in chips)
Seat 6: 6790cdfe ($10.02 in chips)
Hero: posts small blind $0.05
b25008d6: posts big blind $0.1
*** HOLE CARDS ***
Dealt to 5e9b034b 
Dealt to Hero [Qc 4h]
Dealt to b25008d6 
Dealt to 46b22a80 
Dealt to c92e79df 
Dealt to 6790cdfe 
46b22a80: folds
c92e79df: raises $0.13 to $0.23
6790cdfe: folds
5e9b034b: folds
Hero: folds
b25008d6: folds
Uncalled bet ($0.13) returned to c92e79df
*** SHOWDOWN ***
c92e79df collected $0.25 from pot
*** SUMMARY ***
Total pot $0.25 | Rake $0 | Jackpot $0 | Bingo $0 | Fortune $0 | Tax $0
Seat 1: 5e9b034b (button) folded before Flop (didn't bet)
Seat 2: Hero (small blind) folded before Flop
Seat 3: b25008d6 (big blind) folded before Flop
Seat 4: 46b22a80 folded before Flop (didn't bet)
Seat 5: c92e79df collected ($0.25)
Seat 6: 6790cdfe folded before Flop (didn't bet)


Poker Hand #RC2075596564: Hold'em No Limit ($0.05/$0.1) - 2023/12/21 23:37:40
Table 'RushAndCash298585' 6-max Seat #1 is the button
Seat 1: dd84fd1b ($10 in chips)
Seat 2: be294949 ($27.3 in chips)
Seat 3: Hero ($15.63 in chips)
Seat 4: e889978c ($17.58 in chips)
Seat 5: b3daa05a ($12.85 in chips)
Seat 6: d317b792 ($6.19 in chips)
be294949: posts small blind $0.05
Hero: posts big blind $0.1
*** HOLE CARDS ***
Dealt to dd84fd1b 
Dealt to be294949 
Dealt to Hero [9s 2c]
Dealt to e889978c 
Dealt to b3daa05a 
Dealt to d317b792 
e889978c: folds
b3daa05a: raises $0.15 to $0.25
d317b792: folds
dd84fd1b: folds
be294949: folds
Hero: folds
Uncalled bet ($0.15) returned to b3daa05a
*** SHOWDOWN ***
b3daa05a collected $0.25 from pot
*** SUMMARY ***
Total pot $0.25 | Rake $0 | Jackpot $0 | Bingo $0 | Fortune $0 | Tax $0
Seat 1: dd84fd1b (button) folded before Flop (didn't bet)
Seat 2: be294949 (small blind) folded before Flop
Seat 3: Hero (big blind) folded before Flop
Seat 4: e889978c folded before Flop (didn't bet)
Seat 5: b3daa05a collected ($0.25)
Seat 6: d317b792 folded before Flop (didn't bet)


Poker Hand #RC2075596448: Hold'em No Limit ($0.05/$0.1) - 2023/12/21 23:37:35
Table 'RushAndCash298517' 6-max Seat #1 is the button
Seat 1: 8932199d ($16.91 in chips)
Seat 2: 2cf092c4 ($14.49 in chips)
Seat 3: 3a7412a7 ($11.79 in chips)
Seat 4: Hero ($15.63 in chips)
Seat 5: 46e7bc86 ($10.82 in chips)
Seat 6: a7e691c9 ($17.24 in chips)
2cf092c4: posts small blind $0.05
3a7412a7: posts big blind $0.1
*** HOLE CARDS ***
Dealt to 8932199d 
Dealt to 2cf092c4 
Dealt to 3a7412a7 
Dealt to Hero [6h 9h]
Dealt to 46e7bc86 
Dealt to a7e691c9 
Hero: folds
46e7bc86: folds
a7e691c9: folds
8932199d: folds
2cf092c4: raises $0.2 to $0.3
3a7412a7: folds
Uncalled bet ($0.2) returned to 2cf092c4
*** SHOWDOWN ***
2cf092c4 collected $0.2 from pot
*** SUMMARY ***
Total pot $0.2 | Rake $0 | Jackpot $0 | Bingo $0 | Fortune $0 | Tax $0
Seat 1: 8932199d (button) folded before Flop (didn't bet)
Seat 2: 2cf092c4 (small blind) collected ($0.2)
Seat 3: 3a7412a7 (big blind) folded before Flop
Seat 4: Hero folded before Flop (didn't bet)
Seat 5: 46e7bc86 folded before Flop (didn't bet)
Seat 6: a7e691c9 folded before Flop (didn't bet)


Poker Hand #RC2075596359: Hold'em No Limit ($0.05/$0.1) - 2023/12/21 23:37:31
Table 'RushAndCash298469' 6-max Seat #1 is the button
Seat 1: 12fba559 ($20.44 in chips)
Seat 2: 4180e6b2 ($20.29 in chips)
Seat 3: 27c46f07 ($10.24 in chips)
Seat 4: e0e3bf27 ($11.66 in chips)
Seat 5: b6f96cb ($7.85 in chips)
Seat 6: Hero ($15.63 in chips)
4180e6b2: posts small blind $0.05
27c46f07: posts big blind $0.1
*** HOLE CARDS ***
Dealt to 12fba559 
Dealt to 4180e6b2 
Dealt to 27c46f07 
Dealt to e0e3bf27 
Dealt to b6f96cb 
Dealt to Hero [9d Qs]
e0e3bf27: folds
b6f96cb: raises $0.11 to $0.21
Hero: folds
12fba559: folds
4180e6b2: folds
27c46f07: folds
Uncalled bet ($0.11) returned to b6f96cb
*** SHOWDOWN ***
b6f96cb collected $0.25 from pot
*** SUMMARY ***
Total pot $0.25 | Rake $0 | Jackpot $0 | Bingo $0 | Fortune $0 | Tax $0
Seat 1: 12fba559 (button) folded before Flop (didn't bet)
Seat 2: 4180e6b2 (small blind) folded before Flop
Seat 3: 27c46f07 (big blind) folded before Flop
Seat 4: e0e3bf27 folded before Flop (didn't bet)
Seat 5: b6f96cb collected ($0.25)
Seat 6: Hero folded before Flop (didn't bet)


Poker Hand #RC2075596286: Hold'em No Limit ($0.05/$0.1) - 2023/12/21 23:37:28
Table 'RushAndCash298427' 6-max Seat #1 is the button
Seat 1: Hero ($15.63 in chips)
Seat 2: cc034b89 ($19.91 in chips)
Seat 3: c31f2e43 ($12.91 in chips)
Seat 4: dd84fd1b ($10 in chips)
Seat 5: 80c60920 ($10 in chips)
Seat 6: db45a1dd ($10.82 in chips)
cc034b89: posts small blind $0.05
c31f2e43: posts big blind $0.1
*** HOLE CARDS ***
Dealt to Hero [9h Ad]
Dealt to cc034b89 
Dealt to c31f2e43 
Dealt to dd84fd1b 
Dealt to 80c60920 
Dealt to db45a1dd 
dd84fd1b: folds
80c60920: folds
db45a1dd: folds
Hero: folds
cc034b89: folds
Uncalled bet ($0.05) returned to c31f2e43
*** SHOWDOWN ***
c31f2e43 collected $0.1 from pot
*** SUMMARY ***
Total pot $0.1 | Rake $0 | Jackpot $0 | Bingo $0 | Fortune $0 | Tax $0
Seat 1: Hero (button) folded before Flop (didn't bet)
Seat 2: cc034b89 (small blind) folded before Flop
Seat 3: c31f2e43 (big blind) collected ($0.1)
Seat 4: dd84fd1b folded before Flop (didn't bet)
Seat 5: 80c60920 folded before Flop (didn't bet)
Seat 6: db45a1dd folded before Flop (didn't bet)


Poker Hand #RC2075595722: Hold'em No Limit ($0.05/$0.1) - 2023/12/21 23:37:02
Table 'RushAndCash298107' 6-max Seat #1 is the button
Seat 1: 8e7494bb ($30.82 in chips)
Seat 2: ae4ceda9 ($14.1 in chips)
Seat 3: 5a7aed9f ($32.74 in chips)
Seat 4: 4e1bb4a9 ($52.2 in chips)
Seat 5: Hero ($15.83 in chips)
Seat 6: 31ea123d ($16.09 in chips)
ae4ceda9: posts small blind $0.05
5a7aed9f: posts big blind $0.1
*** HOLE CARDS ***
Dealt to 8e7494bb 
Dealt to ae4ceda9 
Dealt to 5a7aed9f 
Dealt to 4e1bb4a9 
Dealt to Hero [As 4s]
Dealt to 31ea123d 
4e1bb4a9: folds
Hero: raises $0.1 to $0.2
31ea123d: folds
8e7494bb: calls $0.2
ae4ceda9: folds
5a7aed9f: calls $0.1
*** FLOP *** [Jh Kc 4h]
5a7aed9f: checks
Hero: checks
8e7494bb: checks
*** TURN *** [Jh Kc 4h] [5s]
5a7aed9f: bets $0.33
Hero: folds
8e7494bb: folds
Uncalled bet ($0.33) returned to 5a7aed9f
*** SHOWDOWN ***
5a7aed9f collected $0.62 from pot
*** SUMMARY ***
Total pot $0.65 | Rake $0.03 | Jackpot $0 | Bingo $0 | Fortune $0 | Tax $0
Board [Jh Kc 4h 5s]
Seat 1: 8e7494bb (button) folded on the Turn
Seat 2: ae4ceda9 (small blind) folded before Flop
Seat 3: 5a7aed9f (big blind) won ($0.62)
Seat 4: 4e1bb4a9 folded before Flop (didn't bet)
Seat 5: Hero folded on the Turn
Seat 6: 31ea123d folded before Flop (didn't bet)


Poker Hand #RC2075594809: Hold'em No Limit ($0.05/$0.1) - 2023/12/21 23:36:23
Table 'RushAndCash297574' 6-max Seat #1 is the button
Seat 1: c1ccea94 ($24.03 in chips)
Seat 2: Hero ($16.08 in chips)
Seat 3: 3e9d02d0 ($10.69 in chips)
Seat 4: e087d3e2 ($10.05 in chips)
Seat 5: f0445c60 ($10.05 in chips)
Seat 6: 8e7494bb ($30.5 in chips)
Hero: posts small blind $0.05
3e9d02d0: posts big blind $0.1
*** HOLE CARDS ***
Dealt to c1ccea94 
Dealt to Hero [2s 2c]
Dealt to 3e9d02d0 
Dealt to e087d3e2 
Dealt to f0445c60 
Dealt to 8e7494bb 
e087d3e2: folds
f0445c60: folds
8e7494bb: raises $0.15 to $0.25
c1ccea94: folds
Hero: calls $0.2
3e9d02d0: folds
*** FLOP *** [9c 4c Tc]
Hero: checks
8e7494bb: checks
*** TURN *** [9c 4c Tc] [Qs]
Hero: checks
8e7494bb: checks
*** RIVER *** [9c 4c Tc Qs] [Th]
Hero: checks
8e7494bb: bets $0.67
Hero: folds
Uncalled bet ($0.67) returned to 8e7494bb
*** SHOWDOWN ***
8e7494bb collected $0.57 from pot
*** SUMMARY ***
Total pot $0.6 | Rake $0.03 | Jackpot $0 | Bingo $0 | Fortune $0 | Tax $0
Board [9c 4c Tc Qs Th]
Seat 1: c1ccea94 (button) folded before Flop (didn't bet)
Seat 2: Hero (small blind) folded on the River
Seat 3: 3e9d02d0 (big blind) folded before Flop
Seat 4: e087d3e2 folded before Flop (didn't bet)
Seat 5: f0445c60 folded before Flop (didn't bet)
Seat 6: 8e7494bb won ($0.57)


Poker Hand #RC2075584723: Hold'em No Limit ($0.05/$0.1) - 2023/12/21 23:36:18
Table 'RushAndCash297522' 6-max Seat #1 is the button
Seat 1: Hero ($16.08 in chips)
Seat 2: bba4186b ($7.68 in chips)
Seat 3: f0421476 ($9.5 in chips)
Seat 4: be2018bd ($9 in chips)
Seat 5: da62d8e8 ($10 in chips)
Seat 6: 11f85ff8 ($28.61 in chips)
bba4186b: posts small blind $0.05
f0421476: posts big blind $0.1
*** HOLE CARDS ***
Dealt to Hero [2s 5d]
Dealt to bba4186b 
Dealt to f0421476 
Dealt to be2018bd 
Dealt to da62d8e8 
Dealt to 11f85ff8 
be2018bd: folds
da62d8e8: raises $0.12 to $0.22
11f85ff8: calls $0.22
Hero: folds
bba4186b: calls $0.17
f0421476: folds
*** FLOP *** [Ts Tc 2h]
bba4186b: bets $0.57
da62d8e8: folds
11f85ff8: folds
Uncalled bet ($0.57) returned to bba4186b
*** SHOWDOWN ***
bba4186b collected $0.73 from pot
*** SUMMARY ***
Total pot $0.76 | Rake $0.03 | Jackpot $0 | Bingo $0 | Fortune $0 | Tax $0
Board [Ts Tc 2h]
Seat 1: Hero (button) folded before Flop (didn't bet)
Seat 2: bba4186b (small blind) won ($0.73)
Seat 3: f0421476 (big blind) folded before Flop
Seat 4: be2018bd folded before Flop (didn't bet)
Seat 5: da62d8e8 folded on the Flop
Seat 6: 11f85ff8 folded on the Flop


Poker Hand #RC2075583473: Hold'em No Limit ($0.05/$0.1) - 2023/12/21 23:35:23
Table 'RushAndCash296792' 6-max Seat #1 is the button
Seat 1: a2bf292a ($10 in chips)
Seat 2: 94b5433b ($34.05 in chips)
Seat 3: Hero ($16.99 in chips)
Seat 4: 6c088572 ($10.39 in chips)
Seat 5: 56cc92cb ($20.45 in chips)
Seat 6: 15f20d85 ($3.58 in chips)
94b5433b: posts small blind $0.05
Hero: posts big blind $0.1
*** HOLE CARDS ***
Dealt to a2bf292a 
Dealt to 94b5433b 
Dealt to Hero [Ac 4h]
Dealt to 6c088572 
Dealt to 56cc92cb 
Dealt to 15f20d85 
6c088572: folds
56cc92cb: folds
15f20d85: folds
a2bf292a: raises $0.15 to $0.25
94b5433b: folds
Hero: calls $0.15
*** FLOP *** [6c 3s Ah]
Hero: checks
a2bf292a: bets $0.17
Hero: calls $0.17
*** TURN *** [6c 3s Ah] [4d]
Hero: checks
a2bf292a: bets $0.49
Hero: calls $0.49
*** RIVER *** [6c 3s Ah 4d] [6d]
Hero: checks
a2bf292a: checks
Hero: shows [Ac 4h] (Pair of Aces and Pair of Sixes)
a2bf292a: shows [As 9c] (Pair of Aces and Pair of Sixes)
*** SHOWDOWN ***
a2bf292a collected $1.78 from pot
*** SUMMARY ***
Total pot $1.87 | Rake $0.09 | Jackpot $0 | Bingo $0 | Fortune $0 | Tax $0
Board [6c 3s Ah 4d 6d]
Seat 1: a2bf292a (button) showed [As 9c] and won ($1.78) with Pair of Aces and Pair of Sixes
Seat 2: 94b5433b (small blind) folded before Flop
Seat 3: Hero (big blind) showed [Ac 4h] and lost with Pair of Aces and Pair of Sixes
Seat 4: 6c088572 folded before Flop (didn't bet)
Seat 5: 56cc92cb folded before Flop (didn't bet)
Seat 6: 15f20d85 folded before Flop (didn't bet)


Poker Hand #RC2075583334: Hold'em No Limit ($0.05/$0.1) - 2023/12/21 23:35:18
Table 'RushAndCash296716' 6-max Seat #1 is the button
Seat 1: da041f02 ($10 in chips)
Seat 2: 82ce3dd4 ($4.2 in chips)
Seat 3: 4703e6e2 ($12.87 in chips)
Seat 4: e568a613 ($20.27 in chips)
Seat 5: Hero ($16.99 in chips)
Seat 6: fef126ba ($10.28 in chips)
82ce3dd4: posts small blind $0.05
4703e6e2: posts big blind $0.1
*** HOLE CARDS ***
Dealt to da041f02 
Dealt to 82ce3dd4 
Dealt to 4703e6e2 
Dealt to e568a613 
Dealt to Hero [2c 7c]
Dealt to fef126ba 
e568a613: folds
Hero: folds
fef126ba: folds
da041f02: folds
82ce3dd4: folds
Uncalled bet ($0.05) returned to 4703e6e2
*** SHOWDOWN ***
4703e6e2 collected $0.1 from pot
*** SUMMARY ***
Total pot $0.1 | Rake $0 | Jackpot $0 | Bingo $0 | Fortune $0 | Tax $0
Seat 1: da041f02 (button) folded before Flop (didn't bet)
Seat 2: 82ce3dd4 (small blind) folded before Flop
Seat 3: 4703e6e2 (big blind) collected ($0.1)
Seat 4: e568a613 folded before Flop (didn't bet)
Seat 5: Hero folded before Flop (didn't bet)
Seat 6: fef126ba folded before Flop (didn't bet)


Poker Hand #RC2075583203: Hold'em No Limit ($0.05/$0.1) - 2023/12/21 23:35:12
Table 'RushAndCash296643' 6-max Seat #1 is the button
Seat 1: Hero ($16.99 in chips)
Seat 2: cf879fe7 ($10.71 in chips)
Seat 3: 2546deef ($5.73 in chips)
Seat 4: afd0eb43 ($10.15 in chips)
Seat 5: a3dd2069 ($12.21 in chips)
Seat 6: d63653ff ($11.34 in chips)
cf879fe7: posts small blind $0.05
2546deef: posts big blind $0.1
*** HOLE CARDS ***
Dealt to Hero [Qh 3c]
Dealt to cf879fe7 
Dealt to 2546deef 
Dealt to afd0eb43 
Dealt to a3dd2069 
Dealt to d63653ff 
afd0eb43: folds
a3dd2069: folds
d63653ff: raises $0.15 to $0.25
Hero: folds
cf879fe7: folds
2546deef: calls $0.15
*** FLOP *** [Ah 9c Th]
2546deef: checks
d63653ff: bets $0.42
2546deef: folds
Uncalled bet ($0.42) returned to d63653ff
*** SHOWDOWN ***
d63653ff collected $0.53 from pot
*** SUMMARY ***
Total pot $0.55 | Rake $0.02 | Jackpot $0 | Bingo $0 | Fortune $0 | Tax $0
Board [Ah 9c Th]
Seat 1: Hero (button) folded before Flop (didn't bet)
Seat 2: cf879fe7 (small blind) folded before Flop
Seat 3: 2546deef (big blind) folded on the Flop
Seat 4: afd0eb43 folded before Flop (didn't bet)
Seat 5: a3dd2069 folded before Flop (didn't bet)
Seat 6: d63653ff won ($0.53)


Poker Hand #RC2075583105: Hold'em No Limit ($0.05/$0.1) - 2023/12/21 23:35:08
Table 'RushAndCash296592' 6-max Seat #1 is the button
Seat 1: 3e2719f9 ($20.81 in chips)
Seat 2: 8f3dd4c7 ($6.53 in chips)
Seat 3: 188b618a ($10.3 in chips)
Seat 4: 8ab6cdf3 ($12.18 in chips)
Seat 5: Hero ($16.99 in chips)
Seat 6: 74f7ee57 ($10.15 in chips)
8f3dd4c7: posts small blind $0.05
188b618a: posts big blind $0.1
*** HOLE CARDS ***
Dealt to 3e2719f9 
Dealt to 8f3dd4c7 
Dealt to 188b618a 
Dealt to 8ab6cdf3 
Dealt to Hero [7d 9s]
Dealt to 74f7ee57 
8ab6cdf3: folds
Hero: folds
74f7ee57: folds
3e2719f9: folds
8f3dd4c7: folds
Uncalled bet ($0.05) returned to 188b618a
*** SHOWDOWN ***
188b618a collected $0.1 from pot
*** SUMMARY ***
Total pot $0.1 | Rake $0 | Jackpot $0 | Bingo $0 | Fortune $0 | Tax $0
Seat 1: 3e2719f9 (button) folded before Flop (didn't bet)
Seat 2: 8f3dd4c7 (small blind) folded before Flop
Seat 3: 188b618a (big blind) collected ($0.1)
Seat 4: 8ab6cdf3 folded before Flop (didn't bet)
Seat 5: Hero folded before Flop (didn't bet)
Seat 6: 74f7ee57 folded before Flop (didn't bet)


Poker Hand #RC2075582698: Hold'em No Limit ($0.05/$0.1) - 2023/12/21 23:34:51
Table 'RushAndCash296363' 6-max Seat #1 is the button
Seat 1: 44c9b821 ($6.89 in chips)
Seat 2: 7539525b ($10.35 in chips)
Seat 3: a837aa46 ($48.43 in chips)
Seat 4: 19d4d1e2 ($75.27 in chips)
Seat 5: 7050748d ($4.77 in chips)
Seat 6: Hero ($16.84 in chips)
7539525b: posts small blind $0.05
a837aa46: posts big blind $0.1
*** HOLE CARDS ***
Dealt to 44c9b821 
Dealt to 7539525b 
Dealt to a837aa46 
Dealt to 19d4d1e2 
Dealt to 7050748d 
Dealt to Hero [Jc Qh]
19d4d1e2: folds
7050748d: folds
Hero: raises $0.1 to $0.2
44c9b821: folds
7539525b: folds
a837aa46: folds
Uncalled bet ($0.1) returned to Hero
*** SHOWDOWN ***
Hero collected $0.25 from pot
*** SUMMARY ***
Total pot $0.25 | Rake $0 | Jackpot $0 | Bingo $0 | Fortune $0 | Tax $0
Seat 1: 44c9b821 (button) folded before Flop (didn't bet)
Seat 2: 7539525b (small blind) folded before Flop
Seat 3: a837aa46 (big blind) folded before Flop
Seat 4: 19d4d1e2 folded before Flop (didn't bet)
Seat 5: 7050748d folded before Flop (didn't bet)
Seat 6: Hero collected ($0.25)


Poker Hand #RC2075582573: Hold'em No Limit ($0.05/$0.1) - 2023/12/21 23:34:46
Table 'RushAndCash296292' 6-max Seat #1 is the button
Seat 1: f22e4c47 ($10.02 in chips)
Seat 2: 8a752503 ($24.09 in chips)
Seat 3: 8326b18b ($12.53 in chips)
Seat 4: e481851b ($14.65 in chips)
Seat 5: Hero ($16.84 in chips)
Seat 6: 3e9d02d0 ($10.46 in chips)
8a752503: posts small blind $0.05
8326b18b: posts big blind $0.1
*** HOLE CARDS ***
Dealt to f22e4c47 
Dealt to 8a752503 
Dealt to 8326b18b 
Dealt to e481851b 
Dealt to Hero [9h 2h]
Dealt to 3e9d02d0 
e481851b: folds
Hero: folds
3e9d02d0: folds
f22e4c47: raises $0.2 to $0.3
8a752503: folds
8326b18b: folds
Uncalled bet ($0.2) returned to f22e4c47
*** SHOWDOWN ***
f22e4c47 collected $0.25 from pot
*** SUMMARY ***
Total pot $0.25 | Rake $0 | Jackpot $0 | Bingo $0 | Fortune $0 | Tax $0
Seat 1: f22e4c47 (button) collected ($0.25)
Seat 2: 8a752503 (small blind) folded before Flop
Seat 3: 8326b18b (big blind) folded before Flop
Seat 4: e481851b folded before Flop (didn't bet)
Seat 5: Hero folded before Flop (didn't bet)
Seat 6: 3e9d02d0 folded before Flop (didn't bet)


Poker Hand #RC2075582334: Hold'em No Limit ($0.05/$0.1) - 2023/12/21 23:34:35
Table 'RushAndCash296150' 6-max Seat #1 is the button
Seat 1: 22bdafa1 ($10 in chips)
Seat 2: 5a7794f3 ($8.62 in chips)
Seat 3: Hero ($16.94 in chips)
Seat 4: 7050748d ($4.62 in chips)
Seat 5: 36465e5a ($10.23 in chips)
Seat 6: c0a47dfa ($36.75 in chips)
5a7794f3: posts small blind $0.05
Hero: posts big blind $0.1
*** HOLE CARDS ***
Dealt to 22bdafa1 
Dealt to 5a7794f3 
Dealt to Hero [8s 3c]
Dealt to 7050748d 
Dealt to 36465e5a 
Dealt to c0a47dfa 
7050748d: raises $0.15 to $0.25
36465e5a: folds
c0a47dfa: folds
22bdafa1: folds
5a7794f3: folds
Hero: folds
Uncalled bet ($0.15) returned to 7050748d
*** SHOWDOWN ***
7050748d collected $0.25 from pot
*** SUMMARY ***
Total pot $0.25 | Rake $0 | Jackpot $0 | Bingo $0 | Fortune $0 | Tax $0
Seat 1: 22bdafa1 (button) folded before Flop (didn't bet)
Seat 2: 5a7794f3 (small blind) folded before Flop
Seat 3: Hero (big blind) folded before Flop
Seat 4: 7050748d collected ($0.25)
Seat 5: 36465e5a folded before Flop (didn't bet)
Seat 6: c0a47dfa folded before Flop (didn't bet)


Poker Hand #RC2075582162: Hold'em No Limit ($0.05/$0.1) - 2023/12/21 23:34:27
Table 'RushAndCash296043' 6-max Seat #1 is the button
Seat 1: 9c33e2c7 ($10.15 in chips)
Seat 2: Hero ($16.99 in chips)
Seat 3: 7539525b ($10.3 in chips)
Seat 4: a47e75ec ($19.9 in chips)
Seat 5: 30e36e59 ($10.1 in chips)
Seat 6: 7ba8aae3 ($11.01 in chips)
Hero: posts small blind $0.05
7539525b: posts big blind $0.1
*** HOLE CARDS ***
Dealt to 9c33e2c7 
Dealt to Hero [2s 6c]
Dealt to 7539525b 
Dealt to a47e75ec 
Dealt to 30e36e59 
Dealt to 7ba8aae3 
a47e75ec: folds
30e36e59: folds
7ba8aae3: folds
9c33e2c7: folds
Hero: folds
Uncalled bet ($0.05) returned to 7539525b
*** SHOWDOWN ***
7539525b collected $0.1 from pot
*** SUMMARY ***
Total pot $0.1 | Rake $0 | Jackpot $0 | Bingo $0 | Fortune $0 | Tax $0
Seat 1: 9c33e2c7 (button) folded before Flop (didn't bet)
Seat 2: Hero (small blind) folded before Flop
Seat 3: 7539525b (big blind) collected ($0.1)
Seat 4: a47e75ec folded before Flop (didn't bet)
Seat 5: 30e36e59 folded before Flop (didn't bet)
Seat 6: 7ba8aae3 folded before Flop (didn't bet)


Poker Hand #RC2075582021: Hold'em No Limit ($0.05/$0.1) - 2023/12/21 23:34:22
Table 'RushAndCash295962' 6-max Seat #1 is the button
Seat 1: 46c18cd5 ($5.46 in chips)
Seat 2: dfc8dd6f ($10 in chips)
Seat 3: 61685ef9 ($29.8 in chips)
Seat 4: 92e35b8f ($10 in chips)
Seat 5: 2d7523aa ($10.87 in chips)
Seat 6: Hero ($16.99 in chips)
dfc8dd6f: posts small blind $0.05
61685ef9: posts big blind $0.1
*** HOLE CARDS ***
Dealt to 46c18cd5 
Dealt to dfc8dd6f 
Dealt to 61685ef9 
Dealt to 92e35b8f 
Dealt to 2d7523aa 
Dealt to Hero [3c 5h]
92e35b8f: raises $0.12 to $0.22
2d7523aa: folds
Hero: folds
46c18cd5: folds
dfc8dd6f: raises $0.81 to $1.03
61685ef9: folds
92e35b8f: calls $0.81
*** FLOP *** [2c 6s Qd]
dfc8dd6f: bets $0.72
92e35b8f: calls $0.72
*** TURN *** [2c 6s Qd] [6d]
dfc8dd6f: bets $1.19
92e35b8f: folds
Uncalled bet ($1.19) returned to dfc8dd6f
*** SHOWDOWN ***
dfc8dd6f collected $3.28 from pot
*** SUMMARY ***
Total pot $3.6 | Rake $0.17 | Jackpot $0.15 | Bingo $0 | Fortune $0 | Tax $0
Board [2c 6s Qd 6d]
Seat 1: 46c18cd5 (button) folded before Flop (didn't bet)
Seat 2: dfc8dd6f (small blind) won ($3.28)
Seat 3: 61685ef9 (big blind) folded before Flop
Seat 4: 92e35b8f folded on the Turn
Seat 5: 2d7523aa folded before Flop (didn't bet)
Seat 6: Hero folded before Flop (didn't bet)


Poker Hand #RC2075581918: Hold'em No Limit ($0.05/$0.1) - 2023/12/21 23:34:17
Table 'RushAndCash295900' 6-max Seat #1 is the button
Seat 1: Hero ($16.99 in chips)
Seat 2: 5efae841 ($11.67 in chips)
Seat 3: 60b3834a ($6.93 in chips)
Seat 4: 6aa0cc1d ($10 in chips)
Seat 5: 98ccc29 ($19.15 in chips)
Seat 6: eb16ca9a ($32.07 in chips)
5efae841: posts small blind $0.05
60b3834a: posts big blind $0.1
*** HOLE CARDS ***
Dealt to Hero [Qh 2c]
Dealt to 5efae841 
Dealt to 60b3834a 
Dealt to 6aa0cc1d 
Dealt to 98ccc29 
Dealt to eb16ca9a 
6aa0cc1d: folds
98ccc29: folds
eb16ca9a: folds
Hero: folds
5efae841: folds
Uncalled bet ($0.05) returned to 60b3834a
*** SHOWDOWN ***
60b3834a collected $0.1 from pot
*** SUMMARY ***
Total pot $0.1 | Rake $0 | Jackpot $0 | Bingo $0 | Fortune $0 | Tax $0
Seat 1: Hero (button) folded before Flop (didn't bet)
Seat 2: 5efae841 (small blind) folded before Flop
Seat 3: 60b3834a (big blind) collected ($0.1)
Seat 4: 6aa0cc1d folded before Flop (didn't bet)
Seat 5: 98ccc29 folded before Flop (didn't bet)
Seat 6: eb16ca9a folded before Flop (didn't bet)


Poker Hand #RC2075581773: Hold'em No Limit ($0.05/$0.1) - 2023/12/21 23:34:11
Table 'RushAndCash295816' 6-max Seat #1 is the button
Seat 1: f4bd8f9 ($10.05 in chips)
Seat 2: bb01fcd0 ($10.44 in chips)
Seat 3: 3d83b5d2 ($29.4 in chips)
Seat 4: Hero ($16.99 in chips)
Seat 5: d8d6bf23 ($21.71 in chips)
Seat 6: 190b572b ($10.44 in chips)
bb01fcd0: posts small blind $0.05
3d83b5d2: posts big blind $0.1
*** HOLE CARDS ***
Dealt to f4bd8f9 
Dealt to bb01fcd0 
Dealt to 3d83b5d2 
Dealt to Hero [9c 8h]
Dealt to d8d6bf23 
Dealt to 190b572b 
Hero: folds
d8d6bf23: folds
190b572b: folds
f4bd8f9: folds
bb01fcd0: folds
Uncalled bet ($0.05) returned to 3d83b5d2
*** SHOWDOWN ***
3d83b5d2 collected $0.1 from pot
*** SUMMARY ***
Total pot $0.1 | Rake $0 | Jackpot $0 | Bingo $0 | Fortune $0 | Tax $0
Seat 1: f4bd8f9 (button) folded before Flop (didn't bet)
Seat 2: bb01fcd0 (small blind) folded before Flop
Seat 3: 3d83b5d2 (big blind) collected ($0.1)
Seat 4: Hero folded before Flop (didn't bet)
Seat 5: d8d6bf23 folded before Flop (didn't bet)
Seat 6: 190b572b folded before Flop (didn't bet)


Poker Hand #RC2075581673: Hold'em No Limit ($0.05/$0.1) - 2023/12/21 23:34:07
Table 'RushAndCash295759' 6-max Seat #1 is the button
Seat 1: f4f320ca ($18.27 in chips)
Seat 2: cac5f00e ($35.79 in chips)
Seat 3: 292d782 ($10.75 in chips)
Seat 4: 196f3bee ($11.43 in chips)
Seat 5: Hero ($16.99 in chips)
Seat 6: 8ccbc20a ($22.65 in chips)
cac5f00e: posts small blind $0.05
292d782: posts big blind $0.1
*** HOLE CARDS ***
Dealt to f4f320ca 
Dealt to cac5f00e 
Dealt to 292d782 
Dealt to 196f3bee 
Dealt to Hero [Kd 2h]
Dealt to 8ccbc20a 
196f3bee: raises $0.1 to $0.2
Hero: folds
8ccbc20a: folds
f4f320ca: folds
cac5f00e: folds
292d782: folds
Uncalled bet ($0.1) returned to 196f3bee
*** SHOWDOWN ***
196f3bee collected $0.25 from pot
*** SUMMARY ***
Total pot $0.25 | Rake $0 | Jackpot $0 | Bingo $0 | Fortune $0 | Tax $0
Seat 1: f4f320ca (button) folded before Flop (didn't bet)
Seat 2: cac5f00e (small blind) folded before Flop
Seat 3: 292d782 (big blind) folded before Flop
Seat 4: 196f3bee collected ($0.25)
Seat 5: Hero folded before Flop (didn't bet)
Seat 6: 8ccbc20a folded before Flop (didn't bet)


Poker Hand #RC2075581491: Hold'em No Limit ($0.05/$0.1) - 2023/12/21 23:33:58
Table 'RushAndCash295658' 6-max Seat #1 is the button
Seat 1: bba4186b ($3.85 in chips)
Seat 2: 598922ef ($34.72 in chips)
Seat 3: Hero ($17.09 in chips)
Seat 4: 9c562155 ($7.6 in chips)
Seat 5: c7064c89 ($10.91 in chips)
Seat 6: dd69db1b ($11.42 in chips)
598922ef: posts small blind $0.05
Hero: posts big blind $0.1
*** HOLE CARDS ***
Dealt to bba4186b 
Dealt to 598922ef 
Dealt to Hero [2s Ah]
Dealt to 9c562155 
Dealt to c7064c89 
Dealt to dd69db1b 
9c562155: folds
c7064c89: folds
dd69db1b: folds
bba4186b: raises $0.1 to $0.2
598922ef: raises $0.8 to $1
Hero: folds
bba4186b: raises $2.85 to $3.85 and is all-in
598922ef: calls $2.85
bba4186b: shows [Ts Td]
598922ef: shows [9d 9h]
*** FIRST FLOP *** [4c 2c 6d]
*** FIRST TURN *** [4c 2c 6d] [6s]
*** FIRST RIVER *** [4c 2c 6d 6s] [4s]
*** SECOND FLOP *** [2h Ac 5d]
*** SECOND TURN *** [2h Ac 5d] [Jh]
*** SECOND RIVER *** [2h Ac 5d Jh] [Qh]
*** FIRST SHOWDOWN ***
bba4186b collected $3.68 from pot
*** SECOND SHOWDOWN ***
bba4186b collected $3.67 from pot
*** SUMMARY ***
Total pot $7.8 | Rake $0.3 | Jackpot $0.15 | Bingo $0 | Fortune $0 | Tax $0
Hand was run two times
FIRST Board [4c 2c 6d 6s 4s]
SECOND Board [2h Ac 5d Jh Qh]
Seat 1: bba4186b (button) showed [Ts Td] and won ($3.68) with Pair of Tens and Pair of Sixes, and won ($3.67) with Pair of Tens
Seat 2: 598922ef (small blind) showed [9d 9h] and lost with Pair of Nines and Pair of Sixes, and lost with Pair of Nines
Seat 3: Hero (big blind) folded before Flop
Seat 4: 9c562155 folded before Flop (didn't bet)
Seat 5: c7064c89 folded before Flop (didn't bet)
Seat 6: dd69db1b folded before Flop (didn't bet)


Poker Hand #RC2075581350: Hold'em No Limit ($0.05/$0.1) - 2023/12/21 23:33:53
Table 'RushAndCash295580' 6-max Seat #1 is the button
Seat 1: 6171e97d ($12.61 in chips)
Seat 2: 20cdc7db ($10.82 in chips)
Seat 3: f168df8e ($16.16 in chips)
Seat 4: 9c11fa0c ($16.1 in chips)
Seat 5: Hero ($17.09 in chips)
Seat 6: 320aaa96 ($10.15 in chips)
20cdc7db: posts small blind $0.05
f168df8e: posts big blind $0.1
*** HOLE CARDS ***
Dealt to 6171e97d 
Dealt to 20cdc7db 
Dealt to f168df8e 
Dealt to 9c11fa0c 
Dealt to Hero [9h Kh]
Dealt to 320aaa96 
9c11fa0c: raises $0.13 to $0.23
Hero: folds
320aaa96: folds
6171e97d: folds
20cdc7db: folds
f168df8e: folds
Uncalled bet ($0.13) returned to 9c11fa0c
*** SHOWDOWN ***
9c11fa0c collected $0.25 from pot
*** SUMMARY ***
Total pot $0.25 | Rake $0 | Jackpot $0 | Bingo $0 | Fortune $0 | Tax $0
Seat 1: 6171e97d (button) folded before Flop (didn't bet)
Seat 2: 20cdc7db (small blind) folded before Flop
Seat 3: f168df8e (big blind) folded before Flop
Seat 4: 9c11fa0c collected ($0.25)
Seat 5: Hero folded before Flop (didn't bet)
Seat 6: 320aaa96 folded before Flop (didn't bet)


Poker Hand #RC2075581152: Hold'em No Limit ($0.05/$0.1) - 2023/12/21 23:33:45
Table 'RushAndCash295461' 6-max Seat #1 is the button
Seat 1: f2921f78 ($19.66 in chips)
Seat 2: Hero ($17.14 in chips)
Seat 3: 5cddbd12 ($5.48 in chips)
Seat 4: 92ab9934 ($6.5 in chips)
Seat 5: 21299dbf ($7.46 in chips)
Seat 6: ac869efa ($13.14 in chips)
Hero: posts small blind $0.05
5cddbd12: posts big blind $0.1
*** HOLE CARDS ***
Dealt to f2921f78 
Dealt to Hero [5d 7h]
Dealt to 5cddbd12 
Dealt to 92ab9934 
Dealt to 21299dbf 
Dealt to ac869efa 
92ab9934: folds
21299dbf: folds
ac869efa: folds
f2921f78: folds
Hero: folds
Uncalled bet ($0.05) returned to 5cddbd12
*** SHOWDOWN ***
5cddbd12 collected $0.1 from pot
*** SUMMARY ***
Total pot $0.1 | Rake $0 | Jackpot $0 | Bingo $0 | Fortune $0 | Tax $0
Seat 1: f2921f78 (button) folded before Flop (didn't bet)
Seat 2: Hero (small blind) folded before Flop
Seat 3: 5cddbd12 (big blind) collected ($0.1)
Seat 4: 92ab9934 folded before Flop (didn't bet)
Seat 5: 21299dbf folded before Flop (didn't bet)
Seat 6: ac869efa folded before Flop (didn't bet)


Poker Hand #RC2075580927: Hold'em No Limit ($0.05/$0.1) - 2023/12/21 23:33:35
Table 'RushAndCash295334' 6-max Seat #1 is the button
Seat 1: 993a804c ($3.95 in chips)
Seat 2: e329e1e4 ($9.49 in chips)
Seat 3: Hero ($17.24 in chips)
Seat 4: 9b5e26de ($47.87 in chips)
Seat 5: e561f7e7 ($12 in chips)
Seat 6: f616323e ($19.94 in chips)
e329e1e4: posts small blind $0.05
Hero: posts big blind $0.1
*** HOLE CARDS ***
Dealt to 993a804c 
Dealt to e329e1e4 
Dealt to Hero [Tc 5c]
Dealt to 9b5e26de 
Dealt to e561f7e7 
Dealt to f616323e 
9b5e26de: folds
e561f7e7: raises $0.15 to $0.25
f616323e: folds
993a804c: calls $0.25
e329e1e4: folds
Hero: folds
*** FLOP *** [Jd Kh 9c]
e561f7e7: checks
993a804c: bets $0.49
e561f7e7: calls $0.49
*** TURN *** [Jd Kh 9c] [5d]
e561f7e7: checks
993a804c: checks
*** RIVER *** [Jd Kh 9c 5d] [5s]
e561f7e7: checks
993a804c: bets $3.21 and is all-in
e561f7e7: folds
Uncalled bet ($3.21) returned to 993a804c
*** SHOWDOWN ***
993a804c collected $1.55 from pot
*** SUMMARY ***
Total pot $1.63 | Rake $0.08 | Jackpot $0 | Bingo $0 | Fortune $0 | Tax $0
Board [Jd Kh 9c 5d 5s]
Seat 1: 993a804c (button) won ($1.55)
Seat 2: e329e1e4 (small blind) folded before Flop
Seat 3: Hero (big blind) folded before Flop
Seat 4: 9b5e26de folded before Flop (didn't bet)
Seat 5: e561f7e7 folded on the River
Seat 6: f616323e folded before Flop (didn't bet)


Poker Hand #RC2075580846: Hold'em No Limit ($0.05/$0.1) - 2023/12/21 23:33:32
Table 'RushAndCash295287' 6-max Seat #1 is the button
Seat 1: cc034b89 ($19.65 in chips)
Seat 2: e8d5c5ad ($10 in chips)
Seat 3: 22c92514 ($10.21 in chips)
Seat 4: Hero ($17.24 in chips)
Seat 5: a377dd30 ($16.83 in chips)
Seat 6: 44608aa1 ($12.04 in chips)
e8d5c5ad: posts small blind $0.05
22c92514: posts big blind $0.1
*** HOLE CARDS ***
Dealt to cc034b89 
Dealt to e8d5c5ad 
Dealt to 22c92514 
Dealt to Hero [Th 6d]
Dealt to a377dd30 
Dealt to 44608aa1 
Hero: folds
a377dd30: folds
44608aa1: raises $0.2 to $0.3
cc034b89: folds
e8d5c5ad: folds
22c92514: folds
Uncalled bet ($0.2) returned to 44608aa1
*** SHOWDOWN ***
44608aa1 collected $0.25 from pot
*** SUMMARY ***
Total pot $0.25 | Rake $0 | Jackpot $0 | Bingo $0 | Fortune $0 | Tax $0
Seat 1: cc034b89 (button) folded before Flop (didn't bet)
Seat 2: e8d5c5ad (small blind) folded before Flop
Seat 3: 22c92514 (big blind) folded before Flop
Seat 4: Hero folded before Flop (didn't bet)
Seat 5: a377dd30 folded before Flop (didn't bet)
Seat 6: 44608aa1 collected ($0.25)


Poker Hand #RC2075580767: Hold'em No Limit ($0.05/$0.1) - 2023/12/21 23:33:29
Table 'RushAndCash295241' 6-max Seat #1 is the button
Seat 1: 9c66bf60 ($14.05 in chips)
Seat 2: 37598c58 ($10 in chips)
Seat 3: 5e9b034b ($10.79 in chips)
Seat 4: 9b8a916d ($11.18 in chips)
Seat 5: Hero ($17.24 in chips)
Seat 6: 2e53f43e ($10 in chips)
37598c58: posts small blind $0.05
5e9b034b: posts big blind $0.1
*** HOLE CARDS ***
Dealt to 9c66bf60 
Dealt to 37598c58 
Dealt to 5e9b034b 
Dealt to 9b8a916d 
Dealt to Hero [7c Ks]
Dealt to 2e53f43e 
9b8a916d: folds
Hero: folds
2e53f43e: raises $0.15 to $0.25
9c66bf60: raises $0.5 to $0.75
37598c58: folds
5e9b034b: folds
2e53f43e: calls $0.5
*** FLOP *** [Td Ts 5d]
2e53f43e: checks
9c66bf60: checks
*** TURN *** [Td Ts 5d] [8c]
2e53f43e: checks
9c66bf60: checks
*** RIVER *** [Td Ts 5d 8c] [3d]
2e53f43e: checks
9c66bf60: bets $1.05
2e53f43e: folds
Uncalled bet ($1.05) returned to 9c66bf60
*** SHOWDOWN ***
9c66bf60 collected $1.57 from pot
*** SUMMARY ***
Total pot $1.65 | Rake $0.08 | Jackpot $0 | Bingo $0 | Fortune $0 | Tax $0
Board [Td Ts 5d 8c 3d]
Seat 1: 9c66bf60 (button) won ($1.57)
Seat 2: 37598c58 (small blind) folded before Flop
Seat 3: 5e9b034b (big blind) folded before Flop
Seat 4: 9b8a916d folded before Flop (didn't bet)
Seat 5: Hero folded before Flop (didn't bet)
Seat 6: 2e53f43e folded on the River


Poker Hand #RC2075580206: Hold'em No Limit ($0.05/$0.1) - 2023/12/21 23:33:04
Table 'RushAndCash294919' 6-max Seat #1 is the button
Seat 1: e0e638e8 ($28.96 in chips)
Seat 2: Hero ($17.45 in chips)
Seat 3: 6ccc8ac3 ($11.46 in chips)
Seat 4: 6d508c29 ($14.7 in chips)
Seat 5: af662651 ($10 in chips)
Seat 6: 57ecc71e ($4.25 in chips)
Hero: posts small blind $0.05
6ccc8ac3: posts big blind $0.1
*** HOLE CARDS ***
Dealt to e0e638e8 
Dealt to Hero [8h Th]
Dealt to 6ccc8ac3 
Dealt to 6d508c29 
Dealt to af662651 
Dealt to 57ecc71e 
6d508c29: folds
af662651: folds
57ecc71e: raises $0.11 to $0.21
e0e638e8: folds
Hero: calls $0.16
6ccc8ac3: calls $0.11
*** FLOP *** [2s 9c 5h]
Hero: checks
6ccc8ac3: checks
57ecc71e: bets $0.21
Hero: folds
6ccc8ac3: folds
Uncalled bet ($0.21) returned to 57ecc71e
*** SHOWDOWN ***
57ecc71e collected $0.6 from pot
*** SUMMARY ***
Total pot $0.63 | Rake $0.03 | Jackpot $0 | Bingo $0 | Fortune $0 | Tax $0
Board [2s 9c 5h]
Seat 1: e0e638e8 (button) folded before Flop (didn't bet)
Seat 2: Hero (small blind) folded on the Flop
Seat 3: 6ccc8ac3 (big blind) folded on the Flop
Seat 4: 6d508c29 folded before Flop (didn't bet)
Seat 5: af662651 folded before Flop (didn't bet)
Seat 6: 57ecc71e won ($0.6)


Poker Hand #RC2075580028: Hold'em No Limit ($0.05/$0.1) - 2023/12/21 23:32:57
Table 'RushAndCash294819' 6-max Seat #1 is the button
Seat 1: 5e617a08 ($12.47 in chips)
Seat 2: f16e9798 ($10.62 in chips)
Seat 3: 28d15b39 ($10 in chips)
Seat 4: Hero ($17.45 in chips)
Seat 5: fe713d8b ($10.2 in chips)
Seat 6: f6e4ebac ($10 in chips)
f16e9798: posts small blind $0.05
28d15b39: posts big blind $0.1
*** HOLE CARDS ***
Dealt to 5e617a08 
Dealt to f16e9798 
Dealt to 28d15b39 
Dealt to Hero [8c 6h]
Dealt to fe713d8b 
Dealt to f6e4ebac 
Hero: folds
fe713d8b: folds
f6e4ebac: folds
5e617a08: folds
f16e9798: raises $0.2 to $0.3
28d15b39: folds
Uncalled bet ($0.2) returned to f16e9798
*** SHOWDOWN ***
f16e9798 collected $0.2 from pot
*** SUMMARY ***
Total pot $0.2 | Rake $0 | Jackpot $0 | Bingo $0 | Fortune $0 | Tax $0
Seat 1: 5e617a08 (button) folded before Flop (didn't bet)
Seat 2: f16e9798 (small blind) collected ($0.2)
Seat 3: 28d15b39 (big blind) folded before Flop
Seat 4: Hero folded before Flop (didn't bet)
Seat 5: fe713d8b folded before Flop (didn't bet)
Seat 6: f6e4ebac folded before Flop (didn't bet)


Poker Hand #RC2075579934: Hold'em No Limit ($0.05/$0.1) - 2023/12/21 23:32:53
Table 'RushAndCash294765' 6-max Seat #1 is the button
Seat 1: Hero ($17.45 in chips)
Seat 2: 20cdc7db ($10.74 in chips)
Seat 3: 915d8ff9 ($10.58 in chips)
Seat 4: 82e4dbbc ($9.9 in chips)
Seat 5: 11a74ecd ($16.31 in chips)
Seat 6: d8d6bf23 ($21.89 in chips)
20cdc7db: posts small blind $0.05
915d8ff9: posts big blind $0.1
*** HOLE CARDS ***
Dealt to Hero [9h 7c]
Dealt to 20cdc7db 
Dealt to 915d8ff9 
Dealt to 82e4dbbc 
Dealt to 11a74ecd 
Dealt to d8d6bf23 
82e4dbbc: folds
11a74ecd: folds
d8d6bf23: folds
Hero: folds
20cdc7db: calls $0.05
915d8ff9: checks
*** FLOP *** [9d Ah 2d]
20cdc7db: bets $0.1
915d8ff9: calls $0.1
*** TURN *** [9d Ah 2d] [Qh]
20cdc7db: bets $0.2
915d8ff9: folds
Uncalled bet ($0.2) returned to 20cdc7db
*** SHOWDOWN ***
20cdc7db collected $0.38 from pot
*** SUMMARY ***
Total pot $0.4 | Rake $0.02 | Jackpot $0 | Bingo $0 | Fortune $0 | Tax $0
Board [9d Ah 2d Qh]
Seat 1: Hero (button) folded before Flop (didn't bet)
Seat 2: 20cdc7db (small blind) won ($0.38)
Seat 3: 915d8ff9 (big blind) folded on the Turn
Seat 4: 82e4dbbc folded before Flop (didn't bet)
Seat 5: 11a74ecd folded before Flop (didn't bet)
Seat 6: d8d6bf23 folded before Flop (didn't bet)


Poker Hand #RC2075579450: Hold'em No Limit ($0.05/$0.1) - 2023/12/21 23:32:32
Table 'RushAndCash294487' 6-max Seat #1 is the button
Seat 1: a3d8a7a6 ($10.87 in chips)
Seat 2: 6171e97d ($9.75 in chips)
Seat 3: b3f60e24 ($10.45 in chips)
Seat 4: Hero ($16.76 in chips)
Seat 5: 677e2427 ($10.97 in chips)
Seat 6: 5241ee79 ($15.89 in chips)
6171e97d: posts small blind $0.05
b3f60e24: posts big blind $0.1
*** HOLE CARDS ***
Dealt to a3d8a7a6 
Dealt to 6171e97d 
Dealt to b3f60e24 
Dealt to Hero [8d 8c]
Dealt to 677e2427 
Dealt to 5241ee79 
Hero: raises $0.1 to $0.2
677e2427: folds
5241ee79: raises $0.4 to $0.6
a3d8a7a6: folds
6171e97d: folds
b3f60e24: folds
Hero: raises $1.42 to $2.02
5241ee79: folds
Uncalled bet ($1.42) returned to Hero
*** SHOWDOWN ***
Hero collected $1.29 from pot
*** SUMMARY ***
Total pot $1.35 | Rake $0.06 | Jackpot $0 | Bingo $0 | Fortune $0 | Tax $0
Seat 1: a3d8a7a6 (button) folded before Flop (didn't bet)
Seat 2: 6171e97d (small blind) folded before Flop
Seat 3: b3f60e24 (big blind) folded before Flop
Seat 4: Hero collected ($1.29)
Seat 5: 677e2427 folded before Flop (didn't bet)
Seat 6: 5241ee79 folded before Flop


Poker Hand #RC2075579318: Hold'em No Limit ($0.05/$0.1) - 2023/12/21 23:32:26
Table 'RushAndCash294411' 6-max Seat #1 is the button
Seat 1: Hero ($16.76 in chips)
Seat 2: 23ab2c57 ($11.91 in chips)
Seat 3: ecf8da6b ($13.68 in chips)
Seat 4: 2b7f693f ($9.65 in chips)
Seat 5: fef126ba ($10 in chips)
Seat 6: 220d2aa5 ($8.95 in chips)
23ab2c57: posts small blind $0.05
ecf8da6b: posts big blind $0.1
*** HOLE CARDS ***
Dealt to Hero [5d 9s]
Dealt to 23ab2c57 
Dealt to ecf8da6b 
Dealt to 2b7f693f 
Dealt to fef126ba 
Dealt to 220d2aa5 
2b7f693f: folds
fef126ba: folds
220d2aa5: folds
Hero: folds
23ab2c57: folds
Uncalled bet ($0.05) returned to ecf8da6b
*** SHOWDOWN ***
ecf8da6b collected $0.1 from pot
*** SUMMARY ***
Total pot $0.1 | Rake $0 | Jackpot $0 | Bingo $0 | Fortune $0 | Tax $0
Seat 1: Hero (button) folded before Flop (didn't bet)
Seat 2: 23ab2c57 (small blind) folded before Flop
Seat 3: ecf8da6b (big blind) collected ($0.1)
Seat 4: 2b7f693f folded before Flop (didn't bet)
Seat 5: fef126ba folded before Flop (didn't bet)
Seat 6: 220d2aa5 folded before Flop (didn't bet)


Poker Hand #RC2075579219: Hold'em No Limit ($0.05/$0.1) - 2023/12/21 23:32:22
Table 'RushAndCash294351' 6-max Seat #1 is the button
Seat 1: c6de47fd ($43.49 in chips)
Seat 2: Hero ($16.81 in chips)
Seat 3: 43833183 ($11.35 in chips)
Seat 4: a5b681f6 ($10 in chips)
Seat 5: 4f13ac3b ($10.23 in chips)
Seat 6: 113d2da1 ($11.17 in chips)
Hero: posts small blind $0.05
43833183: posts big blind $0.1
*** HOLE CARDS ***
Dealt to c6de47fd 
Dealt to Hero [3s 6c]
Dealt to 43833183 
Dealt to a5b681f6 
Dealt to 4f13ac3b 
Dealt to 113d2da1 
a5b681f6: folds
4f13ac3b: folds
113d2da1: calls $0.1
c6de47fd: raises $0.24 to $0.34
Hero: folds
43833183: calls $0.24
113d2da1: calls $0.24
*** FLOP *** [4c 3c 6h]
43833183: checks
113d2da1: bets $0.54
c6de47fd: folds
43833183: folds
Uncalled bet ($0.54) returned to 113d2da1
*** SHOWDOWN ***
113d2da1 collected $1.02 from pot
*** SUMMARY ***
Total pot $1.07 | Rake $0.05 | Jackpot $0 | Bingo $0 | Fortune $0 | Tax $0
Board [4c 3c 6h]
Seat 1: c6de47fd (button) folded on the Flop
Seat 2: Hero (small blind) folded before Flop
Seat 3: 43833183 (big blind) folded on the Flop
Seat 4: a5b681f6 folded before Flop (didn't bet)
Seat 5: 4f13ac3b folded before Flop (didn't bet)
Seat 6: 113d2da1 won ($1.02)


Poker Hand #RC2075579102: Hold'em No Limit ($0.05/$0.1) - 2023/12/21 23:32:17
Table 'RushAndCash294286' 6-max Seat #1 is the button
Seat 1: 5a7794f3 ($9.35 in chips)
Seat 2: 1e4c755a ($11.09 in chips)
Seat 3: e7322801 ($13.41 in chips)
Seat 4: 27294907 ($12.37 in chips)
Seat 5: Hero ($16.81 in chips)
Seat 6: e0b74dd7 ($36.76 in chips)
1e4c755a: posts small blind $0.05
e7322801: posts big blind $0.1
*** HOLE CARDS ***
Dealt to 5a7794f3 
Dealt to 1e4c755a 
Dealt to e7322801 
Dealt to 27294907 
Dealt to Hero [Qd 8h]
Dealt to e0b74dd7 
27294907: folds
Hero: folds
e0b74dd7: folds
5a7794f3: folds
1e4c755a: raises $0.2 to $0.3
e7322801: folds
Uncalled bet ($0.2) returned to 1e4c755a
*** SHOWDOWN ***
1e4c755a collected $0.2 from pot
*** SUMMARY ***
Total pot $0.2 | Rake $0 | Jackpot $0 | Bingo $0 | Fortune $0 | Tax $0
Seat 1: 5a7794f3 (button) folded before Flop (didn't bet)
Seat 2: 1e4c755a (small blind) collected ($0.2)
Seat 3: e7322801 (big blind) folded before Flop
Seat 4: 27294907 folded before Flop (didn't bet)
Seat 5: Hero folded before Flop (didn't bet)
Seat 6: e0b74dd7 folded before Flop (didn't bet)


Poker Hand #RC2075578967: Hold'em No Limit ($0.05/$0.1) - 2023/12/21 23:32:11
Table 'RushAndCash294212' 6-max Seat #1 is the button
Seat 1: 5a7aed9f ($30.26 in chips)
Seat 2: cfffc369 ($10 in chips)
Seat 3: Hero ($16.91 in chips)
Seat 4: 7dc7f15b ($15.03 in chips)
Seat 5: c3428d47 ($13.49 in chips)
Seat 6: 7539525b ($10.1 in chips)
cfffc369: posts small blind $0.05
Hero: posts big blind $0.1
*** HOLE CARDS ***
Dealt to 5a7aed9f 
Dealt to cfffc369 
Dealt to Hero [3s Th]
Dealt to 7dc7f15b 
Dealt to c3428d47 
Dealt to 7539525b 
7dc7f15b: folds
c3428d47: folds
7539525b: raises $0.15 to $0.25
5a7aed9f: folds
cfffc369: folds
Hero: folds
Uncalled bet ($0.15) returned to 7539525b
*** SHOWDOWN ***
7539525b collected $0.25 from pot
*** SUMMARY ***
Total pot $0.25 | Rake $0 | Jackpot $0 | Bingo $0 | Fortune $0 | Tax $0
Seat 1: 5a7aed9f (button) folded before Flop (didn't bet)
Seat 2: cfffc369 (small blind) folded before Flop
Seat 3: Hero (big blind) folded before Flop
Seat 4: 7dc7f15b folded before Flop (didn't bet)
Seat 5: c3428d47 folded before Flop (didn't bet)
Seat 6: 7539525b collected ($0.25)


Poker Hand #RC2075578829: Hold'em No Limit ($0.05/$0.1) - 2023/12/21 23:32:06
Table 'RushAndCash294136' 6-max Seat #1 is the button
Seat 1: 4369227d ($10 in chips)
Seat 2: ef7c0e05 ($11.46 in chips)
Seat 3: 98e36303 ($34.32 in chips)
Seat 4: ba021e99 ($8.48 in chips)
Seat 5: Hero ($16.91 in chips)
Seat 6: 8e7494bb ($31.86 in chips)
ef7c0e05: posts small blind $0.05
98e36303: posts big blind $0.1
*** HOLE CARDS ***
Dealt to 4369227d 
Dealt to ef7c0e05 
Dealt to 98e36303 
Dealt to ba021e99 
Dealt to Hero [Ad 4c]
Dealt to 8e7494bb 
ba021e99: raises $0.1 to $0.2
Hero: folds
8e7494bb: folds
4369227d: folds
ef7c0e05: folds
98e36303: folds
Uncalled bet ($0.1) returned to ba021e99
*** SHOWDOWN ***
ba021e99 collected $0.25 from pot
*** SUMMARY ***
Total pot $0.25 | Rake $0 | Jackpot $0 | Bingo $0 | Fortune $0 | Tax $0
Seat 1: 4369227d (button) folded before Flop (didn't bet)
Seat 2: ef7c0e05 (small blind) folded before Flop
Seat 3: 98e36303 (big blind) folded before Flop
Seat 4: ba021e99 collected ($0.25)
Seat 5: Hero folded before Flop (didn't bet)
Seat 6: 8e7494bb folded before Flop (didn't bet)


Poker Hand #RC2075578742: Hold'em No Limit ($0.05/$0.1) - 2023/12/21 23:32:01
Table 'RushAndCash294086' 6-max Seat #1 is the button
Seat 1: 2ef1f7c4 ($12.42 in chips)
Seat 2: 510de39d ($11.92 in chips)
Seat 3: c3428d47 ($13.59 in chips)
Seat 4: f2a14e94 ($12.39 in chips)
Seat 5: 76f4ebd9 ($27.88 in chips)
Seat 6: Hero ($16.91 in chips)
510de39d: posts small blind $0.05
c3428d47: posts big blind $0.1
*** HOLE CARDS ***
Dealt to 2ef1f7c4 
Dealt to 510de39d 
Dealt to c3428d47 
Dealt to f2a14e94 
Dealt to 76f4ebd9 
Dealt to Hero [Td 6c]
f2a14e94: folds
76f4ebd9: folds
Hero: folds
2ef1f7c4: folds
510de39d: raises $0.2 to $0.3
c3428d47: folds
Uncalled bet ($0.2) returned to 510de39d
*** SHOWDOWN ***
510de39d collected $0.2 from pot
*** SUMMARY ***
Total pot $0.2 | Rake $0 | Jackpot $0 | Bingo $0 | Fortune $0 | Tax $0
Seat 1: 2ef1f7c4 (button) folded before Flop (didn't bet)
Seat 2: 510de39d (small blind) collected ($0.2)
Seat 3: c3428d47 (big blind) folded before Flop
Seat 4: f2a14e94 folded before Flop (didn't bet)
Seat 5: 76f4ebd9 folded before Flop (didn't bet)
Seat 6: Hero folded before Flop (didn't bet)


Poker Hand #RC2075578655: Hold'em No Limit ($0.05/$0.1) - 2023/12/21 23:31:57
Table 'RushAndCash294037' 6-max Seat #1 is the button
Seat 1: 9951f56b ($11.14 in chips)
Seat 2: 6f163270 ($14.4 in chips)
Seat 3: e1e5daa1 ($12.46 in chips)
Seat 4: Hero ($16.91 in chips)
Seat 5: 7ddc107 ($12.77 in chips)
Seat 6: 4adae999 ($10 in chips)
6f163270: posts small blind $0.05
e1e5daa1: posts big blind $0.1
*** HOLE CARDS ***
Dealt to 9951f56b 
Dealt to 6f163270 
Dealt to e1e5daa1 
Dealt to Hero [2s 8d]
Dealt to 7ddc107 
Dealt to 4adae999 
Hero: folds
7ddc107: folds
4adae999: folds
9951f56b: raises $0.15 to $0.25
6f163270: folds
e1e5daa1: folds
Uncalled bet ($0.15) returned to 9951f56b
*** SHOWDOWN ***
9951f56b collected $0.25 from pot
*** SUMMARY ***
Total pot $0.25 | Rake $0 | Jackpot $0 | Bingo $0 | Fortune $0 | Tax $0
Seat 1: 9951f56b (button) collected ($0.25)
Seat 2: 6f163270 (small blind) folded before Flop
Seat 3: e1e5daa1 (big blind) folded before Flop
Seat 4: Hero folded before Flop (didn't bet)
Seat 5: 7ddc107 folded before Flop (didn't bet)
Seat 6: 4adae999 folded before Flop (didn't bet)


Poker Hand #RC2075578545: Hold'em No Limit ($0.05/$0.1) - 2023/12/21 23:31:53
Table 'RushAndCash293972' 6-max Seat #1 is the button
Seat 1: 962102c7 ($16.75 in chips)
Seat 2: c6b62fbc ($16.28 in chips)
Seat 3: a8e34387 ($10.35 in chips)
Seat 4: dbc67535 ($9.24 in chips)
Seat 5: Hero ($16.91 in chips)
Seat 6: a5728e47 ($13.58 in chips)
c6b62fbc: posts small blind $0.05
a8e34387: posts big blind $0.1
*** HOLE CARDS ***
Dealt to 962102c7 
Dealt to c6b62fbc 
Dealt to a8e34387 
Dealt to dbc67535 
Dealt to Hero [9d 3d]
Dealt to a5728e47 
dbc67535: folds
Hero: folds
a5728e47: folds
962102c7: folds
c6b62fbc: raises $0.15 to $0.25
a8e34387: calls $0.15
*** FLOP *** [5c 8s Ad]
c6b62fbc: bets $0.25
a8e34387: calls $0.25
*** TURN *** [5c 8s Ad] [4h]
c6b62fbc: bets $0.5
a8e34387: folds
Uncalled bet ($0.5) returned to c6b62fbc
*** SHOWDOWN ***
c6b62fbc collected $0.95 from pot
*** SUMMARY ***
Total pot $1 | Rake $0.05 | Jackpot $0 | Bingo $0 | Fortune $0 | Tax $0
Board [5c 8s Ad 4h]
Seat 1: 962102c7 (button) folded before Flop (didn't bet)
Seat 2: c6b62fbc (small blind) won ($0.95)
Seat 3: a8e34387 (big blind) folded on the Turn
Seat 4: dbc67535 folded before Flop (didn't bet)
Seat 5: Hero folded before Flop (didn't bet)
Seat 6: a5728e47 folded before Flop (didn't bet)


Poker Hand #RC2075578263: Hold'em No Limit ($0.05/$0.1) - 2023/12/21 23:31:41
Table 'RushAndCash293813' 6-max Seat #1 is the button
Seat 1: 73fe468b ($8.32 in chips)
Seat 2: Hero ($16.81 in chips)
Seat 3: f6e4ebac ($10.09 in chips)
Seat 4: 633b811f ($10.1 in chips)
Seat 5: 804ac42a ($4.46 in chips)
Seat 6: a697b123 ($3.43 in chips)
Hero: posts small blind $0.05
f6e4ebac: posts big blind $0.1
*** HOLE CARDS ***
Dealt to 73fe468b 
Dealt to Hero [Ah 3d]
Dealt to f6e4ebac 
Dealt to 633b811f 
Dealt to 804ac42a 
Dealt to a697b123 
633b811f: folds
804ac42a: folds
a697b123: folds
73fe468b: folds
Hero: raises $0.2 to $0.3
f6e4ebac: folds
Uncalled bet ($0.2) returned to Hero
*** SHOWDOWN ***
Hero collected $0.2 from pot
*** SUMMARY ***
Total pot $0.2 | Rake $0 | Jackpot $0 | Bingo $0 | Fortune $0 | Tax $0
Seat 1: 73fe468b (button) folded before Flop (didn't bet)
Seat 2: Hero (small blind) collected ($0.2)
Seat 3: f6e4ebac (big blind) folded before Flop
Seat 4: 633b811f folded before Flop (didn't bet)
Seat 5: 804ac42a folded before Flop (didn't bet)
Seat 6: a697b123 folded before Flop (didn't bet)


Poker Hand #RC2075578074: Hold'em No Limit ($0.05/$0.1) - 2023/12/21 23:31:32
Table 'RushAndCash293701' 6-max Seat #1 is the button
Seat 1: ea8afa ($21.82 in chips)
Seat 2: e0ab7d9c ($12.14 in chips)
Seat 3: Hero ($16.76 in chips)
Seat 4: 8c1963dd ($8.57 in chips)
Seat 5: 27d2c161 ($18.85 in chips)
Seat 6: 47fde94b ($10.85 in chips)
e0ab7d9c: posts small blind $0.05
Hero: posts big blind $0.1
*** HOLE CARDS ***
Dealt to ea8afa 
Dealt to e0ab7d9c 
Dealt to Hero [Kc As]
Dealt to 8c1963dd 
Dealt to 27d2c161 
Dealt to 47fde94b 
8c1963dd: folds
27d2c161: folds
47fde94b: folds
ea8afa: folds
e0ab7d9c: folds
Uncalled bet ($0.05) returned to Hero
*** SHOWDOWN ***
Hero collected $0.1 from pot
*** SUMMARY ***
Total pot $0.1 | Rake $0 | Jackpot $0 | Bingo $0 | Fortune $0 | Tax $0
Seat 1: ea8afa (button) folded before Flop (didn't bet)
Seat 2: e0ab7d9c (small blind) folded before Flop
Seat 3: Hero (big blind) collected ($0.1)
Seat 4: 8c1963dd folded before Flop (didn't bet)
Seat 5: 27d2c161 folded before Flop (didn't bet)
Seat 6: 47fde94b folded before Flop (didn't bet)


Poker Hand #RC2075577990: Hold'em No Limit ($0.05/$0.1) - 2023/12/21 23:31:28
Table 'RushAndCash293654' 6-max Seat #1 is the button
Seat 1: Hero ($16.76 in chips)
Seat 2: 20cdc7db ($10.6 in chips)
Seat 3: 21743ebb ($11.34 in chips)
Seat 4: 49b69c38 ($10.63 in chips)
Seat 5: 19d4d1e2 ($75.77 in chips)
Seat 6: 272018f3 ($26.33 in chips)
20cdc7db: posts small blind $0.05
21743ebb: posts big blind $0.1
*** HOLE CARDS ***
Dealt to Hero [3h 7h]
Dealt to 20cdc7db 
Dealt to 21743ebb 
Dealt to 49b69c38 
Dealt to 19d4d1e2 
Dealt to 272018f3 
49b69c38: folds
19d4d1e2: folds
272018f3: folds
Hero: folds
20cdc7db: calls $0.05
21743ebb: checks
*** FLOP *** [Jd Js 6s]
20cdc7db: bets $0.1
21743ebb: folds
Uncalled bet ($0.1) returned to 20cdc7db
*** SHOWDOWN ***
20cdc7db collected $0.19 from pot
*** SUMMARY ***
Total pot $0.2 | Rake $0.01 | Jackpot $0 | Bingo $0 | Fortune $0 | Tax $0
Board [Jd Js 6s]
Seat 1: Hero (button) folded before Flop (didn't bet)
Seat 2: 20cdc7db (small blind) won ($0.19)
Seat 3: 21743ebb (big blind) folded on the Flop
Seat 4: 49b69c38 folded before Flop (didn't bet)
Seat 5: 19d4d1e2 folded before Flop (didn't bet)
Seat 6: 272018f3 folded before Flop (didn't bet)


Poker Hand #RC2075577909: Hold'em No Limit ($0.05/$0.1) - 2023/12/21 23:31:25
Table 'RushAndCash293609' 6-max Seat #1 is the button
Seat 1: abeb5ae3 ($10 in chips)
Seat 2: 90d784f ($12.19 in chips)
Seat 3: 2bbee141 ($10 in chips)
Seat 4: caace5a7 ($10 in chips)
Seat 5: Hero ($16.76 in chips)
Seat 6: 3c5defae ($11.54 in chips)
90d784f: posts small blind $0.05
2bbee141: posts big blind $0.1
*** HOLE CARDS ***
Dealt to abeb5ae3 
Dealt to 90d784f 
Dealt to 2bbee141 
Dealt to caace5a7 
Dealt to Hero [Kh 9s]
Dealt to 3c5defae 
caace5a7: folds
Hero: folds
3c5defae: folds
abeb5ae3: folds
90d784f: folds
Uncalled bet ($0.05) returned to 2bbee141
*** SHOWDOWN ***
2bbee141 collected $0.1 from pot
*** SUMMARY ***
Total pot $0.1 | Rake $0 | Jackpot $0 | Bingo $0 | Fortune $0 | Tax $0
Seat 1: abeb5ae3 (button) folded before Flop (didn't bet)
Seat 2: 90d784f (small blind) folded before Flop
Seat 3: 2bbee141 (big blind) collected ($0.1)
Seat 4: caace5a7 folded before Flop (didn't bet)
Seat 5: Hero folded before Flop (didn't bet)
Seat 6: 3c5defae folded before Flop (didn't bet)


Poker Hand #RC2075577815: Hold'em No Limit ($0.05/$0.1) - 2023/12/21 23:31:21
Table 'RushAndCash293560' 6-max Seat #1 is the button
Seat 1: 1f60f6b4 ($11.99 in chips)
Seat 2: a3dd2069 ($11.87 in chips)
Seat 3: c5b0806d ($10 in chips)
Seat 4: 3cd87350 ($13.34 in chips)
Seat 5: Hero ($16.76 in chips)
Seat 6: d379457a ($10.52 in chips)
a3dd2069: posts small blind $0.05
c5b0806d: posts big blind $0.1
*** HOLE CARDS ***
Dealt to 1f60f6b4 
Dealt to a3dd2069 
Dealt to c5b0806d 
Dealt to 3cd87350 
Dealt to Hero [8h 2s]
Dealt to d379457a 
3cd87350: folds
Hero: folds
d379457a: folds
1f60f6b4: folds
a3dd2069: folds
Uncalled bet ($0.05) returned to c5b0806d
*** SHOWDOWN ***
c5b0806d collected $0.1 from pot
*** SUMMARY ***
Total pot $0.1 | Rake $0 | Jackpot $0 | Bingo $0 | Fortune $0 | Tax $0
Seat 1: 1f60f6b4 (button) folded before Flop (didn't bet)
Seat 2: a3dd2069 (small blind) folded before Flop
Seat 3: c5b0806d (big blind) collected ($0.1)
Seat 4: 3cd87350 folded before Flop (didn't bet)
Seat 5: Hero folded before Flop (didn't bet)
Seat 6: d379457a folded before Flop (didn't bet)


Poker Hand #RC2075577677: Hold'em No Limit ($0.05/$0.1) - 2023/12/21 23:31:15
Table 'RushAndCash293485' 6-max Seat #1 is the button
Seat 1: 343ae01b ($14.53 in chips)
Seat 2: 2b3d35a9 ($9.09 in chips)
Seat 3: Hero ($16.71 in chips)
Seat 4: 3ab01d16 ($14.28 in chips)
Seat 5: 550a1a33 ($13.27 in chips)
Seat 6: a7327808 ($9.47 in chips)
2b3d35a9: posts small blind $0.05
Hero: posts big blind $0.1
*** HOLE CARDS ***
Dealt to 343ae01b 
Dealt to 2b3d35a9 
Dealt to Hero [2c 2h]
Dealt to 3ab01d16 
Dealt to 550a1a33 
Dealt to a7327808 
3ab01d16: folds
550a1a33: folds
a7327808: folds
343ae01b: folds
2b3d35a9: folds
Uncalled bet ($0.05) returned to Hero
*** SHOWDOWN ***
Hero collected $0.1 from pot
*** SUMMARY ***
Total pot $0.1 | Rake $0 | Jackpot $0 | Bingo $0 | Fortune $0 | Tax $0
Seat 1: 343ae01b (button) folded before Flop (didn't bet)
Seat 2: 2b3d35a9 (small blind) folded before Flop
Seat 3: Hero (big blind) collected ($0.1)
Seat 4: 3ab01d16 folded before Flop (didn't bet)
Seat 5: 550a1a33 folded before Flop (didn't bet)
Seat 6: a7327808 folded before Flop (didn't bet)


Poker Hand #RC2075576765: Hold'em No Limit ($0.05/$0.1) - 2023/12/21 23:30:35
Table 'RushAndCash292952' 6-max Seat #1 is the button
Seat 1: d8d7dbd5 ($16.39 in chips)
Seat 2: 3ab01d16 ($13.91 in chips)
Seat 3: 343ae01b ($14.73 in chips)
Seat 4: d3d63fec ($18.87 in chips)
Seat 5: Hero ($16.91 in chips)
Seat 6: c3f8966e ($10.15 in chips)
3ab01d16: posts small blind $0.05
343ae01b: posts big blind $0.1
*** HOLE CARDS ***
Dealt to d8d7dbd5 
Dealt to 3ab01d16 
Dealt to 343ae01b 
Dealt to d3d63fec 
Dealt to Hero [4d Ad]
Dealt to c3f8966e 
d3d63fec: folds
Hero: raises $0.1 to $0.2
c3f8966e: folds
d8d7dbd5: folds
3ab01d16: calls $0.15
343ae01b: calls $0.1
*** FLOP *** [Tc 4c 3d]
3ab01d16: checks
343ae01b: checks
Hero: checks
*** TURN *** [Tc 4c 3d] [Td]
3ab01d16: checks
343ae01b: checks
Hero: checks
*** RIVER *** [Tc 4c 3d Td] [Kc]
3ab01d16: bets $0.3
343ae01b: folds
Hero: folds
Uncalled bet ($0.3) returned to 3ab01d16
343ae01b: shows [Qd] (Pair of Tens)
3ab01d16: shows [Ts] (Three Tens)
*** SHOWDOWN ***
3ab01d16 collected $0.57 from pot
*** SUMMARY ***
Total pot $0.6 | Rake $0.03 | Jackpot $0 | Bingo $0 | Fortune $0 | Tax $0
Board [Tc 4c 3d Td Kc]
Seat 1: d8d7dbd5 (button) folded before Flop (didn't bet)
Seat 2: 3ab01d16 (small blind) showed [Ts] and won ($0.57)
Seat 3: 343ae01b (big blind) folded on the River
Seat 4: d3d63fec folded before Flop (didn't bet)
Seat 5: Hero folded on the River
Seat 6: c3f8966e folded before Flop (didn't bet)


Poker Hand #RC2075576551: Hold'em No Limit ($0.05/$0.1) - 2023/12/21 23:30:25
Table 'RushAndCash292828' 6-max Seat #1 is the button
Seat 1: Hero ($16.91 in chips)
Seat 2: 3892cf8a ($9.66 in chips)
Seat 3: 410c2bb8 ($16.59 in chips)
Seat 4: 796cbdba ($10 in chips)
Seat 5: 950b0368 ($11.14 in chips)
Seat 6: 30675df0 ($33.2 in chips)
3892cf8a: posts small blind $0.05
410c2bb8: posts big blind $0.1
*** HOLE CARDS ***
Dealt to Hero [7h 7s]
Dealt to 3892cf8a 
Dealt to 410c2bb8 
Dealt to 796cbdba 
Dealt to 950b0368 
Dealt to 30675df0 
796cbdba: raises $0.1 to $0.2
950b0368: folds
30675df0: raises $0.42 to $0.62
Hero: folds
3892cf8a: folds
410c2bb8: folds
796cbdba: folds
Uncalled bet ($0.42) returned to 30675df0
*** SHOWDOWN ***
30675df0 collected $0.53 from pot
*** SUMMARY ***
Total pot $0.55 | Rake $0.02 | Jackpot $0 | Bingo $0 | Fortune $0 | Tax $0
Seat 1: Hero (button) folded before Flop (didn't bet)
Seat 2: 3892cf8a (small blind) folded before Flop
Seat 3: 410c2bb8 (big blind) folded before Flop
Seat 4: 796cbdba folded before Flop
Seat 5: 950b0368 folded before Flop (didn't bet)
Seat 6: 30675df0 collected ($0.53)


Poker Hand #RC2075576417: Hold'em No Limit ($0.05/$0.1) - 2023/12/21 23:30:19
Table 'RushAndCash292751' 6-max Seat #1 is the button
Seat 1: dc96911 ($10.15 in chips)
Seat 2: Hero ($16.96 in chips)
Seat 3: 5241ee79 ($16.61 in chips)
Seat 4: c29a9f2d ($10.87 in chips)
Seat 5: 510de39d ($12.11 in chips)
Seat 6: e46ec395 ($10 in chips)
Hero: posts small blind $0.05
5241ee79: posts big blind $0.1
*** HOLE CARDS ***
Dealt to dc96911 
Dealt to Hero [2s 7s]
Dealt to 5241ee79 
Dealt to c29a9f2d 
Dealt to 510de39d 
Dealt to e46ec395 
c29a9f2d: raises $0.1 to $0.2
510de39d: folds
e46ec395: folds
dc96911: folds
Hero: folds
5241ee79: calls $0.1
*** FLOP *** [7c Th Js]
5241ee79: checks
c29a9f2d: bets $0.23
5241ee79: folds
Uncalled bet ($0.23) returned to c29a9f2d
*** SHOWDOWN ***
c29a9f2d collected $0.43 from pot
*** SUMMARY ***
Total pot $0.45 | Rake $0.02 | Jackpot $0 | Bingo $0 | Fortune $0 | Tax $0
Board [7c Th Js]
Seat 1: dc96911 (button) folded before Flop (didn't bet)
Seat 2: Hero (small blind) folded before Flop
Seat 3: 5241ee79 (big blind) folded on the Flop
Seat 4: c29a9f2d won ($0.43)
Seat 5: 510de39d folded before Flop (didn't bet)
Seat 6: e46ec395 folded before Flop (didn't bet)


Poker Hand #RC2075575877: Hold'em No Limit ($0.05/$0.1) - 2023/12/21 23:29:56
Table 'RushAndCash292442' 6-max Seat #1 is the button
Seat 1: Hero ($17.21 in chips)
Seat 2: d7b02d48 ($10 in chips)
Seat 3: c29a9f2d ($10.59 in chips)
Seat 4: d1fe735d ($13.34 in chips)
Seat 5: 7fbb4f1a ($12.54 in chips)
Seat 6: a6f43aa7 ($14.93 in chips)
d7b02d48: posts small blind $0.05
c29a9f2d: posts big blind $0.1
*** HOLE CARDS ***
Dealt to Hero [9h Qh]
Dealt to d7b02d48 
Dealt to c29a9f2d 
Dealt to d1fe735d 
Dealt to 7fbb4f1a 
Dealt to a6f43aa7 
d1fe735d: folds
7fbb4f1a: folds
a6f43aa7: folds
Hero: raises $0.15 to $0.25
d7b02d48: folds
c29a9f2d: raises $0.75 to $1
Hero: folds
Uncalled bet ($0.75) returned to c29a9f2d
*** SHOWDOWN ***
c29a9f2d collected $0.53 from pot
*** SUMMARY ***
Total pot $0.55 | Rake $0.02 | Jackpot $0 | Bingo $0 | Fortune $0 | Tax $0
Seat 1: Hero (button) folded before Flop
Seat 2: d7b02d48 (small blind) folded before Flop
Seat 3: c29a9f2d (big blind) collected ($0.53)
Seat 4: d1fe735d folded before Flop (didn't bet)
Seat 5: 7fbb4f1a folded before Flop (didn't bet)
Seat 6: a6f43aa7 folded before Flop (didn't bet)


Poker Hand #RC2075575778: Hold'em No Limit ($0.05/$0.1) - 2023/12/21 23:29:52
Table 'RushAndCash292382' 6-max Seat #1 is the button
Seat 1: ad42bcdb ($12.09 in chips)
Seat 2: 50d5f1f7 ($13.4 in chips)
Seat 3: 2dd72050 ($47.95 in chips)
Seat 4: Hero ($17.21 in chips)
Seat 5: 62b76185 ($10 in chips)
Seat 6: a377dd30 ($12.08 in chips)
50d5f1f7: posts small blind $0.05
2dd72050: posts big blind $0.1
*** HOLE CARDS ***
Dealt to ad42bcdb 
Dealt to 50d5f1f7 
Dealt to 2dd72050 
Dealt to Hero [Qc 8d]
Dealt to 62b76185 
Dealt to a377dd30 
Hero: folds
62b76185: raises $0.1 to $0.2
a377dd30: folds
ad42bcdb: folds
50d5f1f7: folds
2dd72050: calls $0.1
*** FLOP *** [As 8s 7c]
2dd72050: checks
62b76185: bets $0.15
2dd72050: folds
Uncalled bet ($0.15) returned to 62b76185
*** SHOWDOWN ***
62b76185 collected $0.43 from pot
*** SUMMARY ***
Total pot $0.45 | Rake $0.02 | Jackpot $0 | Bingo $0 | Fortune $0 | Tax $0
Board [As 8s 7c]
Seat 1: ad42bcdb (button) folded before Flop (didn't bet)
Seat 2: 50d5f1f7 (small blind) folded before Flop
Seat 3: 2dd72050 (big blind) folded on the Flop
Seat 4: Hero folded before Flop (didn't bet)
Seat 5: 62b76185 won ($0.43)
Seat 6: a377dd30 folded before Flop (didn't bet)


Poker Hand #RC2075575487: Hold'em No Limit ($0.05/$0.1) - 2023/12/21 23:29:40
Table 'RushAndCash292211' 6-max Seat #1 is the button
Seat 1: 2d929b87 ($10.03 in chips)
Seat 2: aac7d90d ($9.74 in chips)
Seat 3: 272018f3 ($26.37 in chips)
Seat 4: Hero ($17.21 in chips)
Seat 5: 1a09d062 ($13.44 in chips)
Seat 6: af8e879e ($22.98 in chips)
aac7d90d: posts small blind $0.05
272018f3: posts big blind $0.1
*** HOLE CARDS ***
Dealt to 2d929b87 
Dealt to aac7d90d 
Dealt to 272018f3 
Dealt to Hero [4h Jd]
Dealt to 1a09d062 
Dealt to af8e879e 
Hero: folds
1a09d062: folds
af8e879e: folds
2d929b87: folds
aac7d90d: folds
Uncalled bet ($0.05) returned to 272018f3
*** SHOWDOWN ***
272018f3 collected $0.1 from pot
*** SUMMARY ***
Total pot $0.1 | Rake $0 | Jackpot $0 | Bingo $0 | Fortune $0 | Tax $0
Seat 1: 2d929b87 (button) folded before Flop (didn't bet)
Seat 2: aac7d90d (small blind) folded before Flop
Seat 3: 272018f3 (big blind) collected ($0.1)
Seat 4: Hero folded before Flop (didn't bet)
Seat 5: 1a09d062 folded before Flop (didn't bet)
Seat 6: af8e879e folded before Flop (didn't bet)


Poker Hand #RC2075575261: Hold'em No Limit ($0.05/$0.1) - 2023/12/21 23:29:31
Table 'RushAndCash292075' 6-max Seat #1 is the button
Seat 1: 11a74ecd ($13.06 in chips)
Seat 2: cac79080 ($15.85 in chips)
Seat 3: Hero ($17.31 in chips)
Seat 4: 6ed21051 ($14.95 in chips)
Seat 5: 782f63eb ($13.61 in chips)
Seat 6: 285e59ea ($9.62 in chips)
cac79080: posts small blind $0.05
Hero: posts big blind $0.1
*** HOLE CARDS ***
Dealt to 11a74ecd 
Dealt to cac79080 
Dealt to Hero [5s Td]
Dealt to 6ed21051 
Dealt to 782f63eb 
Dealt to 285e59ea 
6ed21051: folds
782f63eb: folds
285e59ea: folds
11a74ecd: raises $0.15 to $0.25
cac79080: folds
Hero: folds
Uncalled bet ($0.15) returned to 11a74ecd
*** SHOWDOWN ***
11a74ecd collected $0.25 from pot
*** SUMMARY ***
Total pot $0.25 | Rake $0 | Jackpot $0 | Bingo $0 | Fortune $0 | Tax $0
Seat 1: 11a74ecd (button) collected ($0.25)
Seat 2: cac79080 (small blind) folded before Flop
Seat 3: Hero (big blind) folded before Flop
Seat 4: 6ed21051 folded before Flop (didn't bet)
Seat 5: 782f63eb folded before Flop (didn't bet)
Seat 6: 285e59ea folded before Flop (didn't bet)


Poker Hand #RC2075575015: Hold'em No Limit ($0.05/$0.1) - 2023/12/21 23:29:20
Table 'RushAndCash291923' 6-max Seat #1 is the button
Seat 1: 8b0cfb4a ($7.68 in chips)
Seat 2: Hero ($17.36 in chips)
Seat 3: 50216073 ($12.43 in chips)
Seat 4: 88436705 ($24.07 in chips)
Seat 5: a19b9e30 ($10.15 in chips)
Seat 6: 8f385308 ($10 in chips)
Hero: posts small blind $0.05
50216073: posts big blind $0.1
*** HOLE CARDS ***
Dealt to 8b0cfb4a 
Dealt to Hero [3h Jc]
Dealt to 50216073 
Dealt to 88436705 
Dealt to a19b9e30 
Dealt to 8f385308 
88436705: folds
a19b9e30: folds
8f385308: raises $0.15 to $0.25
8b0cfb4a: calls $0.25
Hero: folds
50216073: folds
*** FLOP *** [Qd Qh As]
8f385308: bets $0.17
8b0cfb4a: folds
Uncalled bet ($0.17) returned to 8f385308
*** SHOWDOWN ***
8f385308 collected $0.62 from pot
*** SUMMARY ***
Total pot $0.65 | Rake $0.03 | Jackpot $0 | Bingo $0 | Fortune $0 | Tax $0
Board [Qd Qh As]
Seat 1: 8b0cfb4a (button) folded on the Flop
Seat 2: Hero (small blind) folded before Flop
Seat 3: 50216073 (big blind) folded before Flop
Seat 4: 88436705 folded before Flop (didn't bet)
Seat 5: a19b9e30 folded before Flop (didn't bet)
Seat 6: 8f385308 won ($0.62)


Poker Hand #RC2075574931: Hold'em No Limit ($0.05/$0.1) - 2023/12/21 23:29:16
Table 'RushAndCash291871' 6-max Seat #1 is the button
Seat 1: 3fe573ce ($13.02 in chips)
Seat 2: 8f385308 ($10 in chips)
Seat 3: 230b4f23 ($8.25 in chips)
Seat 4: Hero ($17.36 in chips)
Seat 5: 5b4c162c ($16.67 in chips)
Seat 6: 22c48ec7 ($23.58 in chips)
8f385308: posts small blind $0.05
230b4f23: posts big blind $0.1
*** HOLE CARDS ***
Dealt to 3fe573ce 
Dealt to 8f385308 
Dealt to 230b4f23 
Dealt to Hero [4c 2d]
Dealt to 5b4c162c 
Dealt to 22c48ec7 
Hero: folds
5b4c162c: folds
22c48ec7: folds
3fe573ce: folds
8f385308: folds
Uncalled bet ($0.05) returned to 230b4f23
*** SHOWDOWN ***
230b4f23 collected $0.1 from pot
*** SUMMARY ***
Total pot $0.1 | Rake $0 | Jackpot $0 | Bingo $0 | Fortune $0 | Tax $0
Seat 1: 3fe573ce (button) folded before Flop (didn't bet)
Seat 2: 8f385308 (small blind) folded before Flop
Seat 3: 230b4f23 (big blind) collected ($0.1)
Seat 4: Hero folded before Flop (didn't bet)
Seat 5: 5b4c162c folded before Flop (didn't bet)
Seat 6: 22c48ec7 folded before Flop (didn't bet)


Poker Hand #RC2075574842: Hold'em No Limit ($0.05/$0.1) - 2023/12/21 23:29:12
Table 'RushAndCash291819' 6-max Seat #1 is the button
Seat 1: 90b9d59d ($10.84 in chips)
Seat 2: aa4d5c11 ($5.49 in chips)
Seat 3: deaad42c ($9.99 in chips)
Seat 4: Hero ($17.36 in chips)
Seat 5: 599a5534 ($11.73 in chips)
Seat 6: a4d488b5 ($15.09 in chips)
aa4d5c11: posts small blind $0.05
deaad42c: posts big blind $0.1
*** HOLE CARDS ***
Dealt to 90b9d59d 
Dealt to aa4d5c11 
Dealt to deaad42c 
Dealt to Hero [5d 9c]
Dealt to 599a5534 
Dealt to a4d488b5 
Hero: folds
599a5534: folds
a4d488b5: folds
90b9d59d: raises $0.1 to $0.2
aa4d5c11: folds
deaad42c: folds
Uncalled bet ($0.1) returned to 90b9d59d
*** SHOWDOWN ***
90b9d59d collected $0.25 from pot
*** SUMMARY ***
Total pot $0.25 | Rake $0 | Jackpot $0 | Bingo $0 | Fortune $0 | Tax $0
Seat 1: 90b9d59d (button) collected ($0.25)
Seat 2: aa4d5c11 (small blind) folded before Flop
Seat 3: deaad42c (big blind) folded before Flop
Seat 4: Hero folded before Flop (didn't bet)
Seat 5: 599a5534 folded before Flop (didn't bet)
Seat 6: a4d488b5 folded before Flop (didn't bet)


Poker Hand #RC2075554704: Hold'em No Limit ($0.05/$0.1) - 2023/12/21 23:29:07
Table 'RushAndCash291736' 6-max Seat #1 is the button
Seat 1: 33623df8 ($11.62 in chips)
Seat 2: f168df8e ($16.13 in chips)
Seat 3: 6e20c9c3 ($10.77 in chips)
Seat 4: 3eb1acae ($11.19 in chips)
Seat 5: d5dc7579 ($10 in chips)
Seat 6: Hero ($17.36 in chips)
f168df8e: posts small blind $0.05
6e20c9c3: posts big blind $0.1
*** HOLE CARDS ***
Dealt to 33623df8 
Dealt to f168df8e 
Dealt to 6e20c9c3 
Dealt to 3eb1acae 
Dealt to d5dc7579 
Dealt to Hero [Qc 3s]
3eb1acae: raises $0.12 to $0.22
d5dc7579: folds
Hero: folds
33623df8: folds
f168df8e: folds
6e20c9c3: folds
Uncalled bet ($0.12) returned to 3eb1acae
*** SHOWDOWN ***
3eb1acae collected $0.25 from pot
*** SUMMARY ***
Total pot $0.25 | Rake $0 | Jackpot $0 | Bingo $0 | Fortune $0 | Tax $0
Seat 1: 33623df8 (button) folded before Flop (didn't bet)
Seat 2: f168df8e (small blind) folded before Flop
Seat 3: 6e20c9c3 (big blind) folded before Flop
Seat 4: 3eb1acae collected ($0.25)
Seat 5: d5dc7579 folded before Flop (didn't bet)
Seat 6: Hero folded before Flop (didn't bet)


Poker Hand #RC2075554391: Hold'em No Limit ($0.05/$0.1) - 2023/12/21 23:28:53
Table 'RushAndCash291558' 6-max Seat #1 is the button
Seat 1: Hero ($17.21 in chips)
Seat 2: 47fde94b ($10 in chips)
Seat 3: 19d4d1e2 ($76.75 in chips)
Seat 4: 8a72c242 ($10.15 in chips)
Seat 5: e7322801 ($13.12 in chips)
Seat 6: 1f7a8ee9 ($10.95 in chips)
47fde94b: posts small blind $0.05
19d4d1e2: posts big blind $0.1
*** HOLE CARDS ***
Dealt to Hero [2c 2s]
Dealt to 47fde94b 
Dealt to 19d4d1e2 
Dealt to 8a72c242 
Dealt to e7322801 
Dealt to 1f7a8ee9 
8a72c242: folds
e7322801: folds
1f7a8ee9: folds
Hero: raises $0.1 to $0.2
47fde94b: folds
19d4d1e2: folds
Uncalled bet ($0.1) returned to Hero
*** SHOWDOWN ***
Hero collected $0.25 from pot
*** SUMMARY ***
Total pot $0.25 | Rake $0 | Jackpot $0 | Bingo $0 | Fortune $0 | Tax $0
Seat 1: Hero (button) collected ($0.25)
Seat 2: 47fde94b (small blind) folded before Flop
Seat 3: 19d4d1e2 (big blind) folded before Flop
Seat 4: 8a72c242 folded before Flop (didn't bet)
Seat 5: e7322801 folded before Flop (didn't bet)
Seat 6: 1f7a8ee9 folded before Flop (didn't bet)


Poker Hand #RC2075554271: Hold'em No Limit ($0.05/$0.1) - 2023/12/21 23:28:48
Table 'RushAndCash291492' 6-max Seat #1 is the button
Seat 1: d470eda6 ($10.33 in chips)
Seat 2: 1ae739bb ($10.22 in chips)
Seat 3: Hero ($17.31 in chips)
Seat 4: 273a60ae ($18.1 in chips)
Seat 5: 5b4c162c ($16.72 in chips)
Seat 6: ab50b0ef ($12.42 in chips)
1ae739bb: posts small blind $0.05
Hero: posts big blind $0.1
*** HOLE CARDS ***
Dealt to d470eda6 
Dealt to 1ae739bb 
Dealt to Hero [8d Js]
Dealt to 273a60ae 
Dealt to 5b4c162c 
Dealt to ab50b0ef 
273a60ae: folds
5b4c162c: folds
ab50b0ef: folds
d470eda6: raises $0.15 to $0.25
1ae739bb: folds
Hero: folds
Uncalled bet ($0.15) returned to d470eda6
*** SHOWDOWN ***
d470eda6 collected $0.25 from pot
*** SUMMARY ***
Total pot $0.25 | Rake $0 | Jackpot $0 | Bingo $0 | Fortune $0 | Tax $0
Seat 1: d470eda6 (button) collected ($0.25)
Seat 2: 1ae739bb (small blind) folded before Flop
Seat 3: Hero (big blind) folded before Flop
Seat 4: 273a60ae folded before Flop (didn't bet)
Seat 5: 5b4c162c folded before Flop (didn't bet)
Seat 6: ab50b0ef folded before Flop (didn't bet)


Poker Hand #RC2075554170: Hold'em No Limit ($0.05/$0.1) - 2023/12/21 23:28:44
Table 'RushAndCash291437' 6-max Seat #1 is the button
Seat 1: ef7c0e05 ($10.55 in chips)
Seat 2: Hero ($17.36 in chips)
Seat 3: 1ae739bb ($10.32 in chips)
Seat 4: 78aed78d ($10 in chips)
Seat 5: 8f53262f ($14.89 in chips)
Seat 6: ad42bcdb ($11.95 in chips)
Hero: posts small blind $0.05
1ae739bb: posts big blind $0.1
*** HOLE CARDS ***
Dealt to ef7c0e05 
Dealt to Hero [2s Jh]
Dealt to 1ae739bb 
Dealt to 78aed78d 
Dealt to 8f53262f 
Dealt to ad42bcdb 
78aed78d: folds
8f53262f: folds
ad42bcdb: folds
ef7c0e05: folds
Hero: folds
Uncalled bet ($0.05) returned to 1ae739bb
*** SHOWDOWN ***
1ae739bb collected $0.1 from pot
*** SUMMARY ***
Total pot $0.1 | Rake $0 | Jackpot $0 | Bingo $0 | Fortune $0 | Tax $0
Seat 1: ef7c0e05 (button) folded before Flop (didn't bet)
Seat 2: Hero (small blind) folded before Flop
Seat 3: 1ae739bb (big blind) collected ($0.1)
Seat 4: 78aed78d folded before Flop (didn't bet)
Seat 5: 8f53262f folded before Flop (didn't bet)
Seat 6: ad42bcdb folded before Flop (didn't bet)


Poker Hand #RC2075554082: Hold'em No Limit ($0.05/$0.1) - 2023/12/21 23:28:40
Table 'RushAndCash291385' 6-max Seat #1 is the button
Seat 1: 27423c20 ($12.57 in chips)
Seat 2: e3ce59c9 ($10.19 in chips)
Seat 3: 2859beab ($25.55 in chips)
Seat 4: a16f0fb4 ($10.47 in chips)
Seat 5: 3cd87350 ($14.1 in chips)
Seat 6: Hero ($17.36 in chips)
e3ce59c9: posts small blind $0.05
2859beab: posts big blind $0.1
*** HOLE CARDS ***
Dealt to 27423c20 
Dealt to e3ce59c9 
Dealt to 2859beab 
Dealt to a16f0fb4 
Dealt to 3cd87350 
Dealt to Hero [Jc 6c]
a16f0fb4: folds
3cd87350: folds
Hero: folds
27423c20: folds
e3ce59c9: folds
Uncalled bet ($0.05) returned to 2859beab
*** SHOWDOWN ***
2859beab collected $0.1 from pot
*** SUMMARY ***
Total pot $0.1 | Rake $0 | Jackpot $0 | Bingo $0 | Fortune $0 | Tax $0
Seat 1: 27423c20 (button) folded before Flop (didn't bet)
Seat 2: e3ce59c9 (small blind) folded before Flop
Seat 3: 2859beab (big blind) collected ($0.1)
Seat 4: a16f0fb4 folded before Flop (didn't bet)
Seat 5: 3cd87350 folded before Flop (didn't bet)
Seat 6: Hero folded before Flop (didn't bet)


Poker Hand #RC2075553978: Hold'em No Limit ($0.05/$0.1) - 2023/12/21 23:28:36
Table 'RushAndCash291325' 6-max Seat #1 is the button
Seat 1: f15e57df ($51.38 in chips)
Seat 2: 58acae87 ($18.93 in chips)
Seat 3: ddc6a18d ($14.15 in chips)
Seat 4: Hero ($17.36 in chips)
Seat 5: 46e7bc86 ($10.49 in chips)
Seat 6: d3d63fec ($19.47 in chips)
58acae87: posts small blind $0.05
ddc6a18d: posts big blind $0.1
*** HOLE CARDS ***
Dealt to f15e57df 
Dealt to 58acae87 
Dealt to ddc6a18d 
Dealt to Hero [3h 5h]
Dealt to 46e7bc86 
Dealt to d3d63fec 
Hero: folds
46e7bc86: folds
d3d63fec: raises $0.15 to $0.25
f15e57df: folds
58acae87: folds
ddc6a18d: raises $0.9 to $1.15
d3d63fec: folds
Uncalled bet ($0.9) returned to ddc6a18d
*** SHOWDOWN ***
ddc6a18d collected $0.53 from pot
*** SUMMARY ***
Total pot $0.55 | Rake $0.02 | Jackpot $0 | Bingo $0 | Fortune $0 | Tax $0
Seat 1: f15e57df (button) folded before Flop (didn't bet)
Seat 2: 58acae87 (small blind) folded before Flop
Seat 3: ddc6a18d (big blind) collected ($0.53)
Seat 4: Hero folded before Flop (didn't bet)
Seat 5: 46e7bc86 folded before Flop (didn't bet)
Seat 6: d3d63fec folded before Flop


Poker Hand #RC2075552794: Hold'em No Limit ($0.05/$0.1) - 2023/12/21 23:27:45
Table 'RushAndCash290641' 6-max Seat #1 is the button
Seat 1: ddc6a18d ($12.86 in chips)
Seat 2: fe713d8b ($10.13 in chips)
Seat 3: 4cd524c3 ($10 in chips)
Seat 4: 11a74ecd ($13.36 in chips)
Seat 5: Hero ($18.79 in chips)
Seat 6: 6c4ad9e4 ($9.85 in chips)
fe713d8b: posts small blind $0.05
4cd524c3: posts big blind $0.1
*** HOLE CARDS ***
Dealt to ddc6a18d 
Dealt to fe713d8b 
Dealt to 4cd524c3 
Dealt to 11a74ecd 
Dealt to Hero [Ts Td]
Dealt to 6c4ad9e4 
11a74ecd: folds
Hero: raises $0.1 to $0.2
6c4ad9e4: folds
ddc6a18d: raises $0.6 to $0.8
fe713d8b: folds
4cd524c3: folds
Hero: calls $0.6
*** FLOP *** [6d Qs 4s]
Hero: checks
ddc6a18d: bets $0.63
Hero: calls $0.63
*** TURN *** [6d Qs 4s] [7h]
Hero: checks
ddc6a18d: checks
*** RIVER *** [6d Qs 4s 7h] [Ah]
Hero: checks
ddc6a18d: checks
Hero: shows [Ts Td] (Pair of Tens)
ddc6a18d: shows [Jd Qd] (Pair of Queens)
*** SHOWDOWN ***
ddc6a18d collected $2.72 from pot
*** SUMMARY ***
Total pot $3.01 | Rake $0.14 | Jackpot $0.15 | Bingo $0 | Fortune $0 | Tax $0
Board [6d Qs 4s 7h Ah]
Seat 1: ddc6a18d (button) showed [Jd Qd] and won ($2.72) with Pair of Queens
Seat 2: fe713d8b (small blind) folded before Flop
Seat 3: 4cd524c3 (big blind) folded before Flop
Seat 4: 11a74ecd folded before Flop (didn't bet)
Seat 5: Hero showed [Ts Td] and lost with Pair of Tens
Seat 6: 6c4ad9e4 folded before Flop (didn't bet)


Poker Hand #RC2075552694: Hold'em No Limit ($0.05/$0.1) - 2023/12/21 23:27:41
Table 'RushAndCash290586' 6-max Seat #1 is the button
Seat 1: bd5f44b5 ($10 in chips)
Seat 2: 71f03a69 ($14.24 in chips)
Seat 3: e303078c ($10.31 in chips)
Seat 4: 856ea788 ($27 in chips)
Seat 5: 32e4434f ($20.64 in chips)
Seat 6: Hero ($18.79 in chips)
71f03a69: posts small blind $0.05
e303078c: posts big blind $0.1
*** HOLE CARDS ***
Dealt to bd5f44b5 
Dealt to 71f03a69 
Dealt to e303078c 
Dealt to 856ea788 
Dealt to 32e4434f 
Dealt to Hero [5h 6s]
856ea788: folds
32e4434f: folds
Hero: folds
bd5f44b5: folds
71f03a69: folds
Uncalled bet ($0.05) returned to e303078c
*** SHOWDOWN ***
e303078c collected $0.1 from pot
*** SUMMARY ***
Total pot $0.1 | Rake $0 | Jackpot $0 | Bingo $0 | Fortune $0 | Tax $0
Seat 1: bd5f44b5 (button) folded before Flop (didn't bet)
Seat 2: 71f03a69 (small blind) folded before Flop
Seat 3: e303078c (big blind) collected ($0.1)
Seat 4: 856ea788 folded before Flop (didn't bet)
Seat 5: 32e4434f folded before Flop (didn't bet)
Seat 6: Hero folded before Flop (didn't bet)


Poker Hand #RC2075552220: Hold'em No Limit ($0.05/$0.1) - 2023/12/21 23:27:21
Table 'RushAndCash290312' 6-max Seat #1 is the button
Seat 1: f34c4504 ($17.02 in chips)
Seat 2: Hero ($19.09 in chips)
Seat 3: 71f03a69 ($13.97 in chips)
Seat 4: 8c322ae2 ($10.55 in chips)
Seat 5: d8d6bf23 ($23.53 in chips)
Seat 6: 78c7c224 ($10 in chips)
Hero: posts small blind $0.05
71f03a69: posts big blind $0.1
*** HOLE CARDS ***
Dealt to f34c4504 
Dealt to Hero [8d Qd]
Dealt to 71f03a69 
Dealt to 8c322ae2 
Dealt to d8d6bf23 
Dealt to 78c7c224 
8c322ae2: folds
d8d6bf23: folds
78c7c224: folds
f34c4504: folds
Hero: raises $0.2 to $0.3
71f03a69: raises $0.6 to $0.9
Hero: folds
Uncalled bet ($0.6) returned to 71f03a69
*** SHOWDOWN ***
71f03a69 collected $0.57 from pot
*** SUMMARY ***
Total pot $0.6 | Rake $0.03 | Jackpot $0 | Bingo $0 | Fortune $0 | Tax $0
Seat 1: f34c4504 (button) folded before Flop (didn't bet)
Seat 2: Hero (small blind) folded before Flop
Seat 3: 71f03a69 (big blind) collected ($0.57)
Seat 4: 8c322ae2 folded before Flop (didn't bet)
Seat 5: d8d6bf23 folded before Flop (didn't bet)
Seat 6: 78c7c224 folded before Flop (didn't bet)


Poker Hand #RC2075552107: Hold'em No Limit ($0.05/$0.1) - 2023/12/21 23:27:15
Table 'RushAndCash290248' 6-max Seat #1 is the button
Seat 1: Hero ($19.09 in chips)
Seat 2: 1f8e1f6d ($8.65 in chips)
Seat 3: 46e7bc86 ($10.49 in chips)
Seat 4: 647b442f ($34.23 in chips)
Seat 5: cd66a58b ($13.04 in chips)
Seat 6: 4288ffd6 ($10 in chips)
1f8e1f6d: posts small blind $0.05
46e7bc86: posts big blind $0.1
*** HOLE CARDS ***
Dealt to Hero [7s Jc]
Dealt to 1f8e1f6d 
Dealt to 46e7bc86 
Dealt to 647b442f 
Dealt to cd66a58b 
Dealt to 4288ffd6 
647b442f: folds
cd66a58b: folds
4288ffd6: folds
Hero: folds
1f8e1f6d: folds
Uncalled bet ($0.05) returned to 46e7bc86
*** SHOWDOWN ***
46e7bc86 collected $0.1 from pot
*** SUMMARY ***
Total pot $0.1 | Rake $0 | Jackpot $0 | Bingo $0 | Fortune $0 | Tax $0
Seat 1: Hero (button) folded before Flop (didn't bet)
Seat 2: 1f8e1f6d (small blind) folded before Flop
Seat 3: 46e7bc86 (big blind) collected ($0.1)
Seat 4: 647b442f folded before Flop (didn't bet)
Seat 5: cd66a58b folded before Flop (didn't bet)
Seat 6: 4288ffd6 folded before Flop (didn't bet)


Poker Hand #RC2075551826: Hold'em No Limit ($0.05/$0.1) - 2023/12/21 23:27:02
Table 'RushAndCash290092' 6-max Seat #1 is the button
Seat 1: ec591648 ($11.79 in chips)
Seat 2: bc69bf06 ($12.31 in chips)
Seat 3: Hero ($19.04 in chips)
Seat 4: f2921f78 ($15.16 in chips)
Seat 5: 269c665c ($10.15 in chips)
Seat 6: fc7ac6a6 ($10 in chips)
bc69bf06: posts small blind $0.05
Hero: posts big blind $0.1
*** HOLE CARDS ***
Dealt to ec591648 
Dealt to bc69bf06 
Dealt to Hero [9s 9c]
Dealt to f2921f78 
Dealt to 269c665c 
Dealt to fc7ac6a6 
f2921f78: folds
269c665c: folds
fc7ac6a6: folds
ec591648: folds
bc69bf06: folds
Uncalled bet ($0.05) returned to Hero
*** SHOWDOWN ***
Hero collected $0.1 from pot
*** SUMMARY ***
Total pot $0.1 | Rake $0 | Jackpot $0 | Bingo $0 | Fortune $0 | Tax $0
Seat 1: ec591648 (button) folded before Flop (didn't bet)
Seat 2: bc69bf06 (small blind) folded before Flop
Seat 3: Hero (big blind) collected ($0.1)
Seat 4: f2921f78 folded before Flop (didn't bet)
Seat 5: 269c665c folded before Flop (didn't bet)
Seat 6: fc7ac6a6 folded before Flop (didn't bet)


Poker Hand #RC2075551726: Hold'em No Limit ($0.05/$0.1) - 2023/12/21 23:26:58
Table 'RushAndCash290035' 6-max Seat #1 is the button
Seat 1: 63d320d0 ($16.24 in chips)
Seat 2: 8bb52fba ($10 in chips)
Seat 3: b8e6a33a ($13.22 in chips)
Seat 4: Hero ($19.04 in chips)
Seat 5: f52d7ab6 ($8.73 in chips)
Seat 6: bf23faf4 ($10 in chips)
8bb52fba: posts small blind $0.05
b8e6a33a: posts big blind $0.1
*** HOLE CARDS ***
Dealt to 63d320d0 
Dealt to 8bb52fba 
Dealt to b8e6a33a 
Dealt to Hero [5d 6s]
Dealt to f52d7ab6 
Dealt to bf23faf4 
Hero: folds
f52d7ab6: folds
bf23faf4: raises $0.12 to $0.22
63d320d0: raises $0.53 to $0.75
8bb52fba: folds
b8e6a33a: folds
bf23faf4: folds
Uncalled bet ($0.53) returned to 63d320d0
*** SHOWDOWN ***
63d320d0 collected $0.56 from pot
*** SUMMARY ***
Total pot $0.59 | Rake $0.03 | Jackpot $0 | Bingo $0 | Fortune $0 | Tax $0
Seat 1: 63d320d0 (button) collected ($0.56)
Seat 2: 8bb52fba (small blind) folded before Flop
Seat 3: b8e6a33a (big blind) folded before Flop
Seat 4: Hero folded before Flop (didn't bet)
Seat 5: f52d7ab6 folded before Flop (didn't bet)
Seat 6: bf23faf4 folded before Flop


Poker Hand #RC2075551626: Hold'em No Limit ($0.05/$0.1) - 2023/12/21 23:26:54
Table 'RushAndCash289976' 6-max Seat #1 is the button
Seat 1: b709b035 ($11.14 in chips)
Seat 2: aff6db10 ($21.35 in chips)
Seat 3: 83b1f5f9 ($13.14 in chips)
Seat 4: 8eeea9a5 ($35.93 in chips)
Seat 5: Hero ($19.04 in chips)
Seat 6: c26846bf ($24.5 in chips)
aff6db10: posts small blind $0.05
83b1f5f9: posts big blind $0.1
*** HOLE CARDS ***
Dealt to b709b035 
Dealt to aff6db10 
Dealt to 83b1f5f9 
Dealt to 8eeea9a5 
Dealt to Hero [5h 7s]
Dealt to c26846bf 
8eeea9a5: folds
Hero: folds
c26846bf: raises $0.13 to $0.23
b709b035: folds
aff6db10: calls $0.18
83b1f5f9: folds
*** FLOP *** [Qc 4s 9c]
aff6db10: checks
c26846bf: bets $0.29
aff6db10: calls $0.29
*** TURN *** [Qc 4s 9c] [4h]
aff6db10: checks
c26846bf: checks
*** RIVER *** [Qc 4s 9c 4h] [Ah]
aff6db10: checks
c26846bf: checks
aff6db10: shows [6c Ac] (Pair of Aces and Pair of Fours)
c26846bf: shows [As Ts] (Pair of Aces and Pair of Fours)
*** SHOWDOWN ***
aff6db10 collected $0.55 from pot
c26846bf collected $0.55 from pot
*** SUMMARY ***
Total pot $1.14 | Rake $0.04 | Jackpot $0 | Bingo $0 | Fortune $0 | Tax $0
Board [Qc 4s 9c 4h Ah]
Seat 1: b709b035 (button) folded before Flop (didn't bet)
Seat 2: aff6db10 (small blind) showed [6c Ac] and won ($0.55) with Pair of Aces and Pair of Fours
Seat 3: 83b1f5f9 (big blind) folded before Flop
Seat 4: 8eeea9a5 folded before Flop (didn't bet)
Seat 5: Hero folded before Flop (didn't bet)
Seat 6: c26846bf showed [As Ts] and won ($0.55) with Pair of Aces and Pair of Fours


Poker Hand #RC2075551483: Hold'em No Limit ($0.05/$0.1) - 2023/12/21 23:26:47
Table 'RushAndCash289890' 6-max Seat #1 is the button
Seat 1: 512705f5 ($4.08 in chips)
Seat 2: 67ba2b96 ($8.94 in chips)
Seat 3: ae042f12 ($10 in chips)
Seat 4: 1a822896 ($30.77 in chips)
Seat 5: ebd36a7c ($10 in chips)
Seat 6: Hero ($19.04 in chips)
67ba2b96: posts small blind $0.05
ae042f12: posts big blind $0.1
*** HOLE CARDS ***
Dealt to 512705f5 
Dealt to 67ba2b96 
Dealt to ae042f12 
Dealt to 1a822896 
Dealt to ebd36a7c 
Dealt to Hero [Ac 8d]
1a822896: folds
ebd36a7c: folds
Hero: folds
512705f5: folds
67ba2b96: folds
Uncalled bet ($0.05) returned to ae042f12
*** SHOWDOWN ***
ae042f12 collected $0.1 from pot
*** SUMMARY ***
Total pot $0.1 | Rake $0 | Jackpot $0 | Bingo $0 | Fortune $0 | Tax $0
Seat 1: 512705f5 (button) folded before Flop (didn't bet)
Seat 2: 67ba2b96 (small blind) folded before Flop
Seat 3: ae042f12 (big blind) collected ($0.1)
Seat 4: 1a822896 folded before Flop (didn't bet)
Seat 5: ebd36a7c folded before Flop (didn't bet)
Seat 6: Hero folded before Flop (didn't bet)


Poker Hand #RC2075551396: Hold'em No Limit ($0.05/$0.1) - 2023/12/21 23:26:44
Table 'RushAndCash289842' 6-max Seat #1 is the button
Seat 1: 3d83b5d2 ($29.01 in chips)
Seat 2: c82e544f ($9.64 in chips)
Seat 3: 85297cd1 ($10 in chips)
Seat 4: Hero ($19.04 in chips)
Seat 5: 9b5e26de ($31.17 in chips)
Seat 6: 36d8de0f ($21.18 in chips)
c82e544f: posts small blind $0.05
85297cd1: posts big blind $0.1
*** HOLE CARDS ***
Dealt to 3d83b5d2 
Dealt to c82e544f 
Dealt to 85297cd1 
Dealt to Hero [7h 5d]
Dealt to 9b5e26de 
Dealt to 36d8de0f 
Hero: folds
9b5e26de: raises $0.2 to $0.3
36d8de0f: folds
3d83b5d2: folds
c82e544f: folds
85297cd1: folds
Uncalled bet ($0.2) returned to 9b5e26de
*** SHOWDOWN ***
9b5e26de collected $0.25 from pot
*** SUMMARY ***
Total pot $0.25 | Rake $0 | Jackpot $0 | Bingo $0 | Fortune $0 | Tax $0
Seat 1: 3d83b5d2 (button) folded before Flop (didn't bet)
Seat 2: c82e544f (small blind) folded before Flop
Seat 3: 85297cd1 (big blind) folded before Flop
Seat 4: Hero folded before Flop (didn't bet)
Seat 5: 9b5e26de collected ($0.25)
Seat 6: 36d8de0f folded before Flop (didn't bet)


Poker Hand #RC2075551297: Hold'em No Limit ($0.05/$0.1) - 2023/12/21 23:26:40
Table 'RushAndCash289787' 6-max Seat #1 is the button
Seat 1: 96432614 ($21.75 in chips)
Seat 2: Hero ($19.09 in chips)
Seat 3: 366f77eb ($12.03 in chips)
Seat 4: b709b035 ($11.09 in chips)
Seat 5: dd2e0042 ($12.96 in chips)
Seat 6: daab6594 ($14.66 in chips)
Hero: posts small blind $0.05
366f77eb: posts big blind $0.1
*** HOLE CARDS ***
Dealt to 96432614 
Dealt to Hero [Jd 6h]
Dealt to 366f77eb 
Dealt to b709b035 
Dealt to dd2e0042 
Dealt to daab6594 
b709b035: raises $0.14 to $0.24
dd2e0042: folds
daab6594: folds
96432614: folds
Hero: folds
366f77eb: folds
Uncalled bet ($0.14) returned to b709b035
*** SHOWDOWN ***
b709b035 collected $0.25 from pot
*** SUMMARY ***
Total pot $0.25 | Rake $0 | Jackpot $0 | Bingo $0 | Fortune $0 | Tax $0
Seat 1: 96432614 (button) folded before Flop (didn't bet)
Seat 2: Hero (small blind) folded before Flop
Seat 3: 366f77eb (big blind) folded before Flop
Seat 4: b709b035 collected ($0.25)
Seat 5: dd2e0042 folded before Flop (didn't bet)
Seat 6: daab6594 folded before Flop (didn't bet)


Poker Hand #RC2075551108: Hold'em No Limit ($0.05/$0.1) - 2023/12/21 23:26:32
Table 'RushAndCash289674' 6-max Seat #1 is the button
Seat 1: Hero ($19.09 in chips)
Seat 2: 2610ab56 ($19.76 in chips)
Seat 3: 198ae68 ($33.91 in chips)
Seat 4: 7a817c7d ($12.02 in chips)
Seat 5: ca587423 ($24.47 in chips)
Seat 6: db45a1dd ($10.31 in chips)
2610ab56: posts small blind $0.05
198ae68: posts big blind $0.1
*** HOLE CARDS ***
Dealt to Hero [7d 4s]
Dealt to 2610ab56 
Dealt to 198ae68 
Dealt to 7a817c7d 
Dealt to ca587423 
Dealt to db45a1dd 
7a817c7d: raises $0.1 to $0.2
ca587423: folds
db45a1dd: folds
Hero: folds
2610ab56: folds
198ae68: folds
Uncalled bet ($0.1) returned to 7a817c7d
*** SHOWDOWN ***
7a817c7d collected $0.25 from pot
*** SUMMARY ***
Total pot $0.25 | Rake $0 | Jackpot $0 | Bingo $0 | Fortune $0 | Tax $0
Seat 1: Hero (button) folded before Flop (didn't bet)
Seat 2: 2610ab56 (small blind) folded before Flop
Seat 3: 198ae68 (big blind) folded before Flop
Seat 4: 7a817c7d collected ($0.25)
Seat 5: ca587423 folded before Flop (didn't bet)
Seat 6: db45a1dd folded before Flop (didn't bet)


Poker Hand #RC2075550250: Hold'em No Limit ($0.05/$0.1) - 2023/12/21 23:25:55
Table 'RushAndCash289167' 6-max Seat #1 is the button
Seat 1: 387c2653 ($10.8 in chips)
Seat 2: 7a817c7d ($11.84 in chips)
Seat 3: Hero ($19.29 in chips)
Seat 4: 3b9048c3 ($9.85 in chips)
Seat 5: c39cfaab ($10.41 in chips)
Seat 6: f27abeb7 ($16.23 in chips)
7a817c7d: posts small blind $0.05
Hero: posts big blind $0.1
*** HOLE CARDS ***
Dealt to 387c2653 
Dealt to 7a817c7d 
Dealt to Hero [Ad 6c]
Dealt to 3b9048c3 
Dealt to c39cfaab 
Dealt to f27abeb7 
3b9048c3: folds
c39cfaab: folds
f27abeb7: folds
387c2653: folds
7a817c7d: raises $0.1 to $0.2
Hero: calls $0.1
*** FLOP *** [5s Tc 3d]
7a817c7d: checks
Hero: checks
*** TURN *** [5s Tc 3d] [7s]
7a817c7d: bets $0.2
Hero: folds
Uncalled bet ($0.2) returned to 7a817c7d
*** SHOWDOWN ***
7a817c7d collected $0.38 from pot
*** SUMMARY ***
Total pot $0.4 | Rake $0.02 | Jackpot $0 | Bingo $0 | Fortune $0 | Tax $0
Board [5s Tc 3d 7s]
Seat 1: 387c2653 (button) folded before Flop (didn't bet)
Seat 2: 7a817c7d (small blind) won ($0.38)
Seat 3: Hero (big blind) folded on the Turn
Seat 4: 3b9048c3 folded before Flop (didn't bet)
Seat 5: c39cfaab folded before Flop (didn't bet)
Seat 6: f27abeb7 folded before Flop (didn't bet)


Poker Hand #RC2075550167: Hold'em No Limit ($0.05/$0.1) - 2023/12/21 23:25:52
Table 'RushAndCash289119' 6-max Seat #1 is the button
Seat 1: 1694e609 ($24.32 in chips)
Seat 2: c50582a6 ($16.14 in chips)
Seat 3: 6d67f55d ($35.32 in chips)
Seat 4: f27abeb7 ($16.23 in chips)
Seat 5: 7a817c7d ($11.84 in chips)
Seat 6: Hero ($19.29 in chips)
c50582a6: posts small blind $0.05
6d67f55d: posts big blind $0.1
*** HOLE CARDS ***
Dealt to 1694e609 
Dealt to c50582a6 
Dealt to 6d67f55d 
Dealt to f27abeb7 
Dealt to 7a817c7d 
Dealt to Hero [3d 7h]
f27abeb7: folds
7a817c7d: folds
Hero: folds
1694e609: folds
c50582a6: raises $0.11 to $0.21
6d67f55d: calls $0.11
*** FLOP *** [6c Js Ah]
c50582a6: bets $0.14
6d67f55d: calls $0.14
*** TURN *** [6c Js Ah] [8c]
c50582a6: bets $0.24
6d67f55d: folds
Uncalled bet ($0.24) returned to c50582a6
*** SHOWDOWN ***
c50582a6 collected $0.66 from pot
*** SUMMARY ***
Total pot $0.7 | Rake $0.04 | Jackpot $0 | Bingo $0 | Fortune $0 | Tax $0
Board [6c Js Ah 8c]
Seat 1: 1694e609 (button) folded before Flop (didn't bet)
Seat 2: c50582a6 (small blind) won ($0.66)
Seat 3: 6d67f55d (big blind) folded on the Turn
Seat 4: f27abeb7 folded before Flop (didn't bet)
Seat 5: 7a817c7d folded before Flop (didn't bet)
Seat 6: Hero folded before Flop (didn't bet)


Poker Hand #RC2075550030: Hold'em No Limit ($0.05/$0.1) - 2023/12/21 23:25:46
Table 'RushAndCash289039' 6-max Seat #1 is the button
Seat 1: a734301e ($11.04 in chips)
Seat 2: dddcd9d0 ($11.15 in chips)
Seat 3: c37b4286 ($10.3 in chips)
Seat 4: e889978c ($19.74 in chips)
Seat 5: Hero ($19.29 in chips)
Seat 6: 4abe855c ($19.74 in chips)
dddcd9d0: posts small blind $0.05
c37b4286: posts big blind $0.1
*** HOLE CARDS ***
Dealt to a734301e 
Dealt to dddcd9d0 
Dealt to c37b4286 
Dealt to e889978c 
Dealt to Hero [7h Qd]
Dealt to 4abe855c 
e889978c: folds
Hero: folds
4abe855c: folds
a734301e: folds
dddcd9d0: raises $0.2 to $0.3
c37b4286: raises $0.55 to $0.85
dddcd9d0: raises $1.35 to $2.2
c37b4286: folds
Uncalled bet ($1.35) returned to dddcd9d0
*** SHOWDOWN ***
dddcd9d0 collected $1.62 from pot
*** SUMMARY ***
Total pot $1.7 | Rake $0.08 | Jackpot $0 | Bingo $0 | Fortune $0 | Tax $0
Seat 1: a734301e (button) folded before Flop (didn't bet)
Seat 2: dddcd9d0 (small blind) collected ($1.62)
Seat 3: c37b4286 (big blind) folded before Flop
Seat 4: e889978c folded before Flop (didn't bet)
Seat 5: Hero folded before Flop (didn't bet)
Seat 6: 4abe855c folded before Flop (didn't bet)


Poker Hand #RC2075549432: Hold'em No Limit ($0.05/$0.1) - 2023/12/21 23:25:21
Table 'RushAndCash288684' 6-max Seat #1 is the button
Seat 1: Hero ($18.87 in chips)
Seat 2: f15e57df ($52.81 in chips)
Seat 3: ba2c88e ($10 in chips)
Seat 4: e568a613 ($17.85 in chips)
Seat 5: f7a55573 ($24.31 in chips)
Seat 6: 2dbe35f9 ($11.63 in chips)
f15e57df: posts small blind $0.05
ba2c88e: posts big blind $0.1
*** HOLE CARDS ***
Dealt to Hero [Qh Qd]
Dealt to f15e57df 
Dealt to ba2c88e 
Dealt to e568a613 
Dealt to f7a55573 
Dealt to 2dbe35f9 
e568a613: folds
f7a55573: raises $0.2 to $0.3
2dbe35f9: folds
Hero: raises $0.75 to $1.05
f15e57df: folds
ba2c88e: folds
f7a55573: folds
Uncalled bet ($0.75) returned to Hero
*** SHOWDOWN ***
Hero collected $0.72 from pot
*** SUMMARY ***
Total pot $0.75 | Rake $0.03 | Jackpot $0 | Bingo $0 | Fortune $0 | Tax $0
Seat 1: Hero (button) collected ($0.72)
Seat 2: f15e57df (small blind) folded before Flop
Seat 3: ba2c88e (big blind) folded before Flop
Seat 4: e568a613 folded before Flop (didn't bet)
Seat 5: f7a55573 folded before Flop
Seat 6: 2dbe35f9 folded before Flop (didn't bet)


Poker Hand #RC2075548837: Hold'em No Limit ($0.05/$0.1) - 2023/12/21 23:24:56
Table 'RushAndCash288352' 6-max Seat #1 is the button
Seat 1: 22420f5f ($32.45 in chips)
Seat 2: 593dd101 ($11.16 in chips)
Seat 3: Hero ($18.59 in chips)
Seat 4: f15e57df ($53.06 in chips)
Seat 5: 8e27810a ($69.96 in chips)
Seat 6: bedb90db ($11.39 in chips)
593dd101: posts small blind $0.05
Hero: posts big blind $0.1
*** HOLE CARDS ***
Dealt to 22420f5f 
Dealt to 593dd101 
Dealt to Hero [Ad Tc]
Dealt to f15e57df 
Dealt to 8e27810a 
Dealt to bedb90db 
f15e57df: raises $0.15 to $0.25
8e27810a: folds
bedb90db: folds
22420f5f: folds
593dd101: folds
Hero: calls $0.15
*** FLOP *** [5h 5s 7d]
Hero: checks
f15e57df: checks
*** TURN *** [5h 5s 7d] [9d]
Hero: checks
f15e57df: checks
*** RIVER *** [5h 5s 7d 9d] [2d]
Hero: checks
f15e57df: checks
Hero: shows [Ad Tc] (Pair of Fives)
f15e57df: shows [Ts Js] (Pair of Fives)
*** SHOWDOWN ***
Hero collected $0.53 from pot
*** SUMMARY ***
Total pot $0.55 | Rake $0.02 | Jackpot $0 | Bingo $0 | Fortune $0 | Tax $0
Board [5h 5s 7d 9d 2d]
Seat 1: 22420f5f (button) folded before Flop (didn't bet)
Seat 2: 593dd101 (small blind) folded before Flop
Seat 3: Hero (big blind) showed [Ad Tc] and won ($0.53) with Pair of Fives
Seat 4: f15e57df showed [Ts Js] and lost with Pair of Fives
Seat 5: 8e27810a folded before Flop (didn't bet)
Seat 6: bedb90db folded before Flop (didn't bet)


Poker Hand #RC2075547704: Hold'em No Limit ($0.05/$0.1) - 2023/12/21 23:24:10
Table 'RushAndCash287685' 6-max Seat #1 is the button
Seat 1: 2b0be38a ($17.19 in chips)
Seat 2: Hero ($17.38 in chips)
Seat 3: bedb90db ($12.89 in chips)
Seat 4: 86ada8bf ($10 in chips)
Seat 5: e3ce59c9 ($10 in chips)
Seat 6: 97b07d41 ($21.74 in chips)
Hero: posts small blind $0.05
bedb90db: posts big blind $0.1
*** HOLE CARDS ***
Dealt to 2b0be38a 
Dealt to Hero [8h Ad]
Dealt to bedb90db 
Dealt to 86ada8bf 
Dealt to e3ce59c9 
Dealt to 97b07d41 
86ada8bf: folds
e3ce59c9: folds
97b07d41: folds
2b0be38a: folds
Hero: raises $0.2 to $0.3
bedb90db: calls $0.2
*** FLOP *** [Jc Jd Ac]
Hero: checks
bedb90db: checks
*** TURN *** [Jc Jd Ac] [4d]
Hero: checks
bedb90db: bets $0.3
Hero: calls $0.3
*** RIVER *** [Jc Jd Ac 4d] [5d]
Hero: checks
bedb90db: bets $0.9
Hero: calls $0.9
bedb90db: shows [6h Th] (Pair of Jacks)
Hero: shows [8h Ad] (Pair of Aces and Pair of Jacks)
*** SHOWDOWN ***
Hero collected $2.71 from pot
*** SUMMARY ***
Total pot $3 | Rake $0.14 | Jackpot $0.15 | Bingo $0 | Fortune $0 | Tax $0
Board [Jc Jd Ac 4d 5d]
Seat 1: 2b0be38a (button) folded before Flop (didn't bet)
Seat 2: Hero (small blind) showed [8h Ad] and won ($2.71) with Pair of Aces and Pair of Jacks
Seat 3: bedb90db (big blind) showed [6h Th] and lost with Pair of Jacks
Seat 4: 86ada8bf folded before Flop (didn't bet)
Seat 5: e3ce59c9 folded before Flop (didn't bet)
Seat 6: 97b07d41 folded before Flop (didn't bet)


Poker Hand #RC2075546922: Hold'em No Limit ($0.05/$0.1) - 2023/12/21 23:23:38
Table 'RushAndCash287227' 6-max Seat #1 is the button
Seat 1: 980a33e9 ($15.14 in chips)
Seat 2: 15103267 ($10.8 in chips)
Seat 3: 5b0ddb11 ($10.24 in chips)
Seat 4: adb62d5f ($26.11 in chips)
Seat 5: 41287b65 ($20.52 in chips)
Seat 6: Hero ($17.23 in chips)
15103267: posts small blind $0.05
5b0ddb11: posts big blind $0.1
*** HOLE CARDS ***
Dealt to 980a33e9 
Dealt to 15103267 
Dealt to 5b0ddb11 
Dealt to adb62d5f 
Dealt to 41287b65 
Dealt to Hero [Qc Kd]
adb62d5f: folds
41287b65: folds
Hero: raises $0.1 to $0.2
980a33e9: folds
15103267: folds
5b0ddb11: folds
Uncalled bet ($0.1) returned to Hero
*** SHOWDOWN ***
Hero collected $0.25 from pot
*** SUMMARY ***
Total pot $0.25 | Rake $0 | Jackpot $0 | Bingo $0 | Fortune $0 | Tax $0
Seat 1: 980a33e9 (button) folded before Flop (didn't bet)
Seat 2: 15103267 (small blind) folded before Flop
Seat 3: 5b0ddb11 (big blind) folded before Flop
Seat 4: adb62d5f folded before Flop (didn't bet)
Seat 5: 41287b65 folded before Flop (didn't bet)
Seat 6: Hero collected ($0.25)


Poker Hand #RC2075546250: Hold'em No Limit ($0.05/$0.1) - 2023/12/21 23:23:09
Table 'RushAndCash286840' 6-max Seat #1 is the button
Seat 1: 71189ba6 ($17.64 in chips)
Seat 2: Hero ($17.48 in chips)
Seat 3: 1e29268 ($18.67 in chips)
Seat 4: 5b4c162c ($17.49 in chips)
Seat 5: b1f872c6 ($17.37 in chips)
Seat 6: 2ca8cd2b ($13.99 in chips)
Hero: posts small blind $0.05
1e29268: posts big blind $0.1
*** HOLE CARDS ***
Dealt to 71189ba6 
Dealt to Hero [8h As]
Dealt to 1e29268 
Dealt to 5b4c162c 
Dealt to b1f872c6 
Dealt to 2ca8cd2b 
5b4c162c: folds
b1f872c6: folds
2ca8cd2b: folds
71189ba6: raises $0.15 to $0.25
Hero: calls $0.2
1e29268: folds
*** FLOP *** [4s 3s 4c]
Hero: checks
71189ba6: bets $0.2
Hero: folds
Uncalled bet ($0.2) returned to 71189ba6
*** SHOWDOWN ***
71189ba6 collected $0.57 from pot
*** SUMMARY ***
Total pot $0.6 | Rake $0.03 | Jackpot $0 | Bingo $0 | Fortune $0 | Tax $0
Board [4s 3s 4c]
Seat 1: 71189ba6 (button) won ($0.57)
Seat 2: Hero (small blind) folded on the Flop
Seat 3: 1e29268 (big blind) folded before Flop
Seat 4: 5b4c162c folded before Flop (didn't bet)
Seat 5: b1f872c6 folded before Flop (didn't bet)
Seat 6: 2ca8cd2b folded before Flop (didn't bet)


Poker Hand #RC2075545775: Hold'em No Limit ($0.05/$0.1) - 2023/12/21 23:22:49
Table 'RushAndCash286559' 6-max Seat #1 is the button
Seat 1: edce21d8 ($10.12 in chips)
Seat 2: 68807e0f ($9.81 in chips)
Seat 3: Hero ($17.58 in chips)
Seat 4: 1a09d062 ($10 in chips)
Seat 5: ab198371 ($13.57 in chips)
Seat 6: eec070aa ($9.27 in chips)
68807e0f: posts small blind $0.05
Hero: posts big blind $0.1
*** HOLE CARDS ***
Dealt to edce21d8 
Dealt to 68807e0f 
Dealt to Hero [4d Kh]
Dealt to 1a09d062 
Dealt to ab198371 
Dealt to eec070aa 
1a09d062: raises $0.1 to $0.2
ab198371: raises $0.19 to $0.39
eec070aa: calls $0.39
edce21d8: folds
68807e0f: folds
Hero: folds
1a09d062: calls $0.19
*** FLOP *** [Ac 5c Js]
1a09d062: checks
ab198371: bets $0.44
eec070aa: calls $0.44
1a09d062: calls $0.44
*** TURN *** [Ac 5c Js] [2d]
1a09d062: checks
ab198371: checks
eec070aa: checks
*** RIVER *** [Ac 5c Js 2d] [Jc]
1a09d062: bets $9.17 and is all-in
ab198371: folds
eec070aa: folds
Uncalled bet ($9.17) returned to 1a09d062
*** SHOWDOWN ***
1a09d062 collected $2.51 from pot
*** SUMMARY ***
Total pot $2.64 | Rake $0.13 | Jackpot $0 | Bingo $0 | Fortune $0 | Tax $0
Board [Ac 5c Js 2d Jc]
Seat 1: edce21d8 (button) folded before Flop (didn't bet)
Seat 2: 68807e0f (small blind) folded before Flop
Seat 3: Hero (big blind) folded before Flop
Seat 4: 1a09d062 won ($2.51)
Seat 5: ab198371 folded on the River
Seat 6: eec070aa folded on the River


Poker Hand #RC2075545676: Hold'em No Limit ($0.05/$0.1) - 2023/12/21 23:22:45
Table 'RushAndCash286502' 6-max Seat #1 is the button
Seat 1: da62d8e8 ($10.37 in chips)
Seat 2: 1e4a3d4c ($12.71 in chips)
Seat 3: d46cdded ($10.78 in chips)
Seat 4: Hero ($17.58 in chips)
Seat 5: 769f9efe ($10.23 in chips)
Seat 6: a2286d58 ($15.88 in chips)
1e4a3d4c: posts small blind $0.05
d46cdded: posts big blind $0.1
*** HOLE CARDS ***
Dealt to da62d8e8 
Dealt to 1e4a3d4c 
Dealt to d46cdded 
Dealt to Hero [7d Ts]
Dealt to 769f9efe 
Dealt to a2286d58 
Hero: folds
769f9efe: folds
a2286d58: folds
da62d8e8: raises $0.15 to $0.25
1e4a3d4c: folds
d46cdded: calls $0.15
*** FLOP *** [Qs Qh 9h]
d46cdded: checks
da62d8e8: checks
*** TURN *** [Qs Qh 9h] [2s]
d46cdded: bets $0.28
da62d8e8: folds
Uncalled bet ($0.28) returned to d46cdded
*** SHOWDOWN ***
d46cdded collected $0.53 from pot
*** SUMMARY ***
Total pot $0.55 | Rake $0.02 | Jackpot $0 | Bingo $0 | Fortune $0 | Tax $0
Board [Qs Qh 9h 2s]
Seat 1: da62d8e8 (button) folded on the Turn
Seat 2: 1e4a3d4c (small blind) folded before Flop
Seat 3: d46cdded (big blind) won ($0.53)
Seat 4: Hero folded before Flop (didn't bet)
Seat 5: 769f9efe folded before Flop (didn't bet)
Seat 6: a2286d58 folded before Flop (didn't bet)


Poker Hand #RC2075545535: Hold'em No Limit ($0.05/$0.1) - 2023/12/21 23:22:38
Table 'RushAndCash286419' 6-max Seat #1 is the button
Seat 1: d21c8de ($15.71 in chips)
Seat 2: 599835ba ($10 in chips)
Seat 3: e181b664 ($10.72 in chips)
Seat 4: d6740f69 ($11.91 in chips)
Seat 5: 769f9efe ($10.23 in chips)
Seat 6: Hero ($17.58 in chips)
599835ba: posts small blind $0.05
e181b664: posts big blind $0.1
*** HOLE CARDS ***
Dealt to d21c8de 
Dealt to 599835ba 
Dealt to e181b664 
Dealt to d6740f69 
Dealt to 769f9efe 
Dealt to Hero [7h As]
d6740f69: raises $0.11 to $0.21
769f9efe: folds
Hero: folds
d21c8de: folds
599835ba: folds
e181b664: calls $0.11
*** FLOP *** [Js Qh 6s]
e181b664: checks
d6740f69: bets $0.31
e181b664: folds
Uncalled bet ($0.31) returned to d6740f69
*** SHOWDOWN ***
d6740f69 collected $0.45 from pot
*** SUMMARY ***
Total pot $0.47 | Rake $0.02 | Jackpot $0 | Bingo $0 | Fortune $0 | Tax $0
Board [Js Qh 6s]
Seat 1: d21c8de (button) folded before Flop (didn't bet)
Seat 2: 599835ba (small blind) folded before Flop
Seat 3: e181b664 (big blind) folded on the Flop
Seat 4: d6740f69 won ($0.45)
Seat 5: 769f9efe folded before Flop (didn't bet)
Seat 6: Hero folded before Flop (didn't bet)


Poker Hand #RC2075545454: Hold'em No Limit ($0.05/$0.1) - 2023/12/21 23:22:34
Table 'RushAndCash286371' 6-max Seat #1 is the button
Seat 1: Hero ($17.58 in chips)
Seat 2: 98ccc29 ($10 in chips)
Seat 3: 84f0c1ec ($19.84 in chips)
Seat 4: 557246bd ($25.87 in chips)
Seat 5: beddd8cd ($30.83 in chips)
Seat 6: dd4a6c87 ($4.02 in chips)
98ccc29: posts small blind $0.05
84f0c1ec: posts big blind $0.1
*** HOLE CARDS ***
Dealt to Hero [Jc 4c]
Dealt to 98ccc29 
Dealt to 84f0c1ec 
Dealt to 557246bd 
Dealt to beddd8cd 
Dealt to dd4a6c87 
557246bd: folds
beddd8cd: folds
dd4a6c87: folds
Hero: folds
98ccc29: folds
Uncalled bet ($0.05) returned to 84f0c1ec
*** SHOWDOWN ***
84f0c1ec collected $0.1 from pot
*** SUMMARY ***
Total pot $0.1 | Rake $0 | Jackpot $0 | Bingo $0 | Fortune $0 | Tax $0
Seat 1: Hero (button) folded before Flop (didn't bet)
Seat 2: 98ccc29 (small blind) folded before Flop
Seat 3: 84f0c1ec (big blind) collected ($0.1)
Seat 4: 557246bd folded before Flop (didn't bet)
Seat 5: beddd8cd folded before Flop (didn't bet)
Seat 6: dd4a6c87 folded before Flop (didn't bet)


Poker Hand #RC2075545332: Hold'em No Limit ($0.05/$0.1) - 2023/12/21 23:22:30
Table 'RushAndCash286302' 6-max Seat #1 is the button
Seat 1: fb1702bf ($10.67 in chips)
Seat 2: 70c222e3 ($27.32 in chips)
Seat 3: bd3b2870 ($32.55 in chips)
Seat 4: b4ab5408 ($15.71 in chips)
Seat 5: 842f1957 ($18.32 in chips)
Seat 6: Hero ($17.58 in chips)
70c222e3: posts small blind $0.05
bd3b2870: posts big blind $0.1
*** HOLE CARDS ***
Dealt to fb1702bf 
Dealt to 70c222e3 
Dealt to bd3b2870 
Dealt to b4ab5408 
Dealt to 842f1957 
Dealt to Hero [Jc 3h]
b4ab5408: folds
842f1957: folds
Hero: folds
fb1702bf: folds
70c222e3: folds
Uncalled bet ($0.05) returned to bd3b2870
*** SHOWDOWN ***
bd3b2870 collected $0.1 from pot
*** SUMMARY ***
Total pot $0.1 | Rake $0 | Jackpot $0 | Bingo $0 | Fortune $0 | Tax $0
Seat 1: fb1702bf (button) folded before Flop (didn't bet)
Seat 2: 70c222e3 (small blind) folded before Flop
Seat 3: bd3b2870 (big blind) collected ($0.1)
Seat 4: b4ab5408 folded before Flop (didn't bet)
Seat 5: 842f1957 folded before Flop (didn't bet)
Seat 6: Hero folded before Flop (didn't bet)


Poker Hand #RC2075545198: Hold'em No Limit ($0.05/$0.1) - 2023/12/21 23:22:24
Table 'RushAndCash286225' 6-max Seat #1 is the button
Seat 1: 76ffdaa3 ($10 in chips)
Seat 2: 1f60f6b4 ($10 in chips)
Seat 3: 510de39d ($10 in chips)
Seat 4: 45e53bcf ($10 in chips)
Seat 5: Hero ($17.58 in chips)
Seat 6: 6f89d6d3 ($6.96 in chips)
1f60f6b4: posts small blind $0.05
510de39d: posts big blind $0.1
*** HOLE CARDS ***
Dealt to 76ffdaa3 
Dealt to 1f60f6b4 
Dealt to 510de39d 
Dealt to 45e53bcf 
Dealt to Hero [Kh 5d]
Dealt to 6f89d6d3 
45e53bcf: raises $0.1 to $0.2
Hero: folds
6f89d6d3: folds
76ffdaa3: folds
1f60f6b4: folds
510de39d: calls $0.1
*** FLOP *** [7s 8d 2s]
510de39d: checks
45e53bcf: bets $0.25
510de39d: calls $0.25
*** TURN *** [7s 8d 2s] [4c]
510de39d: checks
45e53bcf: bets $0.53
510de39d: calls $0.53
*** RIVER *** [7s 8d 2s 4c] [5s]
510de39d: checks
45e53bcf: bets $1.61
510de39d: folds
Uncalled bet ($1.61) returned to 45e53bcf
*** SHOWDOWN ***
45e53bcf collected $1.91 from pot
*** SUMMARY ***
Total pot $2.01 | Rake $0.1 | Jackpot $0 | Bingo $0 | Fortune $0 | Tax $0
Board [7s 8d 2s 4c 5s]
Seat 1: 76ffdaa3 (button) folded before Flop (didn't bet)
Seat 2: 1f60f6b4 (small blind) folded before Flop
Seat 3: 510de39d (big blind) folded on the River
Seat 4: 45e53bcf won ($1.91)
Seat 5: Hero folded before Flop (didn't bet)
Seat 6: 6f89d6d3 folded before Flop (didn't bet)


Poker Hand #RC2075545046: Hold'em No Limit ($0.05/$0.1) - 2023/12/21 23:22:17
Table 'RushAndCash286139' 6-max Seat #1 is the button
Seat 1: 6d28d0a7 ($15.6 in chips)
Seat 2: 6d508c29 ($25.13 in chips)
Seat 3: 1da59c05 ($11.64 in chips)
Seat 4: 9744ecc5 ($10.89 in chips)
Seat 5: 6952e2c ($10.52 in chips)
Seat 6: Hero ($17.58 in chips)
6d508c29: posts small blind $0.05
1da59c05: posts big blind $0.1
*** HOLE CARDS ***
Dealt to 6d28d0a7 
Dealt to 6d508c29 
Dealt to 1da59c05 
Dealt to 9744ecc5 
Dealt to 6952e2c 
Dealt to Hero [8d Qs]
9744ecc5: raises $0.1 to $0.2
6952e2c: folds
Hero: folds
6d28d0a7: folds
6d508c29: folds
1da59c05: calls $0.1
*** FLOP *** [2c Kc Js]
1da59c05: checks
9744ecc5: bets $0.15
1da59c05: calls $0.15
*** TURN *** [2c Kc Js] [2d]
1da59c05: checks
9744ecc5: bets $0.57
1da59c05: folds
Uncalled bet ($0.57) returned to 9744ecc5
*** SHOWDOWN ***
9744ecc5 collected $0.72 from pot
*** SUMMARY ***
Total pot $0.75 | Rake $0.03 | Jackpot $0 | Bingo $0 | Fortune $0 | Tax $0
Board [2c Kc Js 2d]
Seat 1: 6d28d0a7 (button) folded before Flop (didn't bet)
Seat 2: 6d508c29 (small blind) folded before Flop
Seat 3: 1da59c05 (big blind) folded on the Turn
Seat 4: 9744ecc5 won ($0.72)
Seat 5: 6952e2c folded before Flop (didn't bet)
Seat 6: Hero folded before Flop (didn't bet)


Poker Hand #RC2075524590: Hold'em No Limit ($0.05/$0.1) - 2023/12/21 23:21:57
Table 'RushAndCash285887' 6-max Seat #1 is the button
Seat 1: f16e9798 ($10.2 in chips)
Seat 2: Hero ($17.63 in chips)
Seat 3: 9c11fa0c ($15.33 in chips)
Seat 4: b926a983 ($16.06 in chips)
Seat 5: 256ff75e ($10.47 in chips)
Seat 6: fd721595 ($13.72 in chips)
Hero: posts small blind $0.05
9c11fa0c: posts big blind $0.1
*** HOLE CARDS ***
Dealt to f16e9798 
Dealt to Hero [Ah 7s]
Dealt to 9c11fa0c 
Dealt to b926a983 
Dealt to 256ff75e 
Dealt to fd721595 
b926a983: folds
256ff75e: folds
fd721595: folds
f16e9798: raises $0.1 to $0.2
Hero: folds
9c11fa0c: folds
Uncalled bet ($0.1) returned to f16e9798
*** SHOWDOWN ***
f16e9798 collected $0.25 from pot
*** SUMMARY ***
Total pot $0.25 | Rake $0 | Jackpot $0 | Bingo $0 | Fortune $0 | Tax $0
Seat 1: f16e9798 (button) collected ($0.25)
Seat 2: Hero (small blind) folded before Flop
Seat 3: 9c11fa0c (big blind) folded before Flop
Seat 4: b926a983 folded before Flop (didn't bet)
Seat 5: 256ff75e folded before Flop (didn't bet)
Seat 6: fd721595 folded before Flop (didn't bet)


Poker Hand #RC2075524395: Hold'em No Limit ($0.05/$0.1) - 2023/12/21 23:21:48
Table 'RushAndCash285778' 6-max Seat #1 is the button
Seat 1: 9ffe5b45 ($10.84 in chips)
Seat 2: 69caf1aa ($22.94 in chips)
Seat 3: Hero ($17.58 in chips)
Seat 4: af662651 ($10 in chips)
Seat 5: da27a89e ($18.06 in chips)
Seat 6: 1f60f6b4 ($10 in chips)
69caf1aa: posts small blind $0.05
Hero: posts big blind $0.1
*** HOLE CARDS ***
Dealt to 9ffe5b45 
Dealt to 69caf1aa 
Dealt to Hero [3d 4c]
Dealt to af662651 
Dealt to da27a89e 
Dealt to 1f60f6b4 
af662651: folds
da27a89e: folds
1f60f6b4: folds
9ffe5b45: folds
69caf1aa: folds
Uncalled bet ($0.05) returned to Hero
*** SHOWDOWN ***
Hero collected $0.1 from pot
*** SUMMARY ***
Total pot $0.1 | Rake $0 | Jackpot $0 | Bingo $0 | Fortune $0 | Tax $0
Seat 1: 9ffe5b45 (button) folded before Flop (didn't bet)
Seat 2: 69caf1aa (small blind) folded before Flop
Seat 3: Hero (big blind) collected ($0.1)
Seat 4: af662651 folded before Flop (didn't bet)
Seat 5: da27a89e folded before Flop (didn't bet)
Seat 6: 1f60f6b4 folded before Flop (didn't bet)


Poker Hand #RC2075524252: Hold'em No Limit ($0.05/$0.1) - 2023/12/21 23:21:42
Table 'RushAndCash285697' 6-max Seat #1 is the button
Seat 1: Hero ($17.58 in chips)
Seat 2: e561f7e7 ($10 in chips)
Seat 3: b8e6a33a ($13.16 in chips)
Seat 4: e2adffdd ($18.11 in chips)
Seat 5: fd721595 ($13.72 in chips)
Seat 6: 962102c7 ($28.62 in chips)
e561f7e7: posts small blind $0.05
b8e6a33a: posts big blind $0.1
*** HOLE CARDS ***
Dealt to Hero [5s 8c]
Dealt to e561f7e7 
Dealt to b8e6a33a 
Dealt to e2adffdd 
Dealt to fd721595 
Dealt to 962102c7 
e2adffdd: folds
fd721595: folds
962102c7: folds
Hero: folds
e561f7e7: raises $0.2 to $0.3
b8e6a33a: calls $0.2
*** FLOP *** [Td Qh 5h]
e561f7e7: checks
b8e6a33a: bets $0.34
e561f7e7: folds
Uncalled bet ($0.34) returned to b8e6a33a
*** SHOWDOWN ***
b8e6a33a collected $0.57 from pot
*** SUMMARY ***
Total pot $0.6 | Rake $0.03 | Jackpot $0 | Bingo $0 | Fortune $0 | Tax $0
Board [Td Qh 5h]
Seat 1: Hero (button) folded before Flop (didn't bet)
Seat 2: e561f7e7 (small blind) folded on the Flop
Seat 3: b8e6a33a (big blind) won ($0.57)
Seat 4: e2adffdd folded before Flop (didn't bet)
Seat 5: fd721595 folded before Flop (didn't bet)
Seat 6: 962102c7 folded before Flop (didn't bet)


Poker Hand #RC2075524185: Hold'em No Limit ($0.05/$0.1) - 2023/12/21 23:21:39
Table 'RushAndCash285659' 6-max Seat #1 is the button
Seat 1: a47e75ec ($23.39 in chips)
Seat 2: af8e879e ($10.2 in chips)
Seat 3: 7032505e ($14.17 in chips)
Seat 4: 76f4ebd9 ($29.33 in chips)
Seat 5: Hero ($17.58 in chips)
Seat 6: 88882f24 ($17.23 in chips)
af8e879e: posts small blind $0.05
7032505e: posts big blind $0.1
*** HOLE CARDS ***
Dealt to a47e75ec 
Dealt to af8e879e 
Dealt to 7032505e 
Dealt to 76f4ebd9 
Dealt to Hero [2c 9d]
Dealt to 88882f24 
76f4ebd9: folds
Hero: folds
88882f24: folds
a47e75ec: folds
af8e879e: folds
Uncalled bet ($0.05) returned to 7032505e
*** SHOWDOWN ***
7032505e collected $0.1 from pot
*** SUMMARY ***
Total pot $0.1 | Rake $0 | Jackpot $0 | Bingo $0 | Fortune $0 | Tax $0
Seat 1: a47e75ec (button) folded before Flop (didn't bet)
Seat 2: af8e879e (small blind) folded before Flop
Seat 3: 7032505e (big blind) collected ($0.1)
Seat 4: 76f4ebd9 folded before Flop (didn't bet)
Seat 5: Hero folded before Flop (didn't bet)
Seat 6: 88882f24 folded before Flop (didn't bet)


Poker Hand #RC2075524072: Hold'em No Limit ($0.05/$0.1) - 2023/12/21 23:21:34
Table 'RushAndCash285594' 6-max Seat #1 is the button
Seat 1: b0f2c17b ($13.68 in chips)
Seat 2: 1aa32d3b ($13.99 in chips)
Seat 3: b1f872c6 ($17.19 in chips)
Seat 4: a837aa46 ($35.92 in chips)
Seat 5: Hero ($17.58 in chips)
Seat 6: 5a7aed9f ($32.66 in chips)
1aa32d3b: posts small blind $0.05
b1f872c6: posts big blind $0.1
*** HOLE CARDS ***
Dealt to b0f2c17b 
Dealt to 1aa32d3b 
Dealt to b1f872c6 
Dealt to a837aa46 
Dealt to Hero [Qc 8d]
Dealt to 5a7aed9f 
a837aa46: folds
Hero: folds
5a7aed9f: raises $0.14 to $0.24
b0f2c17b: folds
1aa32d3b: folds
b1f872c6: calls $0.14
*** FLOP *** [Jd 2d 5h]
b1f872c6: checks
5a7aed9f: checks
*** TURN *** [Jd 2d 5h] [8s]
b1f872c6: bets $0.4
5a7aed9f: calls $0.4
*** RIVER *** [Jd 2d 5h 8s] [Kh]
b1f872c6: checks
5a7aed9f: checks
b1f872c6: shows [7h Qh] (King-High)
5a7aed9f: shows [8h Ah] (Pair of Eights)
*** SHOWDOWN ***
5a7aed9f collected $1.27 from pot
*** SUMMARY ***
Total pot $1.33 | Rake $0.06 | Jackpot $0 | Bingo $0 | Fortune $0 | Tax $0
Board [Jd 2d 5h 8s Kh]
Seat 1: b0f2c17b (button) folded before Flop (didn't bet)
Seat 2: 1aa32d3b (small blind) folded before Flop
Seat 3: b1f872c6 (big blind) showed [7h Qh] and lost with King-High
Seat 4: a837aa46 folded before Flop (didn't bet)
Seat 5: Hero folded before Flop (didn't bet)
Seat 6: 5a7aed9f showed [8h Ah] and won ($1.27) with Pair of Eights


Poker Hand #RC2075522898: Hold'em No Limit ($0.05/$0.1) - 2023/12/21 23:20:42
Table 'RushAndCash284937' 6-max Seat #1 is the button
Seat 1: 8c1f2bcb ($14.91 in chips)
Seat 2: f6051b97 ($10.5 in chips)
Seat 3: 1aa32d3b ($13.76 in chips)
Seat 4: 8932199d ($14.68 in chips)
Seat 5: 51876681 ($9.5 in chips)
Seat 6: Hero ($17.78 in chips)
f6051b97: posts small blind $0.05
1aa32d3b: posts big blind $0.1
*** HOLE CARDS ***
Dealt to 8c1f2bcb 
Dealt to f6051b97 
Dealt to 1aa32d3b 
Dealt to 8932199d 
Dealt to 51876681 
Dealt to Hero [Ad 2d]
8932199d: folds
51876681: folds
Hero: raises $0.1 to $0.2
8c1f2bcb: folds
f6051b97: folds
1aa32d3b: calls $0.1
*** FLOP *** [8c 6s 3d]
1aa32d3b: checks
Hero: checks
*** TURN *** [8c 6s 3d] [3c]
1aa32d3b: bets $0.65
Hero: folds
Uncalled bet ($0.65) returned to 1aa32d3b
*** SHOWDOWN ***
1aa32d3b collected $0.43 from pot
*** SUMMARY ***
Total pot $0.45 | Rake $0.02 | Jackpot $0 | Bingo $0 | Fortune $0 | Tax $0
Board [8c 6s 3d 3c]
Seat 1: 8c1f2bcb (button) folded before Flop (didn't bet)
Seat 2: f6051b97 (small blind) folded before Flop
Seat 3: 1aa32d3b (big blind) won ($0.43)
Seat 4: 8932199d folded before Flop (didn't bet)
Seat 5: 51876681 folded before Flop (didn't bet)
Seat 6: Hero folded on the Turn


Poker Hand #RC2075522764: Hold'em No Limit ($0.05/$0.1) - 2023/12/21 23:20:36
Table 'RushAndCash284860' 6-max Seat #1 is the button
Seat 1: ea8afa ($23.98 in chips)
Seat 2: Hero ($17.83 in chips)
Seat 3: 238d1c04 ($11.62 in chips)
Seat 4: 2d08b14 ($10.37 in chips)
Seat 5: 11a74ecd ($13.52 in chips)
Seat 6: 59a51942 ($21.56 in chips)
Hero: posts small blind $0.05
238d1c04: posts big blind $0.1
*** HOLE CARDS ***
Dealt to ea8afa 
Dealt to Hero [Jh 8d]
Dealt to 238d1c04 
Dealt to 2d08b14 
Dealt to 11a74ecd 
Dealt to 59a51942 
2d08b14: folds
11a74ecd: folds
59a51942: raises $0.12 to $0.22
ea8afa: raises $0.61 to $0.83
Hero: folds
238d1c04: folds
59a51942: folds
Uncalled bet ($0.61) returned to ea8afa
*** SHOWDOWN ***
ea8afa collected $0.56 from pot
*** SUMMARY ***
Total pot $0.59 | Rake $0.03 | Jackpot $0 | Bingo $0 | Fortune $0 | Tax $0
Seat 1: ea8afa (button) collected ($0.56)
Seat 2: Hero (small blind) folded before Flop
Seat 3: 238d1c04 (big blind) folded before Flop
Seat 4: 2d08b14 folded before Flop (didn't bet)
Seat 5: 11a74ecd folded before Flop (didn't bet)
Seat 6: 59a51942 folded before Flop


Poker Hand #RC2075522522: Hold'em No Limit ($0.05/$0.1) - 2023/12/21 23:20:26
Table 'RushAndCash284725' 6-max Seat #1 is the button
Seat 1: f168df8e ($12.13 in chips)
Seat 2: ff1fe2f3 ($11.23 in chips)
Seat 3: Hero ($17.93 in chips)
Seat 4: f04b4582 ($10 in chips)
Seat 5: 71f03a69 ($11.47 in chips)
Seat 6: bcfefb74 ($10.57 in chips)
ff1fe2f3: posts small blind $0.05
Hero: posts big blind $0.1
*** HOLE CARDS ***
Dealt to f168df8e 
Dealt to ff1fe2f3 
Dealt to Hero [Ks 5d]
Dealt to f04b4582 
Dealt to 71f03a69 
Dealt to bcfefb74 
f04b4582: folds
71f03a69: raises $0.1 to $0.2
bcfefb74: folds
f168df8e: folds
ff1fe2f3: folds
Hero: folds
Uncalled bet ($0.1) returned to 71f03a69
*** SHOWDOWN ***
71f03a69 collected $0.25 from pot
*** SUMMARY ***
Total pot $0.25 | Rake $0 | Jackpot $0 | Bingo $0 | Fortune $0 | Tax $0
Seat 1: f168df8e (button) folded before Flop (didn't bet)
Seat 2: ff1fe2f3 (small blind) folded before Flop
Seat 3: Hero (big blind) folded before Flop
Seat 4: f04b4582 folded before Flop (didn't bet)
Seat 5: 71f03a69 collected ($0.25)
Seat 6: bcfefb74 folded before Flop (didn't bet)


Poker Hand #RC2075522432: Hold'em No Limit ($0.05/$0.1) - 2023/12/21 23:20:22
Table 'RushAndCash284674' 6-max Seat #1 is the button
Seat 1: 3c937e32 ($11.54 in chips)
Seat 2: 3d83b5d2 ($28.62 in chips)
Seat 3: 69c1c0d0 ($5.34 in chips)
Seat 4: Hero ($17.93 in chips)
Seat 5: e57aeb4c ($18.47 in chips)
Seat 6: c373bc25 ($12.11 in chips)
3d83b5d2: posts small blind $0.05
69c1c0d0: posts big blind $0.1
*** HOLE CARDS ***
Dealt to 3c937e32 
Dealt to 3d83b5d2 
Dealt to 69c1c0d0 
Dealt to Hero [2s Qs]
Dealt to e57aeb4c 
Dealt to c373bc25 
Hero: folds
e57aeb4c: folds
c373bc25: folds
3c937e32: folds
3d83b5d2: raises $0.2 to $0.3
69c1c0d0: folds
Uncalled bet ($0.2) returned to 3d83b5d2
*** SHOWDOWN ***
3d83b5d2 collected $0.2 from pot
*** SUMMARY ***
Total pot $0.2 | Rake $0 | Jackpot $0 | Bingo $0 | Fortune $0 | Tax $0
Seat 1: 3c937e32 (button) folded before Flop (didn't bet)
Seat 2: 3d83b5d2 (small blind) collected ($0.2)
Seat 3: 69c1c0d0 (big blind) folded before Flop
Seat 4: Hero folded before Flop (didn't bet)
Seat 5: e57aeb4c folded before Flop (didn't bet)
Seat 6: c373bc25 folded before Flop (didn't bet)


Poker Hand #RC2075522357: Hold'em No Limit ($0.05/$0.1) - 2023/12/21 23:20:18
Table 'RushAndCash284630' 6-max Seat #1 is the button
Seat 1: Hero ($17.93 in chips)
Seat 2: 7c19ab27 ($14.17 in chips)
Seat 3: a4c0cc7 ($10.91 in chips)
Seat 4: fe713d8b ($10.47 in chips)
Seat 5: c824ca62 ($18.44 in chips)
Seat 6: 9b9b8638 ($10.55 in chips)
7c19ab27: posts small blind $0.05
a4c0cc7: posts big blind $0.1
*** HOLE CARDS ***
Dealt to Hero [As 3d]
Dealt to 7c19ab27 
Dealt to a4c0cc7 
Dealt to fe713d8b 
Dealt to c824ca62 
Dealt to 9b9b8638 
fe713d8b: folds
c824ca62: folds
9b9b8638: folds
Hero: folds
7c19ab27: raises $0.1 to $0.2
a4c0cc7: folds
Uncalled bet ($0.1) returned to 7c19ab27
*** SHOWDOWN ***
7c19ab27 collected $0.2 from pot
*** SUMMARY ***
Total pot $0.2 | Rake $0 | Jackpot $0 | Bingo $0 | Fortune $0 | Tax $0
Seat 1: Hero (button) folded before Flop (didn't bet)
Seat 2: 7c19ab27 (small blind) collected ($0.2)
Seat 3: a4c0cc7 (big blind) folded before Flop
Seat 4: fe713d8b folded before Flop (didn't bet)
Seat 5: c824ca62 folded before Flop (didn't bet)
Seat 6: 9b9b8638 folded before Flop (didn't bet)


Poker Hand #RC2075522079: Hold'em No Limit ($0.05/$0.1) - 2023/12/21 23:20:06
Table 'RushAndCash284475' 6-max Seat #1 is the button
Seat 1: 733a493a ($9.1 in chips)
Seat 2: 9f16fa8a ($14.72 in chips)
Seat 3: 68eb0b28 ($10.15 in chips)
Seat 4: dab3b6e6 ($10 in chips)
Seat 5: beddd8cd ($30.84 in chips)
Seat 6: Hero ($17.93 in chips)
9f16fa8a: posts small blind $0.05
68eb0b28: posts big blind $0.1
*** HOLE CARDS ***
Dealt to 733a493a 
Dealt to 9f16fa8a 
Dealt to 68eb0b28 
Dealt to dab3b6e6 
Dealt to beddd8cd 
Dealt to Hero [Kd 4d]
dab3b6e6: folds
beddd8cd: raises $0.11 to $0.21
Hero: folds
733a493a: folds
9f16fa8a: folds
68eb0b28: folds
Uncalled bet ($0.11) returned to beddd8cd
*** SHOWDOWN ***
beddd8cd collected $0.25 from pot
*** SUMMARY ***
Total pot $0.25 | Rake $0 | Jackpot $0 | Bingo $0 | Fortune $0 | Tax $0
Seat 1: 733a493a (button) folded before Flop (didn't bet)
Seat 2: 9f16fa8a (small blind) folded before Flop
Seat 3: 68eb0b28 (big blind) folded before Flop
Seat 4: dab3b6e6 folded before Flop (didn't bet)
Seat 5: beddd8cd collected ($0.25)
Seat 6: Hero folded before Flop (didn't bet)


Poker Hand #RC2075521960: Hold'em No Limit ($0.05/$0.1) - 2023/12/21 23:20:00
Table 'RushAndCash284405' 6-max Seat #1 is the button
Seat 1: a2286d58 ($13.81 in chips)
Seat 2: 269c665c ($10 in chips)
Seat 3: 23ab2c57 ($11 in chips)
Seat 4: 915d8ff9 ($10 in chips)
Seat 5: Hero ($17.93 in chips)
Seat 6: 80a265e5 ($9.9 in chips)
269c665c: posts small blind $0.05
23ab2c57: posts big blind $0.1
*** HOLE CARDS ***
Dealt to a2286d58 
Dealt to 269c665c 
Dealt to 23ab2c57 
Dealt to 915d8ff9 
Dealt to Hero [Qh 8s]
Dealt to 80a265e5 
915d8ff9: raises $0.15 to $0.25
Hero: folds
80a265e5: calls $0.25
a2286d58: calls $0.25
269c665c: folds
23ab2c57: folds
*** FLOP *** [Js Kc 3s]
915d8ff9: checks
80a265e5: checks
a2286d58: checks
*** TURN *** [Js Kc 3s] [8h]
915d8ff9: bets $0.3
80a265e5: calls $0.3
a2286d58: calls $0.3
*** RIVER *** [Js Kc 3s 8h] [Jc]
915d8ff9: checks
80a265e5: checks
a2286d58: bets $1.2
915d8ff9: folds
80a265e5: folds
Uncalled bet ($1.2) returned to a2286d58
*** SHOWDOWN ***
a2286d58 collected $1.71 from pot
*** SUMMARY ***
Total pot $1.8 | Rake $0.09 | Jackpot $0 | Bingo $0 | Fortune $0 | Tax $0
Board [Js Kc 3s 8h Jc]
Seat 1: a2286d58 (button) won ($1.71)
Seat 2: 269c665c (small blind) folded before Flop
Seat 3: 23ab2c57 (big blind) folded before Flop
Seat 4: 915d8ff9 folded on the River
Seat 5: Hero folded before Flop (didn't bet)
Seat 6: 80a265e5 folded on the River


Poker Hand #RC2075521882: Hold'em No Limit ($0.05/$0.1) - 2023/12/21 23:19:57
Table 'RushAndCash284361' 6-max Seat #1 is the button
Seat 1: 312e123 ($10 in chips)
Seat 2: Hero ($17.98 in chips)
Seat 3: bff71335 ($15.56 in chips)
Seat 4: ef1e2ad6 ($7.2 in chips)
Seat 5: e181b664 ($10.89 in chips)
Seat 6: 3d511405 ($10.68 in chips)
Hero: posts small blind $0.05
bff71335: posts big blind $0.1
*** HOLE CARDS ***
Dealt to 312e123 
Dealt to Hero [Jc 5h]
Dealt to bff71335 
Dealt to ef1e2ad6 
Dealt to e181b664 
Dealt to 3d511405 
ef1e2ad6: folds
e181b664: folds
3d511405: raises $0.15 to $0.25
312e123: folds
Hero: folds
bff71335: folds
Uncalled bet ($0.15) returned to 3d511405
*** SHOWDOWN ***
3d511405 collected $0.25 from pot
*** SUMMARY ***
Total pot $0.25 | Rake $0 | Jackpot $0 | Bingo $0 | Fortune $0 | Tax $0
Seat 1: 312e123 (button) folded before Flop (didn't bet)
Seat 2: Hero (small blind) folded before Flop
Seat 3: bff71335 (big blind) folded before Flop
Seat 4: ef1e2ad6 folded before Flop (didn't bet)
Seat 5: e181b664 folded before Flop (didn't bet)
Seat 6: 3d511405 collected ($0.25)


Poker Hand #RC2075521743: Hold'em No Limit ($0.05/$0.1) - 2023/12/21 23:19:51
Table 'RushAndCash284284' 6-max Seat #1 is the button
Seat 1: 593dd101 ($9.68 in chips)
Seat 2: 7ddc107 ($12.97 in chips)
Seat 3: 796cbdba ($10.33 in chips)
Seat 4: Hero ($17.98 in chips)
Seat 5: 755047f2 ($23.82 in chips)
Seat 6: 4288ffd6 ($10 in chips)
7ddc107: posts small blind $0.05
796cbdba: posts big blind $0.1
*** HOLE CARDS ***
Dealt to 593dd101 
Dealt to 7ddc107 
Dealt to 796cbdba 
Dealt to Hero [4c 9h]
Dealt to 755047f2 
Dealt to 4288ffd6 
Hero: folds
755047f2: folds
4288ffd6: folds
593dd101: raises $0.11 to $0.21
7ddc107: calls $0.16
796cbdba: calls $0.11
*** FLOP *** [3c Ac 7c]
7ddc107: checks
796cbdba: checks
593dd101: bets $0.41
7ddc107: folds
796cbdba: calls $0.41
*** TURN *** [3c Ac 7c] [Js]
796cbdba: bets $0.44
593dd101: folds
Uncalled bet ($0.44) returned to 796cbdba
*** SHOWDOWN ***
796cbdba collected $1.38 from pot
*** SUMMARY ***
Total pot $1.45 | Rake $0.07 | Jackpot $0 | Bingo $0 | Fortune $0 | Tax $0
Board [3c Ac 7c Js]
Seat 1: 593dd101 (button) folded on the Turn
Seat 2: 7ddc107 (small blind) folded on the Flop
Seat 3: 796cbdba (big blind) won ($1.38)
Seat 4: Hero folded before Flop (didn't bet)
Seat 5: 755047f2 folded before Flop (didn't bet)
Seat 6: 4288ffd6 folded before Flop (didn't bet)


Poker Hand #RC2075521274: Hold'em No Limit ($0.05/$0.1) - 2023/12/21 23:19:31
Table 'RushAndCash284009' 6-max Seat #1 is the button
Seat 1: Hero ($18.23 in chips)
Seat 2: fc0a3af9 ($30.12 in chips)
Seat 3: 59a51942 ($21.51 in chips)
Seat 4: da458c4d ($8.06 in chips)
Seat 5: afb9feea ($18.74 in chips)
Seat 6: 7dc7f15b ($10 in chips)
fc0a3af9: posts small blind $0.05
59a51942: posts big blind $0.1
*** HOLE CARDS ***
Dealt to Hero [Ad 4d]
Dealt to fc0a3af9 
Dealt to 59a51942 
Dealt to da458c4d 
Dealt to afb9feea 
Dealt to 7dc7f15b 
da458c4d: folds
afb9feea: folds
7dc7f15b: folds
Hero: raises $0.15 to $0.25
fc0a3af9: raises $0.95 to $1.2
59a51942: folds
Hero: folds
Uncalled bet ($0.95) returned to fc0a3af9
*** SHOWDOWN ***
fc0a3af9 collected $0.57 from pot
*** SUMMARY ***
Total pot $0.6 | Rake $0.03 | Jackpot $0 | Bingo $0 | Fortune $0 | Tax $0
Seat 1: Hero (button) folded before Flop
Seat 2: fc0a3af9 (small blind) collected ($0.57)
Seat 3: 59a51942 (big blind) folded before Flop
Seat 4: da458c4d folded before Flop (didn't bet)
Seat 5: afb9feea folded before Flop (didn't bet)
Seat 6: 7dc7f15b folded before Flop (didn't bet)


Poker Hand #RC2075521190: Hold'em No Limit ($0.05/$0.1) - 2023/12/21 23:19:27
Table 'RushAndCash283960' 6-max Seat #1 is the button
Seat 1: 2119038a ($27.36 in chips)
Seat 2: 6f485ead ($11.01 in chips)
Seat 3: Hero ($18.33 in chips)
Seat 4: 25884f73 ($10.26 in chips)
Seat 5: 99b954a4 ($4.62 in chips)
Seat 6: b926a983 ($17.31 in chips)
6f485ead: posts small blind $0.05
Hero: posts big blind $0.1
*** HOLE CARDS ***
Dealt to 2119038a 
Dealt to 6f485ead 
Dealt to Hero [6d 7s]
Dealt to 25884f73 
Dealt to 99b954a4 
Dealt to b926a983 
25884f73: folds
99b954a4: raises $0.1 to $0.2
b926a983: folds
2119038a: folds
6f485ead: folds
Hero: folds
Uncalled bet ($0.1) returned to 99b954a4
*** SHOWDOWN ***
99b954a4 collected $0.25 from pot
*** SUMMARY ***
Total pot $0.25 | Rake $0 | Jackpot $0 | Bingo $0 | Fortune $0 | Tax $0
Seat 1: 2119038a (button) folded before Flop (didn't bet)
Seat 2: 6f485ead (small blind) folded before Flop
Seat 3: Hero (big blind) folded before Flop
Seat 4: 25884f73 folded before Flop (didn't bet)
Seat 5: 99b954a4 collected ($0.25)
Seat 6: b926a983 folded before Flop (didn't bet)


Poker Hand #RC2075521104: Hold'em No Limit ($0.05/$0.1) - 2023/12/21 23:19:24
Table 'RushAndCash283910' 6-max Seat #1 is the button
Seat 1: 4a5243c ($10.49 in chips)
Seat 2: 3f3ce363 ($10.81 in chips)
Seat 3: 1f7a8ee9 ($14.98 in chips)
Seat 4: 99b954a4 ($4.62 in chips)
Seat 5: b1f872c6 ($17.99 in chips)
Seat 6: Hero ($18.33 in chips)
3f3ce363: posts small blind $0.05
1f7a8ee9: posts big blind $0.1
*** HOLE CARDS ***
Dealt to 4a5243c 
Dealt to 3f3ce363 
Dealt to 1f7a8ee9 
Dealt to 99b954a4 
Dealt to b1f872c6 
Dealt to Hero [Js 9h]
99b954a4: folds
b1f872c6: folds
Hero: folds
4a5243c: raises $0.1 to $0.2
3f3ce363: raises $0.75 to $0.95
1f7a8ee9: raises $1.25 to $2.2
4a5243c: folds
3f3ce363: raises $8.61 to $10.81 and is all-in
1f7a8ee9: folds
Uncalled bet ($8.61) returned to 3f3ce363
1f7a8ee9: shows [Td Ts]
*** SHOWDOWN ***
3f3ce363 collected $4.23 from pot
*** SUMMARY ***
Total pot $4.6 | Rake $0.22 | Jackpot $0.15 | Bingo $0 | Fortune $0 | Tax $0
Seat 1: 4a5243c (button) folded before Flop
Seat 2: 3f3ce363 (small blind) collected ($4.23)
Seat 3: 1f7a8ee9 (big blind) folded before Flop
Seat 4: 99b954a4 folded before Flop (didn't bet)
Seat 5: b1f872c6 folded before Flop (didn't bet)
Seat 6: Hero folded before Flop (didn't bet)


Poker Hand #RC2075520971: Hold'em No Limit ($0.05/$0.1) - 2023/12/21 23:19:18
Table 'RushAndCash283834' 6-max Seat #1 is the button
Seat 1: Hero ($18.33 in chips)
Seat 2: 8eae006e ($25.03 in chips)
Seat 3: a3f02140 ($9.68 in chips)
Seat 4: 97208000 ($10.19 in chips)
Seat 5: 61685ef9 ($23.52 in chips)
Seat 6: dd3d29eb ($11.49 in chips)
8eae006e: posts small blind $0.05
a3f02140: posts big blind $0.1
*** HOLE CARDS ***
Dealt to Hero [9s 8d]
Dealt to 8eae006e 
Dealt to a3f02140 
Dealt to 97208000 
Dealt to 61685ef9 
Dealt to dd3d29eb 
97208000: folds
61685ef9: raises $0.1 to $0.2
dd3d29eb: folds
Hero: folds
8eae006e: folds
a3f02140: calls $0.1
*** FLOP *** [Qc Jd 8s]
a3f02140: checks
61685ef9: bets $0.15
a3f02140: calls $0.15
*** TURN *** [Qc Jd 8s] [3s]
a3f02140: checks
61685ef9: checks
*** RIVER *** [Qc Jd 8s 3s] [Td]
a3f02140: checks
61685ef9: checks
a3f02140: shows [7s As] (Ace-High)
61685ef9: shows [Kh Tc] (Pair of Tens)
*** SHOWDOWN ***
61685ef9 collected $0.72 from pot
*** SUMMARY ***
Total pot $0.75 | Rake $0.03 | Jackpot $0 | Bingo $0 | Fortune $0 | Tax $0
Board [Qc Jd 8s 3s Td]
Seat 1: Hero (button) folded before Flop (didn't bet)
Seat 2: 8eae006e (small blind) folded before Flop
Seat 3: a3f02140 (big blind) showed [7s As] and lost with Ace-High
Seat 4: 97208000 folded before Flop (didn't bet)
Seat 5: 61685ef9 showed [Kh Tc] and won ($0.72) with Pair of Tens
Seat 6: dd3d29eb folded before Flop (didn't bet)


Poker Hand #RC2075520755: Hold'em No Limit ($0.05/$0.1) - 2023/12/21 23:19:08
Table 'RushAndCash283703' 6-max Seat #1 is the button
Seat 1: a3f02140 ($9.73 in chips)
Seat 2: Hero ($18.38 in chips)
Seat 3: 2d32f8f3 ($21.21 in chips)
Seat 4: 18756e23 ($10.2 in chips)
Seat 5: 7e5bf647 ($23.31 in chips)
Seat 6: e205620a ($10.57 in chips)
Hero: posts small blind $0.05
2d32f8f3: posts big blind $0.1
*** HOLE CARDS ***
Dealt to a3f02140 
Dealt to Hero [Ah 5d]
Dealt to 2d32f8f3 
Dealt to 18756e23 
Dealt to 7e5bf647 
Dealt to e205620a 
18756e23: folds
7e5bf647: folds
e205620a: raises $0.15 to $0.25
a3f02140: folds
Hero: folds
2d32f8f3: folds
Uncalled bet ($0.15) returned to e205620a
*** SHOWDOWN ***
e205620a collected $0.25 from pot
*** SUMMARY ***
Total pot $0.25 | Rake $0 | Jackpot $0 | Bingo $0 | Fortune $0 | Tax $0
Seat 1: a3f02140 (button) folded before Flop (didn't bet)
Seat 2: Hero (small blind) folded before Flop
Seat 3: 2d32f8f3 (big blind) folded before Flop
Seat 4: 18756e23 folded before Flop (didn't bet)
Seat 5: 7e5bf647 folded before Flop (didn't bet)
Seat 6: e205620a collected ($0.25)


Poker Hand #RC2075520558: Hold'em No Limit ($0.05/$0.1) - 2023/12/21 23:18:59
Table 'RushAndCash283593' 6-max Seat #1 is the button
Seat 1: 9f6ea604 ($13.2 in chips)
Seat 2: 1fec3bbe ($11.53 in chips)
Seat 3: Hero ($18.33 in chips)
Seat 4: e568a613 ($19.85 in chips)
Seat 5: e6ec727d ($10.5 in chips)
Seat 6: 981f5256 ($10.95 in chips)
1fec3bbe: posts small blind $0.05
Hero: posts big blind $0.1
*** HOLE CARDS ***
Dealt to 9f6ea604 
Dealt to 1fec3bbe 
Dealt to Hero [3s As]
Dealt to e568a613 
Dealt to e6ec727d 
Dealt to 981f5256 
e568a613: folds
e6ec727d: folds
981f5256: folds
9f6ea604: folds
1fec3bbe: folds
Uncalled bet ($0.05) returned to Hero
*** SHOWDOWN ***
Hero collected $0.1 from pot
*** SUMMARY ***
Total pot $0.1 | Rake $0 | Jackpot $0 | Bingo $0 | Fortune $0 | Tax $0
Seat 1: 9f6ea604 (button) folded before Flop (didn't bet)
Seat 2: 1fec3bbe (small blind) folded before Flop
Seat 3: Hero (big blind) collected ($0.1)
Seat 4: e568a613 folded before Flop (didn't bet)
Seat 5: e6ec727d folded before Flop (didn't bet)
Seat 6: 981f5256 folded before Flop (didn't bet)


Poker Hand #RC2075520462: Hold'em No Limit ($0.05/$0.1) - 2023/12/21 23:18:54
Table 'RushAndCash283536' 6-max Seat #1 is the button
Seat 1: 272650e5 ($10.12 in chips)
Seat 2: 59b7f5e ($8.57 in chips)
Seat 3: 3b544772 ($10 in chips)
Seat 4: Hero ($18.33 in chips)
Seat 5: 561e331c ($14.85 in chips)
Seat 6: 4d3be08a ($13.02 in chips)
59b7f5e: posts small blind $0.05
3b544772: posts big blind $0.1
*** HOLE CARDS ***
Dealt to 272650e5 
Dealt to 59b7f5e 
Dealt to 3b544772 
Dealt to Hero [Qc Jh]
Dealt to 561e331c 
Dealt to 4d3be08a 
Hero: folds
561e331c: folds
4d3be08a: folds
272650e5: folds
59b7f5e: folds
Uncalled bet ($0.05) returned to 3b544772
*** SHOWDOWN ***
3b544772 collected $0.1 from pot
*** SUMMARY ***
Total pot $0.1 | Rake $0 | Jackpot $0 | Bingo $0 | Fortune $0 | Tax $0
Seat 1: 272650e5 (button) folded before Flop (didn't bet)
Seat 2: 59b7f5e (small blind) folded before Flop
Seat 3: 3b544772 (big blind) collected ($0.1)
Seat 4: Hero folded before Flop (didn't bet)
Seat 5: 561e331c folded before Flop (didn't bet)
Seat 6: 4d3be08a folded before Flop (didn't bet)


Poker Hand #RC2075519340: Hold'em No Limit ($0.05/$0.1) - 2023/12/21 23:18:06
Table 'RushAndCash282874' 6-max Seat #1 is the button
Seat 1: 6f725eb5 ($13.42 in chips)
Seat 2: 2ea50534 ($39.52 in chips)
Seat 3: 4d3be08a ($10 in chips)
Seat 4: Hero ($21.75 in chips)
Seat 5: e57aeb4c ($18.67 in chips)
Seat 6: a0c90946 ($26.92 in chips)
2ea50534: posts small blind $0.05
4d3be08a: posts big blind $0.1
*** HOLE CARDS ***
Dealt to 6f725eb5 
Dealt to 2ea50534 
Dealt to 4d3be08a 
Dealt to Hero [Jc Ac]
Dealt to e57aeb4c 
Dealt to a0c90946 
Hero: raises $0.1 to $0.2
e57aeb4c: folds
a0c90946: folds
6f725eb5: folds
2ea50534: folds
4d3be08a: calls $0.1
*** FLOP *** [Jh 9h 6d]
4d3be08a: checks
Hero: bets $0.23
4d3be08a: raises $0.47 to $0.7
Hero: calls $0.47
*** TURN *** [Jh 9h 6d] [3d]
4d3be08a: bets $1.02
Hero: calls $1.02
*** RIVER *** [Jh 9h 6d 3d] [Ah]
4d3be08a: bets $1.5
Hero: calls $1.5
4d3be08a: shows [7h Th] (Ace High Flush)
Hero: shows [Jc Ac] (Pair of Aces and Pair of Jacks)
*** SHOWDOWN ***
4d3be08a collected $6.44 from pot
*** SUMMARY ***
Total pot $6.89 | Rake $0.3 | Jackpot $0.15 | Bingo $0 | Fortune $0 | Tax $0
Board [Jh 9h 6d 3d Ah]
Seat 1: 6f725eb5 (button) folded before Flop (didn't bet)
Seat 2: 2ea50534 (small blind) folded before Flop
Seat 3: 4d3be08a (big blind) showed [7h Th] and won ($6.44) with Ace High Flush
Seat 4: Hero showed [Jc Ac] and lost with Pair of Aces and Pair of Jacks
Seat 5: e57aeb4c folded before Flop (didn't bet)
Seat 6: a0c90946 folded before Flop (didn't bet)


Poker Hand #RC2075519256: Hold'em No Limit ($0.05/$0.1) - 2023/12/21 23:18:02
Table 'RushAndCash282822' 6-max Seat #1 is the button
Seat 1: 198ae68 ($32.25 in chips)
Seat 2: a5728e47 ($10 in chips)
Seat 3: f5045307 ($9.69 in chips)
Seat 4: Hero ($21.75 in chips)
Seat 5: 50b19d32 ($23.17 in chips)
Seat 6: 69a3e403 ($10.83 in chips)
a5728e47: posts small blind $0.05
f5045307: posts big blind $0.1
*** HOLE CARDS ***
Dealt to 198ae68 
Dealt to a5728e47 
Dealt to f5045307 
Dealt to Hero [5d 8c]
Dealt to 50b19d32 
Dealt to 69a3e403 
Hero: folds
50b19d32: folds
69a3e403: raises $0.15 to $0.25
198ae68: folds
a5728e47: folds
f5045307: calls $0.15
*** FLOP *** [4d 7s 2h]
f5045307: checks
69a3e403: checks
*** TURN *** [4d 7s 2h] [Ah]
f5045307: bets $0.28
69a3e403: folds
Uncalled bet ($0.28) returned to f5045307
*** SHOWDOWN ***
f5045307 collected $0.53 from pot
*** SUMMARY ***
Total pot $0.55 | Rake $0.02 | Jackpot $0 | Bingo $0 | Fortune $0 | Tax $0
Board [4d 7s 2h Ah]
Seat 1: 198ae68 (button) folded before Flop (didn't bet)
Seat 2: a5728e47 (small blind) folded before Flop
Seat 3: f5045307 (big blind) won ($0.53)
Seat 4: Hero folded before Flop (didn't bet)
Seat 5: 50b19d32 folded before Flop (didn't bet)
Seat 6: 69a3e403 folded on the Turn


Poker Hand #RC2075519136: Hold'em No Limit ($0.05/$0.1) - 2023/12/21 23:17:57
Table 'RushAndCash282754' 6-max Seat #1 is the button
Seat 1: d8212adf ($16.65 in chips)
Seat 2: a0328120 ($11.93 in chips)
Seat 3: ad3ca843 ($30.5 in chips)
Seat 4: c8812ed9 ($12.3 in chips)
Seat 5: Hero ($21.75 in chips)
Seat 6: 2d569436 ($10 in chips)
a0328120: posts small blind $0.05
ad3ca843: posts big blind $0.1
*** HOLE CARDS ***
Dealt to d8212adf 
Dealt to a0328120 
Dealt to ad3ca843 
Dealt to c8812ed9 
Dealt to Hero [2s 9d]
Dealt to 2d569436 
c8812ed9: folds
Hero: folds
2d569436: folds
d8212adf: raises $0.1 to $0.2
a0328120: folds
ad3ca843: calls $0.1
*** FLOP *** [Ac Js 5d]
ad3ca843: checks
d8212adf: bets $0.3
ad3ca843: calls $0.3
*** TURN *** [Ac Js 5d] [5s]
ad3ca843: checks
d8212adf: bets $0.73
ad3ca843: folds
Uncalled bet ($0.73) returned to d8212adf
*** SHOWDOWN ***
d8212adf collected $1 from pot
*** SUMMARY ***
Total pot $1.05 | Rake $0.05 | Jackpot $0 | Bingo $0 | Fortune $0 | Tax $0
Board [Ac Js 5d 5s]
Seat 1: d8212adf (button) won ($1)
Seat 2: a0328120 (small blind) folded before Flop
Seat 3: ad3ca843 (big blind) folded on the Turn
Seat 4: c8812ed9 folded before Flop (didn't bet)
Seat 5: Hero folded before Flop (didn't bet)
Seat 6: 2d569436 folded before Flop (didn't bet)


Poker Hand #RC2075518847: Hold'em No Limit ($0.05/$0.1) - 2023/12/21 23:17:44
Table 'RushAndCash282585' 6-max Seat #1 is the button
Seat 1: a8e34387 ($12.44 in chips)
Seat 2: Hero ($21.65 in chips)
Seat 3: 88436705 ($21.4 in chips)
Seat 4: 2d70a465 ($9.96 in chips)
Seat 5: 866fef18 ($10.28 in chips)
Seat 6: 1c43a6ef ($16.06 in chips)
Hero: posts small blind $0.05
88436705: posts big blind $0.1
*** HOLE CARDS ***
Dealt to a8e34387 
Dealt to Hero [Ah 8c]
Dealt to 88436705 
Dealt to 2d70a465 
Dealt to 866fef18 
Dealt to 1c43a6ef 
2d70a465: folds
866fef18: folds
1c43a6ef: folds
a8e34387: folds
Hero: folds
Uncalled bet ($0.05) returned to 88436705
*** SHOWDOWN ***
88436705 collected $0.1 from pot
*** SUMMARY ***
Total pot $0.1 | Rake $0 | Jackpot $0 | Bingo $0 | Fortune $0 | Tax $0
Seat 1: a8e34387 (button) folded before Flop (didn't bet)
Seat 2: Hero (small blind) folded before Flop
Seat 3: 88436705 (big blind) collected ($0.1)
Seat 4: 2d70a465 folded before Flop (didn't bet)
Seat 5: 866fef18 folded before Flop (didn't bet)
Seat 6: 1c43a6ef folded before Flop (didn't bet)


Poker Hand #RC2075518739: Hold'em No Limit ($0.05/$0.1) - 2023/12/21 23:17:39
Table 'RushAndCash282525' 6-max Seat #1 is the button
Seat 1: ca733d1c ($11.63 in chips)
Seat 2: 78ec8b1b ($12.02 in chips)
Seat 3: Hero ($21.75 in chips)
Seat 4: 1a75fa06 ($18.01 in chips)
Seat 5: fb1e534b ($6.35 in chips)
Seat 6: d0e1a15f ($10 in chips)
78ec8b1b: posts small blind $0.05
Hero: posts big blind $0.1
*** HOLE CARDS ***
Dealt to ca733d1c 
Dealt to 78ec8b1b 
Dealt to Hero [Ac 2d]
Dealt to 1a75fa06 
Dealt to fb1e534b 
Dealt to d0e1a15f 
1a75fa06: folds
fb1e534b: folds
d0e1a15f: folds
ca733d1c: folds
78ec8b1b: folds
Uncalled bet ($0.05) returned to Hero
*** SHOWDOWN ***
Hero collected $0.1 from pot
*** SUMMARY ***
Total pot $0.1 | Rake $0 | Jackpot $0 | Bingo $0 | Fortune $0 | Tax $0
Seat 1: ca733d1c (button) folded before Flop (didn't bet)
Seat 2: 78ec8b1b (small blind) folded before Flop
Seat 3: Hero (big blind) collected ($0.1)
Seat 4: 1a75fa06 folded before Flop (didn't bet)
Seat 5: fb1e534b folded before Flop (didn't bet)
Seat 6: d0e1a15f folded before Flop (didn't bet)


Poker Hand #RC2075518606: Hold'em No Limit ($0.05/$0.1) - 2023/12/21 23:17:33
Table 'RushAndCash282447' 6-max Seat #1 is the button
Seat 1: Hero ($21.75 in chips)
Seat 2: de002975 ($21.12 in chips)
Seat 3: 5444bd0e ($14.72 in chips)
Seat 4: bf23faf4 ($11.13 in chips)
Seat 5: afdd922f ($10.15 in chips)
Seat 6: 197cd9e6 ($43.15 in chips)
de002975: posts small blind $0.05
5444bd0e: posts big blind $0.1
*** HOLE CARDS ***
Dealt to Hero [Ac 7s]
Dealt to de002975 
Dealt to 5444bd0e 
Dealt to bf23faf4 
Dealt to afdd922f 
Dealt to 197cd9e6 
bf23faf4: raises $0.12 to $0.22
afdd922f: folds
197cd9e6: folds
Hero: folds
de002975: folds
5444bd0e: folds
Uncalled bet ($0.12) returned to bf23faf4
*** SHOWDOWN ***
bf23faf4 collected $0.25 from pot
*** SUMMARY ***
Total pot $0.25 | Rake $0 | Jackpot $0 | Bingo $0 | Fortune $0 | Tax $0
Seat 1: Hero (button) folded before Flop (didn't bet)
Seat 2: de002975 (small blind) folded before Flop
Seat 3: 5444bd0e (big blind) folded before Flop
Seat 4: bf23faf4 collected ($0.25)
Seat 5: afdd922f folded before Flop (didn't bet)
Seat 6: 197cd9e6 folded before Flop (didn't bet)


Poker Hand #RC2075518527: Hold'em No Limit ($0.05/$0.1) - 2023/12/21 23:17:30
Table 'RushAndCash282402' 6-max Seat #1 is the button
Seat 1: f5e3eb2a ($10.4 in chips)
Seat 2: 8673df53 ($11.87 in chips)
Seat 3: 1080fc59 ($15.16 in chips)
Seat 4: 90d784f ($10.39 in chips)
Seat 5: Hero ($21.75 in chips)
Seat 6: a56ebe0c ($15.93 in chips)
8673df53: posts small blind $0.05
1080fc59: posts big blind $0.1
*** HOLE CARDS ***
Dealt to f5e3eb2a 
Dealt to 8673df53 
Dealt to 1080fc59 
Dealt to 90d784f 
Dealt to Hero [5s 6h]
Dealt to a56ebe0c 
90d784f: raises $0.11 to $0.21
Hero: folds
a56ebe0c: folds
f5e3eb2a: folds
8673df53: folds
1080fc59: folds
Uncalled bet ($0.11) returned to 90d784f
*** SHOWDOWN ***
90d784f collected $0.25 from pot
*** SUMMARY ***
Total pot $0.25 | Rake $0 | Jackpot $0 | Bingo $0 | Fortune $0 | Tax $0
Seat 1: f5e3eb2a (button) folded before Flop (didn't bet)
Seat 2: 8673df53 (small blind) folded before Flop
Seat 3: 1080fc59 (big blind) folded before Flop
Seat 4: 90d784f collected ($0.25)
Seat 5: Hero folded before Flop (didn't bet)
Seat 6: a56ebe0c folded before Flop (didn't bet)


Poker Hand #RC2075518451: Hold'em No Limit ($0.05/$0.1) - 2023/12/21 23:17:26
Table 'RushAndCash282359' 6-max Seat #1 is the button
Seat 1: e043dc53 ($10.82 in chips)
Seat 2: 44cff037 ($19.7 in chips)
Seat 3: 4e1bb4a9 ($41.09 in chips)
Seat 4: a7faa182 ($11.39 in chips)
Seat 5: 23438d98 ($3.05 in chips)
Seat 6: Hero ($21.75 in chips)
44cff037: posts small blind $0.05
4e1bb4a9: posts big blind $0.1
*** HOLE CARDS ***
Dealt to e043dc53 
Dealt to 44cff037 
Dealt to 4e1bb4a9 
Dealt to a7faa182 
Dealt to 23438d98 
Dealt to Hero [2c 6h]
a7faa182: folds
23438d98: folds
Hero: folds
e043dc53: raises $0.1 to $0.2
44cff037: folds
4e1bb4a9: calls $0.1
*** FLOP *** [Jc 3h Kh]
4e1bb4a9: checks
e043dc53: bets $0.15
4e1bb4a9: calls $0.15
*** TURN *** [Jc 3h Kh] [5s]
4e1bb4a9: checks
e043dc53: checks
*** RIVER *** [Jc 3h Kh 5s] [9c]
4e1bb4a9: checks
e043dc53: checks
4e1bb4a9: shows [Ah Js] (Pair of Jacks)
e043dc53: shows [8c Ac] (Ace-High)
*** SHOWDOWN ***
4e1bb4a9 collected $0.72 from pot
*** SUMMARY ***
Total pot $0.75 | Rake $0.03 | Jackpot $0 | Bingo $0 | Fortune $0 | Tax $0
Board [Jc 3h Kh 5s 9c]
Seat 1: e043dc53 (button) showed [8c Ac] and lost with Ace-High
Seat 2: 44cff037 (small blind) folded before Flop
Seat 3: 4e1bb4a9 (big blind) showed [Ah Js] and won ($0.72) with Pair of Jacks
Seat 4: a7faa182 folded before Flop (didn't bet)
Seat 5: 23438d98 folded before Flop (didn't bet)
Seat 6: Hero folded before Flop (didn't bet)


Poker Hand #RC2075518322: Hold'em No Limit ($0.05/$0.1) - 2023/12/21 23:17:21
Table 'RushAndCash282288' 6-max Seat #1 is the button
Seat 1: e2adffdd ($18.97 in chips)
Seat 2: 2c87d7a8 ($22.31 in chips)
Seat 3: b8e6a33a ($10 in chips)
Seat 4: d3bb083 ($20.34 in chips)
Seat 5: fe35290b ($12.92 in chips)
Seat 6: Hero ($21.75 in chips)
2c87d7a8: posts small blind $0.05
b8e6a33a: posts big blind $0.1
*** HOLE CARDS ***
Dealt to e2adffdd 
Dealt to 2c87d7a8 
Dealt to b8e6a33a 
Dealt to d3bb083 
Dealt to fe35290b 
Dealt to Hero [7d 2s]
d3bb083: raises $0.13 to $0.23
fe35290b: folds
Hero: folds
e2adffdd: folds
2c87d7a8: folds
b8e6a33a: folds
Uncalled bet ($0.13) returned to d3bb083
*** SHOWDOWN ***
d3bb083 collected $0.25 from pot
*** SUMMARY ***
Total pot $0.25 | Rake $0 | Jackpot $0 | Bingo $0 | Fortune $0 | Tax $0
Seat 1: e2adffdd (button) folded before Flop (didn't bet)
Seat 2: 2c87d7a8 (small blind) folded before Flop
Seat 3: b8e6a33a (big blind) folded before Flop
Seat 4: d3bb083 collected ($0.25)
Seat 5: fe35290b folded before Flop (didn't bet)
Seat 6: Hero folded before Flop (didn't bet)


Poker Hand #RC2075518204: Hold'em No Limit ($0.05/$0.1) - 2023/12/21 23:17:15
Table 'RushAndCash282217' 6-max Seat #1 is the button
Seat 1: Hero ($21.6 in chips)
Seat 2: 8998e4c4 ($6.74 in chips)
Seat 3: e31d093b ($10 in chips)
Seat 4: 721f9b20 ($10.39 in chips)
Seat 5: 98e36303 ($29.79 in chips)
Seat 6: 7b7f0036 ($27.17 in chips)
8998e4c4: posts small blind $0.05
e31d093b: posts big blind $0.1
*** HOLE CARDS ***
Dealt to Hero [Td 3c]
Dealt to 8998e4c4 
Dealt to e31d093b 
Dealt to 721f9b20 
Dealt to 98e36303 
Dealt to 7b7f0036 
721f9b20: folds
98e36303: folds
7b7f0036: folds
Hero: folds
8998e4c4: raises $0.2 to $0.3
e31d093b: calls $0.2
*** FLOP *** [Qc 7s Kc]
8998e4c4: bets $0.3
e31d093b: folds
Uncalled bet ($0.3) returned to 8998e4c4
*** SHOWDOWN ***
8998e4c4 collected $0.57 from pot
*** SUMMARY ***
Total pot $0.6 | Rake $0.03 | Jackpot $0 | Bingo $0 | Fortune $0 | Tax $0
Board [Qc 7s Kc]
Seat 1: Hero (button) folded before Flop (didn't bet)
Seat 2: 8998e4c4 (small blind) won ($0.57)
Seat 3: e31d093b (big blind) folded on the Flop
Seat 4: 721f9b20 folded before Flop (didn't bet)
Seat 5: 98e36303 folded before Flop (didn't bet)
Seat 6: 7b7f0036 folded before Flop (didn't bet)


Poker Hand #RC2075518106: Hold'em No Limit ($0.05/$0.1) - 2023/12/21 23:17:11
Table 'RushAndCash282160' 6-max Seat #1 is the button
Seat 1: 9a3d80ca ($14.65 in chips)
Seat 2: 7b7f0036 ($27.22 in chips)
Seat 3: Hero ($21.7 in chips)
Seat 4: 8e7494bb ($33.74 in chips)
Seat 5: 9b5e26de ($28.79 in chips)
Seat 6: 75725f39 ($10 in chips)
7b7f0036: posts small blind $0.05
Hero: posts big blind $0.1
*** HOLE CARDS ***
Dealt to 9a3d80ca 
Dealt to 7b7f0036 
Dealt to Hero [Td Kc]
Dealt to 8e7494bb 
Dealt to 9b5e26de 
Dealt to 75725f39 
8e7494bb: folds
9b5e26de: folds
75725f39: folds
9a3d80ca: folds
7b7f0036: folds
Uncalled bet ($0.05) returned to Hero
*** SHOWDOWN ***
Hero collected $0.1 from pot
*** SUMMARY ***
Total pot $0.1 | Rake $0 | Jackpot $0 | Bingo $0 | Fortune $0 | Tax $0
Seat 1: 9a3d80ca (button) folded before Flop (didn't bet)
Seat 2: 7b7f0036 (small blind) folded before Flop
Seat 3: Hero (big blind) collected ($0.1)
Seat 4: 8e7494bb folded before Flop (didn't bet)
Seat 5: 9b5e26de folded before Flop (didn't bet)
Seat 6: 75725f39 folded before Flop (didn't bet)


Poker Hand #RC2075517943: Hold'em No Limit ($0.05/$0.1) - 2023/12/21 23:17:03
Table 'RushAndCash282065' 6-max Seat #1 is the button
Seat 1: 733a493a ($9.85 in chips)
Seat 2: Hero ($21.75 in chips)
Seat 3: 14f46803 ($9.02 in chips)
Seat 4: 8b9c060b ($11.22 in chips)
Seat 5: cd6bdce7 ($14.11 in chips)
Seat 6: da62d8e8 ($10 in chips)
Hero: posts small blind $0.05
14f46803: posts big blind $0.1
*** HOLE CARDS ***
Dealt to 733a493a 
Dealt to Hero [7c 2c]
Dealt to 14f46803 
Dealt to 8b9c060b 
Dealt to cd6bdce7 
Dealt to da62d8e8 
8b9c060b: folds
cd6bdce7: folds
da62d8e8: raises $0.12 to $0.22
733a493a: raises $0.12 to $0.34
Hero: folds
14f46803: folds
da62d8e8: calls $0.12
*** FLOP *** [9h 5h 4h]
da62d8e8: checks
733a493a: checks
*** TURN *** [9h 5h 4h] [4s]
da62d8e8: checks
733a493a: bets $0.42
da62d8e8: folds
Uncalled bet ($0.42) returned to 733a493a
*** SHOWDOWN ***
733a493a collected $0.79 from pot
*** SUMMARY ***
Total pot $0.83 | Rake $0.04 | Jackpot $0 | Bingo $0 | Fortune $0 | Tax $0
Board [9h 5h 4h 4s]
Seat 1: 733a493a (button) won ($0.79)
Seat 2: Hero (small blind) folded before Flop
Seat 3: 14f46803 (big blind) folded before Flop
Seat 4: 8b9c060b folded before Flop (didn't bet)
Seat 5: cd6bdce7 folded before Flop (didn't bet)
Seat 6: da62d8e8 folded on the Turn


Poker Hand #RC2075517825: Hold'em No Limit ($0.05/$0.1) - 2023/12/21 23:16:59
Table 'RushAndCash281990' 6-max Seat #1 is the button
Seat 1: bf10ab18 ($19.03 in chips)
Seat 2: a3b94cac ($23.25 in chips)
Seat 3: 510bab8b ($3.04 in chips)
Seat 4: Hero ($21.75 in chips)
Seat 5: 631999d4 ($33.55 in chips)
Seat 6: afd0eb43 ($28.71 in chips)
a3b94cac: posts small blind $0.05
510bab8b: posts big blind $0.1
*** HOLE CARDS ***
Dealt to bf10ab18 
Dealt to a3b94cac 
Dealt to 510bab8b 
Dealt to Hero [8d 2d]
Dealt to 631999d4 
Dealt to afd0eb43 
Hero: folds
631999d4: folds
afd0eb43: folds
bf10ab18: folds
a3b94cac: folds
Uncalled bet ($0.05) returned to 510bab8b
*** SHOWDOWN ***
510bab8b collected $0.1 from pot
*** SUMMARY ***
Total pot $0.1 | Rake $0 | Jackpot $0 | Bingo $0 | Fortune $0 | Tax $0
Seat 1: bf10ab18 (button) folded before Flop (didn't bet)
Seat 2: a3b94cac (small blind) folded before Flop
Seat 3: 510bab8b (big blind) collected ($0.1)
Seat 4: Hero folded before Flop (didn't bet)
Seat 5: 631999d4 folded before Flop (didn't bet)
Seat 6: afd0eb43 folded before Flop (didn't bet)


Poker Hand #RC2075517712: Hold'em No Limit ($0.05/$0.1) - 2023/12/21 23:16:54
Table 'RushAndCash281924' 6-max Seat #1 is the button
Seat 1: 806cf479 ($10 in chips)
Seat 2: df309ad0 ($10 in chips)
Seat 3: aa4d5c11 ($5.7 in chips)
Seat 4: c1ccea94 ($16.45 in chips)
Seat 5: 4a0fd81 ($18.86 in chips)
Seat 6: Hero ($21.75 in chips)
df309ad0: posts small blind $0.05
aa4d5c11: posts big blind $0.1
*** HOLE CARDS ***
Dealt to 806cf479 
Dealt to df309ad0 
Dealt to aa4d5c11 
Dealt to c1ccea94 
Dealt to 4a0fd81 
Dealt to Hero [Th 3d]
c1ccea94: folds
4a0fd81: raises $0.15 to $0.25
Hero: folds
806cf479: calls $0.25
df309ad0: raises $1.04 to $1.29
aa4d5c11: folds
4a0fd81: calls $1.04
806cf479: folds
*** FLOP *** [8c 5h 3s]
df309ad0: bets $1.67
4a0fd81: calls $1.67
*** TURN *** [8c 5h 3s] [9d]
df309ad0: checks
4a0fd81: checks
*** RIVER *** [8c 5h 3s 9d] [9h]
df309ad0: checks
4a0fd81: bets $2.07
df309ad0: raises $4.97 to $7.04 and is all-in
4a0fd81: calls $4.97
df309ad0: shows [Qs Kc] (Pair of Nines)
4a0fd81: shows [9c 9s] (Four Nines)
*** SHOWDOWN ***
4a0fd81 collected $19.9 from pot
*** SUMMARY ***
Total pot $20.35 | Rake $0.3 | Jackpot $0.15 | Bingo $0 | Fortune $0 | Tax $0
Board [8c 5h 3s 9d 9h]
Seat 1: 806cf479 (button) folded before Flop
Seat 2: df309ad0 (small blind) showed [Qs Kc] and lost with Pair of Nines
Seat 3: aa4d5c11 (big blind) folded before Flop
Seat 4: c1ccea94 folded before Flop (didn't bet)
Seat 5: 4a0fd81 showed [9c 9s] and won ($19.9) with Four Nines
Seat 6: Hero folded before Flop (didn't bet)


Poker Hand #RC2075517531: Hold'em No Limit ($0.05/$0.1) - 2023/12/21 23:16:46
Table 'RushAndCash281815' 6-max Seat #1 is the button
Seat 1: 84f0c1ec ($22.3 in chips)
Seat 2: Hero ($21.8 in chips)
Seat 3: 5d172986 ($15.5 in chips)
Seat 4: d8212adf ($15.65 in chips)
Seat 5: 478aac27 ($12.79 in chips)
Seat 6: 33623df8 ($10 in chips)
Hero: posts small blind $0.05
5d172986: posts big blind $0.1
*** HOLE CARDS ***
Dealt to 84f0c1ec 
Dealt to Hero [Tc Qd]
Dealt to 5d172986 
Dealt to d8212adf 
Dealt to 478aac27 
Dealt to 33623df8 
d8212adf: folds
478aac27: folds
33623df8: folds
84f0c1ec: raises $0.14 to $0.24
Hero: folds
5d172986: folds
Uncalled bet ($0.14) returned to 84f0c1ec
*** SHOWDOWN ***
84f0c1ec collected $0.25 from pot
*** SUMMARY ***
Total pot $0.25 | Rake $0 | Jackpot $0 | Bingo $0 | Fortune $0 | Tax $0
Seat 1: 84f0c1ec (button) collected ($0.25)
Seat 2: Hero (small blind) folded before Flop
Seat 3: 5d172986 (big blind) folded before Flop
Seat 4: d8212adf folded before Flop (didn't bet)
Seat 5: 478aac27 folded before Flop (didn't bet)
Seat 6: 33623df8 folded before Flop (didn't bet)


Poker Hand #RC2075517444: Hold'em No Limit ($0.05/$0.1) - 2023/12/21 23:16:43
Table 'RushAndCash281760' 6-max Seat #1 is the button
Seat 1: 6aa2ac93 ($11.06 in chips)
Seat 2: ab0aaad8 ($9.33 in chips)
Seat 3: e5e46b19 ($30.16 in chips)
Seat 4: 8998e4c4 ($6.84 in chips)
Seat 5: 14f46803 ($9.07 in chips)
Seat 6: Hero ($21.8 in chips)
ab0aaad8: posts small blind $0.05
e5e46b19: posts big blind $0.1
*** HOLE CARDS ***
Dealt to 6aa2ac93 
Dealt to ab0aaad8 
Dealt to e5e46b19 
Dealt to 8998e4c4 
Dealt to 14f46803 
Dealt to Hero [3d Qd]
8998e4c4: folds
14f46803: folds
Hero: folds
6aa2ac93: folds
ab0aaad8: folds
Uncalled bet ($0.05) returned to e5e46b19
*** SHOWDOWN ***
e5e46b19 collected $0.1 from pot
*** SUMMARY ***
Total pot $0.1 | Rake $0 | Jackpot $0 | Bingo $0 | Fortune $0 | Tax $0
Seat 1: 6aa2ac93 (button) folded before Flop (didn't bet)
Seat 2: ab0aaad8 (small blind) folded before Flop
Seat 3: e5e46b19 (big blind) collected ($0.1)
Seat 4: 8998e4c4 folded before Flop (didn't bet)
Seat 5: 14f46803 folded before Flop (didn't bet)
Seat 6: Hero folded before Flop (didn't bet)


Poker Hand #RC2075517122: Hold'em No Limit ($0.05/$0.1) - 2023/12/21 23:16:28
Table 'RushAndCash281567' 6-max Seat #1 is the button
Seat 1: 6ff8dba9 ($10.15 in chips)
Seat 2: 1f946730 ($11.65 in chips)
Seat 3: Hero ($21.9 in chips)
Seat 4: 8b803640 ($10.3 in chips)
Seat 5: 2859beab ($29.55 in chips)
Seat 6: f168df8e ($12 in chips)
1f946730: posts small blind $0.05
Hero: posts big blind $0.1
*** HOLE CARDS ***
Dealt to 6ff8dba9 
Dealt to 1f946730 
Dealt to Hero [5s 4d]
Dealt to 8b803640 
Dealt to 2859beab 
Dealt to f168df8e 
8b803640: raises $0.13 to $0.23
2859beab: raises $0.47 to $0.7
f168df8e: folds
6ff8dba9: folds
1f946730: folds
Hero: folds
8b803640: calls $0.47
*** FLOP *** [2h Qc 7d]
8b803640: checks
2859beab: bets $0.41
8b803640: raises $0.62 to $1.03
2859beab: calls $0.62
*** TURN *** [2h Qc 7d] [4s]
8b803640: checks
2859beab: checks
*** RIVER *** [2h Qc 7d 4s] [5d]
8b803640: checks
2859beab: checks
8b803640: shows [Kc Jc] (King-High)
2859beab: shows [Ac Ad] (Pair of Aces)
*** SHOWDOWN ***
2859beab collected $3.29 from pot
*** SUMMARY ***
Total pot $3.61 | Rake $0.17 | Jackpot $0.15 | Bingo $0 | Fortune $0 | Tax $0
Board [2h Qc 7d 4s 5d]
Seat 1: 6ff8dba9 (button) folded before Flop (didn't bet)
Seat 2: 1f946730 (small blind) folded before Flop
Seat 3: Hero (big blind) folded before Flop
Seat 4: 8b803640 showed [Kc Jc] and lost with King-High
Seat 5: 2859beab showed [Ac Ad] and won ($3.29) with Pair of Aces
Seat 6: f168df8e folded before Flop (didn't bet)


Poker Hand #RC2075517032: Hold'em No Limit ($0.05/$0.1) - 2023/12/21 23:16:24
Table 'RushAndCash281515' 6-max Seat #1 is the button
Seat 1: Hero ($21.9 in chips)
Seat 2: 53ab37d ($12.91 in chips)
Seat 3: c73d2867 ($10.2 in chips)
Seat 4: b22fb319 ($9.1 in chips)
Seat 5: 50272865 ($10.63 in chips)
Seat 6: ec0c4bef ($20.06 in chips)
53ab37d: posts small blind $0.05
c73d2867: posts big blind $0.1
*** HOLE CARDS ***
Dealt to Hero [4c 9h]
Dealt to 53ab37d 
Dealt to c73d2867 
Dealt to b22fb319 
Dealt to 50272865 
Dealt to ec0c4bef 
b22fb319: folds
50272865: folds
ec0c4bef: folds
Hero: folds
53ab37d: raises $0.18 to $0.28
c73d2867: folds
Uncalled bet ($0.18) returned to 53ab37d
*** SHOWDOWN ***
53ab37d collected $0.2 from pot
*** SUMMARY ***
Total pot $0.2 | Rake $0 | Jackpot $0 | Bingo $0 | Fortune $0 | Tax $0
Seat 1: Hero (button) folded before Flop (didn't bet)
Seat 2: 53ab37d (small blind) collected ($0.2)
Seat 3: c73d2867 (big blind) folded before Flop
Seat 4: b22fb319 folded before Flop (didn't bet)
Seat 5: 50272865 folded before Flop (didn't bet)
Seat 6: ec0c4bef folded before Flop (didn't bet)


Poker Hand #RC2075516891: Hold'em No Limit ($0.05/$0.1) - 2023/12/21 23:16:18
Table 'RushAndCash281432' 6-max Seat #1 is the button
Seat 1: 5b0ddb11 ($13.19 in chips)
Seat 2: d5602646 ($30.08 in chips)
Seat 3: f1a00604 ($21.87 in chips)
Seat 4: Hero ($21.9 in chips)
Seat 5: e16917ab ($7.12 in chips)
Seat 6: bc69bf06 ($10.66 in chips)
d5602646: posts small blind $0.05
f1a00604: posts big blind $0.1
*** HOLE CARDS ***
Dealt to 5b0ddb11 
Dealt to d5602646 
Dealt to f1a00604 
Dealt to Hero [4d Jh]
Dealt to e16917ab 
Dealt to bc69bf06 
Hero: folds
e16917ab: folds
bc69bf06: raises $0.15 to $0.25
5b0ddb11: folds
d5602646: folds
f1a00604: calls $0.15
*** FLOP *** [4s Th 7s]
f1a00604: checks
bc69bf06: bets $0.42
f1a00604: folds
Uncalled bet ($0.42) returned to bc69bf06
*** SHOWDOWN ***
bc69bf06 collected $0.53 from pot
*** SUMMARY ***
Total pot $0.55 | Rake $0.02 | Jackpot $0 | Bingo $0 | Fortune $0 | Tax $0
Board [4s Th 7s]
Seat 1: 5b0ddb11 (button) folded before Flop (didn't bet)
Seat 2: d5602646 (small blind) folded before Flop
Seat 3: f1a00604 (big blind) folded on the Flop
Seat 4: Hero folded before Flop (didn't bet)
Seat 5: e16917ab folded before Flop (didn't bet)
Seat 6: bc69bf06 won ($0.53)


Poker Hand #RC2075516774: Hold'em No Limit ($0.05/$0.1) - 2023/12/21 23:16:13
Table 'RushAndCash281363' 6-max Seat #1 is the button
Seat 1: b2788e30 ($17.2 in chips)
Seat 2: 87436cf6 ($14.54 in chips)
Seat 3: aadda150 ($25.13 in chips)
Seat 4: 18f9a329 ($13.58 in chips)
Seat 5: Hero ($21.9 in chips)
Seat 6: 1ba2affc ($15.82 in chips)
87436cf6: posts small blind $0.05
aadda150: posts big blind $0.1
*** HOLE CARDS ***
Dealt to b2788e30 
Dealt to 87436cf6 
Dealt to aadda150 
Dealt to 18f9a329 
Dealt to Hero [3h Ac]
Dealt to 1ba2affc 
18f9a329: folds
Hero: folds
1ba2affc: folds
b2788e30: raises $0.1 to $0.2
87436cf6: folds
aadda150: folds
Uncalled bet ($0.1) returned to b2788e30
*** SHOWDOWN ***
b2788e30 collected $0.25 from pot
*** SUMMARY ***
Total pot $0.25 | Rake $0 | Jackpot $0 | Bingo $0 | Fortune $0 | Tax $0
Seat 1: b2788e30 (button) collected ($0.25)
Seat 2: 87436cf6 (small blind) folded before Flop
Seat 3: aadda150 (big blind) folded before Flop
Seat 4: 18f9a329 folded before Flop (didn't bet)
Seat 5: Hero folded before Flop (didn't bet)
Seat 6: 1ba2affc folded before Flop (didn't bet)


Poker Hand #RC2075516259: Hold'em No Limit ($0.05/$0.1) - 2023/12/21 23:15:50
Table 'RushAndCash281057' 6-max Seat #1 is the button
Seat 1: 643461d5 ($10 in chips)
Seat 2: 2ca8cd2b ($15.39 in chips)
Seat 3: e50ccad6 ($10.15 in chips)
Seat 4: 654de1ee ($10.69 in chips)
Seat 5: e4426deb ($7.87 in chips)
Seat 6: Hero ($21.75 in chips)
2ca8cd2b: posts small blind $0.05
e50ccad6: posts big blind $0.1
*** HOLE CARDS ***
Dealt to 643461d5 
Dealt to 2ca8cd2b 
Dealt to e50ccad6 
Dealt to 654de1ee 
Dealt to e4426deb 
Dealt to Hero [9d 9h]
654de1ee: folds
e4426deb: folds
Hero: raises $0.1 to $0.2
643461d5: folds
2ca8cd2b: folds
e50ccad6: folds
Uncalled bet ($0.1) returned to Hero
*** SHOWDOWN ***
Hero collected $0.25 from pot
*** SUMMARY ***
Total pot $0.25 | Rake $0 | Jackpot $0 | Bingo $0 | Fortune $0 | Tax $0
Seat 1: 643461d5 (button) folded before Flop (didn't bet)
Seat 2: 2ca8cd2b (small blind) folded before Flop
Seat 3: e50ccad6 (big blind) folded before Flop
Seat 4: 654de1ee folded before Flop (didn't bet)
Seat 5: e4426deb folded before Flop (didn't bet)
Seat 6: Hero collected ($0.25)


Poker Hand #RC2075516178: Hold'em No Limit ($0.05/$0.1) - 2023/12/21 23:15:47
Table 'RushAndCash281010' 6-max Seat #1 is the button
Seat 1: 27e5b815 ($14.91 in chips)
Seat 2: 654de1ee ($10.74 in chips)
Seat 3: 272018f3 ($27.98 in chips)
Seat 4: 5c894fe2 ($19.25 in chips)
Seat 5: Hero ($21.75 in chips)
Seat 6: caace5a7 ($10.03 in chips)
654de1ee: posts small blind $0.05
272018f3: posts big blind $0.1
*** HOLE CARDS ***
Dealt to 27e5b815 
Dealt to 654de1ee 
Dealt to 272018f3 
Dealt to 5c894fe2 
Dealt to Hero [3s Qd]
Dealt to caace5a7 
5c894fe2: folds
Hero: folds
caace5a7: folds
27e5b815: raises $0.15 to $0.25
654de1ee: folds
272018f3: folds
Uncalled bet ($0.15) returned to 27e5b815
*** SHOWDOWN ***
27e5b815 collected $0.25 from pot
*** SUMMARY ***
Total pot $0.25 | Rake $0 | Jackpot $0 | Bingo $0 | Fortune $0 | Tax $0
Seat 1: 27e5b815 (button) collected ($0.25)
Seat 2: 654de1ee (small blind) folded before Flop
Seat 3: 272018f3 (big blind) folded before Flop
Seat 4: 5c894fe2 folded before Flop (didn't bet)
Seat 5: Hero folded before Flop (didn't bet)
Seat 6: caace5a7 folded before Flop (didn't bet)


Poker Hand #RC2075515304: Hold'em No Limit ($0.05/$0.1) - 2023/12/21 23:15:07
Table 'RushAndCash280483' 6-max Seat #1 is the button
Seat 1: 272018f3 ($30.21 in chips)
Seat 2: Hero ($19.64 in chips)
Seat 3: 78c7c224 ($10 in chips)
Seat 4: aff6db10 ($11.51 in chips)
Seat 5: ab1fcb67 ($10.15 in chips)
Seat 6: 2b9d56dd ($10 in chips)
Hero: posts small blind $0.05
78c7c224: posts big blind $0.1
*** HOLE CARDS ***
Dealt to 272018f3 
Dealt to Hero [Kh Ah]
Dealt to 78c7c224 
Dealt to aff6db10 
Dealt to ab1fcb67 
Dealt to 2b9d56dd 
aff6db10: folds
ab1fcb67: folds
2b9d56dd: folds
272018f3: raises $0.13 to $0.23
Hero: raises $0.86 to $1.09
78c7c224: folds
272018f3: calls $0.86
*** FLOP *** [Kd Js 4d]
Hero: bets $1.14
272018f3: calls $1.14
*** TURN *** [Kd Js 4d] [Qh]
Hero: bets $2.28
272018f3: folds
Uncalled bet ($2.28) returned to Hero
*** SHOWDOWN ***
Hero collected $4.19 from pot
*** SUMMARY ***
Total pot $4.56 | Rake $0.22 | Jackpot $0.15 | Bingo $0 | Fortune $0 | Tax $0
Board [Kd Js 4d Qh]
Seat 1: 272018f3 (button) folded on the Turn
Seat 2: Hero (small blind) won ($4.19)
Seat 3: 78c7c224 (big blind) folded before Flop
Seat 4: aff6db10 folded before Flop (didn't bet)
Seat 5: ab1fcb67 folded before Flop (didn't bet)
Seat 6: 2b9d56dd folded before Flop (didn't bet)


Poker Hand #RC2075515092: Hold'em No Limit ($0.05/$0.1) - 2023/12/21 23:14:57
Table 'RushAndCash280355' 6-max Seat #1 is the button
Seat 1: 21743ebb ($11.35 in chips)
Seat 2: 71f03a69 ($15.13 in chips)
Seat 3: Hero ($19.74 in chips)
Seat 4: 5f4767cb ($25.03 in chips)
Seat 5: edce21d8 ($10.5 in chips)
Seat 6: 988faf17 ($23.4 in chips)
71f03a69: posts small blind $0.05
Hero: posts big blind $0.1
*** HOLE CARDS ***
Dealt to 21743ebb 
Dealt to 71f03a69 
Dealt to Hero [5s Qd]
Dealt to 5f4767cb 
Dealt to edce21d8 
Dealt to 988faf17 
5f4767cb: folds
edce21d8: folds
988faf17: folds
21743ebb: folds
71f03a69: folds
Uncalled bet ($0.05) returned to Hero
*** SHOWDOWN ***
Hero collected $0.1 from pot
*** SUMMARY ***
Total pot $0.1 | Rake $0 | Jackpot $0 | Bingo $0 | Fortune $0 | Tax $0
Seat 1: 21743ebb (button) folded before Flop (didn't bet)
Seat 2: 71f03a69 (small blind) folded before Flop
Seat 3: Hero (big blind) collected ($0.1)
Seat 4: 5f4767cb folded before Flop (didn't bet)
Seat 5: edce21d8 folded before Flop (didn't bet)
Seat 6: 988faf17 folded before Flop (didn't bet)


Poker Hand #RC2075515003: Hold'em No Limit ($0.05/$0.1) - 2023/12/21 23:14:53
Table 'RushAndCash280303' 6-max Seat #1 is the button
Seat 1: Hero ($19.74 in chips)
Seat 2: f5603fc2 ($10 in chips)
Seat 3: 7c059b6c ($10.28 in chips)
Seat 4: f2deab29 ($10 in chips)
Seat 5: be2018bd ($8.99 in chips)
Seat 6: 243279ca ($14.44 in chips)
f5603fc2: posts small blind $0.05
7c059b6c: posts big blind $0.1
*** HOLE CARDS ***
Dealt to Hero [Jd 8c]
Dealt to f5603fc2 
Dealt to 7c059b6c 
Dealt to f2deab29 
Dealt to be2018bd 
Dealt to 243279ca 
f2deab29: folds
be2018bd: folds
243279ca: folds
Hero: folds
f5603fc2: folds
Uncalled bet ($0.05) returned to 7c059b6c
*** SHOWDOWN ***
7c059b6c collected $0.1 from pot
*** SUMMARY ***
Total pot $0.1 | Rake $0 | Jackpot $0 | Bingo $0 | Fortune $0 | Tax $0
Seat 1: Hero (button) folded before Flop (didn't bet)
Seat 2: f5603fc2 (small blind) folded before Flop
Seat 3: 7c059b6c (big blind) collected ($0.1)
Seat 4: f2deab29 folded before Flop (didn't bet)
Seat 5: be2018bd folded before Flop (didn't bet)
Seat 6: 243279ca folded before Flop (didn't bet)


Poker Hand #RC2075514897: Hold'em No Limit ($0.05/$0.1) - 2023/12/21 23:14:48
Table 'RushAndCash280238' 6-max Seat #1 is the button
Seat 1: 8d159876 ($11.92 in chips)
Seat 2: 36465e5a ($10 in chips)
Seat 3: ecf8da6b ($14.58 in chips)
Seat 4: fe8e9d75 ($10 in chips)
Seat 5: 1a75fa06 ($19.19 in chips)
Seat 6: Hero ($19.74 in chips)
36465e5a: posts small blind $0.05
ecf8da6b: posts big blind $0.1
*** HOLE CARDS ***
Dealt to 8d159876 
Dealt to 36465e5a 
Dealt to ecf8da6b 
Dealt to fe8e9d75 
Dealt to 1a75fa06 
Dealt to Hero [Ac 7s]
fe8e9d75: raises $0.15 to $0.25
1a75fa06: folds
Hero: folds
8d159876: folds
36465e5a: folds
ecf8da6b: folds
Uncalled bet ($0.15) returned to fe8e9d75
*** SHOWDOWN ***
fe8e9d75 collected $0.25 from pot
*** SUMMARY ***
Total pot $0.25 | Rake $0 | Jackpot $0 | Bingo $0 | Fortune $0 | Tax $0
Seat 1: 8d159876 (button) folded before Flop (didn't bet)
Seat 2: 36465e5a (small blind) folded before Flop
Seat 3: ecf8da6b (big blind) folded before Flop
Seat 4: fe8e9d75 collected ($0.25)
Seat 5: 1a75fa06 folded before Flop (didn't bet)
Seat 6: Hero folded before Flop (didn't bet)


Poker Hand #RC2075514825: Hold'em No Limit ($0.05/$0.1) - 2023/12/21 23:14:44
Table 'RushAndCash280195' 6-max Seat #1 is the button
Seat 1: 79f9d91 ($10 in chips)
Seat 2: 9b8a916d ($12.22 in chips)
Seat 3: aaa5fdde ($11.87 in chips)
Seat 4: Hero ($19.74 in chips)
Seat 5: 8280b779 ($9.85 in chips)
Seat 6: cd85353e ($10.35 in chips)
9b8a916d: posts small blind $0.05
aaa5fdde: posts big blind $0.1
*** HOLE CARDS ***
Dealt to 79f9d91 
Dealt to 9b8a916d 
Dealt to aaa5fdde 
Dealt to Hero [6h Kc]
Dealt to 8280b779 
Dealt to cd85353e 
Hero: folds
8280b779: folds
cd85353e: folds
79f9d91: folds
9b8a916d: folds
Uncalled bet ($0.05) returned to aaa5fdde
*** SHOWDOWN ***
aaa5fdde collected $0.1 from pot
*** SUMMARY ***
Total pot $0.1 | Rake $0 | Jackpot $0 | Bingo $0 | Fortune $0 | Tax $0
Seat 1: 79f9d91 (button) folded before Flop (didn't bet)
Seat 2: 9b8a916d (small blind) folded before Flop
Seat 3: aaa5fdde (big blind) collected ($0.1)
Seat 4: Hero folded before Flop (didn't bet)
Seat 5: 8280b779 folded before Flop (didn't bet)
Seat 6: cd85353e folded before Flop (didn't bet)


Poker Hand #RC2075514750: Hold'em No Limit ($0.05/$0.1) - 2023/12/21 23:14:41
Table 'RushAndCash280153' 6-max Seat #1 is the button
Seat 1: 6db82de6 ($10.14 in chips)
Seat 2: Hero ($19.79 in chips)
Seat 3: 8bb52fba ($10 in chips)
Seat 4: e7322801 ($7.01 in chips)
Seat 5: bff71335 ($17.32 in chips)
Seat 6: 86a73692 ($6.9 in chips)
Hero: posts small blind $0.05
8bb52fba: posts big blind $0.1
*** HOLE CARDS ***
Dealt to 6db82de6 
Dealt to Hero [7h 3c]
Dealt to 8bb52fba 
Dealt to e7322801 
Dealt to bff71335 
Dealt to 86a73692 
e7322801: raises $0.15 to $0.25
bff71335: folds
86a73692: folds
6db82de6: folds
Hero: folds
8bb52fba: folds
Uncalled bet ($0.15) returned to e7322801
*** SHOWDOWN ***
e7322801 collected $0.25 from pot
*** SUMMARY ***
Total pot $0.25 | Rake $0 | Jackpot $0 | Bingo $0 | Fortune $0 | Tax $0
Seat 1: 6db82de6 (button) folded before Flop (didn't bet)
Seat 2: Hero (small blind) folded before Flop
Seat 3: 8bb52fba (big blind) folded before Flop
Seat 4: e7322801 collected ($0.25)
Seat 5: bff71335 folded before Flop (didn't bet)
Seat 6: 86a73692 folded before Flop (didn't bet)


Poker Hand #RC2075504675: Hold'em No Limit ($0.05/$0.1) - 2023/12/21 23:14:37
Table 'RushAndCash280109' 6-max Seat #1 is the button
Seat 1: 48f722e7 ($6.19 in chips)
Seat 2: b709b035 ($10.28 in chips)
Seat 3: Hero ($19.89 in chips)
Seat 4: 866fef18 ($10.37 in chips)
Seat 5: f421811d ($10 in chips)
Seat 6: 7c059b6c ($10.28 in chips)
b709b035: posts small blind $0.05
Hero: posts big blind $0.1
*** HOLE CARDS ***
Dealt to 48f722e7 
Dealt to b709b035 
Dealt to Hero [Td 2d]
Dealt to 866fef18 
Dealt to f421811d 
Dealt to 7c059b6c 
866fef18: folds
f421811d: folds
7c059b6c: folds
48f722e7: folds
b709b035: raises $0.2 to $0.3
Hero: folds
Uncalled bet ($0.2) returned to b709b035
*** SHOWDOWN ***
b709b035 collected $0.2 from pot
*** SUMMARY ***
Total pot $0.2 | Rake $0 | Jackpot $0 | Bingo $0 | Fortune $0 | Tax $0
Seat 1: 48f722e7 (button) folded before Flop (didn't bet)
Seat 2: b709b035 (small blind) collected ($0.2)
Seat 3: Hero (big blind) folded before Flop
Seat 4: 866fef18 folded before Flop (didn't bet)
Seat 5: f421811d folded before Flop (didn't bet)
Seat 6: 7c059b6c folded before Flop (didn't bet)


Poker Hand #RC2075504594: Hold'em No Limit ($0.05/$0.1) - 2023/12/21 23:14:33
Table 'RushAndCash280061' 6-max Seat #1 is the button
Seat 1: Hero ($19.89 in chips)
Seat 2: 99b954a4 ($4.6 in chips)
Seat 3: f0445c60 ($10 in chips)
Seat 4: 5a7aed9f ($31.71 in chips)
Seat 5: e1263251 ($10.15 in chips)
Seat 6: 6db82de6 ($10.14 in chips)
99b954a4: posts small blind $0.05
f0445c60: posts big blind $0.1
*** HOLE CARDS ***
Dealt to Hero [Jd 2d]
Dealt to 99b954a4 
Dealt to f0445c60 
Dealt to 5a7aed9f 
Dealt to e1263251 
Dealt to 6db82de6 
5a7aed9f: raises $0.1 to $0.2
e1263251: folds
6db82de6: folds
Hero: folds
99b954a4: folds
f0445c60: folds
Uncalled bet ($0.1) returned to 5a7aed9f
*** SHOWDOWN ***
5a7aed9f collected $0.25 from pot
*** SUMMARY ***
Total pot $0.25 | Rake $0 | Jackpot $0 | Bingo $0 | Fortune $0 | Tax $0
Seat 1: Hero (button) folded before Flop (didn't bet)
Seat 2: 99b954a4 (small blind) folded before Flop
Seat 3: f0445c60 (big blind) folded before Flop
Seat 4: 5a7aed9f collected ($0.25)
Seat 5: e1263251 folded before Flop (didn't bet)
Seat 6: 6db82de6 folded before Flop (didn't bet)


Poker Hand #RC2075504481: Hold'em No Limit ($0.05/$0.1) - 2023/12/21 23:14:28
Table 'RushAndCash279996' 6-max Seat #1 is the button
Seat 1: 19439590 ($3.55 in chips)
Seat 2: 2c92b617 ($12.25 in chips)
Seat 3: 18f9a329 ($13.88 in chips)
Seat 4: 60778cfb ($10 in chips)
Seat 5: 5d3a28af ($18.41 in chips)
Seat 6: Hero ($19.89 in chips)
2c92b617: posts small blind $0.05
18f9a329: posts big blind $0.1
*** HOLE CARDS ***
Dealt to 19439590 
Dealt to 2c92b617 
Dealt to 18f9a329 
Dealt to 60778cfb 
Dealt to 5d3a28af 
Dealt to Hero [4d Ks]
60778cfb: folds
5d3a28af: raises $0.15 to $0.25
Hero: folds
19439590: folds
2c92b617: folds
18f9a329: folds
Uncalled bet ($0.15) returned to 5d3a28af
*** SHOWDOWN ***
5d3a28af collected $0.25 from pot
*** SUMMARY ***
Total pot $0.25 | Rake $0 | Jackpot $0 | Bingo $0 | Fortune $0 | Tax $0
Seat 1: 19439590 (button) folded before Flop (didn't bet)
Seat 2: 2c92b617 (small blind) folded before Flop
Seat 3: 18f9a329 (big blind) folded before Flop
Seat 4: 60778cfb folded before Flop (didn't bet)
Seat 5: 5d3a28af collected ($0.25)
Seat 6: Hero folded before Flop (didn't bet)


Poker Hand #RC2075504395: Hold'em No Limit ($0.05/$0.1) - 2023/12/21 23:14:24
Table 'RushAndCash279948' 6-max Seat #1 is the button
Seat 1: c7064c89 ($10.01 in chips)
Seat 2: 357d16d2 ($10 in chips)
Seat 3: 1a822896 ($36.92 in chips)
Seat 4: c6d97203 ($11.03 in chips)
Seat 5: Hero ($19.89 in chips)
Seat 6: 2be34245 ($15.95 in chips)
357d16d2: posts small blind $0.05
1a822896: posts big blind $0.1
*** HOLE CARDS ***
Dealt to c7064c89 
Dealt to 357d16d2 
Dealt to 1a822896 
Dealt to c6d97203 
Dealt to Hero [2d 6c]
Dealt to 2be34245 
c6d97203: folds
Hero: folds
2be34245: folds
c7064c89: raises $0.15 to $0.25
357d16d2: folds
1a822896: folds
Uncalled bet ($0.15) returned to c7064c89
*** SHOWDOWN ***
c7064c89 collected $0.25 from pot
*** SUMMARY ***
Total pot $0.25 | Rake $0 | Jackpot $0 | Bingo $0 | Fortune $0 | Tax $0
Seat 1: c7064c89 (button) collected ($0.25)
Seat 2: 357d16d2 (small blind) folded before Flop
Seat 3: 1a822896 (big blind) folded before Flop
Seat 4: c6d97203 folded before Flop (didn't bet)
Seat 5: Hero folded before Flop (didn't bet)
Seat 6: 2be34245 folded before Flop (didn't bet)


Poker Hand #RC2075504039: Hold'em No Limit ($0.05/$0.1) - 2023/12/21 23:14:08
Table 'RushAndCash279750' 6-max Seat #1 is the button
Seat 1: fa3498b3 ($11.42 in chips)
Seat 2: Hero ($19.79 in chips)
Seat 3: bb0b62fd ($10.4 in chips)
Seat 4: ea51cb0 ($11.65 in chips)
Seat 5: a4d488b5 ($16.23 in chips)
Seat 6: e481851b ($20.44 in chips)
Hero: posts small blind $0.05
bb0b62fd: posts big blind $0.1
*** HOLE CARDS ***
Dealt to fa3498b3 
Dealt to Hero [6d 6c]
Dealt to bb0b62fd 
Dealt to ea51cb0 
Dealt to a4d488b5 
Dealt to e481851b 
ea51cb0: folds
a4d488b5: folds
e481851b: folds
fa3498b3: folds
Hero: raises $0.2 to $0.3
bb0b62fd: folds
Uncalled bet ($0.2) returned to Hero
*** SHOWDOWN ***
Hero collected $0.2 from pot
*** SUMMARY ***
Total pot $0.2 | Rake $0 | Jackpot $0 | Bingo $0 | Fortune $0 | Tax $0
Seat 1: fa3498b3 (button) folded before Flop (didn't bet)
Seat 2: Hero (small blind) collected ($0.2)
Seat 3: bb0b62fd (big blind) folded before Flop
Seat 4: ea51cb0 folded before Flop (didn't bet)
Seat 5: a4d488b5 folded before Flop (didn't bet)
Seat 6: e481851b folded before Flop (didn't bet)


Poker Hand #RC2075503942: Hold'em No Limit ($0.05/$0.1) - 2023/12/21 23:14:04
Table 'RushAndCash279697' 6-max Seat #1 is the button
Seat 1: 6aa2ac93 ($11 in chips)
Seat 2: 1da59c05 ($12.29 in chips)
Seat 3: b8680ebe ($10.15 in chips)
Seat 4: f3e18da3 ($11.6 in chips)
Seat 5: 68618e34 ($10.98 in chips)
Seat 6: Hero ($19.79 in chips)
1da59c05: posts small blind $0.05
b8680ebe: posts big blind $0.1
*** HOLE CARDS ***
Dealt to 6aa2ac93 
Dealt to 1da59c05 
Dealt to b8680ebe 
Dealt to f3e18da3 
Dealt to 68618e34 
Dealt to Hero [Jc 6s]
f3e18da3: folds
68618e34: raises $0.12 to $0.22
Hero: folds
6aa2ac93: folds
1da59c05: folds
b8680ebe: calls $0.12
*** FLOP *** [8d 3h Jd]
b8680ebe: checks
68618e34: checks
*** TURN *** [8d 3h Jd] [4d]
b8680ebe: checks
68618e34: bets $0.25
b8680ebe: calls $0.25
*** RIVER *** [8d 3h Jd 4d] [6c]
b8680ebe: checks
68618e34: bets $0.5
b8680ebe: folds
Uncalled bet ($0.5) returned to 68618e34
*** SHOWDOWN ***
68618e34 collected $0.94 from pot
*** SUMMARY ***
Total pot $0.99 | Rake $0.05 | Jackpot $0 | Bingo $0 | Fortune $0 | Tax $0
Board [8d 3h Jd 4d 6c]
Seat 1: 6aa2ac93 (button) folded before Flop (didn't bet)
Seat 2: 1da59c05 (small blind) folded before Flop
Seat 3: b8680ebe (big blind) folded on the River
Seat 4: f3e18da3 folded before Flop (didn't bet)
Seat 5: 68618e34 won ($0.94)
Seat 6: Hero folded before Flop (didn't bet)


Poker Hand #RC2075503470: Hold'em No Limit ($0.05/$0.1) - 2023/12/21 23:13:44
Table 'RushAndCash279414' 6-max Seat #1 is the button
Seat 1: Hero ($19.64 in chips)
Seat 2: 21ed920e ($3.48 in chips)
Seat 3: 7fbb4f1a ($13.09 in chips)
Seat 4: 127bbe68 ($10.51 in chips)
Seat 5: 3b3d52db ($10.91 in chips)
Seat 6: 8ccbc20a ($13.6 in chips)
21ed920e: posts small blind $0.05
7fbb4f1a: posts big blind $0.1
*** HOLE CARDS ***
Dealt to Hero [Kh Qc]
Dealt to 21ed920e 
Dealt to 7fbb4f1a 
Dealt to 127bbe68 
Dealt to 3b3d52db 
Dealt to 8ccbc20a 
127bbe68: folds
3b3d52db: folds
8ccbc20a: folds
Hero: raises $0.15 to $0.25
21ed920e: folds
7fbb4f1a: folds
Uncalled bet ($0.15) returned to Hero
*** SHOWDOWN ***
Hero collected $0.25 from pot
*** SUMMARY ***
Total pot $0.25 | Rake $0 | Jackpot $0 | Bingo $0 | Fortune $0 | Tax $0
Seat 1: Hero (button) collected ($0.25)
Seat 2: 21ed920e (small blind) folded before Flop
Seat 3: 7fbb4f1a (big blind) folded before Flop
Seat 4: 127bbe68 folded before Flop (didn't bet)
Seat 5: 3b3d52db folded before Flop (didn't bet)
Seat 6: 8ccbc20a folded before Flop (didn't bet)


Poker Hand #RC2075503347: Hold'em No Limit ($0.05/$0.1) - 2023/12/21 23:13:38
Table 'RushAndCash279340' 6-max Seat #1 is the button
Seat 1: 8e27810a ($67.81 in chips)
Seat 2: 760452c5 ($9.93 in chips)
Seat 3: Hero ($19.74 in chips)
Seat 4: 59b7f5e ($9.07 in chips)
Seat 5: bb0b62fd ($10.45 in chips)
Seat 6: c9e6a055 ($9.83 in chips)
760452c5: posts small blind $0.05
Hero: posts big blind $0.1
*** HOLE CARDS ***
Dealt to 8e27810a 
Dealt to 760452c5 
Dealt to Hero [4c 6s]
Dealt to 59b7f5e 
Dealt to bb0b62fd 
Dealt to c9e6a055 
59b7f5e: raises $0.1 to $0.2
bb0b62fd: folds
c9e6a055: folds
8e27810a: folds
760452c5: folds
Hero: folds
Uncalled bet ($0.1) returned to 59b7f5e
*** SHOWDOWN ***
59b7f5e collected $0.25 from pot
*** SUMMARY ***
Total pot $0.25 | Rake $0 | Jackpot $0 | Bingo $0 | Fortune $0 | Tax $0
Seat 1: 8e27810a (button) folded before Flop (didn't bet)
Seat 2: 760452c5 (small blind) folded before Flop
Seat 3: Hero (big blind) folded before Flop
Seat 4: 59b7f5e collected ($0.25)
Seat 5: bb0b62fd folded before Flop (didn't bet)
Seat 6: c9e6a055 folded before Flop (didn't bet)


Poker Hand #RC2075503219: Hold'em No Limit ($0.05/$0.1) - 2023/12/21 23:13:33
Table 'RushAndCash279263' 6-max Seat #1 is the button
Seat 1: 7c185a02 ($17.7 in chips)
Seat 2: ab50b0ef ($11.69 in chips)
Seat 3: 1bc8be2d ($10 in chips)
Seat 4: Hero ($19.74 in chips)
Seat 5: e873eecf ($9.95 in chips)
Seat 6: cda54d7b ($9.51 in chips)
ab50b0ef: posts small blind $0.05
1bc8be2d: posts big blind $0.1
*** HOLE CARDS ***
Dealt to 7c185a02 
Dealt to ab50b0ef 
Dealt to 1bc8be2d 
Dealt to Hero [7s Qs]
Dealt to e873eecf 
Dealt to cda54d7b 
Hero: folds
e873eecf: folds
cda54d7b: folds
7c185a02: folds
ab50b0ef: folds
Uncalled bet ($0.05) returned to 1bc8be2d
*** SHOWDOWN ***
1bc8be2d collected $0.1 from pot
*** SUMMARY ***
Total pot $0.1 | Rake $0 | Jackpot $0 | Bingo $0 | Fortune $0 | Tax $0
Seat 1: 7c185a02 (button) folded before Flop (didn't bet)
Seat 2: ab50b0ef (small blind) folded before Flop
Seat 3: 1bc8be2d (big blind) collected ($0.1)
Seat 4: Hero folded before Flop (didn't bet)
Seat 5: e873eecf folded before Flop (didn't bet)
Seat 6: cda54d7b folded before Flop (didn't bet)


Poker Hand #RC2075503080: Hold'em No Limit ($0.05/$0.1) - 2023/12/21 23:13:27
Table 'RushAndCash279179' 6-max Seat #1 is the button
Seat 1: 69c1c0d0 ($9.85 in chips)
Seat 2: 36465e5a ($10 in chips)
Seat 3: a3f02140 ($9.9 in chips)
Seat 4: e889978c ($21.73 in chips)
Seat 5: Hero ($19.74 in chips)
Seat 6: d0e1a15f ($10.1 in chips)
36465e5a: posts small blind $0.05
a3f02140: posts big blind $0.1
*** HOLE CARDS ***
Dealt to 69c1c0d0 
Dealt to 36465e5a 
Dealt to a3f02140 
Dealt to e889978c 
Dealt to Hero [7c 5s]
Dealt to d0e1a15f 
e889978c: folds
Hero: folds
d0e1a15f: raises $0.12 to $0.22
69c1c0d0: folds
36465e5a: folds
a3f02140: calls $0.12
*** FLOP *** [6c Qh 9c]
a3f02140: checks
d0e1a15f: bets $0.33
a3f02140: folds
Uncalled bet ($0.33) returned to d0e1a15f
*** SHOWDOWN ***
d0e1a15f collected $0.47 from pot
*** SUMMARY ***
Total pot $0.49 | Rake $0.02 | Jackpot $0 | Bingo $0 | Fortune $0 | Tax $0
Board [6c Qh 9c]
Seat 1: 69c1c0d0 (button) folded before Flop (didn't bet)
Seat 2: 36465e5a (small blind) folded before Flop
Seat 3: a3f02140 (big blind) folded on the Flop
Seat 4: e889978c folded before Flop (didn't bet)
Seat 5: Hero folded before Flop (didn't bet)
Seat 6: d0e1a15f won ($0.47)


Poker Hand #RC2075502913: Hold'em No Limit ($0.05/$0.1) - 2023/12/21 23:13:19
Table 'RushAndCash279077' 6-max Seat #1 is the button
Seat 1: Hero ($19.74 in chips)
Seat 2: 1726f29 ($7.27 in chips)
Seat 3: f51fda7f ($13.92 in chips)
Seat 4: e481851b ($20.54 in chips)
Seat 5: bedb90db ($10.1 in chips)
Seat 6: 22bdafa1 ($11.53 in chips)
1726f29: posts small blind $0.05
f51fda7f: posts big blind $0.1
*** HOLE CARDS ***
Dealt to Hero [3s 6d]
Dealt to 1726f29 
Dealt to f51fda7f 
Dealt to e481851b 
Dealt to bedb90db 
Dealt to 22bdafa1 
e481851b: folds
bedb90db: folds
22bdafa1: raises $0.13 to $0.23
Hero: folds
1726f29: calls $0.18
f51fda7f: folds
*** FLOP *** [Kd 6c Kh]
1726f29: checks
22bdafa1: checks
*** TURN *** [Kd 6c Kh] [Jc]
1726f29: checks
22bdafa1: checks
*** RIVER *** [Kd 6c Kh Jc] [Qd]
1726f29: checks
22bdafa1: bets $0.64
1726f29: folds
Uncalled bet ($0.64) returned to 22bdafa1
*** SHOWDOWN ***
22bdafa1 collected $0.54 from pot
*** SUMMARY ***
Total pot $0.56 | Rake $0.02 | Jackpot $0 | Bingo $0 | Fortune $0 | Tax $0
Board [Kd 6c Kh Jc Qd]
Seat 1: Hero (button) folded before Flop (didn't bet)
Seat 2: 1726f29 (small blind) folded on the River
Seat 3: f51fda7f (big blind) folded before Flop
Seat 4: e481851b folded before Flop (didn't bet)
Seat 5: bedb90db folded before Flop (didn't bet)
Seat 6: 22bdafa1 won ($0.54)


Poker Hand #RC2075502675: Hold'em No Limit ($0.05/$0.1) - 2023/12/21 23:13:09
Table 'RushAndCash278937' 6-max Seat #1 is the button
Seat 1: 24ad9d69 ($6.29 in chips)
Seat 2: Hero ($19.79 in chips)
Seat 3: 76ceebc1 ($24.33 in chips)
Seat 4: 782f63eb ($11.27 in chips)
Seat 5: 85952fee ($12.79 in chips)
Seat 6: 3fe573ce ($10.84 in chips)
Hero: posts small blind $0.05
76ceebc1: posts big blind $0.1
*** HOLE CARDS ***
Dealt to 24ad9d69 
Dealt to Hero [Js 2h]
Dealt to 76ceebc1 
Dealt to 782f63eb 
Dealt to 85952fee 
Dealt to 3fe573ce 
782f63eb: folds
85952fee: folds
3fe573ce: folds
24ad9d69: folds
Hero: folds
Uncalled bet ($0.05) returned to 76ceebc1
*** SHOWDOWN ***
76ceebc1 collected $0.1 from pot
*** SUMMARY ***
Total pot $0.1 | Rake $0 | Jackpot $0 | Bingo $0 | Fortune $0 | Tax $0
Seat 1: 24ad9d69 (button) folded before Flop (didn't bet)
Seat 2: Hero (small blind) folded before Flop
Seat 3: 76ceebc1 (big blind) collected ($0.1)
Seat 4: 782f63eb folded before Flop (didn't bet)
Seat 5: 85952fee folded before Flop (didn't bet)
Seat 6: 3fe573ce folded before Flop (didn't bet)


Poker Hand #RC2075502474: Hold'em No Limit ($0.05/$0.1) - 2023/12/21 23:13:00
Table 'RushAndCash278822' 6-max Seat #1 is the button
Seat 1: 5b1f039d ($6.61 in chips)
Seat 2: 1c804e1f ($10.05 in chips)
Seat 3: Hero ($19.89 in chips)
Seat 4: a39934e9 ($9.3 in chips)
Seat 5: caf9a75 ($33.09 in chips)
Seat 6: 56eaa298 ($5.56 in chips)
1c804e1f: posts small blind $0.05
Hero: posts big blind $0.1
*** HOLE CARDS ***
Dealt to 5b1f039d 
Dealt to 1c804e1f 
Dealt to Hero [Qd 7h]
Dealt to a39934e9 
Dealt to caf9a75 
Dealt to 56eaa298 
a39934e9: folds
caf9a75: raises $0.12 to $0.22
56eaa298: folds
5b1f039d: folds
1c804e1f: folds
Hero: folds
Uncalled bet ($0.12) returned to caf9a75
*** SHOWDOWN ***
caf9a75 collected $0.25 from pot
*** SUMMARY ***
Total pot $0.25 | Rake $0 | Jackpot $0 | Bingo $0 | Fortune $0 | Tax $0
Seat 1: 5b1f039d (button) folded before Flop (didn't bet)
Seat 2: 1c804e1f (small blind) folded before Flop
Seat 3: Hero (big blind) folded before Flop
Seat 4: a39934e9 folded before Flop (didn't bet)
Seat 5: caf9a75 collected ($0.25)
Seat 6: 56eaa298 folded before Flop (didn't bet)


Poker Hand #RC2075502304: Hold'em No Limit ($0.05/$0.1) - 2023/12/21 23:12:52
Table 'RushAndCash278719' 6-max Seat #1 is the button
Seat 1: 35f88a2c ($16.07 in chips)
Seat 2: ecf8da6b ($15.28 in chips)
Seat 3: 2546deef ($9 in chips)
Seat 4: ae28816c ($8.71 in chips)
Seat 5: 782f63eb ($11.12 in chips)
Seat 6: Hero ($19.89 in chips)
ecf8da6b: posts small blind $0.05
2546deef: posts big blind $0.1
*** HOLE CARDS ***
Dealt to 35f88a2c 
Dealt to ecf8da6b 
Dealt to 2546deef 
Dealt to ae28816c 
Dealt to 782f63eb 
Dealt to Hero [4s Ks]
ae28816c: folds
782f63eb: raises $0.15 to $0.25
Hero: folds
35f88a2c: folds
ecf8da6b: folds
2546deef: folds
Uncalled bet ($0.15) returned to 782f63eb
*** SHOWDOWN ***
782f63eb collected $0.25 from pot
*** SUMMARY ***
Total pot $0.25 | Rake $0 | Jackpot $0 | Bingo $0 | Fortune $0 | Tax $0
Seat 1: 35f88a2c (button) folded before Flop (didn't bet)
Seat 2: ecf8da6b (small blind) folded before Flop
Seat 3: 2546deef (big blind) folded before Flop
Seat 4: ae28816c folded before Flop (didn't bet)
Seat 5: 782f63eb collected ($0.25)
Seat 6: Hero folded before Flop (didn't bet)


Poker Hand #RC2075502205: Hold'em No Limit ($0.05/$0.1) - 2023/12/21 23:12:48
Table 'RushAndCash278655' 6-max Seat #1 is the button
Seat 1: b926a983 ($11.46 in chips)
Seat 2: 85f1432b ($13.03 in chips)
Seat 3: c1ccea94 ($10.25 in chips)
Seat 4: Hero ($19.89 in chips)
Seat 5: d86116c7 ($10.07 in chips)
Seat 6: 8ccbc20a ($15.07 in chips)
85f1432b: posts small blind $0.05
c1ccea94: posts big blind $0.1
*** HOLE CARDS ***
Dealt to b926a983 
Dealt to 85f1432b 
Dealt to c1ccea94 
Dealt to Hero [9h 6s]
Dealt to d86116c7 
Dealt to 8ccbc20a 
Hero: folds
d86116c7: folds
8ccbc20a: folds
b926a983: raises $0.1 to $0.2
85f1432b: folds
c1ccea94: folds
Uncalled bet ($0.1) returned to b926a983
*** SHOWDOWN ***
b926a983 collected $0.25 from pot
*** SUMMARY ***
Total pot $0.25 | Rake $0 | Jackpot $0 | Bingo $0 | Fortune $0 | Tax $0
Seat 1: b926a983 (button) collected ($0.25)
Seat 2: 85f1432b (small blind) folded before Flop
Seat 3: c1ccea94 (big blind) folded before Flop
Seat 4: Hero folded before Flop (didn't bet)
Seat 5: d86116c7 folded before Flop (didn't bet)
Seat 6: 8ccbc20a folded before Flop (didn't bet)


Poker Hand #RC2075502096: Hold'em No Limit ($0.05/$0.1) - 2023/12/21 23:12:43
Table 'RushAndCash278587' 6-max Seat #1 is the button
Seat 1: 2238335f ($13.76 in chips)
Seat 2: de002975 ($10.85 in chips)
Seat 3: 3f0b9a17 ($13.04 in chips)
Seat 4: e46924d4 ($15.47 in chips)
Seat 5: 6aa2ac93 ($10.35 in chips)
Seat 6: Hero ($19.89 in chips)
de002975: posts small blind $0.05
3f0b9a17: posts big blind $0.1
*** HOLE CARDS ***
Dealt to 2238335f 
Dealt to de002975 
Dealt to 3f0b9a17 
Dealt to e46924d4 
Dealt to 6aa2ac93 
Dealt to Hero [6d 5s]
e46924d4: raises $0.1 to $0.2
6aa2ac93: folds
Hero: folds
2238335f: folds
de002975: folds
3f0b9a17: folds
Uncalled bet ($0.1) returned to e46924d4
*** SHOWDOWN ***
e46924d4 collected $0.25 from pot
*** SUMMARY ***
Total pot $0.25 | Rake $0 | Jackpot $0 | Bingo $0 | Fortune $0 | Tax $0
Seat 1: 2238335f (button) folded before Flop (didn't bet)
Seat 2: de002975 (small blind) folded before Flop
Seat 3: 3f0b9a17 (big blind) folded before Flop
Seat 4: e46924d4 collected ($0.25)
Seat 5: 6aa2ac93 folded before Flop (didn't bet)
Seat 6: Hero folded before Flop (didn't bet)


Poker Hand #RC2075501858: Hold'em No Limit ($0.05/$0.1) - 2023/12/21 23:12:32
Table 'RushAndCash278445' 6-max Seat #1 is the button
Seat 1: b4ab5408 ($16.79 in chips)
Seat 2: b95ef50d ($11.11 in chips)
Seat 3: 74db4029 ($16.42 in chips)
Seat 4: e2adffdd ($25.5 in chips)
Seat 5: ec17075 ($12.49 in chips)
Seat 6: Hero ($19.89 in chips)
b95ef50d: posts small blind $0.05
74db4029: posts big blind $0.1
*** HOLE CARDS ***
Dealt to b4ab5408 
Dealt to b95ef50d 
Dealt to 74db4029 
Dealt to e2adffdd 
Dealt to ec17075 
Dealt to Hero [6s 5s]
e2adffdd: folds
ec17075: raises $0.2 to $0.3
Hero: folds
b4ab5408: folds
b95ef50d: folds
74db4029: calls $0.2
*** FLOP *** [Ad Tc 4h]
74db4029: checks
ec17075: checks
*** TURN *** [Ad Tc 4h] [3s]
74db4029: bets $0.33
ec17075: raises $0.99 to $1.32
74db4029: folds
Uncalled bet ($0.99) returned to ec17075
*** SHOWDOWN ***
ec17075 collected $1.25 from pot
*** SUMMARY ***
Total pot $1.31 | Rake $0.06 | Jackpot $0 | Bingo $0 | Fortune $0 | Tax $0
Board [Ad Tc 4h 3s]
Seat 1: b4ab5408 (button) folded before Flop (didn't bet)
Seat 2: b95ef50d (small blind) folded before Flop
Seat 3: 74db4029 (big blind) folded on the Turn
Seat 4: e2adffdd folded before Flop (didn't bet)
Seat 5: ec17075 won ($1.25)
Seat 6: Hero folded before Flop (didn't bet)


Poker Hand #RC2075501778: Hold'em No Limit ($0.05/$0.1) - 2023/12/21 23:12:28
Table 'RushAndCash278397' 6-max Seat #1 is the button
Seat 1: Hero ($19.89 in chips)
Seat 2: 7274ee07 ($10.43 in chips)
Seat 3: 6c0d02bd ($10.62 in chips)
Seat 4: 35f88a2c ($16.22 in chips)
Seat 5: e7a2d540 ($23.82 in chips)
Seat 6: 41b79fc6 ($9.24 in chips)
7274ee07: posts small blind $0.05
6c0d02bd: posts big blind $0.1
*** HOLE CARDS ***
Dealt to Hero [9s 6c]
Dealt to 7274ee07 
Dealt to 6c0d02bd 
Dealt to 35f88a2c 
Dealt to e7a2d540 
Dealt to 41b79fc6 
35f88a2c: folds
e7a2d540: folds
41b79fc6: folds
Hero: folds
7274ee07: folds
Uncalled bet ($0.05) returned to 6c0d02bd
*** SHOWDOWN ***
6c0d02bd collected $0.1 from pot
*** SUMMARY ***
Total pot $0.1 | Rake $0 | Jackpot $0 | Bingo $0 | Fortune $0 | Tax $0
Seat 1: Hero (button) folded before Flop (didn't bet)
Seat 2: 7274ee07 (small blind) folded before Flop
Seat 3: 6c0d02bd (big blind) collected ($0.1)
Seat 4: 35f88a2c folded before Flop (didn't bet)
Seat 5: e7a2d540 folded before Flop (didn't bet)
Seat 6: 41b79fc6 folded before Flop (didn't bet)


Poker Hand #RC2075501632: Hold'em No Limit ($0.05/$0.1) - 2023/12/21 23:12:22
Table 'RushAndCash278307' 6-max Seat #1 is the button
Seat 1: 31924eb3 ($11.91 in chips)
Seat 2: Hero ($19.94 in chips)
Seat 3: 12ed0b3f ($14.56 in chips)
Seat 4: 473378d7 ($15.19 in chips)
Seat 5: 2e3ae197 ($7.83 in chips)
Seat 6: fc75df44 ($10 in chips)
Hero: posts small blind $0.05
12ed0b3f: posts big blind $0.1
*** HOLE CARDS ***
Dealt to 31924eb3 
Dealt to Hero [Ad 7c]
Dealt to 12ed0b3f 
Dealt to 473378d7 
Dealt to 2e3ae197 
Dealt to fc75df44 
473378d7: folds
2e3ae197: folds
fc75df44: folds
31924eb3: raises $0.15 to $0.25
Hero: folds
12ed0b3f: folds
Uncalled bet ($0.15) returned to 31924eb3
*** SHOWDOWN ***
31924eb3 collected $0.25 from pot
*** SUMMARY ***
Total pot $0.25 | Rake $0 | Jackpot $0 | Bingo $0 | Fortune $0 | Tax $0
Seat 1: 31924eb3 (button) collected ($0.25)
Seat 2: Hero (small blind) folded before Flop
Seat 3: 12ed0b3f (big blind) folded before Flop
Seat 4: 473378d7 folded before Flop (didn't bet)
Seat 5: 2e3ae197 folded before Flop (didn't bet)
Seat 6: fc75df44 folded before Flop (didn't bet)


Poker Hand #RC2075500926: Hold'em No Limit ($0.05/$0.1) - 2023/12/21 23:11:49
Table 'RushAndCash277869' 6-max Seat #1 is the button
Seat 1: 3db6ac28 ($3.8 in chips)
Seat 2: 2c2c64b ($27.61 in chips)
Seat 3: Hero ($19.71 in chips)
Seat 4: 2ef4700b ($11.32 in chips)
Seat 5: b0cce9fb ($5.84 in chips)
Seat 6: 835eed05 ($13.38 in chips)
2c2c64b: posts small blind $0.05
Hero: posts big blind $0.1
*** HOLE CARDS ***
Dealt to 3db6ac28 
Dealt to 2c2c64b 
Dealt to Hero [Qs Ad]
Dealt to 2ef4700b 
Dealt to b0cce9fb 
Dealt to 835eed05 
2ef4700b: folds
b0cce9fb: folds
835eed05: folds
3db6ac28: folds
2c2c64b: raises $0.15 to $0.25
Hero: raises $0.7 to $0.95
2c2c64b: folds
Uncalled bet ($0.7) returned to Hero
*** SHOWDOWN ***
Hero collected $0.48 from pot
*** SUMMARY ***
Total pot $0.5 | Rake $0.02 | Jackpot $0 | Bingo $0 | Fortune $0 | Tax $0
Seat 1: 3db6ac28 (button) folded before Flop (didn't bet)
Seat 2: 2c2c64b (small blind) folded before Flop
Seat 3: Hero (big blind) collected ($0.48)
Seat 4: 2ef4700b folded before Flop (didn't bet)
Seat 5: b0cce9fb folded before Flop (didn't bet)
Seat 6: 835eed05 folded before Flop (didn't bet)


Poker Hand #RC2075500676: Hold'em No Limit ($0.05/$0.1) - 2023/12/21 23:11:38
Table 'RushAndCash277717' 6-max Seat #1 is the button
Seat 1: 204ddcea ($13.25 in chips)
Seat 2: f4b6c56f ($17.52 in chips)
Seat 3: 93003415 ($21.19 in chips)
Seat 4: d61063ac ($10.74 in chips)
Seat 5: Hero ($19.56 in chips)
Seat 6: 5b1f039d ($6.91 in chips)
f4b6c56f: posts small blind $0.05
93003415: posts big blind $0.1
*** HOLE CARDS ***
Dealt to 204ddcea 
Dealt to f4b6c56f 
Dealt to 93003415 
Dealt to d61063ac 
Dealt to Hero [Qc Jc]
Dealt to 5b1f039d 
d61063ac: folds
Hero: raises $0.1 to $0.2
5b1f039d: folds
204ddcea: folds
f4b6c56f: folds
93003415: folds
Uncalled bet ($0.1) returned to Hero
*** SHOWDOWN ***
Hero collected $0.25 from pot
*** SUMMARY ***
Total pot $0.25 | Rake $0 | Jackpot $0 | Bingo $0 | Fortune $0 | Tax $0
Seat 1: 204ddcea (button) folded before Flop (didn't bet)
Seat 2: f4b6c56f (small blind) folded before Flop
Seat 3: 93003415 (big blind) folded before Flop
Seat 4: d61063ac folded before Flop (didn't bet)
Seat 5: Hero collected ($0.25)
Seat 6: 5b1f039d folded before Flop (didn't bet)


Poker Hand #RC2075500497: Hold'em No Limit ($0.05/$0.1) - 2023/12/21 23:11:30
Table 'RushAndCash277604' 6-max Seat #1 is the button
Seat 1: c29cd73b ($2.92 in chips)
Seat 2: c50582a6 ($14.64 in chips)
Seat 3: 2484b4d8 ($10 in chips)
Seat 4: afb9feea ($18.11 in chips)
Seat 5: Hero ($19.56 in chips)
Seat 6: 94289964 ($8.39 in chips)
c50582a6: posts small blind $0.05
2484b4d8: posts big blind $0.1
*** HOLE CARDS ***
Dealt to c29cd73b 
Dealt to c50582a6 
Dealt to 2484b4d8 
Dealt to afb9feea 
Dealt to Hero [8s Kd]
Dealt to 94289964 
afb9feea: folds
Hero: folds
94289964: folds
c29cd73b: folds
c50582a6: folds
Uncalled bet ($0.05) returned to 2484b4d8
*** SHOWDOWN ***
2484b4d8 collected $0.1 from pot
*** SUMMARY ***
Total pot $0.1 | Rake $0 | Jackpot $0 | Bingo $0 | Fortune $0 | Tax $0
Seat 1: c29cd73b (button) folded before Flop (didn't bet)
Seat 2: c50582a6 (small blind) folded before Flop
Seat 3: 2484b4d8 (big blind) collected ($0.1)
Seat 4: afb9feea folded before Flop (didn't bet)
Seat 5: Hero folded before Flop (didn't bet)
Seat 6: 94289964 folded before Flop (didn't bet)


Poker Hand #RC2075500308: Hold'em No Limit ($0.05/$0.1) - 2023/12/21 23:11:22
Table 'RushAndCash277486' 6-max Seat #1 is the button
Seat 1: b95ef50d ($10.96 in chips)
Seat 2: ff1fe2f3 ($8.48 in chips)
Seat 3: 84f0c1ec ($24.84 in chips)
Seat 4: 88b4672a ($10.4 in chips)
Seat 5: 2859beab ($30.25 in chips)
Seat 6: Hero ($19.56 in chips)
ff1fe2f3: posts small blind $0.05
84f0c1ec: posts big blind $0.1
*** HOLE CARDS ***
Dealt to b95ef50d 
Dealt to ff1fe2f3 
Dealt to 84f0c1ec 
Dealt to 88b4672a 
Dealt to 2859beab 
Dealt to Hero [4s Qd]
88b4672a: folds
2859beab: raises $0.1 to $0.2
Hero: folds
b95ef50d: folds
ff1fe2f3: folds
84f0c1ec: folds
Uncalled bet ($0.1) returned to 2859beab
*** SHOWDOWN ***
2859beab collected $0.25 from pot
*** SUMMARY ***
Total pot $0.25 | Rake $0 | Jackpot $0 | Bingo $0 | Fortune $0 | Tax $0
Seat 1: b95ef50d (button) folded before Flop (didn't bet)
Seat 2: ff1fe2f3 (small blind) folded before Flop
Seat 3: 84f0c1ec (big blind) folded before Flop
Seat 4: 88b4672a folded before Flop (didn't bet)
Seat 5: 2859beab collected ($0.25)
Seat 6: Hero folded before Flop (didn't bet)


Poker Hand #RC2075500025: Hold'em No Limit ($0.05/$0.1) - 2023/12/21 23:11:09
Table 'RushAndCash277311' 6-max Seat #1 is the button
Seat 1: Hero ($19.56 in chips)
Seat 2: 8e27810a ($69.2 in chips)
Seat 3: 8ce2ebbb ($11.43 in chips)
Seat 4: 8bffd3fd ($21.76 in chips)
Seat 5: a3f02140 ($9.34 in chips)
Seat 6: e784e513 ($11.04 in chips)
8e27810a: posts small blind $0.05
8ce2ebbb: posts big blind $0.1
*** HOLE CARDS ***
Dealt to Hero [Kd Ts]
Dealt to 8e27810a 
Dealt to 8ce2ebbb 
Dealt to 8bffd3fd 
Dealt to a3f02140 
Dealt to e784e513 
8bffd3fd: folds
a3f02140: raises $0.2 to $0.3
e784e513: folds
Hero: folds
8e27810a: folds
8ce2ebbb: folds
Uncalled bet ($0.2) returned to a3f02140
*** SHOWDOWN ***
a3f02140 collected $0.25 from pot
*** SUMMARY ***
Total pot $0.25 | Rake $0 | Jackpot $0 | Bingo $0 | Fortune $0 | Tax $0
Seat 1: Hero (button) folded before Flop (didn't bet)
Seat 2: 8e27810a (small blind) folded before Flop
Seat 3: 8ce2ebbb (big blind) folded before Flop
Seat 4: 8bffd3fd folded before Flop (didn't bet)
Seat 5: a3f02140 collected ($0.25)
Seat 6: e784e513 folded before Flop (didn't bet)


Poker Hand #RC2075499874: Hold'em No Limit ($0.05/$0.1) - 2023/12/21 23:11:03
Table 'RushAndCash277216' 6-max Seat #1 is the button
Seat 1: adb62d5f ($27.64 in chips)
Seat 2: Hero ($19.61 in chips)
Seat 3: 391c843f ($36.69 in chips)
Seat 4: 346b9524 ($10.47 in chips)
Seat 5: f168df8e ($11.09 in chips)
Seat 6: 7ae869d4 ($5.15 in chips)
Hero: posts small blind $0.05
391c843f: posts big blind $0.1
*** HOLE CARDS ***
Dealt to adb62d5f 
Dealt to Hero [9h 6s]
Dealt to 391c843f 
Dealt to 346b9524 
Dealt to f168df8e 
Dealt to 7ae869d4 
346b9524: folds
f168df8e: folds
7ae869d4: folds
adb62d5f: folds
Hero: folds
Uncalled bet ($0.05) returned to 391c843f
*** SHOWDOWN ***
391c843f collected $0.1 from pot
*** SUMMARY ***
Total pot $0.1 | Rake $0 | Jackpot $0 | Bingo $0 | Fortune $0 | Tax $0
Seat 1: adb62d5f (button) folded before Flop (didn't bet)
Seat 2: Hero (small blind) folded before Flop
Seat 3: 391c843f (big blind) collected ($0.1)
Seat 4: 346b9524 folded before Flop (didn't bet)
Seat 5: f168df8e folded before Flop (didn't bet)
Seat 6: 7ae869d4 folded before Flop (didn't bet)


Poker Hand #RC2075498743: Hold'em No Limit ($0.05/$0.1) - 2023/12/21 23:10:11
Table 'RushAndCash276522' 6-max Seat #1 is the button
Seat 1: 618fe6d4 ($12.39 in chips)
Seat 2: 8c1f2bcb ($13.81 in chips)
Seat 3: Hero ($20.05 in chips)
Seat 4: 598922ef ($34.91 in chips)
Seat 5: 16e5f62 ($10.27 in chips)
Seat 6: a559c778 ($18.33 in chips)
8c1f2bcb: posts small blind $0.05
Hero: posts big blind $0.1
*** HOLE CARDS ***
Dealt to 618fe6d4 
Dealt to 8c1f2bcb 
Dealt to Hero [Kd Js]
Dealt to 598922ef 
Dealt to 16e5f62 
Dealt to a559c778 
598922ef: folds
16e5f62: raises $0.15 to $0.25
a559c778: folds
618fe6d4: folds
8c1f2bcb: folds
Hero: calls $0.15
*** FLOP *** [9d 9c Qs]
Hero: checks
16e5f62: bets $0.19
Hero: calls $0.19
*** TURN *** [9d 9c Qs] [Ac]
Hero: checks
16e5f62: bets $0.31
Hero: folds
Uncalled bet ($0.31) returned to 16e5f62
*** SHOWDOWN ***
16e5f62 collected $0.89 from pot
*** SUMMARY ***
Total pot $0.93 | Rake $0.04 | Jackpot $0 | Bingo $0 | Fortune $0 | Tax $0
Board [9d 9c Qs Ac]
Seat 1: 618fe6d4 (button) folded before Flop (didn't bet)
Seat 2: 8c1f2bcb (small blind) folded before Flop
Seat 3: Hero (big blind) folded on the Turn
Seat 4: 598922ef folded before Flop (didn't bet)
Seat 5: 16e5f62 won ($0.89)
Seat 6: a559c778 folded before Flop (didn't bet)


Poker Hand #RC2075498652: Hold'em No Limit ($0.05/$0.1) - 2023/12/21 23:10:07
Table 'RushAndCash276468' 6-max Seat #1 is the button
Seat 1: cac88962 ($10.15 in chips)
Seat 2: 6bd2232e ($10.88 in chips)
Seat 3: 599a5534 ($11.41 in chips)
Seat 4: 693663a ($8.76 in chips)
Seat 5: 5a7794f3 ($9.05 in chips)
Seat 6: Hero ($20.05 in chips)
6bd2232e: posts small blind $0.05
599a5534: posts big blind $0.1
*** HOLE CARDS ***
Dealt to cac88962 
Dealt to 6bd2232e 
Dealt to 599a5534 
Dealt to 693663a 
Dealt to 5a7794f3 
Dealt to Hero [3h 4h]
693663a: raises $0.16 to $0.26
5a7794f3: folds
Hero: folds
cac88962: folds
6bd2232e: folds
599a5534: calls $0.16
*** FLOP *** [8d Qs 7s]
599a5534: checks
693663a: bets $0.26
599a5534: raises $0.54 to $0.8
693663a: folds
Uncalled bet ($0.54) returned to 599a5534
693663a: shows [Ac Kh] (Ace-High)
*** SHOWDOWN ***
599a5534 collected $1.04 from pot
*** SUMMARY ***
Total pot $1.09 | Rake $0.05 | Jackpot $0 | Bingo $0 | Fortune $0 | Tax $0
Board [8d Qs 7s]
Seat 1: cac88962 (button) folded before Flop (didn't bet)
Seat 2: 6bd2232e (small blind) folded before Flop
Seat 3: 599a5534 (big blind) won ($1.04)
Seat 4: 693663a folded on the Flop
Seat 5: 5a7794f3 folded before Flop (didn't bet)
Seat 6: Hero folded before Flop (didn't bet)


Poker Hand #RC2075498513: Hold'em No Limit ($0.05/$0.1) - 2023/12/21 23:10:01
Table 'RushAndCash276382' 6-max Seat #1 is the button
Seat 1: Hero ($20.05 in chips)
Seat 2: a2286d58 ($10.15 in chips)
Seat 3: edce21d8 ($9.53 in chips)
Seat 4: 99c7403c ($12.98 in chips)
Seat 5: 478e84bf ($21.98 in chips)
Seat 6: d119cb70 ($9.85 in chips)
a2286d58: posts small blind $0.05
edce21d8: posts big blind $0.1
*** HOLE CARDS ***
Dealt to Hero [3s 5s]
Dealt to a2286d58 
Dealt to edce21d8 
Dealt to 99c7403c 
Dealt to 478e84bf 
Dealt to d119cb70 
99c7403c: folds
478e84bf: raises $0.1 to $0.2
d119cb70: raises $0.82 to $1.02
Hero: folds
a2286d58: folds
edce21d8: folds
478e84bf: folds
Uncalled bet ($0.82) returned to d119cb70
*** SHOWDOWN ***
d119cb70 collected $0.53 from pot
*** SUMMARY ***
Total pot $0.55 | Rake $0.02 | Jackpot $0 | Bingo $0 | Fortune $0 | Tax $0
Seat 1: Hero (button) folded before Flop (didn't bet)
Seat 2: a2286d58 (small blind) folded before Flop
Seat 3: edce21d8 (big blind) folded before Flop
Seat 4: 99c7403c folded before Flop (didn't bet)
Seat 5: 478e84bf folded before Flop
Seat 6: d119cb70 collected ($0.53)


Poker Hand #RC2075498423: Hold'em No Limit ($0.05/$0.1) - 2023/12/21 23:09:57
Table 'RushAndCash276325' 6-max Seat #1 is the button
Seat 1: f5c3936f ($10 in chips)
Seat 2: b14398ca ($20.72 in chips)
Seat 3: 387a6e45 ($10.43 in chips)
Seat 4: 6e6fec39 ($18.32 in chips)
Seat 5: 25884f73 ($10 in chips)
Seat 6: Hero ($20.05 in chips)
b14398ca: posts small blind $0.05
387a6e45: posts big blind $0.1
*** HOLE CARDS ***
Dealt to f5c3936f 
Dealt to b14398ca 
Dealt to 387a6e45 
Dealt to 6e6fec39 
Dealt to 25884f73 
Dealt to Hero [Jh 2h]
6e6fec39: folds
25884f73: folds
Hero: folds
f5c3936f: folds
b14398ca: folds
Uncalled bet ($0.05) returned to 387a6e45
*** SHOWDOWN ***
387a6e45 collected $0.1 from pot
*** SUMMARY ***
Total pot $0.1 | Rake $0 | Jackpot $0 | Bingo $0 | Fortune $0 | Tax $0
Seat 1: f5c3936f (button) folded before Flop (didn't bet)
Seat 2: b14398ca (small blind) folded before Flop
Seat 3: 387a6e45 (big blind) collected ($0.1)
Seat 4: 6e6fec39 folded before Flop (didn't bet)
Seat 5: 25884f73 folded before Flop (didn't bet)
Seat 6: Hero folded before Flop (didn't bet)


Poker Hand #RC2075498271: Hold'em No Limit ($0.05/$0.1) - 2023/12/21 23:09:49
Table 'RushAndCash276230' 6-max Seat #1 is the button
Seat 1: fe713d8b ($10.3 in chips)
Seat 2: f5045307 ($10.02 in chips)
Seat 3: 90d784f ($10.7 in chips)
Seat 4: Hero ($19.9 in chips)
Seat 5: 5d4b25d5 ($8.16 in chips)
Seat 6: be333114 ($11.02 in chips)
f5045307: posts small blind $0.05
90d784f: posts big blind $0.1
*** HOLE CARDS ***
Dealt to fe713d8b 
Dealt to f5045307 
Dealt to 90d784f 
Dealt to Hero [Ts 2h]
Dealt to 5d4b25d5 
Dealt to be333114 
Hero: folds
5d4b25d5: folds
be333114: folds
fe713d8b: folds
f5045307: folds
Uncalled bet ($0.05) returned to 90d784f
*** SHOWDOWN ***
90d784f collected $0.1 from pot
*** SUMMARY ***
Total pot $0.1 | Rake $0 | Jackpot $0 | Bingo $0 | Fortune $0 | Tax $0
Seat 1: fe713d8b (button) folded before Flop (didn't bet)
Seat 2: f5045307 (small blind) folded before Flop
Seat 3: 90d784f (big blind) collected ($0.1)
Seat 4: Hero folded before Flop (didn't bet)
Seat 5: 5d4b25d5 folded before Flop (didn't bet)
Seat 6: be333114 folded before Flop (didn't bet)


Poker Hand #RC2075498194: Hold'em No Limit ($0.05/$0.1) - 2023/12/21 23:09:46
Table 'RushAndCash276180' 6-max Seat #1 is the button
Seat 1: 5b495a42 ($16.09 in chips)
Seat 2: f5c3936f ($10.15 in chips)
Seat 3: Hero ($20 in chips)
Seat 4: b2f623b4 ($7.31 in chips)
Seat 5: 1adb71b5 ($5.73 in chips)
Seat 6: 3db6ac28 ($4.25 in chips)
f5c3936f: posts small blind $0.05
Hero: posts big blind $0.1
*** HOLE CARDS ***
Dealt to 5b495a42 
Dealt to f5c3936f 
Dealt to Hero [Qc 8h]
Dealt to b2f623b4 
Dealt to 1adb71b5 
Dealt to 3db6ac28 
b2f623b4: folds
1adb71b5: folds
3db6ac28: folds
5b495a42: folds
f5c3936f: folds
Uncalled bet ($0.05) returned to Hero
*** SHOWDOWN ***
Hero collected $0.1 from pot
*** SUMMARY ***
Total pot $0.1 | Rake $0 | Jackpot $0 | Bingo $0 | Fortune $0 | Tax $0
Seat 1: 5b495a42 (button) folded before Flop (didn't bet)
Seat 2: f5c3936f (small blind) folded before Flop
Seat 3: Hero (big blind) collected ($0.1)
Seat 4: b2f623b4 folded before Flop (didn't bet)
Seat 5: 1adb71b5 folded before Flop (didn't bet)
Seat 6: 3db6ac28 folded before Flop (didn't bet)


Poker Hand #RC2075497887: Hold'em No Limit ($0.05/$0.1) - 2023/12/21 23:09:32
Table 'RushAndCash275982' 6-max Seat #1 is the button
Seat 1: 802ea8ef ($10 in chips)
Seat 2: Hero ($20.05 in chips)
Seat 3: 6ece201a ($10.1 in chips)
Seat 4: 811e1b4a ($22.73 in chips)
Seat 5: fd721595 ($21.13 in chips)
Seat 6: e9b184f8 ($11.03 in chips)
Hero: posts small blind $0.05
6ece201a: posts big blind $0.1
*** HOLE CARDS ***
Dealt to 802ea8ef 
Dealt to Hero [8s 3c]
Dealt to 6ece201a 
Dealt to 811e1b4a 
Dealt to fd721595 
Dealt to e9b184f8 
811e1b4a: raises $0.13 to $0.23
fd721595: folds
e9b184f8: folds
802ea8ef: folds
Hero: folds
6ece201a: folds
Uncalled bet ($0.13) returned to 811e1b4a
*** SHOWDOWN ***
811e1b4a collected $0.25 from pot
*** SUMMARY ***
Total pot $0.25 | Rake $0 | Jackpot $0 | Bingo $0 | Fortune $0 | Tax $0
Seat 1: 802ea8ef (button) folded before Flop (didn't bet)
Seat 2: Hero (small blind) folded before Flop
Seat 3: 6ece201a (big blind) folded before Flop
Seat 4: 811e1b4a collected ($0.25)
Seat 5: fd721595 folded before Flop (didn't bet)
Seat 6: e9b184f8 folded before Flop (didn't bet)


Poker Hand #RC2075497774: Hold'em No Limit ($0.05/$0.1) - 2023/12/21 23:09:28
Table 'RushAndCash275914' 6-max Seat #1 is the button
Seat 1: 143af99f ($14.05 in chips)
Seat 2: de4275e3 ($10.28 in chips)
Seat 3: b8f8f3ff ($19.46 in chips)
Seat 4: a638cbb5 ($10.42 in chips)
Seat 5: Hero ($20.05 in chips)
Seat 6: f0586c2b ($10.05 in chips)
de4275e3: posts small blind $0.05
b8f8f3ff: posts big blind $0.1
*** HOLE CARDS ***
Dealt to 143af99f 
Dealt to de4275e3 
Dealt to b8f8f3ff 
Dealt to a638cbb5 
Dealt to Hero [Jd 8h]
Dealt to f0586c2b 
a638cbb5: folds
Hero: folds
f0586c2b: raises $0.12 to $0.22
143af99f: raises $0.52 to $0.74
de4275e3: folds
b8f8f3ff: folds
f0586c2b: calls $0.52
*** FLOP *** [As 6d Qd]
f0586c2b: checks
143af99f: bets $0.41
f0586c2b: calls $0.41
*** TURN *** [As 6d Qd] [7c]
f0586c2b: checks
143af99f: checks
*** RIVER *** [As 6d Qd 7c] [2h]
f0586c2b: bets $1.62
143af99f: calls $1.62
f0586c2b: shows [7s 6s] (Pair of Sevens and Pair of Sixes)
143af99f: shows [Tc Qc] (Pair of Queens)
*** SHOWDOWN ***
f0586c2b collected $5.27 from pot
*** SUMMARY ***
Total pot $5.69 | Rake $0.27 | Jackpot $0.15 | Bingo $0 | Fortune $0 | Tax $0
Board [As 6d Qd 7c 2h]
Seat 1: 143af99f (button) showed [Tc Qc] and lost with Pair of Queens
Seat 2: de4275e3 (small blind) folded before Flop
Seat 3: b8f8f3ff (big blind) folded before Flop
Seat 4: a638cbb5 folded before Flop (didn't bet)
Seat 5: Hero folded before Flop (didn't bet)
Seat 6: f0586c2b showed [7s 6s] and won ($5.27) with Pair of Sevens and Pair of Sixes


Poker Hand #RC2075497418: Hold'em No Limit ($0.05/$0.1) - 2023/12/21 23:09:11
Table 'RushAndCash275705' 6-max Seat #1 is the button
Seat 1: a7faa182 ($10.93 in chips)
Seat 2: a59a2f88 ($10.54 in chips)
Seat 3: 8373ec2c ($20.91 in chips)
Seat 4: Hero ($19.9 in chips)
Seat 5: 79a22c26 ($5.67 in chips)
Seat 6: 86e56a04 ($21.88 in chips)
a59a2f88: posts small blind $0.05
8373ec2c: posts big blind $0.1
*** HOLE CARDS ***
Dealt to a7faa182 
Dealt to a59a2f88 
Dealt to 8373ec2c 
Dealt to Hero [Jc Kc]
Dealt to 79a22c26 
Dealt to 86e56a04 
Hero: raises $0.1 to $0.2
79a22c26: folds
86e56a04: folds
a7faa182: folds
a59a2f88: folds
8373ec2c: folds
Uncalled bet ($0.1) returned to Hero
*** SHOWDOWN ***
Hero collected $0.25 from pot
*** SUMMARY ***
Total pot $0.25 | Rake $0 | Jackpot $0 | Bingo $0 | Fortune $0 | Tax $0
Seat 1: a7faa182 (button) folded before Flop (didn't bet)
Seat 2: a59a2f88 (small blind) folded before Flop
Seat 3: 8373ec2c (big blind) folded before Flop
Seat 4: Hero collected ($0.25)
Seat 5: 79a22c26 folded before Flop (didn't bet)
Seat 6: 86e56a04 folded before Flop (didn't bet)


Poker Hand #RC2075497287: Hold'em No Limit ($0.05/$0.1) - 2023/12/21 23:09:06
Table 'RushAndCash275625' 6-max Seat #1 is the button
Seat 1: 3d511405 ($10.36 in chips)
Seat 2: Hero ($19.95 in chips)
Seat 3: b6da9325 ($37.57 in chips)
Seat 4: 3e1b51f7 ($10.18 in chips)
Seat 5: 618fe6d4 ($13.62 in chips)
Seat 6: 4a324856 ($12.31 in chips)
Hero: posts small blind $0.05
b6da9325: posts big blind $0.1
*** HOLE CARDS ***
Dealt to 3d511405 
Dealt to Hero [Qd 7h]
Dealt to b6da9325 
Dealt to 3e1b51f7 
Dealt to 618fe6d4 
Dealt to 4a324856 
3e1b51f7: folds
618fe6d4: raises $0.13 to $0.23
4a324856: folds
3d511405: folds
Hero: folds
b6da9325: calls $0.13
*** FLOP *** [6s 2h 8c]
b6da9325: checks
618fe6d4: checks
*** TURN *** [6s 2h 8c] [Ad]
b6da9325: checks
618fe6d4: bets $0.3
b6da9325: calls $0.3
*** RIVER *** [6s 2h 8c Ad] [4c]
b6da9325: checks
618fe6d4: bets $0.6
b6da9325: calls $0.6
618fe6d4: shows [9s Ks] (Ace-High)
b6da9325: shows [Ah 9d] (Pair of Aces)
*** SHOWDOWN ***
b6da9325 collected $2.2 from pot
*** SUMMARY ***
Total pot $2.31 | Rake $0.11 | Jackpot $0 | Bingo $0 | Fortune $0 | Tax $0
Board [6s 2h 8c Ad 4c]
Seat 1: 3d511405 (button) folded before Flop (didn't bet)
Seat 2: Hero (small blind) folded before Flop
Seat 3: b6da9325 (big blind) showed [Ah 9d] and won ($2.2) with Pair of Aces
Seat 4: 3e1b51f7 folded before Flop (didn't bet)
Seat 5: 618fe6d4 showed [9s Ks] and lost with Ace-High
Seat 6: 4a324856 folded before Flop (didn't bet)


Poker Hand #RC2075497184: Hold'em No Limit ($0.05/$0.1) - 2023/12/21 23:09:01
Table 'RushAndCash275558' 6-max Seat #1 is the button
Seat 1: f76bc4ef ($5.95 in chips)
Seat 2: 25c34211 ($10.05 in chips)
Seat 3: 962102c7 ($34.45 in chips)
Seat 4: 7c895666 ($10.15 in chips)
Seat 5: Hero ($19.95 in chips)
Seat 6: 16e5f62 ($10.05 in chips)
25c34211: posts small blind $0.05
962102c7: posts big blind $0.1
*** HOLE CARDS ***
Dealt to f76bc4ef 
Dealt to 25c34211 
Dealt to 962102c7 
Dealt to 7c895666 
Dealt to Hero [3h 7s]
Dealt to 16e5f62 
7c895666: raises $0.15 to $0.25
Hero: folds
16e5f62: folds
f76bc4ef: folds
25c34211: folds
962102c7: calls $0.15
*** FLOP *** [7h 5c 5d]
962102c7: checks
7c895666: checks
*** TURN *** [7h 5c 5d] [9s]
962102c7: bets $0.3
7c895666: folds
Uncalled bet ($0.3) returned to 962102c7
*** SHOWDOWN ***
962102c7 collected $0.53 from pot
*** SUMMARY ***
Total pot $0.55 | Rake $0.02 | Jackpot $0 | Bingo $0 | Fortune $0 | Tax $0
Board [7h 5c 5d 9s]
Seat 1: f76bc4ef (button) folded before Flop (didn't bet)
Seat 2: 25c34211 (small blind) folded before Flop
Seat 3: 962102c7 (big blind) won ($0.53)
Seat 4: 7c895666 folded on the Turn
Seat 5: Hero folded before Flop (didn't bet)
Seat 6: 16e5f62 folded before Flop (didn't bet)


Poker Hand #RC2075497049: Hold'em No Limit ($0.05/$0.1) - 2023/12/21 23:08:55
Table 'RushAndCash275474' 6-max Seat #1 is the button
Seat 1: Hero ($19.8 in chips)
Seat 2: e16917ab ($7.01 in chips)
Seat 3: d8d6bf23 ($23.01 in chips)
Seat 4: 87436cf6 ($12.21 in chips)
Seat 5: 90eac02c ($10 in chips)
Seat 6: 5b4c162c ($17.94 in chips)
e16917ab: posts small blind $0.05
d8d6bf23: posts big blind $0.1
*** HOLE CARDS ***
Dealt to Hero [Jd 4c]
Dealt to e16917ab 
Dealt to d8d6bf23 
Dealt to 87436cf6 
Dealt to 90eac02c 
Dealt to 5b4c162c 
87436cf6: folds
90eac02c: folds
5b4c162c: folds
Hero: folds
e16917ab: folds
Uncalled bet ($0.05) returned to d8d6bf23
*** SHOWDOWN ***
d8d6bf23 collected $0.1 from pot
*** SUMMARY ***
Total pot $0.1 | Rake $0 | Jackpot $0 | Bingo $0 | Fortune $0 | Tax $0
Seat 1: Hero (button) folded before Flop (didn't bet)
Seat 2: e16917ab (small blind) folded before Flop
Seat 3: d8d6bf23 (big blind) collected ($0.1)
Seat 4: 87436cf6 folded before Flop (didn't bet)
Seat 5: 90eac02c folded before Flop (didn't bet)
Seat 6: 5b4c162c folded before Flop (didn't bet)


Poker Hand #RC2075496946: Hold'em No Limit ($0.05/$0.1) - 2023/12/21 23:08:50
Table 'RushAndCash275406' 6-max Seat #1 is the button
Seat 1: baa27ded ($11.34 in chips)
Seat 2: 620d7aac ($14.91 in chips)
Seat 3: Hero ($19.9 in chips)
Seat 4: 87436cf6 ($12.21 in chips)
Seat 5: b14398ca ($20.01 in chips)
Seat 6: 6ece201a ($10 in chips)
620d7aac: posts small blind $0.05
Hero: posts big blind $0.1
*** HOLE CARDS ***
Dealt to baa27ded 
Dealt to 620d7aac 
Dealt to Hero [7d Qc]
Dealt to 87436cf6 
Dealt to b14398ca 
Dealt to 6ece201a 
87436cf6: folds
b14398ca: folds
6ece201a: folds
baa27ded: folds
620d7aac: folds
Uncalled bet ($0.05) returned to Hero
*** SHOWDOWN ***
Hero collected $0.1 from pot
*** SUMMARY ***
Total pot $0.1 | Rake $0 | Jackpot $0 | Bingo $0 | Fortune $0 | Tax $0
Seat 1: baa27ded (button) folded before Flop (didn't bet)
Seat 2: 620d7aac (small blind) folded before Flop
Seat 3: Hero (big blind) collected ($0.1)
Seat 4: 87436cf6 folded before Flop (didn't bet)
Seat 5: b14398ca folded before Flop (didn't bet)
Seat 6: 6ece201a folded before Flop (didn't bet)


Poker Hand #RC2075496852: Hold'em No Limit ($0.05/$0.1) - 2023/12/21 23:08:46
Table 'RushAndCash275349' 6-max Seat #1 is the button
Seat 1: f76bc4ef ($6 in chips)
Seat 2: 85891fa5 ($10 in chips)
Seat 3: 969ab6b9 ($13.63 in chips)
Seat 4: 49b69c38 ($13 in chips)
Seat 5: Hero ($19.9 in chips)
Seat 6: c516ab0f ($9.77 in chips)
85891fa5: posts small blind $0.05
969ab6b9: posts big blind $0.1
*** HOLE CARDS ***
Dealt to f76bc4ef 
Dealt to 85891fa5 
Dealt to 969ab6b9 
Dealt to 49b69c38 
Dealt to Hero [Qh Ts]
Dealt to c516ab0f 
49b69c38: folds
Hero: folds
c516ab0f: raises $0.1 to $0.2
f76bc4ef: folds
85891fa5: folds
969ab6b9: folds
Uncalled bet ($0.1) returned to c516ab0f
*** SHOWDOWN ***
c516ab0f collected $0.25 from pot
*** SUMMARY ***
Total pot $0.25 | Rake $0 | Jackpot $0 | Bingo $0 | Fortune $0 | Tax $0
Seat 1: f76bc4ef (button) folded before Flop (didn't bet)
Seat 2: 85891fa5 (small blind) folded before Flop
Seat 3: 969ab6b9 (big blind) folded before Flop
Seat 4: 49b69c38 folded before Flop (didn't bet)
Seat 5: Hero folded before Flop (didn't bet)
Seat 6: c516ab0f collected ($0.25)


Poker Hand #RC2075496747: Hold'em No Limit ($0.05/$0.1) - 2023/12/21 23:08:42
Table 'RushAndCash275284' 6-max Seat #1 is the button
Seat 1: 8c031b80 ($8.91 in chips)
Seat 2: 1486f31 ($25.08 in chips)
Seat 3: 28f1237c ($9.83 in chips)
Seat 4: 74b81912 ($14.05 in chips)
Seat 5: 94c670bd ($7.8 in chips)
Seat 6: Hero ($19.9 in chips)
1486f31: posts small blind $0.05
28f1237c: posts big blind $0.1
*** HOLE CARDS ***
Dealt to 8c031b80 
Dealt to 1486f31 
Dealt to 28f1237c 
Dealt to 74b81912 
Dealt to 94c670bd 
Dealt to Hero [6h Tc]
74b81912: folds
94c670bd: raises $0.1 to $0.2
Hero: folds
8c031b80: folds
1486f31: folds
28f1237c: folds
Uncalled bet ($0.1) returned to 94c670bd
*** SHOWDOWN ***
94c670bd collected $0.25 from pot
*** SUMMARY ***
Total pot $0.25 | Rake $0 | Jackpot $0 | Bingo $0 | Fortune $0 | Tax $0
Seat 1: 8c031b80 (button) folded before Flop (didn't bet)
Seat 2: 1486f31 (small blind) folded before Flop
Seat 3: 28f1237c (big blind) folded before Flop
Seat 4: 74b81912 folded before Flop (didn't bet)
Seat 5: 94c670bd collected ($0.25)
Seat 6: Hero folded before Flop (didn't bet)


Poker Hand #RC2075496660: Hold'em No Limit ($0.05/$0.1) - 2023/12/21 23:08:38
Table 'RushAndCash275229' 6-max Seat #1 is the button
Seat 1: 24f3f1b4 ($3.45 in chips)
Seat 2: e7322801 ($9.74 in chips)
Seat 3: 2be34245 ($15.86 in chips)
Seat 4: Hero ($19.9 in chips)
Seat 5: c35ebd0c ($8.62 in chips)
Seat 6: a7280055 ($13.85 in chips)
e7322801: posts small blind $0.05
2be34245: posts big blind $0.1
*** HOLE CARDS ***
Dealt to 24f3f1b4 
Dealt to e7322801 
Dealt to 2be34245 
Dealt to Hero [5c 9d]
Dealt to c35ebd0c 
Dealt to a7280055 
Hero: folds
c35ebd0c: folds
a7280055: folds
24f3f1b4: raises $0.15 to $0.25
e7322801: raises $0.6 to $0.85
2be34245: folds
24f3f1b4: folds
Uncalled bet ($0.6) returned to e7322801
*** SHOWDOWN ***
e7322801 collected $0.57 from pot
*** SUMMARY ***
Total pot $0.6 | Rake $0.03 | Jackpot $0 | Bingo $0 | Fortune $0 | Tax $0
Seat 1: 24f3f1b4 (button) folded before Flop
Seat 2: e7322801 (small blind) collected ($0.57)
Seat 3: 2be34245 (big blind) folded before Flop
Seat 4: Hero folded before Flop (didn't bet)
Seat 5: c35ebd0c folded before Flop (didn't bet)
Seat 6: a7280055 folded before Flop (didn't bet)


Poker Hand #RC2075496531: Hold'em No Limit ($0.05/$0.1) - 2023/12/21 23:08:33
Table 'RushAndCash275148' 6-max Seat #1 is the button
Seat 1: Hero ($19.9 in chips)
Seat 2: 67a39c12 ($11.01 in chips)
Seat 3: 817c3f99 ($20.43 in chips)
Seat 4: ad33b1a1 ($10.33 in chips)
Seat 5: 3e2151ef ($11.2 in chips)
Seat 6: c0a47dfa ($34.66 in chips)
67a39c12: posts small blind $0.05
817c3f99: posts big blind $0.1
*** HOLE CARDS ***
Dealt to Hero [3d 4s]
Dealt to 67a39c12 
Dealt to 817c3f99 
Dealt to ad33b1a1 
Dealt to 3e2151ef 
Dealt to c0a47dfa 
ad33b1a1: folds
3e2151ef: folds
c0a47dfa: folds
Hero: folds
67a39c12: folds
Uncalled bet ($0.05) returned to 817c3f99
*** SHOWDOWN ***
817c3f99 collected $0.1 from pot
*** SUMMARY ***
Total pot $0.1 | Rake $0 | Jackpot $0 | Bingo $0 | Fortune $0 | Tax $0
Seat 1: Hero (button) folded before Flop (didn't bet)
Seat 2: 67a39c12 (small blind) folded before Flop
Seat 3: 817c3f99 (big blind) collected ($0.1)
Seat 4: ad33b1a1 folded before Flop (didn't bet)
Seat 5: 3e2151ef folded before Flop (didn't bet)
Seat 6: c0a47dfa folded before Flop (didn't bet)


Poker Hand #RC2075496370: Hold'em No Limit ($0.05/$0.1) - 2023/12/21 23:08:26
Table 'RushAndCash275052' 6-max Seat #1 is the button
Seat 1: f4b6c56f ($17.57 in chips)
Seat 2: Hero ($19.95 in chips)
Seat 3: e57aeb4c ($19.32 in chips)
Seat 4: adb62d5f ($31.35 in chips)
Seat 5: c516ab0f ($9.92 in chips)
Seat 6: dd84fd1b ($10.33 in chips)
Hero: posts small blind $0.05
e57aeb4c: posts big blind $0.1
*** HOLE CARDS ***
Dealt to f4b6c56f 
Dealt to Hero [Jc Ts]
Dealt to e57aeb4c 
Dealt to adb62d5f 
Dealt to c516ab0f 
Dealt to dd84fd1b 
adb62d5f: folds
c516ab0f: folds
dd84fd1b: folds
f4b6c56f: folds
Hero: folds
Uncalled bet ($0.05) returned to e57aeb4c
*** SHOWDOWN ***
e57aeb4c collected $0.1 from pot
*** SUMMARY ***
Total pot $0.1 | Rake $0 | Jackpot $0 | Bingo $0 | Fortune $0 | Tax $0
Seat 1: f4b6c56f (button) folded before Flop (didn't bet)
Seat 2: Hero (small blind) folded before Flop
Seat 3: e57aeb4c (big blind) collected ($0.1)
Seat 4: adb62d5f folded before Flop (didn't bet)
Seat 5: c516ab0f folded before Flop (didn't bet)
Seat 6: dd84fd1b folded before Flop (didn't bet)


Poker Hand #RC2075496184: Hold'em No Limit ($0.05/$0.1) - 2023/12/21 23:08:18
Table 'RushAndCash274940' 6-max Seat #1 is the button
Seat 1: 3cd87350 ($9.6 in chips)
Seat 2: 37ad1ddc ($10.05 in chips)
Seat 3: Hero ($20.05 in chips)
Seat 4: dfe47311 ($28.11 in chips)
Seat 5: ab0aaad8 ($9.55 in chips)
Seat 6: e6ef7605 ($44.22 in chips)
37ad1ddc: posts small blind $0.05
Hero: posts big blind $0.1
*** HOLE CARDS ***
Dealt to 3cd87350 
Dealt to 37ad1ddc 
Dealt to Hero [Ks 8c]
Dealt to dfe47311 
Dealt to ab0aaad8 
Dealt to e6ef7605 
dfe47311: folds
ab0aaad8: folds
e6ef7605: raises $0.12 to $0.22
3cd87350: folds
37ad1ddc: raises $0.81 to $1.03
Hero: folds
e6ef7605: folds
Uncalled bet ($0.81) returned to 37ad1ddc
*** SHOWDOWN ***
37ad1ddc collected $0.52 from pot
*** SUMMARY ***
Total pot $0.54 | Rake $0.02 | Jackpot $0 | Bingo $0 | Fortune $0 | Tax $0
Seat 1: 3cd87350 (button) folded before Flop (didn't bet)
Seat 2: 37ad1ddc (small blind) collected ($0.52)
Seat 3: Hero (big blind) folded before Flop
Seat 4: dfe47311 folded before Flop (didn't bet)
Seat 5: ab0aaad8 folded before Flop (didn't bet)
Seat 6: e6ef7605 folded before Flop


Poker Hand #RC2075496102: Hold'em No Limit ($0.05/$0.1) - 2023/12/21 23:08:14
Table 'RushAndCash274892' 6-max Seat #1 is the button
Seat 1: f920b19c ($13.06 in chips)
Seat 2: ec8086e5 ($11.76 in chips)
Seat 3: cbf647d3 ($29.31 in chips)
Seat 4: ab187254 ($10.05 in chips)
Seat 5: Hero ($20.05 in chips)
Seat 6: b2788e30 ($16.31 in chips)
ec8086e5: posts small blind $0.05
cbf647d3: posts big blind $0.1
*** HOLE CARDS ***
Dealt to f920b19c 
Dealt to ec8086e5 
Dealt to cbf647d3 
Dealt to ab187254 
Dealt to Hero [3s Kd]
Dealt to b2788e30 
ab187254: folds
Hero: folds
b2788e30: folds
f920b19c: folds
ec8086e5: folds
Uncalled bet ($0.05) returned to cbf647d3
*** SHOWDOWN ***
cbf647d3 collected $0.1 from pot
*** SUMMARY ***
Total pot $0.1 | Rake $0 | Jackpot $0 | Bingo $0 | Fortune $0 | Tax $0
Seat 1: f920b19c (button) folded before Flop (didn't bet)
Seat 2: ec8086e5 (small blind) folded before Flop
Seat 3: cbf647d3 (big blind) collected ($0.1)
Seat 4: ab187254 folded before Flop (didn't bet)
Seat 5: Hero folded before Flop (didn't bet)
Seat 6: b2788e30 folded before Flop (didn't bet)


Poker Hand #RC2075495483: Hold'em No Limit ($0.05/$0.1) - 2023/12/21 23:07:46
Table 'RushAndCash274534' 6-max Seat #1 is the button
Seat 1: 2c0aeb87 ($26.62 in chips)
Seat 2: aa3a197d ($10 in chips)
Seat 3: fe8e9d75 ($10 in chips)
Seat 4: ddc6a18d ($10 in chips)
Seat 5: 7b0a7ba6 ($10.22 in chips)
Seat 6: Hero ($20.27 in chips)
aa3a197d: posts small blind $0.05
fe8e9d75: posts big blind $0.1
*** HOLE CARDS ***
Dealt to 2c0aeb87 
Dealt to aa3a197d 
Dealt to fe8e9d75 
Dealt to ddc6a18d 
Dealt to 7b0a7ba6 
Dealt to Hero [Tc 9c]
ddc6a18d: raises $0.12 to $0.22
7b0a7ba6: calls $0.22
Hero: calls $0.22
2c0aeb87: calls $0.22
aa3a197d: folds
fe8e9d75: folds
*** FLOP *** [3h 3c 3d]
ddc6a18d: checks
7b0a7ba6: bets $0.56
Hero: folds
2c0aeb87: folds
ddc6a18d: calls $0.56
*** TURN *** [3h 3c 3d] [Qs]
ddc6a18d: checks
7b0a7ba6: checks
*** RIVER *** [3h 3c 3d Qs] [4h]
ddc6a18d: checks
7b0a7ba6: checks
ddc6a18d: shows [Ad Kc] (Three Treys)
7b0a7ba6: shows [6s 6h] (Treys Full over Sixes)
*** SHOWDOWN ***
7b0a7ba6 collected $2.05 from pot
*** SUMMARY ***
Total pot $2.15 | Rake $0.1 | Jackpot $0 | Bingo $0 | Fortune $0 | Tax $0
Board [3h 3c 3d Qs 4h]
Seat 1: 2c0aeb87 (button) folded on the Flop
Seat 2: aa3a197d (small blind) folded before Flop
Seat 3: fe8e9d75 (big blind) folded before Flop
Seat 4: ddc6a18d showed [Ad Kc] and lost with Three Treys
Seat 5: 7b0a7ba6 showed [6s 6h] and won ($2.05) with Treys Full over Sixes
Seat 6: Hero folded on the Flop


Poker Hand #RC2075495394: Hold'em No Limit ($0.05/$0.1) - 2023/12/21 23:07:43
Table 'RushAndCash274482' 6-max Seat #1 is the button
Seat 1: cc1f7bc2 ($33.03 in chips)
Seat 2: dc18fbf1 ($10.05 in chips)
Seat 3: 67a39c12 ($10.68 in chips)
Seat 4: 9dfab98a ($10.65 in chips)
Seat 5: Hero ($20.27 in chips)
Seat 6: 77d5115b ($10.15 in chips)
dc18fbf1: posts small blind $0.05
67a39c12: posts big blind $0.1
*** HOLE CARDS ***
Dealt to cc1f7bc2 
Dealt to dc18fbf1 
Dealt to 67a39c12 
Dealt to 9dfab98a 
Dealt to Hero [Qs 8d]
Dealt to 77d5115b 
9dfab98a: raises $0.15 to $0.25
Hero: folds
77d5115b: folds
cc1f7bc2: folds
dc18fbf1: folds
67a39c12: folds
Uncalled bet ($0.15) returned to 9dfab98a
*** SHOWDOWN ***
9dfab98a collected $0.25 from pot
*** SUMMARY ***
Total pot $0.25 | Rake $0 | Jackpot $0 | Bingo $0 | Fortune $0 | Tax $0
Seat 1: cc1f7bc2 (button) folded before Flop (didn't bet)
Seat 2: dc18fbf1 (small blind) folded before Flop
Seat 3: 67a39c12 (big blind) folded before Flop
Seat 4: 9dfab98a collected ($0.25)
Seat 5: Hero folded before Flop (didn't bet)
Seat 6: 77d5115b folded before Flop (didn't bet)


Poker Hand #RC2075495308: Hold'em No Limit ($0.05/$0.1) - 2023/12/21 23:07:39
Table 'RushAndCash274428' 6-max Seat #1 is the button
Seat 1: Hero ($20.27 in chips)
Seat 2: 1e29268 ($11.86 in chips)
Seat 3: ba4adc22 ($13.92 in chips)
Seat 4: 3721d0d6 ($20.46 in chips)
Seat 5: fd721595 ($21.79 in chips)
Seat 6: 553f03c9 ($11.25 in chips)
1e29268: posts small blind $0.05
ba4adc22: posts big blind $0.1
*** HOLE CARDS ***
Dealt to Hero [Td 5c]
Dealt to 1e29268 
Dealt to ba4adc22 
Dealt to 3721d0d6 
Dealt to fd721595 
Dealt to 553f03c9 
3721d0d6: raises $0.15 to $0.25
fd721595: folds
553f03c9: folds
Hero: folds
1e29268: calls $0.2
ba4adc22: folds
*** FLOP *** [6h 5s Qh]
1e29268: checks
3721d0d6: bets $0.2
1e29268: raises $0.5 to $0.7
3721d0d6: folds
Uncalled bet ($0.5) returned to 1e29268
*** SHOWDOWN ***
1e29268 collected $0.95 from pot
*** SUMMARY ***
Total pot $1 | Rake $0.05 | Jackpot $0 | Bingo $0 | Fortune $0 | Tax $0
Board [6h 5s Qh]
Seat 1: Hero (button) folded before Flop (didn't bet)
Seat 2: 1e29268 (small blind) won ($0.95)
Seat 3: ba4adc22 (big blind) folded before Flop
Seat 4: 3721d0d6 folded on the Flop
Seat 5: fd721595 folded before Flop (didn't bet)
Seat 6: 553f03c9 folded before Flop (didn't bet)


Poker Hand #RC2075473953: Hold'em No Limit ($0.05/$0.1) - 2023/12/21 23:06:37
Table 'RushAndCash273608' 6-max Seat #1 is the button
Seat 1: 553f03c9 ($11.69 in chips)
Seat 2: Hero ($19.65 in chips)
Seat 3: 1e29268 ($12.09 in chips)
Seat 4: 86a73692 ($5.89 in chips)
Seat 5: 8f53262f ($8.92 in chips)
Seat 6: 5e617a08 ($12.52 in chips)
Hero: posts small blind $0.05
1e29268: posts big blind $0.1
*** HOLE CARDS ***
Dealt to 553f03c9 
Dealt to Hero [Qs Ac]
Dealt to 1e29268 
Dealt to 86a73692 
Dealt to 8f53262f 
Dealt to 5e617a08 
86a73692: folds
8f53262f: folds
5e617a08: folds
553f03c9: raises $0.13 to $0.23
Hero: calls $0.18
1e29268: calls $0.13
*** FLOP *** [4h 4c 4s]
Hero: checks
1e29268: checks
553f03c9: bets $0.21
Hero: calls $0.21
1e29268: folds
*** TURN *** [4h 4c 4s] [Qh]
Hero: checks
553f03c9: checks
*** RIVER *** [4h 4c 4s Qh] [8d]
Hero: bets $0.56
553f03c9: folds
Uncalled bet ($0.56) returned to Hero
*** SHOWDOWN ***
Hero collected $1.06 from pot
*** SUMMARY ***
Total pot $1.11 | Rake $0.05 | Jackpot $0 | Bingo $0 | Fortune $0 | Tax $0
Board [4h 4c 4s Qh 8d]
Seat 1: 553f03c9 (button) folded on the River
Seat 2: Hero (small blind) won ($1.06)
Seat 3: 1e29268 (big blind) folded on the Flop
Seat 4: 86a73692 folded before Flop (didn't bet)
Seat 5: 8f53262f folded before Flop (didn't bet)
Seat 6: 5e617a08 folded before Flop (didn't bet)


Poker Hand #RC2075473752: Hold'em No Limit ($0.05/$0.1) - 2023/12/21 23:06:28
Table 'RushAndCash273487' 6-max Seat #1 is the button
Seat 1: e0ab7d9c ($10.15 in chips)
Seat 2: 8998e4c4 ($8.55 in chips)
Seat 3: Hero ($19.75 in chips)
Seat 4: 6f70aff ($20.24 in chips)
Seat 5: 9f74de59 ($10.42 in chips)
Seat 6: 94c670bd ($10 in chips)
8998e4c4: posts small blind $0.05
Hero: posts big blind $0.1
*** HOLE CARDS ***
Dealt to e0ab7d9c 
Dealt to 8998e4c4 
Dealt to Hero [Ts 6h]
Dealt to 6f70aff 
Dealt to 9f74de59 
Dealt to 94c670bd 
6f70aff: folds
9f74de59: folds
94c670bd: folds
e0ab7d9c: raises $0.15 to $0.25
8998e4c4: folds
Hero: folds
Uncalled bet ($0.15) returned to e0ab7d9c
*** SHOWDOWN ***
e0ab7d9c collected $0.25 from pot
*** SUMMARY ***
Total pot $0.25 | Rake $0 | Jackpot $0 | Bingo $0 | Fortune $0 | Tax $0
Seat 1: e0ab7d9c (button) collected ($0.25)
Seat 2: 8998e4c4 (small blind) folded before Flop
Seat 3: Hero (big blind) folded before Flop
Seat 4: 6f70aff folded before Flop (didn't bet)
Seat 5: 9f74de59 folded before Flop (didn't bet)
Seat 6: 94c670bd folded before Flop (didn't bet)


Poker Hand #RC2075473630: Hold'em No Limit ($0.05/$0.1) - 2023/12/21 23:06:22
Table 'RushAndCash273414' 6-max Seat #1 is the button
Seat 1: e7322801 ($9.74 in chips)
Seat 2: 243279ca ($14.33 in chips)
Seat 3: 88b4672a ($9.42 in chips)
Seat 4: Hero ($19.75 in chips)
Seat 5: 6828e3d8 ($9.97 in chips)
Seat 6: f2deab29 ($10 in chips)
243279ca: posts small blind $0.05
88b4672a: posts big blind $0.1
*** HOLE CARDS ***
Dealt to e7322801 
Dealt to 243279ca 
Dealt to 88b4672a 
Dealt to Hero [5s 4s]
Dealt to 6828e3d8 
Dealt to f2deab29 
Hero: folds
6828e3d8: folds
f2deab29: folds
e7322801: folds
243279ca: raises $0.15 to $0.25
88b4672a: calls $0.15
*** FLOP *** [5h 8s Kh]
243279ca: bets $0.15
88b4672a: calls $0.15
*** TURN *** [5h 8s Kh] [9h]
243279ca: bets $0.35
88b4672a: folds
Uncalled bet ($0.35) returned to 243279ca
*** SHOWDOWN ***
243279ca collected $0.76 from pot
*** SUMMARY ***
Total pot $0.8 | Rake $0.04 | Jackpot $0 | Bingo $0 | Fortune $0 | Tax $0
Board [5h 8s Kh 9h]
Seat 1: e7322801 (button) folded before Flop (didn't bet)
Seat 2: 243279ca (small blind) won ($0.76)
Seat 3: 88b4672a (big blind) folded on the Turn
Seat 4: Hero folded before Flop (didn't bet)
Seat 5: 6828e3d8 folded before Flop (didn't bet)
Seat 6: f2deab29 folded before Flop (didn't bet)


Poker Hand #RC2075473551: Hold'em No Limit ($0.05/$0.1) - 2023/12/21 23:06:19
Table 'RushAndCash273367' 6-max Seat #1 is the button
Seat 1: f616323e ($22.66 in chips)
Seat 2: 585a5f8d ($3.07 in chips)
Seat 3: 4d5d863 ($10 in chips)
Seat 4: Hero ($19.75 in chips)
Seat 5: b8f8f3ff ($20.19 in chips)
Seat 6: 6828e3d8 ($9.97 in chips)
585a5f8d: posts small blind $0.05
4d5d863: posts big blind $0.1
*** HOLE CARDS ***
Dealt to f616323e 
Dealt to 585a5f8d 
Dealt to 4d5d863 
Dealt to Hero [2s 9s]
Dealt to b8f8f3ff 
Dealt to 6828e3d8 
Hero: folds
b8f8f3ff: folds
6828e3d8: folds
f616323e: folds
585a5f8d: raises $0.1 to $0.2
4d5d863: calls $0.1
*** FLOP *** [Tc 5s 8c]
585a5f8d: checks
4d5d863: checks
*** TURN *** [Tc 5s 8c] [Qd]
585a5f8d: checks
4d5d863: bets $0.3
585a5f8d: folds
Uncalled bet ($0.3) returned to 4d5d863
*** SHOWDOWN ***
4d5d863 collected $0.38 from pot
*** SUMMARY ***
Total pot $0.4 | Rake $0.02 | Jackpot $0 | Bingo $0 | Fortune $0 | Tax $0
Board [Tc 5s 8c Qd]
Seat 1: f616323e (button) folded before Flop (didn't bet)
Seat 2: 585a5f8d (small blind) folded on the Turn
Seat 3: 4d5d863 (big blind) won ($0.38)
Seat 4: Hero folded before Flop (didn't bet)
Seat 5: b8f8f3ff folded before Flop (didn't bet)
Seat 6: 6828e3d8 folded before Flop (didn't bet)


Poker Hand #RC2075473478: Hold'em No Limit ($0.05/$0.1) - 2023/12/21 23:06:15
Table 'RushAndCash273325' 6-max Seat #1 is the button
Seat 1: f15e57df ($64.36 in chips)
Seat 2: 2859beab ($32.34 in chips)
Seat 3: 58a8861f ($13.18 in chips)
Seat 4: bf63a7e ($10 in chips)
Seat 5: Hero ($19.75 in chips)
Seat 6: 574aec7c ($4 in chips)
2859beab: posts small blind $0.05
58a8861f: posts big blind $0.1
*** HOLE CARDS ***
Dealt to f15e57df 
Dealt to 2859beab 
Dealt to 58a8861f 
Dealt to bf63a7e 
Dealt to Hero [8c Qs]
Dealt to 574aec7c 
bf63a7e: folds
Hero: folds
574aec7c: folds
f15e57df: folds
2859beab: raises $0.1 to $0.2
58a8861f: calls $0.1
*** FLOP *** [3h Jd 6c]
2859beab: checks
58a8861f: bets $0.2
2859beab: folds
Uncalled bet ($0.2) returned to 58a8861f
*** SHOWDOWN ***
58a8861f collected $0.38 from pot
*** SUMMARY ***
Total pot $0.4 | Rake $0.02 | Jackpot $0 | Bingo $0 | Fortune $0 | Tax $0
Board [3h Jd 6c]
Seat 1: f15e57df (button) folded before Flop (didn't bet)
Seat 2: 2859beab (small blind) folded on the Flop
Seat 3: 58a8861f (big blind) won ($0.38)
Seat 4: bf63a7e folded before Flop (didn't bet)
Seat 5: Hero folded before Flop (didn't bet)
Seat 6: 574aec7c folded before Flop (didn't bet)


Poker Hand #RC2075472863: Hold'em No Limit ($0.05/$0.1) - 2023/12/21 23:05:47
Table 'RushAndCash272953' 6-max Seat #1 is the button
Seat 1: Hero ($20.05 in chips)
Seat 2: 598922ef ($32.23 in chips)
Seat 3: a68ff782 ($14.07 in chips)
Seat 4: 3ead9ce5 ($10.88 in chips)
Seat 5: 27294907 ($10 in chips)
Seat 6: be2018bd ($10.06 in chips)
598922ef: posts small blind $0.05
a68ff782: posts big blind $0.1
*** HOLE CARDS ***
Dealt to Hero [Th Kh]
Dealt to 598922ef 
Dealt to a68ff782 
Dealt to 3ead9ce5 
Dealt to 27294907 
Dealt to be2018bd 
3ead9ce5: folds
27294907: folds
be2018bd: raises $0.2 to $0.3
Hero: calls $0.3
598922ef: folds
a68ff782: folds
*** FLOP *** [2c 9d 3s]
be2018bd: bets $0.38
Hero: folds
Uncalled bet ($0.38) returned to be2018bd
*** SHOWDOWN ***
be2018bd collected $0.72 from pot
*** SUMMARY ***
Total pot $0.75 | Rake $0.03 | Jackpot $0 | Bingo $0 | Fortune $0 | Tax $0
Board [2c 9d 3s]
Seat 1: Hero (button) folded on the Flop
Seat 2: 598922ef (small blind) folded before Flop
Seat 3: a68ff782 (big blind) folded before Flop
Seat 4: 3ead9ce5 folded before Flop (didn't bet)
Seat 5: 27294907 folded before Flop (didn't bet)
Seat 6: be2018bd won ($0.72)


Poker Hand #RC2075471242: Hold'em No Limit ($0.05/$0.1) - 2023/12/21 23:04:36
Table 'RushAndCash271994' 6-max Seat #1 is the button
Seat 1: be333114 ($12.23 in chips)
Seat 2: Hero ($10.2 in chips)
Seat 3: ec0c4bef ($12.83 in chips)
Seat 4: 7e5bf647 ($22.87 in chips)
Seat 5: 9e54d5fe ($40.83 in chips)
Seat 6: dc46972c ($11.97 in chips)
Hero: posts small blind $0.05
ec0c4bef: posts big blind $0.1
*** HOLE CARDS ***
Dealt to be333114 
Dealt to Hero [As Ah]
Dealt to ec0c4bef 
Dealt to 7e5bf647 
Dealt to 9e54d5fe 
Dealt to dc46972c 
7e5bf647: folds
9e54d5fe: folds
dc46972c: raises $0.2 to $0.3
be333114: folds
Hero: raises $0.7 to $1
ec0c4bef: folds
dc46972c: calls $0.7
*** FLOP *** [3d 6d Ks]
Hero: bets $0.7
dc46972c: calls $0.7
*** TURN *** [3d 6d Ks] [4s]
Hero: bets $2.05
dc46972c: calls $2.05
*** RIVER *** [3d 6d Ks 4s] [5d]
Hero: bets $6.45 and is all-in
dc46972c: calls $6.45
Hero: shows [As Ah] (Pair of Aces)
dc46972c: shows [Qh Kh] (Pair of Kings)
*** SHOWDOWN ***
Hero collected $20.05 from pot
*** SUMMARY ***
Total pot $20.5 | Rake $0.3 | Jackpot $0.15 | Bingo $0 | Fortune $0 | Tax $0
Board [3d 6d Ks 4s 5d]
Seat 1: be333114 (button) folded before Flop (didn't bet)
Seat 2: Hero (small blind) showed [As Ah] and won ($20.05) with Pair of Aces
Seat 3: ec0c4bef (big blind) folded before Flop
Seat 4: 7e5bf647 folded before Flop (didn't bet)
Seat 5: 9e54d5fe folded before Flop (didn't bet)
Seat 6: dc46972c showed [Qh Kh] and lost with Pair of Kings


Poker Hand #RC2075470966: Hold'em No Limit ($0.05/$0.1) - 2023/12/21 23:04:23
Table 'RushAndCash271827' 6-max Seat #1 is the button
Seat 1: 74d3c46 ($16.2 in chips)
Seat 2: 49512415 ($11.25 in chips)
Seat 3: Hero ($10.15 in chips)
Seat 4: 2ade888c ($34.43 in chips)
Seat 5: c5694eb2 ($34.88 in chips)
Seat 6: e889978c ($22.98 in chips)
49512415: posts small blind $0.05
Hero: posts big blind $0.1
*** HOLE CARDS ***
Dealt to 74d3c46 
Dealt to 49512415 
Dealt to Hero [5d 7d]
Dealt to 2ade888c 
Dealt to c5694eb2 
Dealt to e889978c 
2ade888c: folds
c5694eb2: folds
e889978c: folds
74d3c46: folds
49512415: folds
Uncalled bet ($0.05) returned to Hero
*** SHOWDOWN ***
Hero collected $0.1 from pot
*** SUMMARY ***
Total pot $0.1 | Rake $0 | Jackpot $0 | Bingo $0 | Fortune $0 | Tax $0
Seat 1: 74d3c46 (button) folded before Flop (didn't bet)
Seat 2: 49512415 (small blind) folded before Flop
Seat 3: Hero (big blind) collected ($0.1)
Seat 4: 2ade888c folded before Flop (didn't bet)
Seat 5: c5694eb2 folded before Flop (didn't bet)
Seat 6: e889978c folded before Flop (didn't bet)


Poker Hand #RC2075470837: Hold'em No Limit ($0.05/$0.1) - 2023/12/21 23:04:18
Table 'RushAndCash271751' 6-max Seat #1 is the button
Seat 1: e14f27f8 ($15.05 in chips)
Seat 2: bce5720c ($4.78 in chips)
Seat 3: 74db4029 ($10.46 in chips)
Seat 4: e400317d ($10 in chips)
Seat 5: ec591648 ($14.93 in chips)
Seat 6: Hero ($10.15 in chips)
bce5720c: posts small blind $0.05
74db4029: posts big blind $0.1
*** HOLE CARDS ***
Dealt to e14f27f8 
Dealt to bce5720c 
Dealt to 74db4029 
Dealt to e400317d 
Dealt to ec591648 
Dealt to Hero [5d 3s]
e400317d: folds
ec591648: folds
Hero: folds
e14f27f8: raises $0.25 to $0.35
bce5720c: raises $0.6 to $0.95
74db4029: folds
e14f27f8: calls $0.6
*** FLOP *** [4c 9h 8d]
bce5720c: checks
e14f27f8: checks
*** TURN *** [4c 9h 8d] [Ad]
bce5720c: bets $3.83 and is all-in
e14f27f8: folds
Uncalled bet ($3.83) returned to bce5720c
*** SHOWDOWN ***
bce5720c collected $1.9 from pot
*** SUMMARY ***
Total pot $2 | Rake $0.1 | Jackpot $0 | Bingo $0 | Fortune $0 | Tax $0
Board [4c 9h 8d Ad]
Seat 1: e14f27f8 (button) folded on the Turn
Seat 2: bce5720c (small blind) won ($1.9)
Seat 3: 74db4029 (big blind) folded before Flop
Seat 4: e400317d folded before Flop (didn't bet)
Seat 5: ec591648 folded before Flop (didn't bet)
Seat 6: Hero folded before Flop (didn't bet)


Poker Hand #RC2075470758: Hold'em No Limit ($0.05/$0.1) - 2023/12/21 23:04:15
Table 'RushAndCash271706' 6-max Seat #1 is the button
Seat 1: 3adb6831 ($10 in chips)
Seat 2: 63cf109b ($10.76 in chips)
Seat 3: a7c9f06e ($10.44 in chips)
Seat 4: 2a287986 ($12.23 in chips)
Seat 5: 2dd72050 ($36.58 in chips)
Seat 6: Hero ($10.15 in chips)
63cf109b: posts small blind $0.05
a7c9f06e: posts big blind $0.1
*** HOLE CARDS ***
Dealt to 3adb6831 
Dealt to 63cf109b 
Dealt to a7c9f06e 
Dealt to 2a287986 
Dealt to 2dd72050 
Dealt to Hero [8c 5c]
2a287986: folds
2dd72050: raises $0.15 to $0.25
Hero: folds
3adb6831: folds
63cf109b: folds
a7c9f06e: calls $0.15
*** FLOP *** [9c 5h 3c]
a7c9f06e: checks
2dd72050: checks
*** TURN *** [9c 5h 3c] [4s]
a7c9f06e: checks
2dd72050: checks
*** RIVER *** [9c 5h 3c 4s] [3s]
a7c9f06e: checks
2dd72050: checks
a7c9f06e: shows [Kc Qh] (Pair of Treys)
2dd72050: shows [Ah Kd] (Pair of Treys)
*** SHOWDOWN ***
2dd72050 collected $0.53 from pot
*** SUMMARY ***
Total pot $0.55 | Rake $0.02 | Jackpot $0 | Bingo $0 | Fortune $0 | Tax $0
Board [9c 5h 3c 4s 3s]
Seat 1: 3adb6831 (button) folded before Flop (didn't bet)
Seat 2: 63cf109b (small blind) folded before Flop
Seat 3: a7c9f06e (big blind) showed [Kc Qh] and lost with Pair of Treys
Seat 4: 2a287986 folded before Flop (didn't bet)
Seat 5: 2dd72050 showed [Ah Kd] and won ($0.53) with Pair of Treys
Seat 6: Hero folded before Flop (didn't bet)


Poker Hand #RC2075470677: Hold'em No Limit ($0.05/$0.1) - 2023/12/21 23:04:11
Table 'RushAndCash271661' 6-max Seat #1 is the button
Seat 1: 626eaf5a ($26.34 in chips)
Seat 2: aaa5fdde ($10.3 in chips)
Seat 3: e5932e75 ($25.94 in chips)
Seat 4: fd721595 ($20.25 in chips)
Seat 5: a7faa182 ($11.07 in chips)
Seat 6: Hero ($10.15 in chips)
aaa5fdde: posts small blind $0.05
e5932e75: posts big blind $0.1
*** HOLE CARDS ***
Dealt to 626eaf5a 
Dealt to aaa5fdde 
Dealt to e5932e75 
Dealt to fd721595 
Dealt to a7faa182 
Dealt to Hero [2d Jd]
fd721595: raises $0.11 to $0.21
a7faa182: folds
Hero: folds
626eaf5a: raises $0.49 to $0.7
aaa5fdde: folds
e5932e75: folds
fd721595: raises $1.3 to $2
626eaf5a: folds
Uncalled bet ($1.3) returned to fd721595
*** SHOWDOWN ***
fd721595 collected $1.48 from pot
*** SUMMARY ***
Total pot $1.55 | Rake $0.07 | Jackpot $0 | Bingo $0 | Fortune $0 | Tax $0
Seat 1: 626eaf5a (button) folded before Flop
Seat 2: aaa5fdde (small blind) folded before Flop
Seat 3: e5932e75 (big blind) folded before Flop
Seat 4: fd721595 collected ($1.48)
Seat 5: a7faa182 folded before Flop (didn't bet)
Seat 6: Hero folded before Flop (didn't bet)


Poker Hand #RC2075470421: Hold'em No Limit ($0.05/$0.1) - 2023/12/21 23:03:58
Table 'RushAndCash271512' 6-max Seat #1 is the button
Seat 1: Hero ($10 in chips)
Seat 2: 8c899e9c ($17.64 in chips)
Seat 3: 273a60ae ($11.48 in chips)
Seat 4: 3147da9a ($21.22 in chips)
Seat 5: 2e53f43e ($10.43 in chips)
Seat 6: d05a1521 ($13.9 in chips)
8c899e9c: posts small blind $0.05
273a60ae: posts big blind $0.1
*** HOLE CARDS ***
Dealt to Hero [Ts Tc]
Dealt to 8c899e9c 
Dealt to 273a60ae 
Dealt to 3147da9a 
Dealt to 2e53f43e 
Dealt to d05a1521 
3147da9a: folds
2e53f43e: folds
d05a1521: folds
Hero: raises $0.15 to $0.25
8c899e9c: folds
273a60ae: folds
Uncalled bet ($0.15) returned to Hero
*** SHOWDOWN ***
Hero collected $0.25 from pot
*** SUMMARY ***
Total pot $0.25 | Rake $0 | Jackpot $0 | Bingo $0 | Fortune $0 | Tax $0
Seat 1: Hero (button) collected ($0.25)
Seat 2: 8c899e9c (small blind) folded before Flop
Seat 3: 273a60ae (big blind) folded before Flop
Seat 4: 3147da9a folded before Flop (didn't bet)
Seat 5: 2e53f43e folded before Flop (didn't bet)
Seat 6: d05a1521 folded before Flop (didn't bet)


Poker Hand #RC2075470281: Hold'em No Limit ($0.05/$0.1) - 2023/12/21 23:03:52
Table 'RushAndCash271429' 6-max Seat #1 is the button
Seat 1: fc6fa719 ($10 in chips)
Seat 2: Hero ($10 in chips)
Seat 3: b8f8f3ff ($17.99 in chips)
Seat 4: b6cbda02 ($12.71 in chips)
Seat 5: 273a60ae ($11.48 in chips)
Seat 6: 31ea123d ($10.48 in chips)
Hero: posts small blind $0.05
b8f8f3ff: posts big blind $0.1
*** HOLE CARDS ***
Dealt to fc6fa719 
Dealt to Hero [8s 3d]
Dealt to b8f8f3ff 
Dealt to b6cbda02 
Dealt to 273a60ae 
Dealt to 31ea123d 
b6cbda02: folds
273a60ae: folds
31ea123d: raises $0.12 to $0.22
fc6fa719: folds
Hero: folds
b8f8f3ff: calls $0.12
*** FLOP *** [Qd Qs Kh]
b8f8f3ff: checks
31ea123d: bets $0.17
b8f8f3ff: folds
Uncalled bet ($0.17) returned to 31ea123d
*** SHOWDOWN ***
31ea123d collected $0.47 from pot
*** SUMMARY ***
Total pot $0.49 | Rake $0.02 | Jackpot $0 | Bingo $0 | Fortune $0 | Tax $0
Board [Qd Qs Kh]
Seat 1: fc6fa719 (button) folded before Flop (didn't bet)
Seat 2: Hero (small blind) folded before Flop
Seat 3: b8f8f3ff (big blind) folded on the Flop
Seat 4: b6cbda02 folded before Flop (didn't bet)
Seat 5: 273a60ae folded before Flop (didn't bet)
Seat 6: 31ea123d won ($0.47)


Poker Hand #RC2075470126: Hold'em No Limit ($0.05/$0.1) - 2023/12/21 23:03:45
Table 'RushAndCash271338' 6-max Seat #1 is the button
Seat 1: 1974b296 ($10.12 in chips)
Seat 2: 2859beab ($32.94 in chips)
Seat 3: Hero ($10 in chips)
Seat 4: 835eed05 ($14.65 in chips)
Seat 5: ab7ba7a2 ($10.43 in chips)
Seat 6: 473378d7 ($4.01 in chips)
2859beab: posts small blind $0.05
Hero: posts big blind $0.1
*** HOLE CARDS ***
Dealt to 1974b296 
Dealt to 2859beab 
Dealt to Hero [Qh 7d]
Dealt to 835eed05 
Dealt to ab7ba7a2 
Dealt to 473378d7 
835eed05: folds
ab7ba7a2: raises $0.15 to $0.25
473378d7: calls $0.25
1974b296: folds
2859beab: folds
Hero: folds
*** FLOP *** [6h 8c 2s]
ab7ba7a2: checks
473378d7: checks
*** TURN *** [6h 8c 2s] [Qc]
ab7ba7a2: checks
473378d7: checks
*** RIVER *** [6h 8c 2s Qc] [Kd]
ab7ba7a2: checks
473378d7: checks
ab7ba7a2: shows [Ts Jh] (King-High)
473378d7: shows [8s 7s] (Pair of Eights)
*** SHOWDOWN ***
473378d7 collected $0.62 from pot
*** SUMMARY ***
Total pot $0.65 | Rake $0.03 | Jackpot $0 | Bingo $0 | Fortune $0 | Tax $0
Board [6h 8c 2s Qc Kd]
Seat 1: 1974b296 (button) folded before Flop (didn't bet)
Seat 2: 2859beab (small blind) folded before Flop
Seat 3: Hero (big blind) folded before Flop
Seat 4: 835eed05 folded before Flop (didn't bet)
Seat 5: ab7ba7a2 showed [Ts Jh] and lost with King-High
Seat 6: 473378d7 showed [8s 7s] and won ($0.62) with Pair of Eights


Poker Hand #RC2075469908: Hold'em No Limit ($0.05/$0.1) - 2023/12/21 23:03:36
Table 'RushAndCash271216' 6-max Seat #1 is the button
Seat 1: e2959f4b ($4.41 in chips)
Seat 2: 3c937e32 ($10.93 in chips)
Seat 3: 87436cf6 ($10 in chips)
Seat 4: 7ff9138c ($5.36 in chips)
Seat 5: Hero ($10 in chips)
Seat 6: 41287b65 ($16.25 in chips)
3c937e32: posts small blind $0.05
87436cf6: posts big blind $0.1
*** HOLE CARDS ***
Dealt to e2959f4b 
Dealt to 3c937e32 
Dealt to 87436cf6 
Dealt to 7ff9138c 
Dealt to Hero [Ac 7d]
Dealt to 41287b65 
7ff9138c: folds
Hero: folds
41287b65: folds
e2959f4b: folds
3c937e32: folds
Uncalled bet ($0.05) returned to 87436cf6
*** SHOWDOWN ***
87436cf6 collected $0.1 from pot
*** SUMMARY ***
Total pot $0.1 | Rake $0 | Jackpot $0 | Bingo $0 | Fortune $0 | Tax $0
Seat 1: e2959f4b (button) folded before Flop (didn't bet)
Seat 2: 3c937e32 (small blind) folded before Flop
Seat 3: 87436cf6 (big blind) collected ($0.1)
Seat 4: 7ff9138c folded before Flop (didn't bet)
Seat 5: Hero folded before Flop (didn't bet)
Seat 6: 41287b65 folded before Flop (didn't bet)


Poker Hand #RC2075468425: Hold'em No Limit ($0.05/$0.1) - 2023/12/21 23:02:30
Table 'RushAndCash270373' 6-max Seat #1 is the button
Seat 1: bea3cc55 ($9.88 in chips)
Seat 2: 53dde893 ($14.47 in chips)
Seat 3: 1a822896 ($35.23 in chips)
Seat 4: f6f7c205 ($13.39 in chips)
Seat 5: 6b0bb383 ($10.25 in chips)
Seat 6: Hero ($10 in chips)
53dde893: posts small blind $0.05
1a822896: posts big blind $0.1
*** HOLE CARDS ***
Dealt to bea3cc55 
Dealt to 53dde893 
Dealt to 1a822896 
Dealt to f6f7c205 
Dealt to 6b0bb383 
Dealt to Hero [Ac Ad]
f6f7c205: folds
6b0bb383: raises $0.1 to $0.2
Hero: raises $0.55 to $0.75
bea3cc55: folds
53dde893: folds
1a822896: folds
6b0bb383: calls $0.55
*** FLOP *** [9h Ts 4s]
6b0bb383: checks
Hero: bets $0.83
6b0bb383: raises $3.31 to $4.14
Hero: raises $5.11 to $9.25 and is all-in
6b0bb383: calls $5.11
Hero: shows [Ac Ad] (Pair of Aces)
6b0bb383: shows [Js Ks] (King-High)
*** FIRST TURN *** [9h Ts 4s] [6h]
*** FIRST RIVER *** [9h Ts 4s 6h] [4c]
*** SECOND TURN *** [9h Ts 4s] [8d]
*** SECOND RIVER *** [9h Ts 4s 8d] [7s]
*** FIRST SHOWDOWN ***
Hero collected $9.85 from pot
*** SECOND SHOWDOWN ***
6b0bb383 collected $9.75 from pot
*** SUMMARY ***
Total pot $20.15 | Rake $0.4 | Jackpot $0.15 | Bingo $0 | Fortune $0 | Tax $0
Hand was run two times
FIRST Board [9h Ts 4s 6h 4c]
SECOND Board [8d 7s]
Seat 1: bea3cc55 (button) folded before Flop (didn't bet)
Seat 2: 53dde893 (small blind) folded before Flop
Seat 3: 1a822896 (big blind) folded before Flop
Seat 4: f6f7c205 folded before Flop (didn't bet)
Seat 5: 6b0bb383 showed [Js Ks] and lost with Pair of Fours, and won ($9.75)
Seat 6: Hero showed [Ac Ad] and won ($9.85) with Pair of Aces and Pair of Fours, and lost


Poker Hand #RC2075468326: Hold'em No Limit ($0.05/$0.1) - 2023/12/21 23:02:25
Table 'RushAndCash270318' 6-max Seat #1 is the button
Seat 1: a7e691c9 ($10 in chips)
Seat 2: 980a33e9 ($13.71 in chips)
Seat 3: d8d7dbd5 ($11.86 in chips)
Seat 4: a671a659 ($32.08 in chips)
Seat 5: Hero ($10 in chips)
Seat 6: 8cb1fe0a ($12.54 in chips)
980a33e9: posts small blind $0.05
d8d7dbd5: posts big blind $0.1
*** HOLE CARDS ***
Dealt to a7e691c9 
Dealt to 980a33e9 
Dealt to d8d7dbd5 
Dealt to a671a659 
Dealt to Hero [9c Ah]
Dealt to 8cb1fe0a 
a671a659: folds
Hero: folds
8cb1fe0a: raises $0.15 to $0.25
a7e691c9: folds
980a33e9: folds
d8d7dbd5: calls $0.15
*** FLOP *** [3d 8c 4d]
d8d7dbd5: checks
8cb1fe0a: bets $0.19
d8d7dbd5: calls $0.19
*** TURN *** [3d 8c 4d] [Jd]
d8d7dbd5: checks
8cb1fe0a: checks
*** RIVER *** [3d 8c 4d Jd] [Th]
d8d7dbd5: bets $0.7
8cb1fe0a: folds
Uncalled bet ($0.7) returned to d8d7dbd5
*** SHOWDOWN ***
d8d7dbd5 collected $0.89 from pot
*** SUMMARY ***
Total pot $0.93 | Rake $0.04 | Jackpot $0 | Bingo $0 | Fortune $0 | Tax $0
Board [3d 8c 4d Jd Th]
Seat 1: a7e691c9 (button) folded before Flop (didn't bet)
Seat 2: 980a33e9 (small blind) folded before Flop
Seat 3: d8d7dbd5 (big blind) won ($0.89)
Seat 4: a671a659 folded before Flop (didn't bet)
Seat 5: Hero folded before Flop (didn't bet)
Seat 6: 8cb1fe0a folded on the River


Poker Hand #RC2075468247: Hold'em No Limit ($0.05/$0.1) - 2023/12/21 23:02:22
Table 'RushAndCash270276' 6-max Seat #1 is the button
Seat 1: ff5dbe65 ($11.19 in chips)
Seat 2: b80c627b ($10 in chips)
Seat 3: 22420f5f ($19.68 in chips)
Seat 4: Hero ($10 in chips)
Seat 5: e5932e75 ($25.46 in chips)
Seat 6: f46bf197 ($19.13 in chips)
b80c627b: posts small blind $0.05
22420f5f: posts big blind $0.1
*** HOLE CARDS ***
Dealt to ff5dbe65 
Dealt to b80c627b 
Dealt to 22420f5f 
Dealt to Hero [Jd 3d]
Dealt to e5932e75 
Dealt to f46bf197 
Hero: folds
e5932e75: raises $0.13 to $0.23
f46bf197: folds
ff5dbe65: folds
b80c627b: folds
22420f5f: folds
Uncalled bet ($0.13) returned to e5932e75
*** SHOWDOWN ***
e5932e75 collected $0.25 from pot
*** SUMMARY ***
Total pot $0.25 | Rake $0 | Jackpot $0 | Bingo $0 | Fortune $0 | Tax $0
Seat 1: ff5dbe65 (button) folded before Flop (didn't bet)
Seat 2: b80c627b (small blind) folded before Flop
Seat 3: 22420f5f (big blind) folded before Flop
Seat 4: Hero folded before Flop (didn't bet)
Seat 5: e5932e75 collected ($0.25)
Seat 6: f46bf197 folded before Flop (didn't bet)


Poker Hand #RC2075468116: Hold'em No Limit ($0.05/$0.1) - 2023/12/21 23:02:16
Table 'RushAndCash270202' 6-max Seat #1 is the button
Seat 1: Hero ($10 in chips)
Seat 2: 15699fcc ($14.17 in chips)
Seat 3: dd98cd50 ($10.56 in chips)
Seat 4: c3428d47 ($5.93 in chips)
Seat 5: 5d2618e4 ($10.48 in chips)
Seat 6: 4a5243c ($10 in chips)
15699fcc: posts small blind $0.05
dd98cd50: posts big blind $0.1
*** HOLE CARDS ***
Dealt to Hero [5c 6d]
Dealt to 15699fcc 
Dealt to dd98cd50 
Dealt to c3428d47 
Dealt to 5d2618e4 
Dealt to 4a5243c 
c3428d47: folds
5d2618e4: raises $0.15 to $0.25
4a5243c: folds
Hero: folds
15699fcc: folds
dd98cd50: folds
Uncalled bet ($0.15) returned to 5d2618e4
*** SHOWDOWN ***
5d2618e4 collected $0.25 from pot
*** SUMMARY ***
Total pot $0.25 | Rake $0 | Jackpot $0 | Bingo $0 | Fortune $0 | Tax $0
Seat 1: Hero (button) folded before Flop (didn't bet)
Seat 2: 15699fcc (small blind) folded before Flop
Seat 3: dd98cd50 (big blind) folded before Flop
Seat 4: c3428d47 folded before Flop (didn't bet)
Seat 5: 5d2618e4 collected ($0.25)
Seat 6: 4a5243c folded before Flop (didn't bet)


Poker Hand #RC2075467942: Hold'em No Limit ($0.05/$0.1) - 2023/12/21 23:02:08
Table 'RushAndCash270106' 6-max Seat #1 is the button
Seat 1: 2327e15d ($15.93 in chips)
Seat 2: Hero ($10 in chips)
Seat 3: 56730e2d ($10 in chips)
Seat 4: 6d67f55d ($28.94 in chips)
Seat 5: 3457dd2a ($11.55 in chips)
Seat 6: cb72bfdb ($23.33 in chips)
Hero: posts small blind $0.05
56730e2d: posts big blind $0.1
*** HOLE CARDS ***
Dealt to 2327e15d 
Dealt to Hero [9c Qs]
Dealt to 56730e2d 
Dealt to 6d67f55d 
Dealt to 3457dd2a 
Dealt to cb72bfdb 
6d67f55d: folds
3457dd2a: folds
cb72bfdb: folds
2327e15d: folds
Hero: folds
Uncalled bet ($0.05) returned to 56730e2d
*** SHOWDOWN ***
56730e2d collected $0.1 from pot
*** SUMMARY ***
Total pot $0.1 | Rake $0 | Jackpot $0 | Bingo $0 | Fortune $0 | Tax $0
Seat 1: 2327e15d (button) folded before Flop (didn't bet)
Seat 2: Hero (small blind) folded before Flop
Seat 3: 56730e2d (big blind) collected ($0.1)
Seat 4: 6d67f55d folded before Flop (didn't bet)
Seat 5: 3457dd2a folded before Flop (didn't bet)
Seat 6: cb72bfdb folded before Flop (didn't bet)


Poker Hand #RC2075467739: Hold'em No Limit ($0.05/$0.1) - 2023/12/21 23:01:59
Table 'RushAndCash269990' 6-max Seat #1 is the button
Seat 1: c6e3721b ($10.53 in chips)
Seat 2: 41276287 ($20.43 in chips)
Seat 3: Hero ($10 in chips)
Seat 4: 79a22c26 ($4.98 in chips)
Seat 5: bff71335 ($10.56 in chips)
Seat 6: 8bffd3fd ($12.02 in chips)
41276287: posts small blind $0.05
Hero: posts big blind $0.1
*** HOLE CARDS ***
Dealt to c6e3721b 
Dealt to 41276287 
Dealt to Hero [2c 9c]
Dealt to 79a22c26 
Dealt to bff71335 
Dealt to 8bffd3fd 
79a22c26: folds
bff71335: folds
8bffd3fd: folds
c6e3721b: raises $0.1 to $0.2
41276287: folds
Hero: folds
Uncalled bet ($0.1) returned to c6e3721b
*** SHOWDOWN ***
c6e3721b collected $0.25 from pot
*** SUMMARY ***
Total pot $0.25 | Rake $0 | Jackpot $0 | Bingo $0 | Fortune $0 | Tax $0
Seat 1: c6e3721b (button) collected ($0.25)
Seat 2: 41276287 (small blind) folded before Flop
Seat 3: Hero (big blind) folded before Flop
Seat 4: 79a22c26 folded before Flop (didn't bet)
Seat 5: bff71335 folded before Flop (didn't bet)
Seat 6: 8bffd3fd folded before Flop (didn't bet)


