Poker Hand #RC2078593605: Hold'em No Limit ($0.02/$0.05) - 2023/12/22 22:12:30
Table 'RushAndCash810662' 6-max Seat #1 is the button
Seat 1: 941f880d ($6.64 in chips)
Seat 2: e657ae1e ($5.01 in chips)
Seat 3: 45ce1aed ($7.81 in chips)
Seat 4: Hero ($5.28 in chips)
Seat 5: d23c04d ($5.21 in chips)
Seat 6: 18b6eece ($5.25 in chips)
e657ae1e: posts small blind $0.02
45ce1aed: posts big blind $0.05
*** HOLE CARDS ***
Dealt to 941f880d 
Dealt to e657ae1e 
Dealt to 45ce1aed 
Dealt to Hero [Kh Kd]
Dealt to d23c04d 
Dealt to 18b6eece 
Hero: raises $0.05 to $0.1
d23c04d: folds
18b6eece: raises $0.2 to $0.3
941f880d: folds
e657ae1e: folds
45ce1aed: folds
Hero: folds
Uncalled bet ($0.2) returned to 18b6eece
*** SHOWDOWN ***
18b6eece collected $0.26 from pot
*** SUMMARY ***
Total pot $0.27 | Rake $0.01 | Jackpot $0 | Bingo $0 | Fortune $0 | Tax $0
Seat 1: 941f880d (button) folded before Flop (didn't bet)
Seat 2: e657ae1e (small blind) folded before Flop
Seat 3: 45ce1aed (big blind) folded before Flop
Seat 4: Hero folded before Flop
Seat 5: d23c04d folded before Flop (didn't bet)
Seat 6: 18b6eece collected ($0.26)


Poker Hand #RC2078593523: Hold'em No Limit ($0.02/$0.05) - 2023/12/22 22:12:26
Table 'RushAndCash810624' 6-max Seat #1 is the button
Seat 1: Hero ($5.28 in chips)
Seat 2: 859547f3 ($5 in chips)
Seat 3: 6c7756a0 ($5.14 in chips)
Seat 4: 4f2e237f ($5.74 in chips)
Seat 5: 53ca81bf ($12.88 in chips)
Seat 6: c6b00fb7 ($5.39 in chips)
859547f3: posts small blind $0.02
6c7756a0: posts big blind $0.05
*** HOLE CARDS ***
Dealt to Hero [2d 5c]
Dealt to 859547f3 
Dealt to 6c7756a0 
Dealt to 4f2e237f 
Dealt to 53ca81bf 
Dealt to c6b00fb7 
4f2e237f: raises $0.08 to $0.13
53ca81bf: folds
c6b00fb7: folds
Hero: folds
859547f3: folds
6c7756a0: folds
Uncalled bet ($0.08) returned to 4f2e237f
*** SHOWDOWN ***
4f2e237f collected $0.12 from pot
*** SUMMARY ***
Total pot $0.12 | Rake $0 | Jackpot $0 | Bingo $0 | Fortune $0 | Tax $0
Seat 1: Hero (button) folded before Flop (didn't bet)
Seat 2: 859547f3 (small blind) folded before Flop
Seat 3: 6c7756a0 (big blind) folded before Flop
Seat 4: 4f2e237f collected ($0.12)
Seat 5: 53ca81bf folded before Flop (didn't bet)
Seat 6: c6b00fb7 folded before Flop (didn't bet)


Poker Hand #RC2078593438: Hold'em No Limit ($0.02/$0.05) - 2023/12/22 22:12:21
Table 'RushAndCash810587' 6-max Seat #1 is the button
Seat 1: 17da2929 ($5 in chips)
Seat 2: 27bbbcd5 ($5.62 in chips)
Seat 3: 3f7ed7e8 ($5.82 in chips)
Seat 4: e5b716b5 ($5 in chips)
Seat 5: Hero ($5.28 in chips)
Seat 6: 8aaa95a5 ($3.57 in chips)
27bbbcd5: posts small blind $0.02
3f7ed7e8: posts big blind $0.05
*** HOLE CARDS ***
Dealt to 17da2929 
Dealt to 27bbbcd5 
Dealt to 3f7ed7e8 
Dealt to e5b716b5 
Dealt to Hero [2h Jh]
Dealt to 8aaa95a5 
e5b716b5: folds
Hero: folds
8aaa95a5: folds
17da2929: raises $0.08 to $0.13
27bbbcd5: folds
3f7ed7e8: raises $0.37 to $0.5
17da2929: calls $0.37
*** FLOP *** [7s 4s Ts]
3f7ed7e8: bets $0.83
17da2929: folds
Uncalled bet ($0.83) returned to 3f7ed7e8
*** SHOWDOWN ***
3f7ed7e8 collected $0.97 from pot
*** SUMMARY ***
Total pot $1.02 | Rake $0.05 | Jackpot $0 | Bingo $0 | Fortune $0 | Tax $0
Board [7s 4s Ts]
Seat 1: 17da2929 (button) folded on the Flop
Seat 2: 27bbbcd5 (small blind) folded before Flop
Seat 3: 3f7ed7e8 (big blind) won ($0.97)
Seat 4: e5b716b5 folded before Flop (didn't bet)
Seat 5: Hero folded before Flop (didn't bet)
Seat 6: 8aaa95a5 folded before Flop (didn't bet)


Poker Hand #RC2078593363: Hold'em No Limit ($0.02/$0.05) - 2023/12/22 22:12:17
Table 'RushAndCash810551' 6-max Seat #1 is the button
Seat 1: 614c6639 ($5.23 in chips)
Seat 2: 32c92a7b ($5.31 in chips)
Seat 3: 90a9fad4 ($51.27 in chips)
Seat 4: Hero ($5.28 in chips)
Seat 5: 3487746e ($5.29 in chips)
Seat 6: 18d2820b ($5 in chips)
32c92a7b: posts small blind $0.02
90a9fad4: posts big blind $0.05
*** HOLE CARDS ***
Dealt to 614c6639 
Dealt to 32c92a7b 
Dealt to 90a9fad4 
Dealt to Hero [3s 4d]
Dealt to 3487746e 
Dealt to 18d2820b 
Hero: folds
3487746e: folds
18d2820b: folds
614c6639: raises $0.1 to $0.15
32c92a7b: folds
90a9fad4: folds
Uncalled bet ($0.1) returned to 614c6639
*** SHOWDOWN ***
614c6639 collected $0.12 from pot
*** SUMMARY ***
Total pot $0.12 | Rake $0 | Jackpot $0 | Bingo $0 | Fortune $0 | Tax $0
Seat 1: 614c6639 (button) collected ($0.12)
Seat 2: 32c92a7b (small blind) folded before Flop
Seat 3: 90a9fad4 (big blind) folded before Flop
Seat 4: Hero folded before Flop (didn't bet)
Seat 5: 3487746e folded before Flop (didn't bet)
Seat 6: 18d2820b folded before Flop (didn't bet)


Poker Hand #RC2078593303: Hold'em No Limit ($0.02/$0.05) - 2023/12/22 22:12:13
Table 'RushAndCash810523' 6-max Seat #1 is the button
Seat 1: 153b1345 ($6.63 in chips)
Seat 2: Hero ($5.3 in chips)
Seat 3: 2b268abe ($1.88 in chips)
Seat 4: 78333bbd ($5 in chips)
Seat 5: 90511c4f ($5.17 in chips)
Seat 6: eaeca826 ($5 in chips)
Hero: posts small blind $0.02
2b268abe: posts big blind $0.05
*** HOLE CARDS ***
Dealt to 153b1345 
Dealt to Hero [8c 5d]
Dealt to 2b268abe 
Dealt to 78333bbd 
Dealt to 90511c4f 
Dealt to eaeca826 
78333bbd: folds
90511c4f: folds
eaeca826: folds
153b1345: folds
Hero: folds
Uncalled bet ($0.03) returned to 2b268abe
*** SHOWDOWN ***
2b268abe collected $0.04 from pot
*** SUMMARY ***
Total pot $0.04 | Rake $0 | Jackpot $0 | Bingo $0 | Fortune $0 | Tax $0
Seat 1: 153b1345 (button) folded before Flop (didn't bet)
Seat 2: Hero (small blind) folded before Flop
Seat 3: 2b268abe (big blind) collected ($0.04)
Seat 4: 78333bbd folded before Flop (didn't bet)
Seat 5: 90511c4f folded before Flop (didn't bet)
Seat 6: eaeca826 folded before Flop (didn't bet)


Poker Hand #RC2078593181: Hold'em No Limit ($0.02/$0.05) - 2023/12/22 22:12:07
Table 'RushAndCash810465' 6-max Seat #1 is the button
Seat 1: 3a20c3a ($8.57 in chips)
Seat 2: 8f1a23de ($6.56 in chips)
Seat 3: Hero ($5.28 in chips)
Seat 4: c8389234 ($15.91 in chips)
Seat 5: 6b3ca2ea ($4.34 in chips)
Seat 6: 112692b6 ($5.77 in chips)
8f1a23de: posts small blind $0.02
Hero: posts big blind $0.05
*** HOLE CARDS ***
Dealt to 3a20c3a 
Dealt to 8f1a23de 
Dealt to Hero [Th 5d]
Dealt to c8389234 
Dealt to 6b3ca2ea 
Dealt to 112692b6 
c8389234: folds
6b3ca2ea: folds
112692b6: folds
3a20c3a: folds
8f1a23de: folds
Uncalled bet ($0.03) returned to Hero
*** SHOWDOWN ***
Hero collected $0.04 from pot
*** SUMMARY ***
Total pot $0.04 | Rake $0 | Jackpot $0 | Bingo $0 | Fortune $0 | Tax $0
Seat 1: 3a20c3a (button) folded before Flop (didn't bet)
Seat 2: 8f1a23de (small blind) folded before Flop
Seat 3: Hero (big blind) collected ($0.04)
Seat 4: c8389234 folded before Flop (didn't bet)
Seat 5: 6b3ca2ea folded before Flop (didn't bet)
Seat 6: 112692b6 folded before Flop (didn't bet)


Poker Hand #RC2078593108: Hold'em No Limit ($0.02/$0.05) - 2023/12/22 22:12:03
Table 'RushAndCash810432' 6-max Seat #1 is the button
Seat 1: 9a865ca9 ($5.56 in chips)
Seat 2: eadbd152 ($5.59 in chips)
Seat 3: d0b2d784 ($9.05 in chips)
Seat 4: bf28a393 ($4.58 in chips)
Seat 5: Hero ($5.28 in chips)
Seat 6: d32741ba ($5.83 in chips)
eadbd152: posts small blind $0.02
d0b2d784: posts big blind $0.05
*** HOLE CARDS ***
Dealt to 9a865ca9 
Dealt to eadbd152 
Dealt to d0b2d784 
Dealt to bf28a393 
Dealt to Hero [5h 2d]
Dealt to d32741ba 
bf28a393: folds
Hero: folds
d32741ba: folds
9a865ca9: raises $0.05 to $0.1
eadbd152: folds
d0b2d784: folds
Uncalled bet ($0.05) returned to 9a865ca9
*** SHOWDOWN ***
9a865ca9 collected $0.12 from pot
*** SUMMARY ***
Total pot $0.12 | Rake $0 | Jackpot $0 | Bingo $0 | Fortune $0 | Tax $0
Seat 1: 9a865ca9 (button) collected ($0.12)
Seat 2: eadbd152 (small blind) folded before Flop
Seat 3: d0b2d784 (big blind) folded before Flop
Seat 4: bf28a393 folded before Flop (didn't bet)
Seat 5: Hero folded before Flop (didn't bet)
Seat 6: d32741ba folded before Flop (didn't bet)


Poker Hand #RC2078593044: Hold'em No Limit ($0.02/$0.05) - 2023/12/22 22:11:59
Table 'RushAndCash810403' 6-max Seat #1 is the button
Seat 1: 6659feae ($5.69 in chips)
Seat 2: cbfe1acc ($4.8 in chips)
Seat 3: ed53cde8 ($8.75 in chips)
Seat 4: d6c4e270 ($3.32 in chips)
Seat 5: 19d300cc ($12.15 in chips)
Seat 6: Hero ($5.28 in chips)
cbfe1acc: posts small blind $0.02
ed53cde8: posts big blind $0.05
*** HOLE CARDS ***
Dealt to 6659feae 
Dealt to cbfe1acc 
Dealt to ed53cde8 
Dealt to d6c4e270 
Dealt to 19d300cc 
Dealt to Hero [3c 4c]
d6c4e270: folds
19d300cc: folds
Hero: folds
6659feae: folds
cbfe1acc: raises $0.08 to $0.13
ed53cde8: folds
Uncalled bet ($0.08) returned to cbfe1acc
*** SHOWDOWN ***
cbfe1acc collected $0.1 from pot
*** SUMMARY ***
Total pot $0.1 | Rake $0 | Jackpot $0 | Bingo $0 | Fortune $0 | Tax $0
Seat 1: 6659feae (button) folded before Flop (didn't bet)
Seat 2: cbfe1acc (small blind) collected ($0.1)
Seat 3: ed53cde8 (big blind) folded before Flop
Seat 4: d6c4e270 folded before Flop (didn't bet)
Seat 5: 19d300cc folded before Flop (didn't bet)
Seat 6: Hero folded before Flop (didn't bet)


Poker Hand #RC2078592972: Hold'em No Limit ($0.02/$0.05) - 2023/12/22 22:11:55
Table 'RushAndCash810373' 6-max Seat #1 is the button
Seat 1: Hero ($5.28 in chips)
Seat 2: 1fbf4612 ($4.95 in chips)
Seat 3: eeb37e34 ($7.55 in chips)
Seat 4: cfc8d200 ($9.19 in chips)
Seat 5: 9ffc9c0 ($3.16 in chips)
Seat 6: 756c67e1 ($5.52 in chips)
1fbf4612: posts small blind $0.02
eeb37e34: posts big blind $0.05
*** HOLE CARDS ***
Dealt to Hero [2d Qd]
Dealt to 1fbf4612 
Dealt to eeb37e34 
Dealt to cfc8d200 
Dealt to 9ffc9c0 
Dealt to 756c67e1 
cfc8d200: folds
9ffc9c0: folds
756c67e1: folds
Hero: folds
1fbf4612: folds
Uncalled bet ($0.03) returned to eeb37e34
*** SHOWDOWN ***
eeb37e34 collected $0.04 from pot
*** SUMMARY ***
Total pot $0.04 | Rake $0 | Jackpot $0 | Bingo $0 | Fortune $0 | Tax $0
Seat 1: Hero (button) folded before Flop (didn't bet)
Seat 2: 1fbf4612 (small blind) folded before Flop
Seat 3: eeb37e34 (big blind) collected ($0.04)
Seat 4: cfc8d200 folded before Flop (didn't bet)
Seat 5: 9ffc9c0 folded before Flop (didn't bet)
Seat 6: 756c67e1 folded before Flop (didn't bet)


Poker Hand #RC2078592910: Hold'em No Limit ($0.02/$0.05) - 2023/12/22 22:11:51
Table 'RushAndCash810348' 6-max Seat #1 is the button
Seat 1: 4a6135fa ($4.37 in chips)
Seat 2: 50bc8c43 ($4.03 in chips)
Seat 3: d72b572 ($4.83 in chips)
Seat 4: a78fec7d ($3.64 in chips)
Seat 5: f1f11b26 ($10.3 in chips)
Seat 6: Hero ($5.28 in chips)
50bc8c43: posts small blind $0.02
d72b572: posts big blind $0.05
*** HOLE CARDS ***
Dealt to 4a6135fa 
Dealt to 50bc8c43 
Dealt to d72b572 
Dealt to a78fec7d 
Dealt to f1f11b26 
Dealt to Hero [2d Tc]
a78fec7d: folds
f1f11b26: folds
Hero: folds
4a6135fa: folds
50bc8c43: calls $0.03
d72b572: checks
*** FLOP *** [5s Qd 2c]
50bc8c43: bets $0.05
d72b572: raises $0.15 to $0.2
50bc8c43: calls $0.15
*** TURN *** [5s Qd 2c] [7s]
50bc8c43: checks
d72b572: bets $0.25
50bc8c43: folds
Uncalled bet ($0.25) returned to d72b572
*** SHOWDOWN ***
d72b572 collected $0.48 from pot
*** SUMMARY ***
Total pot $0.5 | Rake $0.02 | Jackpot $0 | Bingo $0 | Fortune $0 | Tax $0
Board [5s Qd 2c 7s]
Seat 1: 4a6135fa (button) folded before Flop (didn't bet)
Seat 2: 50bc8c43 (small blind) folded on the Turn
Seat 3: d72b572 (big blind) won ($0.48)
Seat 4: a78fec7d folded before Flop (didn't bet)
Seat 5: f1f11b26 folded before Flop (didn't bet)
Seat 6: Hero folded before Flop (didn't bet)


Poker Hand #RC2078592753: Hold'em No Limit ($0.02/$0.05) - 2023/12/22 22:11:42
Table 'RushAndCash810285' 6-max Seat #1 is the button
Seat 1: beea6e5f ($9.01 in chips)
Seat 2: c90c0909 ($5.3 in chips)
Seat 3: 471859f5 ($5.96 in chips)
Seat 4: Hero ($5.28 in chips)
Seat 5: 8626eae9 ($6.78 in chips)
Seat 6: 9b5806d5 ($3.5 in chips)
c90c0909: posts small blind $0.02
471859f5: posts big blind $0.05
*** HOLE CARDS ***
Dealt to beea6e5f 
Dealt to c90c0909 
Dealt to 471859f5 
Dealt to Hero [Kh 4h]
Dealt to 8626eae9 
Dealt to 9b5806d5 
Hero: folds
8626eae9: folds
9b5806d5: raises $0.07 to $0.12
beea6e5f: folds
c90c0909: folds
471859f5: folds
Uncalled bet ($0.07) returned to 9b5806d5
*** SHOWDOWN ***
9b5806d5 collected $0.12 from pot
*** SUMMARY ***
Total pot $0.12 | Rake $0 | Jackpot $0 | Bingo $0 | Fortune $0 | Tax $0
Seat 1: beea6e5f (button) folded before Flop (didn't bet)
Seat 2: c90c0909 (small blind) folded before Flop
Seat 3: 471859f5 (big blind) folded before Flop
Seat 4: Hero folded before Flop (didn't bet)
Seat 5: 8626eae9 folded before Flop (didn't bet)
Seat 6: 9b5806d5 collected ($0.12)


Poker Hand #RC2078592560: Hold'em No Limit ($0.02/$0.05) - 2023/12/22 22:11:31
Table 'RushAndCash810198' 6-max Seat #1 is the button
Seat 1: bb97799 ($5.14 in chips)
Seat 2: 317ccf77 ($4.19 in chips)
Seat 3: Hero ($5.33 in chips)
Seat 4: 23c96099 ($8.28 in chips)
Seat 5: ac4c4fe3 ($6.42 in chips)
Seat 6: e7ed98a7 ($5 in chips)
317ccf77: posts small blind $0.02
Hero: posts big blind $0.05
*** HOLE CARDS ***
Dealt to bb97799 
Dealt to 317ccf77 
Dealt to Hero [8d 6c]
Dealt to 23c96099 
Dealt to ac4c4fe3 
Dealt to e7ed98a7 
23c96099: folds
ac4c4fe3: folds
e7ed98a7: folds
bb97799: raises $0.09 to $0.14
317ccf77: folds
Hero: folds
Uncalled bet ($0.09) returned to bb97799
*** SHOWDOWN ***
bb97799 collected $0.12 from pot
*** SUMMARY ***
Total pot $0.12 | Rake $0 | Jackpot $0 | Bingo $0 | Fortune $0 | Tax $0
Seat 1: bb97799 (button) collected ($0.12)
Seat 2: 317ccf77 (small blind) folded before Flop
Seat 3: Hero (big blind) folded before Flop
Seat 4: 23c96099 folded before Flop (didn't bet)
Seat 5: ac4c4fe3 folded before Flop (didn't bet)
Seat 6: e7ed98a7 folded before Flop (didn't bet)


Poker Hand #RC2078592494: Hold'em No Limit ($0.02/$0.05) - 2023/12/22 22:11:27
Table 'RushAndCash810167' 6-max Seat #1 is the button
Seat 1: 6ded132b ($13.24 in chips)
Seat 2: 491e69f2 ($12.64 in chips)
Seat 3: c70a390e ($6.18 in chips)
Seat 4: 2310f034 ($6.79 in chips)
Seat 5: 6e0be8e1 ($5.07 in chips)
Seat 6: Hero ($5.33 in chips)
491e69f2: posts small blind $0.02
c70a390e: posts big blind $0.05
*** HOLE CARDS ***
Dealt to 6ded132b 
Dealt to 491e69f2 
Dealt to c70a390e 
Dealt to 2310f034 
Dealt to 6e0be8e1 
Dealt to Hero [4d Th]
2310f034: folds
6e0be8e1: folds
Hero: folds
6ded132b: folds
491e69f2: folds
Uncalled bet ($0.03) returned to c70a390e
*** SHOWDOWN ***
c70a390e collected $0.04 from pot
*** SUMMARY ***
Total pot $0.04 | Rake $0 | Jackpot $0 | Bingo $0 | Fortune $0 | Tax $0
Seat 1: 6ded132b (button) folded before Flop (didn't bet)
Seat 2: 491e69f2 (small blind) folded before Flop
Seat 3: c70a390e (big blind) collected ($0.04)
Seat 4: 2310f034 folded before Flop (didn't bet)
Seat 5: 6e0be8e1 folded before Flop (didn't bet)
Seat 6: Hero folded before Flop (didn't bet)


Poker Hand #RC2078592433: Hold'em No Limit ($0.02/$0.05) - 2023/12/22 22:11:23
Table 'RushAndCash810142' 6-max Seat #1 is the button
Seat 1: Hero ($5.33 in chips)
Seat 2: ee19881a ($5 in chips)
Seat 3: 491e69f2 ($12.69 in chips)
Seat 4: d79b0c6a ($5.82 in chips)
Seat 5: f7ec5082 ($5 in chips)
Seat 6: e519a9e8 ($14.79 in chips)
ee19881a: posts small blind $0.02
491e69f2: posts big blind $0.05
*** HOLE CARDS ***
Dealt to Hero [4s 9h]
Dealt to ee19881a 
Dealt to 491e69f2 
Dealt to d79b0c6a 
Dealt to f7ec5082 
Dealt to e519a9e8 
d79b0c6a: folds
f7ec5082: folds
e519a9e8: raises $0.05 to $0.1
Hero: folds
ee19881a: calls $0.08
491e69f2: folds
*** FLOP *** [8h Th 2s]
ee19881a: checks
e519a9e8: bets $0.13
ee19881a: raises $0.46 to $0.59
e519a9e8: folds
Uncalled bet ($0.46) returned to ee19881a
*** SHOWDOWN ***
ee19881a collected $0.49 from pot
*** SUMMARY ***
Total pot $0.51 | Rake $0.02 | Jackpot $0 | Bingo $0 | Fortune $0 | Tax $0
Board [8h Th 2s]
Seat 1: Hero (button) folded before Flop (didn't bet)
Seat 2: ee19881a (small blind) won ($0.49)
Seat 3: 491e69f2 (big blind) folded before Flop
Seat 4: d79b0c6a folded before Flop (didn't bet)
Seat 5: f7ec5082 folded before Flop (didn't bet)
Seat 6: e519a9e8 folded on the Flop


Poker Hand #RC2078592131: Hold'em No Limit ($0.02/$0.05) - 2023/12/22 22:11:05
Table 'RushAndCash810003' 6-max Seat #1 is the button
Seat 1: 3696f71e ($5 in chips)
Seat 2: Hero ($5.35 in chips)
Seat 3: f57c6794 ($7.06 in chips)
Seat 4: bb97799 ($5 in chips)
Seat 5: 4e925dd0 ($8.25 in chips)
Seat 6: b01c40bf ($18.07 in chips)
Hero: posts small blind $0.02
f57c6794: posts big blind $0.05
*** HOLE CARDS ***
Dealt to 3696f71e 
Dealt to Hero [Qh Jc]
Dealt to f57c6794 
Dealt to bb97799 
Dealt to 4e925dd0 
Dealt to b01c40bf 
bb97799: folds
4e925dd0: folds
b01c40bf: raises $0.05 to $0.1
3696f71e: raises $0.25 to $0.35
Hero: folds
f57c6794: calls $0.3
b01c40bf: calls $0.25
*** FLOP *** [Td 6d 5s]
f57c6794: checks
b01c40bf: checks
3696f71e: checks
*** TURN *** [Td 6d 5s] [7c]
f57c6794: checks
b01c40bf: bets $0.3
3696f71e: folds
f57c6794: folds
Uncalled bet ($0.3) returned to b01c40bf
*** SHOWDOWN ***
b01c40bf collected $1.02 from pot
*** SUMMARY ***
Total pot $1.07 | Rake $0.05 | Jackpot $0 | Bingo $0 | Fortune $0 | Tax $0
Board [Td 6d 5s 7c]
Seat 1: 3696f71e (button) folded on the Turn
Seat 2: Hero (small blind) folded before Flop
Seat 3: f57c6794 (big blind) folded on the Turn
Seat 4: bb97799 folded before Flop (didn't bet)
Seat 5: 4e925dd0 folded before Flop (didn't bet)
Seat 6: b01c40bf won ($1.02)


Poker Hand #RC2078592066: Hold'em No Limit ($0.02/$0.05) - 2023/12/22 22:11:02
Table 'RushAndCash809973' 6-max Seat #1 is the button
Seat 1: Hero ($5.35 in chips)
Seat 2: 3696f71e ($5 in chips)
Seat 3: 34d04947 ($5.16 in chips)
Seat 4: e318b89b ($4.99 in chips)
Seat 5: 6c75362e ($11.36 in chips)
Seat 6: d16d9b7 ($5 in chips)
3696f71e: posts small blind $0.02
34d04947: posts big blind $0.05
*** HOLE CARDS ***
Dealt to Hero [2c Jh]
Dealt to 3696f71e 
Dealt to 34d04947 
Dealt to e318b89b 
Dealt to 6c75362e 
Dealt to d16d9b7 
e318b89b: raises $0.1 to $0.15
6c75362e: calls $0.15
d16d9b7: folds
Hero: folds
3696f71e: folds
34d04947: calls $0.1
*** FLOP *** [Ts 9d 7h]
34d04947: checks
e318b89b: bets $0.24
6c75362e: folds
34d04947: folds
Uncalled bet ($0.24) returned to e318b89b
*** SHOWDOWN ***
e318b89b collected $0.45 from pot
*** SUMMARY ***
Total pot $0.47 | Rake $0.02 | Jackpot $0 | Bingo $0 | Fortune $0 | Tax $0
Board [Ts 9d 7h]
Seat 1: Hero (button) folded before Flop (didn't bet)
Seat 2: 3696f71e (small blind) folded before Flop
Seat 3: 34d04947 (big blind) folded on the Flop
Seat 4: e318b89b won ($0.45)
Seat 5: 6c75362e folded on the Flop
Seat 6: d16d9b7 folded before Flop (didn't bet)


Poker Hand #RC2078591912: Hold'em No Limit ($0.02/$0.05) - 2023/12/22 22:10:53
Table 'RushAndCash809901' 6-max Seat #1 is the button
Seat 1: d6dcfaa3 ($5.31 in chips)
Seat 2: Hero ($5.37 in chips)
Seat 3: 1e3d103d ($7.95 in chips)
Seat 4: 3e86bdc7 ($6.4 in chips)
Seat 5: 78c7aa39 ($5.31 in chips)
Seat 6: 1a943c52 ($3.86 in chips)
Hero: posts small blind $0.02
1e3d103d: posts big blind $0.05
*** HOLE CARDS ***
Dealt to d6dcfaa3 
Dealt to Hero [Kd 8d]
Dealt to 1e3d103d 
Dealt to 3e86bdc7 
Dealt to 78c7aa39 
Dealt to 1a943c52 
3e86bdc7: folds
78c7aa39: folds
1a943c52: folds
d6dcfaa3: raises $0.08 to $0.13
Hero: folds
1e3d103d: raises $0.37 to $0.5
d6dcfaa3: folds
Uncalled bet ($0.37) returned to 1e3d103d
*** SHOWDOWN ***
1e3d103d collected $0.27 from pot
*** SUMMARY ***
Total pot $0.28 | Rake $0.01 | Jackpot $0 | Bingo $0 | Fortune $0 | Tax $0
Seat 1: d6dcfaa3 (button) folded before Flop
Seat 2: Hero (small blind) folded before Flop
Seat 3: 1e3d103d (big blind) collected ($0.27)
Seat 4: 3e86bdc7 folded before Flop (didn't bet)
Seat 5: 78c7aa39 folded before Flop (didn't bet)
Seat 6: 1a943c52 folded before Flop (didn't bet)


Poker Hand #RC2078591254: Hold'em No Limit ($0.02/$0.05) - 2023/12/22 22:10:15
Table 'RushAndCash809596' 6-max Seat #1 is the button
Seat 1: 78624e82 ($5.52 in chips)
Seat 2: 32c92a7b ($5.47 in chips)
Seat 3: Hero ($5 in chips)
Seat 4: f06064a0 ($6.18 in chips)
Seat 5: 5dc5e04c ($6.63 in chips)
Seat 6: 90f6987a ($4.25 in chips)
32c92a7b: posts small blind $0.02
Hero: posts big blind $0.05
*** HOLE CARDS ***
Dealt to 78624e82 
Dealt to 32c92a7b 
Dealt to Hero [Jc 5c]
Dealt to f06064a0 
Dealt to 5dc5e04c 
Dealt to 90f6987a 
f06064a0: folds
5dc5e04c: folds
90f6987a: folds
78624e82: raises $0.08 to $0.13
32c92a7b: folds
Hero: calls $0.08
*** FLOP *** [Js Th Qd]
Hero: checks
78624e82: bets $0.1
Hero: calls $0.1
*** TURN *** [Js Th Qd] [9h]
Hero: checks
78624e82: checks
*** RIVER *** [Js Th Qd 9h] [3s]
Hero: bets $0.16
78624e82: calls $0.16
Hero: shows [Jc 5c] (Pair of Jacks)
78624e82: shows [Td Ad] (Pair of Tens)
*** SHOWDOWN ***
Hero collected $0.76 from pot
*** SUMMARY ***
Total pot $0.8 | Rake $0.04 | Jackpot $0 | Bingo $0 | Fortune $0 | Tax $0
Board [Js Th Qd 9h 3s]
Seat 1: 78624e82 (button) showed [Td Ad] and lost with Pair of Tens
Seat 2: 32c92a7b (small blind) folded before Flop
Seat 3: Hero (big blind) showed [Jc 5c] and won ($0.76) with Pair of Jacks
Seat 4: f06064a0 folded before Flop (didn't bet)
Seat 5: 5dc5e04c folded before Flop (didn't bet)
Seat 6: 90f6987a folded before Flop (didn't bet)


Poker Hand #RC2078591189: Hold'em No Limit ($0.02/$0.05) - 2023/12/22 22:10:11
Table 'RushAndCash809566' 6-max Seat #1 is the button
Seat 1: 45ce1aed ($8.07 in chips)
Seat 2: 596eacad ($8.11 in chips)
Seat 3: de92dca7 ($5 in chips)
Seat 4: Hero ($5 in chips)
Seat 5: ed816c3f ($5 in chips)
Seat 6: f57c6794 ($6.99 in chips)
596eacad: posts small blind $0.02
de92dca7: posts big blind $0.05
*** HOLE CARDS ***
Dealt to 45ce1aed 
Dealt to 596eacad 
Dealt to de92dca7 
Dealt to Hero [6s Qh]
Dealt to ed816c3f 
Dealt to f57c6794 
Hero: folds
ed816c3f: folds
f57c6794: raises $0.1 to $0.15
45ce1aed: folds
596eacad: folds
de92dca7: folds
Uncalled bet ($0.1) returned to f57c6794
*** SHOWDOWN ***
f57c6794 collected $0.12 from pot
*** SUMMARY ***
Total pot $0.12 | Rake $0 | Jackpot $0 | Bingo $0 | Fortune $0 | Tax $0
Seat 1: 45ce1aed (button) folded before Flop (didn't bet)
Seat 2: 596eacad (small blind) folded before Flop
Seat 3: de92dca7 (big blind) folded before Flop
Seat 4: Hero folded before Flop (didn't bet)
Seat 5: ed816c3f folded before Flop (didn't bet)
Seat 6: f57c6794 collected ($0.12)


Poker Hand #RC2078591119: Hold'em No Limit ($0.02/$0.05) - 2023/12/22 22:10:07
Table 'RushAndCash809533' 6-max Seat #1 is the button
Seat 1: fa93749b ($7.72 in chips)
Seat 2: 1e6e058c ($12.22 in chips)
Seat 3: 8f240b5e ($9.08 in chips)
Seat 4: 5dc5e04c ($6.63 in chips)
Seat 5: Hero ($5 in chips)
Seat 6: 73f9c9d7 ($5 in chips)
1e6e058c: posts small blind $0.02
8f240b5e: posts big blind $0.05
*** HOLE CARDS ***
Dealt to fa93749b 
Dealt to 1e6e058c 
Dealt to 8f240b5e 
Dealt to 5dc5e04c 
Dealt to Hero [4s 5h]
Dealt to 73f9c9d7 
5dc5e04c: folds
Hero: folds
73f9c9d7: folds
fa93749b: raises $0.07 to $0.12
1e6e058c: folds
8f240b5e: folds
Uncalled bet ($0.07) returned to fa93749b
*** SHOWDOWN ***
fa93749b collected $0.12 from pot
*** SUMMARY ***
Total pot $0.12 | Rake $0 | Jackpot $0 | Bingo $0 | Fortune $0 | Tax $0
Seat 1: fa93749b (button) collected ($0.12)
Seat 2: 1e6e058c (small blind) folded before Flop
Seat 3: 8f240b5e (big blind) folded before Flop
Seat 4: 5dc5e04c folded before Flop (didn't bet)
Seat 5: Hero folded before Flop (didn't bet)
Seat 6: 73f9c9d7 folded before Flop (didn't bet)


Poker Hand #RC2078590926: Hold'em No Limit ($0.02/$0.05) - 2023/12/22 22:09:55
Table 'RushAndCash809447' 6-max Seat #1 is the button
Seat 1: 7095bc76 ($5.52 in chips)
Seat 2: e519a9e8 ($14.86 in chips)
Seat 3: f57c6794 ($7.04 in chips)
Seat 4: def6b062 ($5.48 in chips)
Seat 5: 6c7756a0 ($5 in chips)
Seat 6: Hero ($5 in chips)
e519a9e8: posts small blind $0.02
f57c6794: posts big blind $0.05
*** HOLE CARDS ***
Dealt to 7095bc76 
Dealt to e519a9e8 
Dealt to f57c6794 
Dealt to def6b062 
Dealt to 6c7756a0 
Dealt to Hero [9d 7d]
def6b062: raises $0.07 to $0.12
6c7756a0: folds
Hero: folds
7095bc76: calls $0.12
e519a9e8: folds
f57c6794: folds
*** FLOP *** [Kh Kd 6c]
def6b062: checks
7095bc76: checks
*** TURN *** [Kh Kd 6c] [9h]
def6b062: checks
7095bc76: checks
*** RIVER *** [Kh Kd 6c 9h] [7c]
def6b062: bets $0.24
7095bc76: folds
Uncalled bet ($0.24) returned to def6b062
*** SHOWDOWN ***
def6b062 collected $0.3 from pot
*** SUMMARY ***
Total pot $0.31 | Rake $0.01 | Jackpot $0 | Bingo $0 | Fortune $0 | Tax $0
Board [Kh Kd 6c 9h 7c]
Seat 1: 7095bc76 (button) folded on the River
Seat 2: e519a9e8 (small blind) folded before Flop
Seat 3: f57c6794 (big blind) folded before Flop
Seat 4: def6b062 won ($0.3)
Seat 5: 6c7756a0 folded before Flop (didn't bet)
Seat 6: Hero folded before Flop (didn't bet)


Poker Hand #RC2078590213: Hold'em No Limit ($0.02/$0.05) - 2023/12/22 22:09:14
Table 'RushAndCash809121' 6-max Seat #1 is the button
Seat 1: Hero ($5 in chips)
Seat 2: 6fb5b8 ($5.54 in chips)
Seat 3: 5dc5e04c ($6.51 in chips)
Seat 4: 1259a422 ($8.03 in chips)
Seat 5: 19915c5a ($11.15 in chips)
Seat 6: eeb37e34 ($7.92 in chips)
6fb5b8: posts small blind $0.02
5dc5e04c: posts big blind $0.05
*** HOLE CARDS ***
Dealt to Hero [Tc Qc]
Dealt to 6fb5b8 
Dealt to 5dc5e04c 
Dealt to 1259a422 
Dealt to 19915c5a 
Dealt to eeb37e34 
1259a422: folds
19915c5a: folds
eeb37e34: folds
Hero: raises $0.08 to $0.13
6fb5b8: folds
5dc5e04c: calls $0.08
*** FLOP *** [Ad Jd Td]
5dc5e04c: checks
Hero: checks
*** TURN *** [Ad Jd Td] [9d]
5dc5e04c: checks
Hero: checks
*** RIVER *** [Ad Jd Td 9d] [7h]
5dc5e04c: checks
Hero: checks
5dc5e04c: shows [2s Ah] (Pair of Aces)
Hero: shows [Tc Qc] (Pair of Tens)
*** SHOWDOWN ***
5dc5e04c collected $0.27 from pot
*** SUMMARY ***
Total pot $0.28 | Rake $0.01 | Jackpot $0 | Bingo $0 | Fortune $0 | Tax $0
Board [Ad Jd Td 9d 7h]
Seat 1: Hero (button) showed [Tc Qc] and lost with Pair of Tens
Seat 2: 6fb5b8 (small blind) folded before Flop
Seat 3: 5dc5e04c (big blind) showed [2s Ah] and won ($0.27) with Pair of Aces
Seat 4: 1259a422 folded before Flop (didn't bet)
Seat 5: 19915c5a folded before Flop (didn't bet)
Seat 6: eeb37e34 folded before Flop (didn't bet)


Poker Hand #RC2078590045: Hold'em No Limit ($0.02/$0.05) - 2023/12/22 22:09:04
Table 'RushAndCash809049' 6-max Seat #1 is the button
Seat 1: 9b0ec3a ($20.34 in chips)
Seat 2: Hero ($5.02 in chips)
Seat 3: 7b8defcb ($4.82 in chips)
Seat 4: fe92c523 ($5.45 in chips)
Seat 5: 64f7e138 ($12.05 in chips)
Seat 6: c70a390e ($6.19 in chips)
Hero: posts small blind $0.02
7b8defcb: posts big blind $0.05
*** HOLE CARDS ***
Dealt to 9b0ec3a 
Dealt to Hero [7c Qs]
Dealt to 7b8defcb 
Dealt to fe92c523 
Dealt to 64f7e138 
Dealt to c70a390e 
fe92c523: folds
64f7e138: folds
c70a390e: folds
9b0ec3a: raises $0.08 to $0.13
Hero: folds
7b8defcb: folds
Uncalled bet ($0.08) returned to 9b0ec3a
*** SHOWDOWN ***
9b0ec3a collected $0.12 from pot
*** SUMMARY ***
Total pot $0.12 | Rake $0 | Jackpot $0 | Bingo $0 | Fortune $0 | Tax $0
Seat 1: 9b0ec3a (button) collected ($0.12)
Seat 2: Hero (small blind) folded before Flop
Seat 3: 7b8defcb (big blind) folded before Flop
Seat 4: fe92c523 folded before Flop (didn't bet)
Seat 5: 64f7e138 folded before Flop (didn't bet)
Seat 6: c70a390e folded before Flop (didn't bet)


Poker Hand #RC2078589891: Hold'em No Limit ($0.02/$0.05) - 2023/12/22 22:08:56
Table 'RushAndCash808981' 6-max Seat #1 is the button
Seat 1: 2e11c0b5 ($6.54 in chips)
Seat 2: bcb60fa0 ($2 in chips)
Seat 3: Hero ($5 in chips)
Seat 4: 3a20c3a ($8.96 in chips)
Seat 5: 6e0be8e1 ($5 in chips)
Seat 6: 35d3ab0e ($4.75 in chips)
bcb60fa0: posts small blind $0.02
Hero: posts big blind $0.05
*** HOLE CARDS ***
Dealt to 2e11c0b5 
Dealt to bcb60fa0 
Dealt to Hero [7d 4d]
Dealt to 3a20c3a 
Dealt to 6e0be8e1 
Dealt to 35d3ab0e 
3a20c3a: folds
6e0be8e1: folds
35d3ab0e: folds
2e11c0b5: folds
bcb60fa0: folds
Uncalled bet ($0.03) returned to Hero
*** SHOWDOWN ***
Hero collected $0.04 from pot
*** SUMMARY ***
Total pot $0.04 | Rake $0 | Jackpot $0 | Bingo $0 | Fortune $0 | Tax $0
Seat 1: 2e11c0b5 (button) folded before Flop (didn't bet)
Seat 2: bcb60fa0 (small blind) folded before Flop
Seat 3: Hero (big blind) collected ($0.04)
Seat 4: 3a20c3a folded before Flop (didn't bet)
Seat 5: 6e0be8e1 folded before Flop (didn't bet)
Seat 6: 35d3ab0e folded before Flop (didn't bet)


Poker Hand #RC2078589819: Hold'em No Limit ($0.02/$0.05) - 2023/12/22 22:08:52
Table 'RushAndCash808948' 6-max Seat #1 is the button
Seat 1: 7aec2951 ($5.29 in chips)
Seat 2: 2e11c0b5 ($6.56 in chips)
Seat 3: d4d7018e ($5.41 in chips)
Seat 4: c12643c8 ($5 in chips)
Seat 5: e8ce7aba ($5.07 in chips)
Seat 6: Hero ($5 in chips)
2e11c0b5: posts small blind $0.02
d4d7018e: posts big blind $0.05
*** HOLE CARDS ***
Dealt to 7aec2951 
Dealt to 2e11c0b5 
Dealt to d4d7018e 
Dealt to c12643c8 
Dealt to e8ce7aba 
Dealt to Hero [Kc 2s]
c12643c8: folds
e8ce7aba: folds
Hero: folds
7aec2951: raises $0.05 to $0.1
2e11c0b5: folds
d4d7018e: calls $0.05
*** FLOP *** [3h 8h Qd]
d4d7018e: checks
7aec2951: bets $0.08
d4d7018e: folds
Uncalled bet ($0.08) returned to 7aec2951
*** SHOWDOWN ***
7aec2951 collected $0.21 from pot
*** SUMMARY ***
Total pot $0.22 | Rake $0.01 | Jackpot $0 | Bingo $0 | Fortune $0 | Tax $0
Board [3h 8h Qd]
Seat 1: 7aec2951 (button) won ($0.21)
Seat 2: 2e11c0b5 (small blind) folded before Flop
Seat 3: d4d7018e (big blind) folded on the Flop
Seat 4: c12643c8 folded before Flop (didn't bet)
Seat 5: e8ce7aba folded before Flop (didn't bet)
Seat 6: Hero folded before Flop (didn't bet)


Poker Hand #RC2078589068: Hold'em No Limit ($0.02/$0.05) - 2023/12/22 22:08:09
Table 'RushAndCash808601' 6-max Seat #1 is the button
Seat 1: c3c9a58d ($20.28 in chips)
Seat 2: f702b95b ($8.96 in chips)
Seat 3: 1d0d69cf ($5.1 in chips)
Seat 4: 725fcf25 ($14.36 in chips)
Seat 5: 90b5844 ($6.51 in chips)
Seat 6: Hero ($5.5 in chips)
f702b95b: posts small blind $0.02
1d0d69cf: posts big blind $0.05
*** HOLE CARDS ***
Dealt to c3c9a58d 
Dealt to f702b95b 
Dealt to 1d0d69cf 
Dealt to 725fcf25 
Dealt to 90b5844 
Dealt to Hero [Qc Qh]
725fcf25: raises $0.05 to $0.1
90b5844: folds
Hero: raises $0.27 to $0.37
c3c9a58d: folds
f702b95b: folds
1d0d69cf: folds
725fcf25: calls $0.27
*** FLOP *** [6d 2d As]
725fcf25: checks
Hero: bets $0.27
725fcf25: calls $0.27
*** TURN *** [6d 2d As] [9s]
725fcf25: checks
Hero: checks
*** RIVER *** [6d 2d As 9s] [Jh]
725fcf25: checks
Hero: checks
725fcf25: shows [Kd Kc] (Pair of Kings)
Hero: shows [Qc Qh] (Pair of Queens)
*** SHOWDOWN ***
725fcf25 collected $1.29 from pot
*** SUMMARY ***
Total pot $1.35 | Rake $0.06 | Jackpot $0 | Bingo $0 | Fortune $0 | Tax $0
Board [6d 2d As 9s Jh]
Seat 1: c3c9a58d (button) folded before Flop (didn't bet)
Seat 2: f702b95b (small blind) folded before Flop
Seat 3: 1d0d69cf (big blind) folded before Flop
Seat 4: 725fcf25 showed [Kd Kc] and won ($1.29) with Pair of Kings
Seat 5: 90b5844 folded before Flop (didn't bet)
Seat 6: Hero showed [Qc Qh] and lost with Pair of Queens


Poker Hand #RC2078589016: Hold'em No Limit ($0.02/$0.05) - 2023/12/22 22:08:06
Table 'RushAndCash808578' 6-max Seat #1 is the button
Seat 1: bb8cf690 ($5.11 in chips)
Seat 2: 317ccf77 ($4.55 in chips)
Seat 3: b49c4561 ($2.16 in chips)
Seat 4: Hero ($5.5 in chips)
Seat 5: 10def899 ($5.79 in chips)
Seat 6: f702b95b ($8.96 in chips)
317ccf77: posts small blind $0.02
b49c4561: posts big blind $0.05
*** HOLE CARDS ***
Dealt to bb8cf690 
Dealt to 317ccf77 
Dealt to b49c4561 
Dealt to Hero [7c 6s]
Dealt to 10def899 
Dealt to f702b95b 
Hero: folds
10def899: folds
f702b95b: folds
bb8cf690: folds
317ccf77: folds
Uncalled bet ($0.03) returned to b49c4561
*** SHOWDOWN ***
b49c4561 collected $0.04 from pot
*** SUMMARY ***
Total pot $0.04 | Rake $0 | Jackpot $0 | Bingo $0 | Fortune $0 | Tax $0
Seat 1: bb8cf690 (button) folded before Flop (didn't bet)
Seat 2: 317ccf77 (small blind) folded before Flop
Seat 3: b49c4561 (big blind) collected ($0.04)
Seat 4: Hero folded before Flop (didn't bet)
Seat 5: 10def899 folded before Flop (didn't bet)
Seat 6: f702b95b folded before Flop (didn't bet)


Poker Hand #RC2078588948: Hold'em No Limit ($0.02/$0.05) - 2023/12/22 22:08:02
Table 'RushAndCash808546' 6-max Seat #1 is the button
Seat 1: Hero ($5.5 in chips)
Seat 2: c3c9a58d ($20.3 in chips)
Seat 3: 834fcc3f ($8.71 in chips)
Seat 4: 20b21409 ($5.12 in chips)
Seat 5: 8f240b5e ($9.37 in chips)
Seat 6: 622d6af4 ($21.5 in chips)
c3c9a58d: posts small blind $0.02
834fcc3f: posts big blind $0.05
*** HOLE CARDS ***
Dealt to Hero [7s 9h]
Dealt to c3c9a58d 
Dealt to 834fcc3f 
Dealt to 20b21409 
Dealt to 8f240b5e 
Dealt to 622d6af4 
20b21409: folds
8f240b5e: folds
622d6af4: folds
Hero: folds
c3c9a58d: folds
Uncalled bet ($0.03) returned to 834fcc3f
*** SHOWDOWN ***
834fcc3f collected $0.04 from pot
*** SUMMARY ***
Total pot $0.04 | Rake $0 | Jackpot $0 | Bingo $0 | Fortune $0 | Tax $0
Seat 1: Hero (button) folded before Flop (didn't bet)
Seat 2: c3c9a58d (small blind) folded before Flop
Seat 3: 834fcc3f (big blind) collected ($0.04)
Seat 4: 20b21409 folded before Flop (didn't bet)
Seat 5: 8f240b5e folded before Flop (didn't bet)
Seat 6: 622d6af4 folded before Flop (didn't bet)


Poker Hand #RC2078588488: Hold'em No Limit ($0.02/$0.05) - 2023/12/22 22:07:34
Table 'RushAndCash808334' 6-max Seat #1 is the button
Seat 1: 9242ffb1 ($5.19 in chips)
Seat 2: 5916f023 ($13.98 in chips)
Seat 3: Hero ($5.23 in chips)
Seat 4: 4eb22595 ($7.17 in chips)
Seat 5: ad189083 ($2.14 in chips)
Seat 6: 58864a6e ($17.24 in chips)
5916f023: posts small blind $0.02
Hero: posts big blind $0.05
*** HOLE CARDS ***
Dealt to 9242ffb1 
Dealt to 5916f023 
Dealt to Hero [7h 9h]
Dealt to 4eb22595 
Dealt to ad189083 
Dealt to 58864a6e 
4eb22595: folds
ad189083: folds
58864a6e: folds
9242ffb1: raises $0.08 to $0.13
5916f023: folds
Hero: calls $0.08
*** FLOP *** [Qd Qh 5h]
Hero: checks
9242ffb1: bets $0.14
Hero: calls $0.14
*** TURN *** [Qd Qh 5h] [4d]
Hero: checks
9242ffb1: checks
*** RIVER *** [Qd Qh 5h 4d] [Jh]
Hero: bets $0.19
9242ffb1: folds
Uncalled bet ($0.19) returned to Hero
*** SHOWDOWN ***
Hero collected $0.54 from pot
*** SUMMARY ***
Total pot $0.56 | Rake $0.02 | Jackpot $0 | Bingo $0 | Fortune $0 | Tax $0
Board [Qd Qh 5h 4d Jh]
Seat 1: 9242ffb1 (button) folded on the River
Seat 2: 5916f023 (small blind) folded before Flop
Seat 3: Hero (big blind) won ($0.54)
Seat 4: 4eb22595 folded before Flop (didn't bet)
Seat 5: ad189083 folded before Flop (didn't bet)
Seat 6: 58864a6e folded before Flop (didn't bet)


Poker Hand #RC2078587695: Hold'em No Limit ($0.02/$0.05) - 2023/12/22 22:06:49
Table 'RushAndCash807977' 6-max Seat #1 is the button
Seat 1: Hero ($5 in chips)
Seat 2: 90b5844 ($6.65 in chips)
Seat 3: 9a9a6ce2 ($5 in chips)
Seat 4: 317ccf77 ($4.22 in chips)
Seat 5: 3f7ed7e8 ($7.02 in chips)
Seat 6: 62acde92 ($5.19 in chips)
90b5844: posts small blind $0.02
9a9a6ce2: posts big blind $0.05
*** HOLE CARDS ***
Dealt to Hero [Qd Ac]
Dealt to 90b5844 
Dealt to 9a9a6ce2 
Dealt to 317ccf77 
Dealt to 3f7ed7e8 
Dealt to 62acde92 
317ccf77: folds
3f7ed7e8: folds
62acde92: folds
Hero: raises $0.08 to $0.13
90b5844: folds
9a9a6ce2: calls $0.08
*** FLOP *** [2c Ah Jc]
9a9a6ce2: checks
Hero: bets $0.1
9a9a6ce2: calls $0.1
*** TURN *** [2c Ah Jc] [4h]
9a9a6ce2: checks
Hero: bets $0.29
9a9a6ce2: folds
Uncalled bet ($0.29) returned to Hero
*** SHOWDOWN ***
Hero collected $0.46 from pot
*** SUMMARY ***
Total pot $0.48 | Rake $0.02 | Jackpot $0 | Bingo $0 | Fortune $0 | Tax $0
Board [2c Ah Jc 4h]
Seat 1: Hero (button) won ($0.46)
Seat 2: 90b5844 (small blind) folded before Flop
Seat 3: 9a9a6ce2 (big blind) folded on the Turn
Seat 4: 317ccf77 folded before Flop (didn't bet)
Seat 5: 3f7ed7e8 folded before Flop (didn't bet)
Seat 6: 62acde92 folded before Flop (didn't bet)


Poker Hand #RC2078587459: Hold'em No Limit ($0.02/$0.05) - 2023/12/22 22:06:36
Table 'RushAndCash807864' 6-max Seat #1 is the button
Seat 1: d4d7018e ($5.61 in chips)
Seat 2: Hero ($5 in chips)
Seat 3: e0f80030 ($5.07 in chips)
Seat 4: 6c4d56b8 ($5.37 in chips)
Seat 5: bb8cf690 ($5.11 in chips)
Seat 6: 28218a38 ($3.66 in chips)
Hero: posts small blind $0.02
e0f80030: posts big blind $0.05
*** HOLE CARDS ***
Dealt to d4d7018e 
Dealt to Hero [2s Kd]
Dealt to e0f80030 
Dealt to 6c4d56b8 
Dealt to bb8cf690 
Dealt to 28218a38 
6c4d56b8: folds
bb8cf690: raises $0.1 to $0.15
28218a38: folds
d4d7018e: folds
Hero: folds
e0f80030: folds
Uncalled bet ($0.1) returned to bb8cf690
*** SHOWDOWN ***
bb8cf690 collected $0.12 from pot
*** SUMMARY ***
Total pot $0.12 | Rake $0 | Jackpot $0 | Bingo $0 | Fortune $0 | Tax $0
Seat 1: d4d7018e (button) folded before Flop (didn't bet)
Seat 2: Hero (small blind) folded before Flop
Seat 3: e0f80030 (big blind) folded before Flop
Seat 4: 6c4d56b8 folded before Flop (didn't bet)
Seat 5: bb8cf690 collected ($0.12)
Seat 6: 28218a38 folded before Flop (didn't bet)


Poker Hand #RC2078587295: Hold'em No Limit ($0.02/$0.05) - 2023/12/22 22:06:26
Table 'RushAndCash807790' 6-max Seat #1 is the button
Seat 1: bd5964be ($5.93 in chips)
Seat 2: Hero ($5 in chips)
Seat 3: bbbfa77c ($6.43 in chips)
Seat 4: 153d5b53 ($5.51 in chips)
Seat 5: da6ead6f ($4.72 in chips)
Seat 6: 250fdb1e ($1.12 in chips)
Hero: posts small blind $0.02
bbbfa77c: posts big blind $0.05
*** HOLE CARDS ***
Dealt to bd5964be 
Dealt to Hero [5h 4s]
Dealt to bbbfa77c 
Dealt to 153d5b53 
Dealt to da6ead6f 
Dealt to 250fdb1e 
153d5b53: folds
da6ead6f: folds
250fdb1e: folds
bd5964be: raises $0.1 to $0.15
Hero: folds
bbbfa77c: calls $0.1
*** FLOP *** [7s Js 8c]
bbbfa77c: checks
bd5964be: bets $0.11
bbbfa77c: folds
Uncalled bet ($0.11) returned to bd5964be
*** SHOWDOWN ***
bd5964be collected $0.31 from pot
*** SUMMARY ***
Total pot $0.32 | Rake $0.01 | Jackpot $0 | Bingo $0 | Fortune $0 | Tax $0
Board [7s Js 8c]
Seat 1: bd5964be (button) won ($0.31)
Seat 2: Hero (small blind) folded before Flop
Seat 3: bbbfa77c (big blind) folded on the Flop
Seat 4: 153d5b53 folded before Flop (didn't bet)
Seat 5: da6ead6f folded before Flop (didn't bet)
Seat 6: 250fdb1e folded before Flop (didn't bet)


Poker Hand #RC2078587218: Hold'em No Limit ($0.02/$0.05) - 2023/12/22 22:06:22
Table 'RushAndCash807753' 6-max Seat #1 is the button
Seat 1: 165766e4 ($5 in chips)
Seat 2: 73557c98 ($5 in chips)
Seat 3: feea99ad ($5 in chips)
Seat 4: 6c7756a0 ($5 in chips)
Seat 5: 24503504 ($8.64 in chips)
Seat 6: Hero ($5 in chips)
73557c98: posts small blind $0.02
feea99ad: posts big blind $0.05
*** HOLE CARDS ***
Dealt to 165766e4 
Dealt to 73557c98 
Dealt to feea99ad 
Dealt to 6c7756a0 
Dealt to 24503504 
Dealt to Hero [2s 6s]
6c7756a0: folds
24503504: raises $0.08 to $0.13
Hero: folds
165766e4: folds
73557c98: folds
feea99ad: folds
Uncalled bet ($0.08) returned to 24503504
*** SHOWDOWN ***
24503504 collected $0.12 from pot
*** SUMMARY ***
Total pot $0.12 | Rake $0 | Jackpot $0 | Bingo $0 | Fortune $0 | Tax $0
Seat 1: 165766e4 (button) folded before Flop (didn't bet)
Seat 2: 73557c98 (small blind) folded before Flop
Seat 3: feea99ad (big blind) folded before Flop
Seat 4: 6c7756a0 folded before Flop (didn't bet)
Seat 5: 24503504 collected ($0.12)
Seat 6: Hero folded before Flop (didn't bet)


Poker Hand #RC2078587136: Hold'em No Limit ($0.02/$0.05) - 2023/12/22 22:06:17
Table 'RushAndCash807715' 6-max Seat #1 is the button
Seat 1: 2e11c0b5 ($5.48 in chips)
Seat 2: 7016689e ($7.27 in chips)
Seat 3: 45ce1aed ($5.79 in chips)
Seat 4: acefe34e ($7.14 in chips)
Seat 5: Hero ($5 in chips)
Seat 6: 73557c98 ($5 in chips)
7016689e: posts small blind $0.02
45ce1aed: posts big blind $0.05
*** HOLE CARDS ***
Dealt to 2e11c0b5 
Dealt to 7016689e 
Dealt to 45ce1aed 
Dealt to acefe34e 
Dealt to Hero [4c 9c]
Dealt to 73557c98 
acefe34e: folds
Hero: folds
73557c98: folds
2e11c0b5: folds
7016689e: raises $0.08 to $0.13
45ce1aed: raises $0.21 to $0.34
7016689e: folds
Uncalled bet ($0.21) returned to 45ce1aed
*** SHOWDOWN ***
45ce1aed collected $0.25 from pot
*** SUMMARY ***
Total pot $0.26 | Rake $0.01 | Jackpot $0 | Bingo $0 | Fortune $0 | Tax $0
Seat 1: 2e11c0b5 (button) folded before Flop (didn't bet)
Seat 2: 7016689e (small blind) folded before Flop
Seat 3: 45ce1aed (big blind) collected ($0.25)
Seat 4: acefe34e folded before Flop (didn't bet)
Seat 5: Hero folded before Flop (didn't bet)
Seat 6: 73557c98 folded before Flop (didn't bet)


Poker Hand #RC2078586097: Hold'em No Limit ($0.02/$0.05) - 2023/12/22 22:05:17
Table 'RushAndCash807232' 6-max Seat #1 is the button
Seat 1: a4441de9 ($5.65 in chips)
Seat 2: 3f112fc ($5 in chips)
Seat 3: Hero ($5.21 in chips)
Seat 4: 153d5b53 ($5.26 in chips)
Seat 5: 265fe6b1 ($2.78 in chips)
Seat 6: 2bb677ff ($7.76 in chips)
3f112fc: posts small blind $0.02
Hero: posts big blind $0.05
*** HOLE CARDS ***
Dealt to a4441de9 
Dealt to 3f112fc 
Dealt to Hero [7s Qs]
Dealt to 153d5b53 
Dealt to 265fe6b1 
Dealt to 2bb677ff 
153d5b53: folds
265fe6b1: calls $0.05
2bb677ff: folds
a4441de9: folds
3f112fc: folds
Hero: checks
*** FLOP *** [6c 9h Jd]
Hero: checks
265fe6b1: bets $0.06
Hero: calls $0.06
*** TURN *** [6c 9h Jd] [Tc]
Hero: checks
265fe6b1: bets $0.12
Hero: calls $0.12
*** RIVER *** [6c 9h Jd Tc] [5h]
Hero: checks
265fe6b1: bets $0.24
Hero: folds
Uncalled bet ($0.24) returned to 265fe6b1
*** SHOWDOWN ***
265fe6b1 collected $0.46 from pot
*** SUMMARY ***
Total pot $0.48 | Rake $0.02 | Jackpot $0 | Bingo $0 | Fortune $0 | Tax $0
Board [6c 9h Jd Tc 5h]
Seat 1: a4441de9 (button) folded before Flop (didn't bet)
Seat 2: 3f112fc (small blind) folded before Flop
Seat 3: Hero (big blind) folded on the River
Seat 4: 153d5b53 folded before Flop (didn't bet)
Seat 5: 265fe6b1 won ($0.46)
Seat 6: 2bb677ff folded before Flop (didn't bet)


Poker Hand #RC2078586031: Hold'em No Limit ($0.02/$0.05) - 2023/12/22 22:05:13
Table 'RushAndCash807202' 6-max Seat #1 is the button
Seat 1: 265fe6b1 ($2.78 in chips)
Seat 2: 9b5806d5 ($5.2 in chips)
Seat 3: f283b60 ($5 in chips)
Seat 4: dd486414 ($5.8 in chips)
Seat 5: Hero ($5.21 in chips)
Seat 6: beea6e5f ($7.97 in chips)
9b5806d5: posts small blind $0.02
f283b60: posts big blind $0.05
*** HOLE CARDS ***
Dealt to 265fe6b1 
Dealt to 9b5806d5 
Dealt to f283b60 
Dealt to dd486414 
Dealt to Hero [Ad 8c]
Dealt to beea6e5f 
dd486414: folds
Hero: folds
beea6e5f: folds
265fe6b1: folds
9b5806d5: folds
Uncalled bet ($0.03) returned to f283b60
*** SHOWDOWN ***
f283b60 collected $0.04 from pot
*** SUMMARY ***
Total pot $0.04 | Rake $0 | Jackpot $0 | Bingo $0 | Fortune $0 | Tax $0
Seat 1: 265fe6b1 (button) folded before Flop (didn't bet)
Seat 2: 9b5806d5 (small blind) folded before Flop
Seat 3: f283b60 (big blind) collected ($0.04)
Seat 4: dd486414 folded before Flop (didn't bet)
Seat 5: Hero folded before Flop (didn't bet)
Seat 6: beea6e5f folded before Flop (didn't bet)


Poker Hand #RC2078585979: Hold'em No Limit ($0.02/$0.05) - 2023/12/22 22:05:10
Table 'RushAndCash807179' 6-max Seat #1 is the button
Seat 1: 7ae330b3 ($5.63 in chips)
Seat 2: 20f0489f ($4.95 in chips)
Seat 3: 111c92ae ($8.25 in chips)
Seat 4: Hero ($5.21 in chips)
Seat 5: 5126c2bf ($5.02 in chips)
Seat 6: 9e4b1c03 ($7.03 in chips)
20f0489f: posts small blind $0.02
111c92ae: posts big blind $0.05
*** HOLE CARDS ***
Dealt to 7ae330b3 
Dealt to 20f0489f 
Dealt to 111c92ae 
Dealt to Hero [Jc 5c]
Dealt to 5126c2bf 
Dealt to 9e4b1c03 
Hero: folds
5126c2bf: folds
9e4b1c03: folds
7ae330b3: raises $0.07 to $0.12
20f0489f: folds
111c92ae: calls $0.07
*** FLOP *** [7d 2c 5d]
111c92ae: checks
7ae330b3: checks
*** TURN *** [7d 2c 5d] [3d]
111c92ae: bets $0.2
7ae330b3: folds
Uncalled bet ($0.2) returned to 111c92ae
*** SHOWDOWN ***
111c92ae collected $0.25 from pot
*** SUMMARY ***
Total pot $0.26 | Rake $0.01 | Jackpot $0 | Bingo $0 | Fortune $0 | Tax $0
Board [7d 2c 5d 3d]
Seat 1: 7ae330b3 (button) folded on the Turn
Seat 2: 20f0489f (small blind) folded before Flop
Seat 3: 111c92ae (big blind) won ($0.25)
Seat 4: Hero folded before Flop (didn't bet)
Seat 5: 5126c2bf folded before Flop (didn't bet)
Seat 6: 9e4b1c03 folded before Flop (didn't bet)


Poker Hand #RC2078585823: Hold'em No Limit ($0.02/$0.05) - 2023/12/22 22:05:00
Table 'RushAndCash807104' 6-max Seat #1 is the button
Seat 1: 3d929f9f ($8.7 in chips)
Seat 2: Hero ($5.23 in chips)
Seat 3: 7095bc76 ($11.59 in chips)
Seat 4: 17da2929 ($5.31 in chips)
Seat 5: 67297113 ($5.78 in chips)
Seat 6: 5ee4d099 ($5.37 in chips)
Hero: posts small blind $0.02
7095bc76: posts big blind $0.05
*** HOLE CARDS ***
Dealt to 3d929f9f 
Dealt to Hero [3s 7d]
Dealt to 7095bc76 
Dealt to 17da2929 
Dealt to 67297113 
Dealt to 5ee4d099 
17da2929: folds
67297113: folds
5ee4d099: raises $0.08 to $0.13
3d929f9f: folds
Hero: folds
7095bc76: folds
Uncalled bet ($0.08) returned to 5ee4d099
*** SHOWDOWN ***
5ee4d099 collected $0.12 from pot
*** SUMMARY ***
Total pot $0.12 | Rake $0 | Jackpot $0 | Bingo $0 | Fortune $0 | Tax $0
Seat 1: 3d929f9f (button) folded before Flop (didn't bet)
Seat 2: Hero (small blind) folded before Flop
Seat 3: 7095bc76 (big blind) folded before Flop
Seat 4: 17da2929 folded before Flop (didn't bet)
Seat 5: 67297113 folded before Flop (didn't bet)
Seat 6: 5ee4d099 collected ($0.12)


Poker Hand #RC2078585564: Hold'em No Limit ($0.02/$0.05) - 2023/12/22 22:04:44
Table 'RushAndCash806985' 6-max Seat #1 is the button
Seat 1: 30a2950b ($5.23 in chips)
Seat 2: 11612373 ($13.94 in chips)
Seat 3: Hero ($5.28 in chips)
Seat 4: 4520f334 ($4.17 in chips)
Seat 5: eab48ced ($11.2 in chips)
Seat 6: ede500fa ($5.07 in chips)
11612373: posts small blind $0.02
Hero: posts big blind $0.05
*** HOLE CARDS ***
Dealt to 30a2950b 
Dealt to 11612373 
Dealt to Hero [Kd 6c]
Dealt to 4520f334 
Dealt to eab48ced 
Dealt to ede500fa 
4520f334: folds
eab48ced: folds
ede500fa: folds
30a2950b: raises $0.05 to $0.1
11612373: folds
Hero: folds
Uncalled bet ($0.05) returned to 30a2950b
*** SHOWDOWN ***
30a2950b collected $0.12 from pot
*** SUMMARY ***
Total pot $0.12 | Rake $0 | Jackpot $0 | Bingo $0 | Fortune $0 | Tax $0
Seat 1: 30a2950b (button) collected ($0.12)
Seat 2: 11612373 (small blind) folded before Flop
Seat 3: Hero (big blind) folded before Flop
Seat 4: 4520f334 folded before Flop (didn't bet)
Seat 5: eab48ced folded before Flop (didn't bet)
Seat 6: ede500fa folded before Flop (didn't bet)


Poker Hand #RC2078585509: Hold'em No Limit ($0.02/$0.05) - 2023/12/22 22:04:41
Table 'RushAndCash806958' 6-max Seat #1 is the button
Seat 1: Hero ($5.28 in chips)
Seat 2: e91020c6 ($5.75 in chips)
Seat 3: 641f40f7 ($5 in chips)
Seat 4: 9601129f ($8.92 in chips)
Seat 5: b49a0d77 ($5.33 in chips)
Seat 6: 38e42730 ($9.32 in chips)
e91020c6: posts small blind $0.02
641f40f7: posts big blind $0.05
*** HOLE CARDS ***
Dealt to Hero [6s Qc]
Dealt to e91020c6 
Dealt to 641f40f7 
Dealt to 9601129f 
Dealt to b49a0d77 
Dealt to 38e42730 
9601129f: folds
b49a0d77: raises $0.05 to $0.1
38e42730: folds
Hero: folds
e91020c6: folds
641f40f7: calls $0.05
*** FLOP *** [8c Js Jh]
641f40f7: checks
b49a0d77: bets $0.08
641f40f7: calls $0.08
*** TURN *** [8c Js Jh] [8h]
641f40f7: checks
b49a0d77: checks
*** RIVER *** [8c Js Jh 8h] [4s]
641f40f7: bets $0.31
b49a0d77: folds
Uncalled bet ($0.31) returned to 641f40f7
*** SHOWDOWN ***
641f40f7 collected $0.37 from pot
*** SUMMARY ***
Total pot $0.38 | Rake $0.01 | Jackpot $0 | Bingo $0 | Fortune $0 | Tax $0
Board [8c Js Jh 8h 4s]
Seat 1: Hero (button) folded before Flop (didn't bet)
Seat 2: e91020c6 (small blind) folded before Flop
Seat 3: 641f40f7 (big blind) won ($0.37)
Seat 4: 9601129f folded before Flop (didn't bet)
Seat 5: b49a0d77 folded on the River
Seat 6: 38e42730 folded before Flop (didn't bet)


Poker Hand #RC2078585440: Hold'em No Limit ($0.02/$0.05) - 2023/12/22 22:04:37
Table 'RushAndCash806925' 6-max Seat #1 is the button
Seat 1: 3fd262a7 ($6.74 in chips)
Seat 2: 24503504 ($8.83 in chips)
Seat 3: 39956d46 ($13.84 in chips)
Seat 4: Hero ($5.28 in chips)
Seat 5: 2c2f2262 ($3.99 in chips)
Seat 6: ca1739c4 ($5.58 in chips)
24503504: posts small blind $0.02
39956d46: posts big blind $0.05
*** HOLE CARDS ***
Dealt to 3fd262a7 
Dealt to 24503504 
Dealt to 39956d46 
Dealt to Hero [3c Jh]
Dealt to 2c2f2262 
Dealt to ca1739c4 
Hero: folds
2c2f2262: folds
ca1739c4: raises $0.05 to $0.1
3fd262a7: calls $0.1
24503504: calls $0.08
39956d46: folds
*** FLOP *** [4d Tc Kc]
24503504: checks
ca1739c4: bets $0.12
3fd262a7: raises $0.18 to $0.3
24503504: folds
ca1739c4: calls $0.18
*** TURN *** [4d Tc Kc] [7d]
ca1739c4: checks
3fd262a7: bets $0.88
ca1739c4: calls $0.88
*** RIVER *** [4d Tc Kc 7d] [2h]
ca1739c4: checks
3fd262a7: bets $1.22
ca1739c4: calls $1.22
3fd262a7: shows [4h 4s] (Three Fours)
ca1739c4: shows [Ks Js] (Pair of Kings)
*** SHOWDOWN ***
3fd262a7 collected $4.93 from pot
*** SUMMARY ***
Total pot $5.15 | Rake $0.15 | Jackpot $0.07 | Bingo $0 | Fortune $0 | Tax $0
Board [4d Tc Kc 7d 2h]
Seat 1: 3fd262a7 (button) showed [4h 4s] and won ($4.93) with Three Fours
Seat 2: 24503504 (small blind) folded on the Flop
Seat 3: 39956d46 (big blind) folded before Flop
Seat 4: Hero folded before Flop (didn't bet)
Seat 5: 2c2f2262 folded before Flop (didn't bet)
Seat 6: ca1739c4 showed [Ks Js] and lost with Pair of Kings


Poker Hand #RC2078585361: Hold'em No Limit ($0.02/$0.05) - 2023/12/22 22:04:33
Table 'RushAndCash806888' 6-max Seat #1 is the button
Seat 1: 48b86f00 ($6.3 in chips)
Seat 2: 78624e82 ($5.09 in chips)
Seat 3: 58782f5b ($5.54 in chips)
Seat 4: 90511c4f ($5 in chips)
Seat 5: Hero ($5.28 in chips)
Seat 6: cf3c4384 ($4.15 in chips)
78624e82: posts small blind $0.02
58782f5b: posts big blind $0.05
*** HOLE CARDS ***
Dealt to 48b86f00 
Dealt to 78624e82 
Dealt to 58782f5b 
Dealt to 90511c4f 
Dealt to Hero [Td 3d]
Dealt to cf3c4384 
90511c4f: folds
Hero: folds
cf3c4384: raises $0.08 to $0.13
48b86f00: folds
78624e82: folds
58782f5b: calls $0.08
*** FLOP *** [Kh 7s Ks]
58782f5b: checks
cf3c4384: bets $0.1
58782f5b: calls $0.1
*** TURN *** [Kh 7s Ks] [Ts]
58782f5b: checks
cf3c4384: bets $0.16
58782f5b: folds
Uncalled bet ($0.16) returned to cf3c4384
*** SHOWDOWN ***
cf3c4384 collected $0.46 from pot
*** SUMMARY ***
Total pot $0.48 | Rake $0.02 | Jackpot $0 | Bingo $0 | Fortune $0 | Tax $0
Board [Kh 7s Ks Ts]
Seat 1: 48b86f00 (button) folded before Flop (didn't bet)
Seat 2: 78624e82 (small blind) folded before Flop
Seat 3: 58782f5b (big blind) folded on the Turn
Seat 4: 90511c4f folded before Flop (didn't bet)
Seat 5: Hero folded before Flop (didn't bet)
Seat 6: cf3c4384 won ($0.46)


Poker Hand #RC2078585291: Hold'em No Limit ($0.02/$0.05) - 2023/12/22 22:04:29
Table 'RushAndCash806856' 6-max Seat #1 is the button
Seat 1: 90511c4f ($5 in chips)
Seat 2: 74a53cac ($19.96 in chips)
Seat 3: ca88dd67 ($8.31 in chips)
Seat 4: 4879e77e ($6.72 in chips)
Seat 5: Hero ($5.28 in chips)
Seat 6: 11612373 ($13.94 in chips)
74a53cac: posts small blind $0.02
ca88dd67: posts big blind $0.05
*** HOLE CARDS ***
Dealt to 90511c4f 
Dealt to 74a53cac 
Dealt to ca88dd67 
Dealt to 4879e77e 
Dealt to Hero [6c 9h]
Dealt to 11612373 
4879e77e: folds
Hero: folds
11612373: folds
90511c4f: folds
74a53cac: folds
Uncalled bet ($0.03) returned to ca88dd67
*** SHOWDOWN ***
ca88dd67 collected $0.04 from pot
*** SUMMARY ***
Total pot $0.04 | Rake $0 | Jackpot $0 | Bingo $0 | Fortune $0 | Tax $0
Seat 1: 90511c4f (button) folded before Flop (didn't bet)
Seat 2: 74a53cac (small blind) folded before Flop
Seat 3: ca88dd67 (big blind) collected ($0.04)
Seat 4: 4879e77e folded before Flop (didn't bet)
Seat 5: Hero folded before Flop (didn't bet)
Seat 6: 11612373 folded before Flop (didn't bet)


Poker Hand #RC2078585233: Hold'em No Limit ($0.02/$0.05) - 2023/12/22 22:04:25
Table 'RushAndCash806829' 6-max Seat #1 is the button
Seat 1: 6e872e9c ($16.96 in chips)
Seat 2: df439f39 ($5.31 in chips)
Seat 3: c23d7305 ($1.85 in chips)
Seat 4: e99cedcc ($11.12 in chips)
Seat 5: Hero ($5.28 in chips)
Seat 6: 11612373 ($13.94 in chips)
df439f39: posts small blind $0.02
c23d7305: posts big blind $0.05
*** HOLE CARDS ***
Dealt to 6e872e9c 
Dealt to df439f39 
Dealt to c23d7305 
Dealt to e99cedcc 
Dealt to Hero [5d Kh]
Dealt to 11612373 
e99cedcc: folds
Hero: folds
11612373: folds
6e872e9c: raises $0.08 to $0.13
df439f39: folds
c23d7305: folds
Uncalled bet ($0.08) returned to 6e872e9c
*** SHOWDOWN ***
6e872e9c collected $0.12 from pot
*** SUMMARY ***
Total pot $0.12 | Rake $0 | Jackpot $0 | Bingo $0 | Fortune $0 | Tax $0
Seat 1: 6e872e9c (button) collected ($0.12)
Seat 2: df439f39 (small blind) folded before Flop
Seat 3: c23d7305 (big blind) folded before Flop
Seat 4: e99cedcc folded before Flop (didn't bet)
Seat 5: Hero folded before Flop (didn't bet)
Seat 6: 11612373 folded before Flop (didn't bet)


Poker Hand #RC2078585172: Hold'em No Limit ($0.02/$0.05) - 2023/12/22 22:04:21
Table 'RushAndCash806803' 6-max Seat #1 is the button
Seat 1: a89c43c ($2.34 in chips)
Seat 2: 98347374 ($16.86 in chips)
Seat 3: 11612373 ($13.99 in chips)
Seat 4: 8626eae9 ($5 in chips)
Seat 5: 9b5806d5 ($4.77 in chips)
Seat 6: Hero ($5.28 in chips)
98347374: posts small blind $0.02
11612373: posts big blind $0.05
*** HOLE CARDS ***
Dealt to a89c43c 
Dealt to 98347374 
Dealt to 11612373 
Dealt to 8626eae9 
Dealt to 9b5806d5 
Dealt to Hero [Jd 6h]
8626eae9: folds
9b5806d5: folds
Hero: folds
a89c43c: raises $0.1 to $0.15
98347374: calls $0.13
11612373: folds
*** FLOP *** [3d Qh 2c]
98347374: checks
a89c43c: bets $0.12
98347374: folds
Uncalled bet ($0.12) returned to a89c43c
*** SHOWDOWN ***
a89c43c collected $0.34 from pot
*** SUMMARY ***
Total pot $0.35 | Rake $0.01 | Jackpot $0 | Bingo $0 | Fortune $0 | Tax $0
Board [3d Qh 2c]
Seat 1: a89c43c (button) won ($0.34)
Seat 2: 98347374 (small blind) folded on the Flop
Seat 3: 11612373 (big blind) folded before Flop
Seat 4: 8626eae9 folded before Flop (didn't bet)
Seat 5: 9b5806d5 folded before Flop (didn't bet)
Seat 6: Hero folded before Flop (didn't bet)


Poker Hand #RC2078584788: Hold'em No Limit ($0.02/$0.05) - 2023/12/22 22:04:00
Table 'RushAndCash806626' 6-max Seat #1 is the button
Seat 1: c080453a ($5.27 in chips)
Seat 2: 34ce5e3 ($8.57 in chips)
Seat 3: 97ff30a6 ($6.71 in chips)
Seat 4: Hero ($5.21 in chips)
Seat 5: fd9c9451 ($2.73 in chips)
Seat 6: a532da42 ($5.19 in chips)
34ce5e3: posts small blind $0.02
97ff30a6: posts big blind $0.05
*** HOLE CARDS ***
Dealt to c080453a 
Dealt to 34ce5e3 
Dealt to 97ff30a6 
Dealt to Hero [Ah Kh]
Dealt to fd9c9451 
Dealt to a532da42 
Hero: raises $0.05 to $0.1
fd9c9451: folds
a532da42: folds
c080453a: folds
34ce5e3: folds
97ff30a6: folds
Uncalled bet ($0.05) returned to Hero
*** SHOWDOWN ***
Hero collected $0.12 from pot
*** SUMMARY ***
Total pot $0.12 | Rake $0 | Jackpot $0 | Bingo $0 | Fortune $0 | Tax $0
Seat 1: c080453a (button) folded before Flop (didn't bet)
Seat 2: 34ce5e3 (small blind) folded before Flop
Seat 3: 97ff30a6 (big blind) folded before Flop
Seat 4: Hero collected ($0.12)
Seat 5: fd9c9451 folded before Flop (didn't bet)
Seat 6: a532da42 folded before Flop (didn't bet)


Poker Hand #RC2078584637: Hold'em No Limit ($0.02/$0.05) - 2023/12/22 22:03:51
Table 'RushAndCash806559' 6-max Seat #1 is the button
Seat 1: e7ed98a7 ($5 in chips)
Seat 2: b24bb7c1 ($4.95 in chips)
Seat 3: Hero ($5.26 in chips)
Seat 4: d4fe283f ($6.19 in chips)
Seat 5: 1475b478 ($2.91 in chips)
Seat 6: bba39737 ($6.27 in chips)
b24bb7c1: posts small blind $0.02
Hero: posts big blind $0.05
*** HOLE CARDS ***
Dealt to e7ed98a7 
Dealt to b24bb7c1 
Dealt to Hero [2h 8d]
Dealt to d4fe283f 
Dealt to 1475b478 
Dealt to bba39737 
d4fe283f: folds
1475b478: raises $0.05 to $0.1
bba39737: folds
e7ed98a7: folds
b24bb7c1: folds
Hero: folds
Uncalled bet ($0.05) returned to 1475b478
*** SHOWDOWN ***
1475b478 collected $0.12 from pot
*** SUMMARY ***
Total pot $0.12 | Rake $0 | Jackpot $0 | Bingo $0 | Fortune $0 | Tax $0
Seat 1: e7ed98a7 (button) folded before Flop (didn't bet)
Seat 2: b24bb7c1 (small blind) folded before Flop
Seat 3: Hero (big blind) folded before Flop
Seat 4: d4fe283f folded before Flop (didn't bet)
Seat 5: 1475b478 collected ($0.12)
Seat 6: bba39737 folded before Flop (didn't bet)


Poker Hand #RC2078583955: Hold'em No Limit ($0.02/$0.05) - 2023/12/22 22:03:09
Table 'RushAndCash806245' 6-max Seat #1 is the button
Seat 1: 1475b478 ($3.14 in chips)
Seat 2: Hero ($5 in chips)
Seat 3: d0173848 ($1.77 in chips)
Seat 4: e657ae1e ($5.07 in chips)
Seat 5: 558ffb3 ($7.16 in chips)
Seat 6: bd6855dc ($6.33 in chips)
Hero: posts small blind $0.02
d0173848: posts big blind $0.05
*** HOLE CARDS ***
Dealt to 1475b478 
Dealt to Hero [4s 4d]
Dealt to d0173848 
Dealt to e657ae1e 
Dealt to 558ffb3 
Dealt to bd6855dc 
e657ae1e: folds
558ffb3: folds
bd6855dc: folds
1475b478: raises $0.05 to $0.1
Hero: calls $0.08
d0173848: folds
*** FLOP *** [4h 3s 9d]
Hero: checks
1475b478: checks
*** TURN *** [4h 3s 9d] [Jc]
Hero: checks
1475b478: checks
*** RIVER *** [4h 3s 9d Jc] [Qd]
Hero: checks
1475b478: bets $0.13
Hero: raises $0.23 to $0.36
1475b478: folds
Uncalled bet ($0.23) returned to Hero
*** SHOWDOWN ***
Hero collected $0.49 from pot
*** SUMMARY ***
Total pot $0.51 | Rake $0.02 | Jackpot $0 | Bingo $0 | Fortune $0 | Tax $0
Board [4h 3s 9d Jc Qd]
Seat 1: 1475b478 (button) folded on the River
Seat 2: Hero (small blind) won ($0.49)
Seat 3: d0173848 (big blind) folded before Flop
Seat 4: e657ae1e folded before Flop (didn't bet)
Seat 5: 558ffb3 folded before Flop (didn't bet)
Seat 6: bd6855dc folded before Flop (didn't bet)


Poker Hand #RC2078583097: Hold'em No Limit ($0.02/$0.05) - 2023/12/22 22:02:21
Table 'RushAndCash805833' 6-max Seat #1 is the button
Seat 1: Hero ($5.54 in chips)
Seat 2: 7095bc76 ($10.22 in chips)
Seat 3: a89c43c ($2.39 in chips)
Seat 4: c444ec1 ($9.99 in chips)
Seat 5: 536634f0 ($5 in chips)
Seat 6: 317ccf77 ($4.09 in chips)
7095bc76: posts small blind $0.02
a89c43c: posts big blind $0.05
*** HOLE CARDS ***
Dealt to Hero [Qs Qh]
Dealt to 7095bc76 
Dealt to a89c43c 
Dealt to c444ec1 
Dealt to 536634f0 
Dealt to 317ccf77 
c444ec1: folds
536634f0: folds
317ccf77: folds
Hero: raises $0.08 to $0.13
7095bc76: raises $0.39 to $0.52
a89c43c: folds
Hero: calls $0.39
*** FLOP *** [3d 9s 9d]
7095bc76: bets $0.92
Hero: calls $0.92
*** TURN *** [3d 9s 9d] [4d]
7095bc76: bets $8.78 and is all-in
Hero: folds
Uncalled bet ($8.78) returned to 7095bc76
*** SHOWDOWN ***
7095bc76 collected $2.72 from pot
*** SUMMARY ***
Total pot $2.93 | Rake $0.14 | Jackpot $0.07 | Bingo $0 | Fortune $0 | Tax $0
Board [3d 9s 9d 4d]
Seat 1: Hero (button) folded on the Turn
Seat 2: 7095bc76 (small blind) won ($2.72)
Seat 3: a89c43c (big blind) folded before Flop
Seat 4: c444ec1 folded before Flop (didn't bet)
Seat 5: 536634f0 folded before Flop (didn't bet)
Seat 6: 317ccf77 folded before Flop (didn't bet)


Poker Hand #RC2078582991: Hold'em No Limit ($0.02/$0.05) - 2023/12/22 22:02:15
Table 'RushAndCash805783' 6-max Seat #1 is the button
Seat 1: Hero ($5.54 in chips)
Seat 2: 42422ecf ($5.47 in chips)
Seat 3: 190cd877 ($5.54 in chips)
Seat 4: ff6f425f ($10.63 in chips)
Seat 5: c2881b52 ($8.71 in chips)
Seat 6: 20b21409 ($5 in chips)
42422ecf: posts small blind $0.02
190cd877: posts big blind $0.05
*** HOLE CARDS ***
Dealt to Hero [5h 8d]
Dealt to 42422ecf 
Dealt to 190cd877 
Dealt to ff6f425f 
Dealt to c2881b52 
Dealt to 20b21409 
ff6f425f: folds
c2881b52: raises $0.06 to $0.11
20b21409: folds
Hero: folds
42422ecf: folds
190cd877: calls $0.06
*** FLOP *** [Qc Ks 9d]
190cd877: checks
c2881b52: bets $0.08
190cd877: folds
Uncalled bet ($0.08) returned to c2881b52
*** SHOWDOWN ***
c2881b52 collected $0.23 from pot
*** SUMMARY ***
Total pot $0.24 | Rake $0.01 | Jackpot $0 | Bingo $0 | Fortune $0 | Tax $0
Board [Qc Ks 9d]
Seat 1: Hero (button) folded before Flop (didn't bet)
Seat 2: 42422ecf (small blind) folded before Flop
Seat 3: 190cd877 (big blind) folded on the Flop
Seat 4: ff6f425f folded before Flop (didn't bet)
Seat 5: c2881b52 won ($0.23)
Seat 6: 20b21409 folded before Flop (didn't bet)


Poker Hand #RC2078582916: Hold'em No Limit ($0.02/$0.05) - 2023/12/22 22:02:10
Table 'RushAndCash805750' 6-max Seat #1 is the button
Seat 1: 4a7d05b1 ($7.97 in chips)
Seat 2: d4fe283f ($6.12 in chips)
Seat 3: Hero ($5.59 in chips)
Seat 4: 4520f334 ($4.02 in chips)
Seat 5: 2f160a64 ($7.7 in chips)
Seat 6: 2520bab9 ($5.07 in chips)
d4fe283f: posts small blind $0.02
Hero: posts big blind $0.05
*** HOLE CARDS ***
Dealt to 4a7d05b1 
Dealt to d4fe283f 
Dealt to Hero [9s 2s]
Dealt to 4520f334 
Dealt to 2f160a64 
Dealt to 2520bab9 
4520f334: folds
2f160a64: folds
2520bab9: folds
4a7d05b1: raises $0.05 to $0.1
d4fe283f: folds
Hero: folds
Uncalled bet ($0.05) returned to 4a7d05b1
*** SHOWDOWN ***
4a7d05b1 collected $0.12 from pot
*** SUMMARY ***
Total pot $0.12 | Rake $0 | Jackpot $0 | Bingo $0 | Fortune $0 | Tax $0
Seat 1: 4a7d05b1 (button) collected ($0.12)
Seat 2: d4fe283f (small blind) folded before Flop
Seat 3: Hero (big blind) folded before Flop
Seat 4: 4520f334 folded before Flop (didn't bet)
Seat 5: 2f160a64 folded before Flop (didn't bet)
Seat 6: 2520bab9 folded before Flop (didn't bet)


Poker Hand #RC2078582861: Hold'em No Limit ($0.02/$0.05) - 2023/12/22 22:02:07
Table 'RushAndCash805724' 6-max Seat #1 is the button
Seat 1: 129846c0 ($6.67 in chips)
Seat 2: d2e52b8d ($33.9 in chips)
Seat 3: 4a7d05b1 ($8.02 in chips)
Seat 4: 50e2e09e ($5.38 in chips)
Seat 5: aa4f5482 ($8.47 in chips)
Seat 6: Hero ($5.59 in chips)
d2e52b8d: posts small blind $0.02
4a7d05b1: posts big blind $0.05
*** HOLE CARDS ***
Dealt to 129846c0 
Dealt to d2e52b8d 
Dealt to 4a7d05b1 
Dealt to 50e2e09e 
Dealt to aa4f5482 
Dealt to Hero [2d 9h]
50e2e09e: folds
aa4f5482: folds
Hero: folds
129846c0: folds
d2e52b8d: folds
Uncalled bet ($0.03) returned to 4a7d05b1
*** SHOWDOWN ***
4a7d05b1 collected $0.04 from pot
*** SUMMARY ***
Total pot $0.04 | Rake $0 | Jackpot $0 | Bingo $0 | Fortune $0 | Tax $0
Seat 1: 129846c0 (button) folded before Flop (didn't bet)
Seat 2: d2e52b8d (small blind) folded before Flop
Seat 3: 4a7d05b1 (big blind) collected ($0.04)
Seat 4: 50e2e09e folded before Flop (didn't bet)
Seat 5: aa4f5482 folded before Flop (didn't bet)
Seat 6: Hero folded before Flop (didn't bet)


Poker Hand #RC2078582804: Hold'em No Limit ($0.02/$0.05) - 2023/12/22 22:02:03
Table 'RushAndCash805698' 6-max Seat #1 is the button
Seat 1: 17e936 ($5 in chips)
Seat 2: f60e42f0 ($9.6 in chips)
Seat 3: 8e36a030 ($6.85 in chips)
Seat 4: Hero ($5.59 in chips)
Seat 5: 2af18136 ($4.34 in chips)
Seat 6: c4ffe01a ($5.59 in chips)
f60e42f0: posts small blind $0.02
8e36a030: posts big blind $0.05
*** HOLE CARDS ***
Dealt to 17e936 
Dealt to f60e42f0 
Dealt to 8e36a030 
Dealt to Hero [As 6c]
Dealt to 2af18136 
Dealt to c4ffe01a 
Hero: folds
2af18136: folds
c4ffe01a: folds
17e936: folds
f60e42f0: folds
Uncalled bet ($0.03) returned to 8e36a030
*** SHOWDOWN ***
8e36a030 collected $0.04 from pot
*** SUMMARY ***
Total pot $0.04 | Rake $0 | Jackpot $0 | Bingo $0 | Fortune $0 | Tax $0
Seat 1: 17e936 (button) folded before Flop (didn't bet)
Seat 2: f60e42f0 (small blind) folded before Flop
Seat 3: 8e36a030 (big blind) collected ($0.04)
Seat 4: Hero folded before Flop (didn't bet)
Seat 5: 2af18136 folded before Flop (didn't bet)
Seat 6: c4ffe01a folded before Flop (didn't bet)


Poker Hand #RC2078582670: Hold'em No Limit ($0.02/$0.05) - 2023/12/22 22:01:55
Table 'RushAndCash805633' 6-max Seat #1 is the button
Seat 1: 41270a9a ($5.48 in chips)
Seat 2: Hero ($5.61 in chips)
Seat 3: d45bc7f3 ($6.95 in chips)
Seat 4: 4eb22595 ($6.85 in chips)
Seat 5: a809eadb ($6.05 in chips)
Seat 6: ef1573b1 ($9.7 in chips)
Hero: posts small blind $0.02
d45bc7f3: posts big blind $0.05
*** HOLE CARDS ***
Dealt to 41270a9a 
Dealt to Hero [8c 4c]
Dealt to d45bc7f3 
Dealt to 4eb22595 
Dealt to a809eadb 
Dealt to ef1573b1 
4eb22595: folds
a809eadb: folds
ef1573b1: folds
41270a9a: raises $0.08 to $0.13
Hero: folds
d45bc7f3: folds
Uncalled bet ($0.08) returned to 41270a9a
*** SHOWDOWN ***
41270a9a collected $0.12 from pot
*** SUMMARY ***
Total pot $0.12 | Rake $0 | Jackpot $0 | Bingo $0 | Fortune $0 | Tax $0
Seat 1: 41270a9a (button) collected ($0.12)
Seat 2: Hero (small blind) folded before Flop
Seat 3: d45bc7f3 (big blind) folded before Flop
Seat 4: 4eb22595 folded before Flop (didn't bet)
Seat 5: a809eadb folded before Flop (didn't bet)
Seat 6: ef1573b1 folded before Flop (didn't bet)


Poker Hand #RC2078582610: Hold'em No Limit ($0.02/$0.05) - 2023/12/22 22:01:51
Table 'RushAndCash805605' 6-max Seat #1 is the button
Seat 1: ee19881a ($5 in chips)
Seat 2: 9e737c95 ($1.34 in chips)
Seat 3: b49a0d77 ($5.41 in chips)
Seat 4: Hero ($5.61 in chips)
Seat 5: a532da42 ($5.19 in chips)
Seat 6: 97e300ed ($5.57 in chips)
9e737c95: posts small blind $0.02
b49a0d77: posts big blind $0.05
*** HOLE CARDS ***
Dealt to ee19881a 
Dealt to 9e737c95 
Dealt to b49a0d77 
Dealt to Hero [Ks 6c]
Dealt to a532da42 
Dealt to 97e300ed 
Hero: folds
a532da42: folds
97e300ed: raises $0.1 to $0.15
ee19881a: folds
9e737c95: folds
b49a0d77: calls $0.1
*** FLOP *** [9d 9c 8s]
b49a0d77: checks
97e300ed: bets $0.16
b49a0d77: folds
Uncalled bet ($0.16) returned to 97e300ed
*** SHOWDOWN ***
97e300ed collected $0.31 from pot
*** SUMMARY ***
Total pot $0.32 | Rake $0.01 | Jackpot $0 | Bingo $0 | Fortune $0 | Tax $0
Board [9d 9c 8s]
Seat 1: ee19881a (button) folded before Flop (didn't bet)
Seat 2: 9e737c95 (small blind) folded before Flop
Seat 3: b49a0d77 (big blind) folded on the Flop
Seat 4: Hero folded before Flop (didn't bet)
Seat 5: a532da42 folded before Flop (didn't bet)
Seat 6: 97e300ed won ($0.31)


Poker Hand #RC2078582543: Hold'em No Limit ($0.02/$0.05) - 2023/12/22 22:01:48
Table 'RushAndCash805572' 6-max Seat #1 is the button
Seat 1: ed26e80a ($8.61 in chips)
Seat 2: 354c4fad ($4.36 in chips)
Seat 3: ab5dffec ($6.33 in chips)
Seat 4: Hero ($5.61 in chips)
Seat 5: da6ead6f ($5.23 in chips)
Seat 6: 3d582dec ($5.39 in chips)
354c4fad: posts small blind $0.02
ab5dffec: posts big blind $0.05
*** HOLE CARDS ***
Dealt to ed26e80a 
Dealt to 354c4fad 
Dealt to ab5dffec 
Dealt to Hero [Ad 4s]
Dealt to da6ead6f 
Dealt to 3d582dec 
Hero: folds
da6ead6f: folds
3d582dec: raises $0.05 to $0.1
ed26e80a: folds
354c4fad: folds
ab5dffec: calls $0.05
*** FLOP *** [Qs Ac 5s]
ab5dffec: checks
3d582dec: bets $0.18
ab5dffec: folds
Uncalled bet ($0.18) returned to 3d582dec
*** SHOWDOWN ***
3d582dec collected $0.21 from pot
*** SUMMARY ***
Total pot $0.22 | Rake $0.01 | Jackpot $0 | Bingo $0 | Fortune $0 | Tax $0
Board [Qs Ac 5s]
Seat 1: ed26e80a (button) folded before Flop (didn't bet)
Seat 2: 354c4fad (small blind) folded before Flop
Seat 3: ab5dffec (big blind) folded on the Flop
Seat 4: Hero folded before Flop (didn't bet)
Seat 5: da6ead6f folded before Flop (didn't bet)
Seat 6: 3d582dec won ($0.21)


Poker Hand #RC2078582475: Hold'em No Limit ($0.02/$0.05) - 2023/12/22 22:01:44
Table 'RushAndCash805544' 6-max Seat #1 is the button
Seat 1: c90c0909 ($5.34 in chips)
Seat 2: 7faa6e20 ($6.69 in chips)
Seat 3: ed26e80a ($8.66 in chips)
Seat 4: aa4f5482 ($8.4 in chips)
Seat 5: Hero ($5.61 in chips)
Seat 6: bba39737 ($6.88 in chips)
7faa6e20: posts small blind $0.02
ed26e80a: posts big blind $0.05
*** HOLE CARDS ***
Dealt to c90c0909 
Dealt to 7faa6e20 
Dealt to ed26e80a 
Dealt to aa4f5482 
Dealt to Hero [Ah 9c]
Dealt to bba39737 
aa4f5482: raises $0.08 to $0.13
Hero: folds
bba39737: folds
c90c0909: folds
7faa6e20: folds
ed26e80a: folds
Uncalled bet ($0.08) returned to aa4f5482
*** SHOWDOWN ***
aa4f5482 collected $0.12 from pot
*** SUMMARY ***
Total pot $0.12 | Rake $0 | Jackpot $0 | Bingo $0 | Fortune $0 | Tax $0
Seat 1: c90c0909 (button) folded before Flop (didn't bet)
Seat 2: 7faa6e20 (small blind) folded before Flop
Seat 3: ed26e80a (big blind) folded before Flop
Seat 4: aa4f5482 collected ($0.12)
Seat 5: Hero folded before Flop (didn't bet)
Seat 6: bba39737 folded before Flop (didn't bet)


Poker Hand #RC2078582411: Hold'em No Limit ($0.02/$0.05) - 2023/12/22 22:01:40
Table 'RushAndCash805516' 6-max Seat #1 is the button
Seat 1: 32cf626d ($5.07 in chips)
Seat 2: 548ecbec ($7.69 in chips)
Seat 3: ce689ce4 ($5.52 in chips)
Seat 4: Hero ($5.61 in chips)
Seat 5: 2520bab9 ($5.02 in chips)
Seat 6: 584b7eb7 ($5.32 in chips)
548ecbec: posts small blind $0.02
ce689ce4: posts big blind $0.05
*** HOLE CARDS ***
Dealt to 32cf626d 
Dealt to 548ecbec 
Dealt to ce689ce4 
Dealt to Hero [3h Td]
Dealt to 2520bab9 
Dealt to 584b7eb7 
Hero: folds
2520bab9: folds
584b7eb7: raises $0.05 to $0.1
32cf626d: folds
548ecbec: folds
ce689ce4: folds
Uncalled bet ($0.05) returned to 584b7eb7
*** SHOWDOWN ***
584b7eb7 collected $0.12 from pot
*** SUMMARY ***
Total pot $0.12 | Rake $0 | Jackpot $0 | Bingo $0 | Fortune $0 | Tax $0
Seat 1: 32cf626d (button) folded before Flop (didn't bet)
Seat 2: 548ecbec (small blind) folded before Flop
Seat 3: ce689ce4 (big blind) folded before Flop
Seat 4: Hero folded before Flop (didn't bet)
Seat 5: 2520bab9 folded before Flop (didn't bet)
Seat 6: 584b7eb7 collected ($0.12)


Poker Hand #RC2078582351: Hold'em No Limit ($0.02/$0.05) - 2023/12/22 22:01:37
Table 'RushAndCash805488' 6-max Seat #1 is the button
Seat 1: 584b7eb7 ($5.32 in chips)
Seat 2: a89c43c ($2.65 in chips)
Seat 3: 5dd9d007 ($3.37 in chips)
Seat 4: efbf8ee8 ($12.64 in chips)
Seat 5: 40a1742d ($10.1 in chips)
Seat 6: Hero ($5.61 in chips)
a89c43c: posts small blind $0.02
5dd9d007: posts big blind $0.05
*** HOLE CARDS ***
Dealt to 584b7eb7 
Dealt to a89c43c 
Dealt to 5dd9d007 
Dealt to efbf8ee8 
Dealt to 40a1742d 
Dealt to Hero [2s 8h]
efbf8ee8: raises $0.05 to $0.1
40a1742d: folds
Hero: folds
584b7eb7: folds
a89c43c: folds
5dd9d007: calls $0.05
*** FLOP *** [Jc Qh 3h]
5dd9d007: checks
efbf8ee8: bets $0.12
5dd9d007: folds
Uncalled bet ($0.12) returned to efbf8ee8
*** SHOWDOWN ***
efbf8ee8 collected $0.21 from pot
*** SUMMARY ***
Total pot $0.22 | Rake $0.01 | Jackpot $0 | Bingo $0 | Fortune $0 | Tax $0
Board [Jc Qh 3h]
Seat 1: 584b7eb7 (button) folded before Flop (didn't bet)
Seat 2: a89c43c (small blind) folded before Flop
Seat 3: 5dd9d007 (big blind) folded on the Flop
Seat 4: efbf8ee8 won ($0.21)
Seat 5: 40a1742d folded before Flop (didn't bet)
Seat 6: Hero folded before Flop (didn't bet)


Poker Hand #RC2078582261: Hold'em No Limit ($0.02/$0.05) - 2023/12/22 22:01:31
Table 'RushAndCash805450' 6-max Seat #1 is the button
Seat 1: 1259a422 ($7.19 in chips)
Seat 2: f2833e42 ($10.04 in chips)
Seat 3: 317ccf77 ($4.28 in chips)
Seat 4: 46892673 ($5.72 in chips)
Seat 5: Hero ($5.61 in chips)
Seat 6: 4520f334 ($3.36 in chips)
f2833e42: posts small blind $0.02
317ccf77: posts big blind $0.05
*** HOLE CARDS ***
Dealt to 1259a422 
Dealt to f2833e42 
Dealt to 317ccf77 
Dealt to 46892673 
Dealt to Hero [5s 9c]
Dealt to 4520f334 
46892673: folds
Hero: folds
4520f334: folds
1259a422: folds
f2833e42: raises $0.1 to $0.15
317ccf77: folds
Uncalled bet ($0.1) returned to f2833e42
*** SHOWDOWN ***
f2833e42 collected $0.1 from pot
*** SUMMARY ***
Total pot $0.1 | Rake $0 | Jackpot $0 | Bingo $0 | Fortune $0 | Tax $0
Seat 1: 1259a422 (button) folded before Flop (didn't bet)
Seat 2: f2833e42 (small blind) collected ($0.1)
Seat 3: 317ccf77 (big blind) folded before Flop
Seat 4: 46892673 folded before Flop (didn't bet)
Seat 5: Hero folded before Flop (didn't bet)
Seat 6: 4520f334 folded before Flop (didn't bet)


Poker Hand #RC2078582111: Hold'em No Limit ($0.02/$0.05) - 2023/12/22 22:01:23
Table 'RushAndCash805380' 6-max Seat #1 is the button
Seat 1: 58864a6e ($16.3 in chips)
Seat 2: 37a644bb ($5 in chips)
Seat 3: Hero ($5.66 in chips)
Seat 4: b0755516 ($5 in chips)
Seat 5: 3487746e ($5 in chips)
Seat 6: 3748ad62 ($6.63 in chips)
37a644bb: posts small blind $0.02
Hero: posts big blind $0.05
*** HOLE CARDS ***
Dealt to 58864a6e 
Dealt to 37a644bb 
Dealt to Hero [2d 9s]
Dealt to b0755516 
Dealt to 3487746e 
Dealt to 3748ad62 
b0755516: folds
3487746e: folds
3748ad62: folds
58864a6e: raises $0.1 to $0.15
37a644bb: folds
Hero: folds
Uncalled bet ($0.1) returned to 58864a6e
*** SHOWDOWN ***
58864a6e collected $0.12 from pot
*** SUMMARY ***
Total pot $0.12 | Rake $0 | Jackpot $0 | Bingo $0 | Fortune $0 | Tax $0
Seat 1: 58864a6e (button) collected ($0.12)
Seat 2: 37a644bb (small blind) folded before Flop
Seat 3: Hero (big blind) folded before Flop
Seat 4: b0755516 folded before Flop (didn't bet)
Seat 5: 3487746e folded before Flop (didn't bet)
Seat 6: 3748ad62 folded before Flop (didn't bet)


Poker Hand #RC2078582001: Hold'em No Limit ($0.02/$0.05) - 2023/12/22 22:01:16
Table 'RushAndCash805327' 6-max Seat #1 is the button
Seat 1: Hero ($5.66 in chips)
Seat 2: c3adc948 ($17.16 in chips)
Seat 3: 2af18136 ($4.27 in chips)
Seat 4: 77a2d2f ($4.83 in chips)
Seat 5: 2fb7c647 ($1.99 in chips)
Seat 6: 2643d6fa ($5 in chips)
c3adc948: posts small blind $0.02
2af18136: posts big blind $0.05
*** HOLE CARDS ***
Dealt to Hero [Qd Ts]
Dealt to c3adc948 
Dealt to 2af18136 
Dealt to 77a2d2f 
Dealt to 2fb7c647 
Dealt to 2643d6fa 
77a2d2f: folds
2fb7c647: folds
2643d6fa: folds
Hero: folds
c3adc948: folds
Uncalled bet ($0.03) returned to 2af18136
*** SHOWDOWN ***
2af18136 collected $0.04 from pot
*** SUMMARY ***
Total pot $0.04 | Rake $0 | Jackpot $0 | Bingo $0 | Fortune $0 | Tax $0
Seat 1: Hero (button) folded before Flop (didn't bet)
Seat 2: c3adc948 (small blind) folded before Flop
Seat 3: 2af18136 (big blind) collected ($0.04)
Seat 4: 77a2d2f folded before Flop (didn't bet)
Seat 5: 2fb7c647 folded before Flop (didn't bet)
Seat 6: 2643d6fa folded before Flop (didn't bet)


Poker Hand #RC2078580990: Hold'em No Limit ($0.02/$0.05) - 2023/12/22 22:00:18
Table 'RushAndCash804856' 6-max Seat #1 is the button
Seat 1: a8629ffc ($3.02 in chips)
Seat 2: 40a1742d ($5 in chips)
Seat 3: 801c157f ($26.5 in chips)
Seat 4: Hero ($5 in chips)
Seat 5: afc1ca79 ($4.33 in chips)
Seat 6: 2af18136 ($4.93 in chips)
40a1742d: posts small blind $0.02
801c157f: posts big blind $0.05
*** HOLE CARDS ***
Dealt to a8629ffc 
Dealt to 40a1742d 
Dealt to 801c157f 
Dealt to Hero [5s 5h]
Dealt to afc1ca79 
Dealt to 2af18136 
Hero: raises $0.05 to $0.1
afc1ca79: folds
2af18136: calls $0.1
a8629ffc: folds
40a1742d: folds
801c157f: folds
*** FLOP *** [Tc 8h 5d]
Hero: checks
2af18136: checks
*** TURN *** [Tc 8h 5d] [9d]
Hero: bets $0.14
2af18136: calls $0.14
*** RIVER *** [Tc 8h 5d 9d] [8c]
Hero: bets $0.42
2af18136: calls $0.42
Hero: shows [5s 5h] (Fives Full over Eights)
2af18136: shows [3h 3s] (Pair of Eights and Pair of Treys)
*** SHOWDOWN ***
Hero collected $1.32 from pot
*** SUMMARY ***
Total pot $1.39 | Rake $0.07 | Jackpot $0 | Bingo $0 | Fortune $0 | Tax $0
Board [Tc 8h 5d 9d 8c]
Seat 1: a8629ffc (button) folded before Flop (didn't bet)
Seat 2: 40a1742d (small blind) folded before Flop
Seat 3: 801c157f (big blind) folded before Flop
Seat 4: Hero showed [5s 5h] and won ($1.32) with Fives Full over Eights
Seat 5: afc1ca79 folded before Flop (didn't bet)
Seat 6: 2af18136 showed [3h 3s] and lost with Pair of Eights and Pair of Treys


Poker Hand #RC2078580881: Hold'em No Limit ($0.02/$0.05) - 2023/12/22 22:00:12
Table 'RushAndCash804806' 6-max Seat #1 is the button
Seat 1: 277673c ($5.01 in chips)
Seat 2: 570cf06f ($5.08 in chips)
Seat 3: ef1573b1 ($9.87 in chips)
Seat 4: Hero ($5 in chips)
Seat 5: e0f80030 ($5.07 in chips)
Seat 6: d2e52b8d ($33.51 in chips)
570cf06f: posts small blind $0.02
ef1573b1: posts big blind $0.05
*** HOLE CARDS ***
Dealt to 277673c 
Dealt to 570cf06f 
Dealt to ef1573b1 
Dealt to Hero [7c Jc]
Dealt to e0f80030 
Dealt to d2e52b8d 
Hero: folds
e0f80030: raises $0.06 to $0.11
d2e52b8d: folds
277673c: folds
570cf06f: calls $0.09
ef1573b1: calls $0.06
*** FLOP *** [8d 8h 6h]
570cf06f: checks
ef1573b1: checks
e0f80030: checks
*** TURN *** [8d 8h 6h] [Kc]
570cf06f: bets $0.17
ef1573b1: folds
e0f80030: folds
Uncalled bet ($0.17) returned to 570cf06f
570cf06f: shows [Kd] (Pair of Kings and Pair of Eights)
*** SHOWDOWN ***
570cf06f collected $0.32 from pot
*** SUMMARY ***
Total pot $0.33 | Rake $0.01 | Jackpot $0 | Bingo $0 | Fortune $0 | Tax $0
Board [8d 8h 6h Kc]
Seat 1: 277673c (button) folded before Flop (didn't bet)
Seat 2: 570cf06f (small blind) showed [Kd] and won ($0.32)
Seat 3: ef1573b1 (big blind) folded on the Turn
Seat 4: Hero folded before Flop (didn't bet)
Seat 5: e0f80030 folded on the Turn
Seat 6: d2e52b8d folded before Flop (didn't bet)


Poker Hand #RC2078580804: Hold'em No Limit ($0.02/$0.05) - 2023/12/22 22:00:07
Table 'RushAndCash804773' 6-max Seat #1 is the button
Seat 1: 73f9c9d7 ($5 in chips)
Seat 2: Hero ($5 in chips)
Seat 3: 57eb4842 ($5.14 in chips)
Seat 4: 2bb677ff ($8.37 in chips)
Seat 5: 859547f3 ($5.19 in chips)
Seat 6: 418df7c3 ($3.89 in chips)
Hero: posts small blind $0.02
57eb4842: posts big blind $0.05
*** HOLE CARDS ***
Dealt to 73f9c9d7 
Dealt to Hero [Jd 8s]
Dealt to 57eb4842 
Dealt to 2bb677ff 
Dealt to 859547f3 
Dealt to 418df7c3 
2bb677ff: folds
859547f3: raises $0.05 to $0.1
418df7c3: folds
73f9c9d7: folds
Hero: folds
57eb4842: folds
Uncalled bet ($0.05) returned to 859547f3
*** SHOWDOWN ***
859547f3 collected $0.12 from pot
*** SUMMARY ***
Total pot $0.12 | Rake $0 | Jackpot $0 | Bingo $0 | Fortune $0 | Tax $0
Seat 1: 73f9c9d7 (button) folded before Flop (didn't bet)
Seat 2: Hero (small blind) folded before Flop
Seat 3: 57eb4842 (big blind) folded before Flop
Seat 4: 2bb677ff folded before Flop (didn't bet)
Seat 5: 859547f3 collected ($0.12)
Seat 6: 418df7c3 folded before Flop (didn't bet)


Poker Hand #RC2078580732: Hold'em No Limit ($0.02/$0.05) - 2023/12/22 22:00:03
Table 'RushAndCash804744' 6-max Seat #1 is the button
Seat 1: 7c10f852 ($35.56 in chips)
Seat 2: e3e578eb ($5.09 in chips)
Seat 3: a75d4daa ($5.19 in chips)
Seat 4: b5577ea2 ($5.29 in chips)
Seat 5: Hero ($5 in chips)
Seat 6: 9601129f ($8.81 in chips)
e3e578eb: posts small blind $0.02
a75d4daa: posts big blind $0.05
*** HOLE CARDS ***
Dealt to 7c10f852 
Dealt to e3e578eb 
Dealt to a75d4daa 
Dealt to b5577ea2 
Dealt to Hero [5c 3c]
Dealt to 9601129f 
b5577ea2: raises $0.05 to $0.1
Hero: folds
9601129f: folds
7c10f852: folds
e3e578eb: folds
a75d4daa: folds
Uncalled bet ($0.05) returned to b5577ea2
*** SHOWDOWN ***
b5577ea2 collected $0.12 from pot
*** SUMMARY ***
Total pot $0.12 | Rake $0 | Jackpot $0 | Bingo $0 | Fortune $0 | Tax $0
Seat 1: 7c10f852 (button) folded before Flop (didn't bet)
Seat 2: e3e578eb (small blind) folded before Flop
Seat 3: a75d4daa (big blind) folded before Flop
Seat 4: b5577ea2 collected ($0.12)
Seat 5: Hero folded before Flop (didn't bet)
Seat 6: 9601129f folded before Flop (didn't bet)


Poker Hand #RC2078580653: Hold'em No Limit ($0.02/$0.05) - 2023/12/22 21:59:59
Table 'RushAndCash804709' 6-max Seat #1 is the button
Seat 1: Hero ($5 in chips)
Seat 2: 463feb61 ($6.39 in chips)
Seat 3: 5f11c3da ($16.09 in chips)
Seat 4: 7385f3 ($4.64 in chips)
Seat 5: 21a497ff ($5.07 in chips)
Seat 6: 17e936 ($5.14 in chips)
463feb61: posts small blind $0.02
5f11c3da: posts big blind $0.05
*** HOLE CARDS ***
Dealt to Hero [Td 6d]
Dealt to 463feb61 
Dealt to 5f11c3da 
Dealt to 7385f3 
Dealt to 21a497ff 
Dealt to 17e936 
7385f3: folds
21a497ff: folds
17e936: calls $0.05
Hero: folds
463feb61: folds
5f11c3da: checks
*** FLOP *** [6s Js Kh]
5f11c3da: checks
17e936: bets $0.06
5f11c3da: calls $0.06
*** TURN *** [6s Js Kh] [4d]
5f11c3da: checks
17e936: bets $0.12
5f11c3da: calls $0.12
*** RIVER *** [6s Js Kh 4d] [7c]
5f11c3da: checks
17e936: checks
5f11c3da: shows [9s Jh] (Pair of Jacks)
17e936: shows [8h 8c] (Pair of Eights)
*** SHOWDOWN ***
5f11c3da collected $0.46 from pot
*** SUMMARY ***
Total pot $0.48 | Rake $0.02 | Jackpot $0 | Bingo $0 | Fortune $0 | Tax $0
Board [6s Js Kh 4d 7c]
Seat 1: Hero (button) folded before Flop (didn't bet)
Seat 2: 463feb61 (small blind) folded before Flop
Seat 3: 5f11c3da (big blind) showed [9s Jh] and won ($0.46) with Pair of Jacks
Seat 4: 7385f3 folded before Flop (didn't bet)
Seat 5: 21a497ff folded before Flop (didn't bet)
Seat 6: 17e936 showed [8h 8c] and lost with Pair of Eights


Poker Hand #RC2078580541: Hold'em No Limit ($0.02/$0.05) - 2023/12/22 21:59:52
Table 'RushAndCash804657' 6-max Seat #1 is the button
Seat 1: 2bd4532c ($3.41 in chips)
Seat 2: Hero ($5 in chips)
Seat 3: 8626eae9 ($5 in chips)
Seat 4: 7736e9f3 ($5.3 in chips)
Seat 5: 9c51ae09 ($5.68 in chips)
Seat 6: 4b46876e ($9.55 in chips)
Hero: posts small blind $0.02
8626eae9: posts big blind $0.05
*** HOLE CARDS ***
Dealt to 2bd4532c 
Dealt to Hero [2s 9d]
Dealt to 8626eae9 
Dealt to 7736e9f3 
Dealt to 9c51ae09 
Dealt to 4b46876e 
7736e9f3: folds
9c51ae09: folds
4b46876e: folds
2bd4532c: raises $0.12 to $0.17
Hero: folds
8626eae9: folds
Uncalled bet ($0.12) returned to 2bd4532c
*** SHOWDOWN ***
2bd4532c collected $0.12 from pot
*** SUMMARY ***
Total pot $0.12 | Rake $0 | Jackpot $0 | Bingo $0 | Fortune $0 | Tax $0
Seat 1: 2bd4532c (button) collected ($0.12)
Seat 2: Hero (small blind) folded before Flop
Seat 3: 8626eae9 (big blind) folded before Flop
Seat 4: 7736e9f3 folded before Flop (didn't bet)
Seat 5: 9c51ae09 folded before Flop (didn't bet)
Seat 6: 4b46876e folded before Flop (didn't bet)


Poker Hand #RC2078579958: Hold'em No Limit ($0.02/$0.05) - 2023/12/22 21:59:18
Table 'RushAndCash804383' 6-max Seat #1 is the button
Seat 1: 755667f9 ($5.05 in chips)
Seat 2: 31a55fda ($5.19 in chips)
Seat 3: Hero ($5 in chips)
Seat 4: c3c9a58d ($18.96 in chips)
Seat 5: a6b60e2c ($5.68 in chips)
Seat 6: bb8cf690 ($5 in chips)
31a55fda: posts small blind $0.02
Hero: posts big blind $0.05
*** HOLE CARDS ***
Dealt to 755667f9 
Dealt to 31a55fda 
Dealt to Hero [Ad 9s]
Dealt to c3c9a58d 
Dealt to a6b60e2c 
Dealt to bb8cf690 
c3c9a58d: folds
a6b60e2c: raises $0.05 to $0.1
bb8cf690: folds
755667f9: folds
31a55fda: folds
Hero: calls $0.05
*** FLOP *** [4d 2d 8c]
Hero: checks
a6b60e2c: bets $0.11
Hero: calls $0.11
*** TURN *** [4d 2d 8c] [Qs]
Hero: checks
a6b60e2c: bets $0.33
Hero: folds
Uncalled bet ($0.33) returned to a6b60e2c
*** SHOWDOWN ***
a6b60e2c collected $0.42 from pot
*** SUMMARY ***
Total pot $0.44 | Rake $0.02 | Jackpot $0 | Bingo $0 | Fortune $0 | Tax $0
Board [4d 2d 8c Qs]
Seat 1: 755667f9 (button) folded before Flop (didn't bet)
Seat 2: 31a55fda (small blind) folded before Flop
Seat 3: Hero (big blind) folded on the Turn
Seat 4: c3c9a58d folded before Flop (didn't bet)
Seat 5: a6b60e2c won ($0.42)
Seat 6: bb8cf690 folded before Flop (didn't bet)


Poker Hand #RC2078579877: Hold'em No Limit ($0.02/$0.05) - 2023/12/22 21:59:14
Table 'RushAndCash804340' 6-max Seat #1 is the button
Seat 1: d4529d70 ($5.53 in chips)
Seat 2: 3580bebf ($5.29 in chips)
Seat 3: 469c47cc ($13.68 in chips)
Seat 4: 725fcf25 ($14.27 in chips)
Seat 5: Hero ($5 in chips)
Seat 6: bcaa3feb ($5.3 in chips)
3580bebf: posts small blind $0.02
469c47cc: posts big blind $0.05
*** HOLE CARDS ***
Dealt to d4529d70 
Dealt to 3580bebf 
Dealt to 469c47cc 
Dealt to 725fcf25 
Dealt to Hero [6d 5h]
Dealt to bcaa3feb 
725fcf25: raises $0.08 to $0.13
Hero: folds
bcaa3feb: calls $0.13
d4529d70: folds
3580bebf: raises $0.52 to $0.65
469c47cc: folds
725fcf25: folds
bcaa3feb: folds
Uncalled bet ($0.52) returned to 3580bebf
*** SHOWDOWN ***
3580bebf collected $0.42 from pot
*** SUMMARY ***
Total pot $0.44 | Rake $0.02 | Jackpot $0 | Bingo $0 | Fortune $0 | Tax $0
Seat 1: d4529d70 (button) folded before Flop (didn't bet)
Seat 2: 3580bebf (small blind) collected ($0.42)
Seat 3: 469c47cc (big blind) folded before Flop
Seat 4: 725fcf25 folded before Flop
Seat 5: Hero folded before Flop (didn't bet)
Seat 6: bcaa3feb folded before Flop


Poker Hand #RC2078579792: Hold'em No Limit ($0.02/$0.05) - 2023/12/22 21:59:10
Table 'RushAndCash804302' 6-max Seat #1 is the button
Seat 1: Hero ($5 in chips)
Seat 2: 2af18136 ($5.14 in chips)
Seat 3: 7faa6e20 ($7.23 in chips)
Seat 4: 2e20f1d7 ($4.2 in chips)
Seat 5: 8a94bd25 ($5.97 in chips)
Seat 6: b5577ea2 ($4.93 in chips)
2af18136: posts small blind $0.02
7faa6e20: posts big blind $0.05
*** HOLE CARDS ***
Dealt to Hero [4c Ts]
Dealt to 2af18136 
Dealt to 7faa6e20 
Dealt to 2e20f1d7 
Dealt to 8a94bd25 
Dealt to b5577ea2 
2e20f1d7: folds
8a94bd25: folds
b5577ea2: raises $0.05 to $0.1
Hero: folds
2af18136: folds
7faa6e20: calls $0.05
*** FLOP *** [7h 2c 8d]
7faa6e20: checks
b5577ea2: bets $0.08
7faa6e20: raises $0.19 to $0.27
b5577ea2: calls $0.19
*** TURN *** [7h 2c 8d] [6d]
7faa6e20: checks
b5577ea2: bets $0.57
7faa6e20: folds
Uncalled bet ($0.57) returned to b5577ea2
*** SHOWDOWN ***
b5577ea2 collected $0.73 from pot
*** SUMMARY ***
Total pot $0.76 | Rake $0.03 | Jackpot $0 | Bingo $0 | Fortune $0 | Tax $0
Board [7h 2c 8d 6d]
Seat 1: Hero (button) folded before Flop (didn't bet)
Seat 2: 2af18136 (small blind) folded before Flop
Seat 3: 7faa6e20 (big blind) folded on the Turn
Seat 4: 2e20f1d7 folded before Flop (didn't bet)
Seat 5: 8a94bd25 folded before Flop (didn't bet)
Seat 6: b5577ea2 won ($0.73)


Poker Hand #RC2078579571: Hold'em No Limit ($0.02/$0.05) - 2023/12/22 21:58:57
Table 'RushAndCash804205' 6-max Seat #1 is the button
Seat 1: 1c28bbd5 ($4.69 in chips)
Seat 2: Hero ($5 in chips)
Seat 3: ca88dd67 ($8.47 in chips)
Seat 4: 9e737c95 ($3.94 in chips)
Seat 5: 153b1345 ($9.01 in chips)
Seat 6: 17e936 ($5.07 in chips)
Hero: posts small blind $0.02
ca88dd67: posts big blind $0.05
*** HOLE CARDS ***
Dealt to 1c28bbd5 
Dealt to Hero [5h 2d]
Dealt to ca88dd67 
Dealt to 9e737c95 
Dealt to 153b1345 
Dealt to 17e936 
9e737c95: folds
153b1345: folds
17e936: raises $0.05 to $0.1
1c28bbd5: folds
Hero: folds
ca88dd67: folds
Uncalled bet ($0.05) returned to 17e936
*** SHOWDOWN ***
17e936 collected $0.12 from pot
*** SUMMARY ***
Total pot $0.12 | Rake $0 | Jackpot $0 | Bingo $0 | Fortune $0 | Tax $0
Seat 1: 1c28bbd5 (button) folded before Flop (didn't bet)
Seat 2: Hero (small blind) folded before Flop
Seat 3: ca88dd67 (big blind) folded before Flop
Seat 4: 9e737c95 folded before Flop (didn't bet)
Seat 5: 153b1345 folded before Flop (didn't bet)
Seat 6: 17e936 collected ($0.12)


Poker Hand #RC2078579411: Hold'em No Limit ($0.02/$0.05) - 2023/12/22 21:58:48
Table 'RushAndCash804132' 6-max Seat #1 is the button
Seat 1: 2643d6fa ($5.29 in chips)
Seat 2: cd49ac31 ($4.8 in chips)
Seat 3: f1f11b26 ($10.87 in chips)
Seat 4: 9f5fff7b ($5 in chips)
Seat 5: 570cf06f ($5.34 in chips)
Seat 6: Hero ($5 in chips)
cd49ac31: posts small blind $0.02
f1f11b26: posts big blind $0.05
*** HOLE CARDS ***
Dealt to 2643d6fa 
Dealt to cd49ac31 
Dealt to f1f11b26 
Dealt to 9f5fff7b 
Dealt to 570cf06f 
Dealt to Hero [4h 3c]
9f5fff7b: folds
570cf06f: folds
Hero: folds
2643d6fa: folds
cd49ac31: folds
Uncalled bet ($0.03) returned to f1f11b26
*** SHOWDOWN ***
f1f11b26 collected $0.04 from pot
*** SUMMARY ***
Total pot $0.04 | Rake $0 | Jackpot $0 | Bingo $0 | Fortune $0 | Tax $0
Seat 1: 2643d6fa (button) folded before Flop (didn't bet)
Seat 2: cd49ac31 (small blind) folded before Flop
Seat 3: f1f11b26 (big blind) collected ($0.04)
Seat 4: 9f5fff7b folded before Flop (didn't bet)
Seat 5: 570cf06f folded before Flop (didn't bet)
Seat 6: Hero folded before Flop (didn't bet)


Poker Hand #RC2078578666: Hold'em No Limit ($0.02/$0.05) - 2023/12/22 21:58:05
Table 'RushAndCash803796' 6-max Seat #1 is the button
Seat 1: 58782f5b ($4.93 in chips)
Seat 2: ee1691f8 ($8.29 in chips)
Seat 3: Hero ($5 in chips)
Seat 4: 7093f460 ($4.93 in chips)
Seat 5: f2833e42 ($10.12 in chips)
Seat 6: 9e9d954c ($4.93 in chips)
ee1691f8: posts small blind $0.02
Hero: posts big blind $0.05
*** HOLE CARDS ***
Dealt to 58782f5b 
Dealt to ee1691f8 
Dealt to Hero [Ad 2c]
Dealt to 7093f460 
Dealt to f2833e42 
Dealt to 9e9d954c 
7093f460: raises $0.05 to $0.1
f2833e42: folds
9e9d954c: folds
58782f5b: folds
ee1691f8: folds
Hero: calls $0.05
*** FLOP *** [Ts Qc 3s]
Hero: checks
7093f460: bets $0.11
Hero: folds
Uncalled bet ($0.11) returned to 7093f460
*** SHOWDOWN ***
7093f460 collected $0.21 from pot
*** SUMMARY ***
Total pot $0.22 | Rake $0.01 | Jackpot $0 | Bingo $0 | Fortune $0 | Tax $0
Board [Ts Qc 3s]
Seat 1: 58782f5b (button) folded before Flop (didn't bet)
Seat 2: ee1691f8 (small blind) folded before Flop
Seat 3: Hero (big blind) folded on the Flop
Seat 4: 7093f460 won ($0.21)
Seat 5: f2833e42 folded before Flop (didn't bet)
Seat 6: 9e9d954c folded before Flop (didn't bet)


Poker Hand #RC2078578561: Hold'em No Limit ($0.02/$0.05) - 2023/12/22 21:57:59
Table 'RushAndCash803747' 6-max Seat #1 is the button
Seat 1: 8df660de ($5 in chips)
Seat 2: fcb65fa9 ($4.26 in chips)
Seat 3: c7726580 ($5 in chips)
Seat 4: 2afe98d4 ($4.44 in chips)
Seat 5: a8629ffc ($4.08 in chips)
Seat 6: Hero ($5 in chips)
fcb65fa9: posts small blind $0.02
c7726580: posts big blind $0.05
*** HOLE CARDS ***
Dealt to 8df660de 
Dealt to fcb65fa9 
Dealt to c7726580 
Dealt to 2afe98d4 
Dealt to a8629ffc 
Dealt to Hero [7h As]
2afe98d4: folds
a8629ffc: folds
Hero: folds
8df660de: raises $0.08 to $0.13
fcb65fa9: folds
c7726580: folds
Uncalled bet ($0.08) returned to 8df660de
*** SHOWDOWN ***
8df660de collected $0.12 from pot
*** SUMMARY ***
Total pot $0.12 | Rake $0 | Jackpot $0 | Bingo $0 | Fortune $0 | Tax $0
Seat 1: 8df660de (button) collected ($0.12)
Seat 2: fcb65fa9 (small blind) folded before Flop
Seat 3: c7726580 (big blind) folded before Flop
Seat 4: 2afe98d4 folded before Flop (didn't bet)
Seat 5: a8629ffc folded before Flop (didn't bet)
Seat 6: Hero folded before Flop (didn't bet)


Poker Hand #RC2078578489: Hold'em No Limit ($0.02/$0.05) - 2023/12/22 21:57:55
Table 'RushAndCash803711' 6-max Seat #1 is the button
Seat 1: 5b1212ec ($6.12 in chips)
Seat 2: ec5f3643 ($4.07 in chips)
Seat 3: 5a7ccd94 ($5.13 in chips)
Seat 4: Hero ($5 in chips)
Seat 5: 242358f0 ($6.1 in chips)
Seat 6: 5f9f6e5e ($5.05 in chips)
ec5f3643: posts small blind $0.02
5a7ccd94: posts big blind $0.05
*** HOLE CARDS ***
Dealt to 5b1212ec 
Dealt to ec5f3643 
Dealt to 5a7ccd94 
Dealt to Hero [9c Jd]
Dealt to 242358f0 
Dealt to 5f9f6e5e 
Hero: folds
242358f0: folds
5f9f6e5e: folds
5b1212ec: folds
ec5f3643: folds
Uncalled bet ($0.03) returned to 5a7ccd94
*** SHOWDOWN ***
5a7ccd94 collected $0.04 from pot
*** SUMMARY ***
Total pot $0.04 | Rake $0 | Jackpot $0 | Bingo $0 | Fortune $0 | Tax $0
Seat 1: 5b1212ec (button) folded before Flop (didn't bet)
Seat 2: ec5f3643 (small blind) folded before Flop
Seat 3: 5a7ccd94 (big blind) collected ($0.04)
Seat 4: Hero folded before Flop (didn't bet)
Seat 5: 242358f0 folded before Flop (didn't bet)
Seat 6: 5f9f6e5e folded before Flop (didn't bet)


Poker Hand #RC2078578376: Hold'em No Limit ($0.02/$0.05) - 2023/12/22 21:57:48
Table 'RushAndCash803658' 6-max Seat #1 is the button
Seat 1: e789f462 ($3.51 in chips)
Seat 2: d2518611 ($3.8 in chips)
Seat 3: b75c858f ($5.59 in chips)
Seat 4: Hero ($5 in chips)
Seat 5: 1e611c6e ($6.31 in chips)
Seat 6: 972d9171 ($11.66 in chips)
d2518611: posts small blind $0.02
b75c858f: posts big blind $0.05
*** HOLE CARDS ***
Dealt to e789f462 
Dealt to d2518611 
Dealt to b75c858f 
Dealt to Hero [5c Ts]
Dealt to 1e611c6e 
Dealt to 972d9171 
Hero: folds
1e611c6e: raises $0.05 to $0.1
972d9171: folds
e789f462: folds
d2518611: folds
b75c858f: folds
Uncalled bet ($0.05) returned to 1e611c6e
*** SHOWDOWN ***
1e611c6e collected $0.12 from pot
*** SUMMARY ***
Total pot $0.12 | Rake $0 | Jackpot $0 | Bingo $0 | Fortune $0 | Tax $0
Seat 1: e789f462 (button) folded before Flop (didn't bet)
Seat 2: d2518611 (small blind) folded before Flop
Seat 3: b75c858f (big blind) folded before Flop
Seat 4: Hero folded before Flop (didn't bet)
Seat 5: 1e611c6e collected ($0.12)
Seat 6: 972d9171 folded before Flop (didn't bet)


Poker Hand #RC2078577722: Hold'em No Limit ($0.02/$0.05) - 2023/12/22 21:57:11
Table 'RushAndCash803345' 6-max Seat #1 is the button
Seat 1: 806c9c64 ($3.78 in chips)
Seat 2: 680eb0e1 ($19.66 in chips)
Seat 3: 89f19970 ($5.43 in chips)
Seat 4: fafe49aa ($7.07 in chips)
Seat 5: 190cd877 ($6.16 in chips)
Seat 6: Hero ($5 in chips)
680eb0e1: posts small blind $0.02
89f19970: posts big blind $0.05
*** HOLE CARDS ***
Dealt to 806c9c64 
Dealt to 680eb0e1 
Dealt to 89f19970 
Dealt to fafe49aa 
Dealt to 190cd877 
Dealt to Hero [5d 4d]
fafe49aa: folds
190cd877: folds
Hero: raises $0.05 to $0.1
806c9c64: calls $0.1
680eb0e1: folds
89f19970: raises $0.48 to $0.58
Hero: folds
806c9c64: folds
Uncalled bet ($0.48) returned to 89f19970
*** SHOWDOWN ***
89f19970 collected $0.31 from pot
*** SUMMARY ***
Total pot $0.32 | Rake $0.01 | Jackpot $0 | Bingo $0 | Fortune $0 | Tax $0
Seat 1: 806c9c64 (button) folded before Flop
Seat 2: 680eb0e1 (small blind) folded before Flop
Seat 3: 89f19970 (big blind) collected ($0.31)
Seat 4: fafe49aa folded before Flop (didn't bet)
Seat 5: 190cd877 folded before Flop (didn't bet)
Seat 6: Hero folded before Flop


Poker Hand #RC2078577537: Hold'em No Limit ($0.02/$0.05) - 2023/12/22 21:57:00
Table 'RushAndCash803259' 6-max Seat #1 is the button
Seat 1: f9ff013a ($5.18 in chips)
Seat 2: a809eadb ($5 in chips)
Seat 3: Hero ($5 in chips)
Seat 4: 78624e82 ($5.46 in chips)
Seat 5: eb32f25a ($6.09 in chips)
Seat 6: 4e73adeb ($5 in chips)
a809eadb: posts small blind $0.02
Hero: posts big blind $0.05
*** HOLE CARDS ***
Dealt to f9ff013a 
Dealt to a809eadb 
Dealt to Hero [5s 7s]
Dealt to 78624e82 
Dealt to eb32f25a 
Dealt to 4e73adeb 
78624e82: raises $0.08 to $0.13
eb32f25a: folds
4e73adeb: folds
f9ff013a: folds
a809eadb: raises $0.31 to $0.44
Hero: folds
78624e82: folds
Uncalled bet ($0.31) returned to a809eadb
*** SHOWDOWN ***
a809eadb collected $0.3 from pot
*** SUMMARY ***
Total pot $0.31 | Rake $0.01 | Jackpot $0 | Bingo $0 | Fortune $0 | Tax $0
Seat 1: f9ff013a (button) folded before Flop (didn't bet)
Seat 2: a809eadb (small blind) collected ($0.3)
Seat 3: Hero (big blind) folded before Flop
Seat 4: 78624e82 folded before Flop
Seat 5: eb32f25a folded before Flop (didn't bet)
Seat 6: 4e73adeb folded before Flop (didn't bet)


Poker Hand #RC2078576844: Hold'em No Limit ($0.02/$0.05) - 2023/12/22 21:56:20
Table 'RushAndCash802939' 6-max Seat #1 is the button
Seat 1: Hero ($5.05 in chips)
Seat 2: d31038ce ($8.42 in chips)
Seat 3: 725fcf25 ($5.32 in chips)
Seat 4: 257cb6ea ($5.74 in chips)
Seat 5: 73f9c9d7 ($5.24 in chips)
Seat 6: c883264a ($11.73 in chips)
d31038ce: posts small blind $0.02
725fcf25: posts big blind $0.05
*** HOLE CARDS ***
Dealt to Hero [As 6s]
Dealt to d31038ce 
Dealt to 725fcf25 
Dealt to 257cb6ea 
Dealt to 73f9c9d7 
Dealt to c883264a 
257cb6ea: folds
73f9c9d7: folds
c883264a: folds
Hero: raises $0.08 to $0.13
d31038ce: folds
725fcf25: calls $0.08
*** FLOP *** [Tc 7d 5c]
725fcf25: checks
Hero: checks
*** TURN *** [Tc 7d 5c] [3h]
725fcf25: bets $0.14
Hero: folds
Uncalled bet ($0.14) returned to 725fcf25
*** SHOWDOWN ***
725fcf25 collected $0.27 from pot
*** SUMMARY ***
Total pot $0.28 | Rake $0.01 | Jackpot $0 | Bingo $0 | Fortune $0 | Tax $0
Board [Tc 7d 5c 3h]
Seat 1: Hero (button) folded on the Turn
Seat 2: d31038ce (small blind) folded before Flop
Seat 3: 725fcf25 (big blind) won ($0.27)
Seat 4: 257cb6ea folded before Flop (didn't bet)
Seat 5: 73f9c9d7 folded before Flop (didn't bet)
Seat 6: c883264a folded before Flop (didn't bet)


Poker Hand #RC2078576575: Hold'em No Limit ($0.02/$0.05) - 2023/12/22 21:56:03
Table 'RushAndCash802815' 6-max Seat #1 is the button
Seat 1: 17da2929 ($5.22 in chips)
Seat 2: Hero ($5.07 in chips)
Seat 3: 5902639 ($5 in chips)
Seat 4: 8bb72729 ($5 in chips)
Seat 5: f9df797f ($5.28 in chips)
Seat 6: 8af98014 ($5.88 in chips)
Hero: posts small blind $0.02
5902639: posts big blind $0.05
*** HOLE CARDS ***
Dealt to 17da2929 
Dealt to Hero [2d 3h]
Dealt to 5902639 
Dealt to 8bb72729 
Dealt to f9df797f 
Dealt to 8af98014 
8bb72729: folds
f9df797f: raises $0.05 to $0.1
8af98014: folds
17da2929: folds
Hero: folds
5902639: calls $0.05
*** FLOP *** [8c Ad Tc]
5902639: checks
f9df797f: checks
*** TURN *** [8c Ad Tc] [8d]
5902639: bets $0.08
f9df797f: folds
Uncalled bet ($0.08) returned to 5902639
*** SHOWDOWN ***
5902639 collected $0.21 from pot
*** SUMMARY ***
Total pot $0.22 | Rake $0.01 | Jackpot $0 | Bingo $0 | Fortune $0 | Tax $0
Board [8c Ad Tc 8d]
Seat 1: 17da2929 (button) folded before Flop (didn't bet)
Seat 2: Hero (small blind) folded before Flop
Seat 3: 5902639 (big blind) won ($0.21)
Seat 4: 8bb72729 folded before Flop (didn't bet)
Seat 5: f9df797f folded on the Turn
Seat 6: 8af98014 folded before Flop (didn't bet)


Poker Hand #RC2078576393: Hold'em No Limit ($0.02/$0.05) - 2023/12/22 21:55:52
Table 'RushAndCash802734' 6-max Seat #1 is the button
Seat 1: 491e69f2 ($5.93 in chips)
Seat 2: 88e57a08 ($14.63 in chips)
Seat 3: 1d81a4c5 ($8.96 in chips)
Seat 4: dd486414 ($5 in chips)
Seat 5: Hero ($5 in chips)
Seat 6: c7d7813b ($5 in chips)
88e57a08: posts small blind $0.02
1d81a4c5: posts big blind $0.05
*** HOLE CARDS ***
Dealt to 491e69f2 
Dealt to 88e57a08 
Dealt to 1d81a4c5 
Dealt to dd486414 
Dealt to Hero [6c Ac]
Dealt to c7d7813b 
dd486414: folds
Hero: raises $0.05 to $0.1
c7d7813b: folds
491e69f2: folds
88e57a08: folds
1d81a4c5: folds
Uncalled bet ($0.05) returned to Hero
*** SHOWDOWN ***
Hero collected $0.12 from pot
*** SUMMARY ***
Total pot $0.12 | Rake $0 | Jackpot $0 | Bingo $0 | Fortune $0 | Tax $0
Seat 1: 491e69f2 (button) folded before Flop (didn't bet)
Seat 2: 88e57a08 (small blind) folded before Flop
Seat 3: 1d81a4c5 (big blind) folded before Flop
Seat 4: dd486414 folded before Flop (didn't bet)
Seat 5: Hero collected ($0.12)
Seat 6: c7d7813b folded before Flop (didn't bet)


Poker Hand #RC2078576237: Hold'em No Limit ($0.02/$0.05) - 2023/12/22 21:55:42
Table 'RushAndCash802662' 6-max Seat #1 is the button
Seat 1: 30a2950b ($5 in chips)
Seat 2: Hero ($5 in chips)
Seat 3: 886872c9 ($6.6 in chips)
Seat 4: 214a7e26 ($5 in chips)
Seat 5: 25a36e51 ($0.86 in chips)
Seat 6: 93d5c821 ($11.7 in chips)
Hero: posts small blind $0.02
886872c9: posts big blind $0.05
*** HOLE CARDS ***
Dealt to 30a2950b 
Dealt to Hero [Kc 4c]
Dealt to 886872c9 
Dealt to 214a7e26 
Dealt to 25a36e51 
Dealt to 93d5c821 
214a7e26: folds
25a36e51: raises $0.1 to $0.15
93d5c821: folds
30a2950b: folds
Hero: folds
886872c9: folds
Uncalled bet ($0.1) returned to 25a36e51
*** SHOWDOWN ***
25a36e51 collected $0.12 from pot
*** SUMMARY ***
Total pot $0.12 | Rake $0 | Jackpot $0 | Bingo $0 | Fortune $0 | Tax $0
Seat 1: 30a2950b (button) folded before Flop (didn't bet)
Seat 2: Hero (small blind) folded before Flop
Seat 3: 886872c9 (big blind) folded before Flop
Seat 4: 214a7e26 folded before Flop (didn't bet)
Seat 5: 25a36e51 collected ($0.12)
Seat 6: 93d5c821 folded before Flop (didn't bet)


Poker Hand #RC2078575453: Hold'em No Limit ($0.02/$0.05) - 2023/12/22 21:54:56
Table 'RushAndCash802296' 6-max Seat #1 is the button
Seat 1: 548ecbec ($8.15 in chips)
Seat 2: 93d5c821 ($11.43 in chips)
Seat 3: Hero ($5.11 in chips)
Seat 4: f30308e3 ($5 in chips)
Seat 5: f4e201f0 ($10.35 in chips)
Seat 6: fa7bd554 ($6.13 in chips)
93d5c821: posts small blind $0.02
Hero: posts big blind $0.05
*** HOLE CARDS ***
Dealt to 548ecbec 
Dealt to 93d5c821 
Dealt to Hero [Jh Kd]
Dealt to f30308e3 
Dealt to f4e201f0 
Dealt to fa7bd554 
f30308e3: folds
f4e201f0: folds
fa7bd554: folds
548ecbec: folds
93d5c821: raises $0.05 to $0.1
Hero: calls $0.05
*** FLOP *** [As Qs Ac]
93d5c821: bets $0.05
Hero: raises $0.15 to $0.2
93d5c821: calls $0.15
*** TURN *** [As Qs Ac] [8h]
93d5c821: checks
Hero: checks
*** RIVER *** [As Qs Ac 8h] [6s]
93d5c821: checks
Hero: checks
93d5c821: shows [Qc 6c] (Pair of Aces and Pair of Queens)
Hero: shows [Jh Kd] (Pair of Aces)
*** SHOWDOWN ***
93d5c821 collected $0.57 from pot
*** SUMMARY ***
Total pot $0.6 | Rake $0.03 | Jackpot $0 | Bingo $0 | Fortune $0 | Tax $0
Board [As Qs Ac 8h 6s]
Seat 1: 548ecbec (button) folded before Flop (didn't bet)
Seat 2: 93d5c821 (small blind) showed [Qc 6c] and won ($0.57) with Pair of Aces and Pair of Queens
Seat 3: Hero (big blind) showed [Jh Kd] and lost with Pair of Aces
Seat 4: f30308e3 folded before Flop (didn't bet)
Seat 5: f4e201f0 folded before Flop (didn't bet)
Seat 6: fa7bd554 folded before Flop (didn't bet)


Poker Hand #RC2078575015: Hold'em No Limit ($0.02/$0.05) - 2023/12/22 21:54:31
Table 'RushAndCash802083' 6-max Seat #1 is the button
Seat 1: 235741f1 ($8.63 in chips)
Seat 2: 129846c0 ($5.02 in chips)
Seat 3: 49a9584 ($5.05 in chips)
Seat 4: 57689caa ($5 in chips)
Seat 5: fc7e8623 ($19.69 in chips)
Seat 6: Hero ($5 in chips)
129846c0: posts small blind $0.02
49a9584: posts big blind $0.05
*** HOLE CARDS ***
Dealt to 235741f1 
Dealt to 129846c0 
Dealt to 49a9584 
Dealt to 57689caa 
Dealt to fc7e8623 
Dealt to Hero [8d Td]
57689caa: folds
fc7e8623: folds
Hero: raises $0.05 to $0.1
235741f1: folds
129846c0: folds
49a9584: calls $0.05
*** FLOP *** [Ts 6d 9d]
49a9584: checks
Hero: bets $0.1
49a9584: folds
Uncalled bet ($0.1) returned to Hero
*** SHOWDOWN ***
Hero collected $0.21 from pot
*** SUMMARY ***
Total pot $0.22 | Rake $0.01 | Jackpot $0 | Bingo $0 | Fortune $0 | Tax $0
Board [Ts 6d 9d]
Seat 1: 235741f1 (button) folded before Flop (didn't bet)
Seat 2: 129846c0 (small blind) folded before Flop
Seat 3: 49a9584 (big blind) folded on the Flop
Seat 4: 57689caa folded before Flop (didn't bet)
Seat 5: fc7e8623 folded before Flop (didn't bet)
Seat 6: Hero won ($0.21)


Poker Hand #RC2078544571: Hold'em No Limit ($0.02/$0.05) - 2023/12/22 21:54:06
Table 'RushAndCash801864' 6-max Seat #1 is the button
Seat 1: 20ec78d4 ($5.17 in chips)
Seat 2: d25e9ff3 ($5.93 in chips)
Seat 3: 6c4d56b8 ($5.21 in chips)
Seat 4: 73c8f8b5 ($6.22 in chips)
Seat 5: Hero ($5.03 in chips)
Seat 6: aa4f5482 ($9.28 in chips)
d25e9ff3: posts small blind $0.02
6c4d56b8: posts big blind $0.05
*** HOLE CARDS ***
Dealt to 20ec78d4 
Dealt to d25e9ff3 
Dealt to 6c4d56b8 
Dealt to 73c8f8b5 
Dealt to Hero [9h Qh]
Dealt to aa4f5482 
73c8f8b5: folds
Hero: raises $0.05 to $0.1
aa4f5482: folds
20ec78d4: folds
d25e9ff3: folds
6c4d56b8: calls $0.05
*** FLOP *** [Kd Jc 2c]
6c4d56b8: bets $0.05
Hero: folds
Uncalled bet ($0.05) returned to 6c4d56b8
*** SHOWDOWN ***
6c4d56b8 collected $0.21 from pot
*** SUMMARY ***
Total pot $0.22 | Rake $0.01 | Jackpot $0 | Bingo $0 | Fortune $0 | Tax $0
Board [Kd Jc 2c]
Seat 1: 20ec78d4 (button) folded before Flop (didn't bet)
Seat 2: d25e9ff3 (small blind) folded before Flop
Seat 3: 6c4d56b8 (big blind) won ($0.21)
Seat 4: 73c8f8b5 folded before Flop (didn't bet)
Seat 5: Hero folded on the Flop
Seat 6: aa4f5482 folded before Flop (didn't bet)


Poker Hand #RC2078544509: Hold'em No Limit ($0.02/$0.05) - 2023/12/22 21:54:03
Table 'RushAndCash801836' 6-max Seat #1 is the button
Seat 1: 8af98014 ($5 in chips)
Seat 2: 59da0131 ($12.65 in chips)
Seat 3: e302c0c6 ($6.58 in chips)
Seat 4: e9deb15a ($15.16 in chips)
Seat 5: 859547f3 ($5.89 in chips)
Seat 6: Hero ($5.03 in chips)
59da0131: posts small blind $0.02
e302c0c6: posts big blind $0.05
*** HOLE CARDS ***
Dealt to 8af98014 
Dealt to 59da0131 
Dealt to e302c0c6 
Dealt to e9deb15a 
Dealt to 859547f3 
Dealt to Hero [4c 5h]
e9deb15a: folds
859547f3: folds
Hero: folds
8af98014: folds
59da0131: raises $0.1 to $0.15
e302c0c6: calls $0.1
*** FLOP *** [9c 8s 4d]
59da0131: bets $0.1
e302c0c6: calls $0.1
*** TURN *** [9c 8s 4d] [2s]
59da0131: checks
e302c0c6: bets $0.38
59da0131: calls $0.38
*** RIVER *** [9c 8s 4d 2s] [4h]
59da0131: checks
e302c0c6: bets $1.89
59da0131: calls $1.89
e302c0c6: shows [4s 7s] (Three Fours)
59da0131: shows [9s 3s] (Pair of Nines and Pair of Fours)
*** SHOWDOWN ***
e302c0c6 collected $4.82 from pot
*** SUMMARY ***
Total pot $5.04 | Rake $0.15 | Jackpot $0.07 | Bingo $0 | Fortune $0 | Tax $0
Board [9c 8s 4d 2s 4h]
Seat 1: 8af98014 (button) folded before Flop (didn't bet)
Seat 2: 59da0131 (small blind) showed [9s 3s] and lost with Pair of Nines and Pair of Fours
Seat 3: e302c0c6 (big blind) showed [4s 7s] and won ($4.82) with Three Fours
Seat 4: e9deb15a folded before Flop (didn't bet)
Seat 5: 859547f3 folded before Flop (didn't bet)
Seat 6: Hero folded before Flop (didn't bet)


Poker Hand #RC2078544444: Hold'em No Limit ($0.02/$0.05) - 2023/12/22 21:54:00
Table 'RushAndCash801806' 6-max Seat #1 is the button
Seat 1: b257878a ($5.36 in chips)
Seat 2: 308f9422 ($7.66 in chips)
Seat 3: 31a55fda ($5.06 in chips)
Seat 4: ee1f67f7 ($5.63 in chips)
Seat 5: 8369fc6c ($6.9 in chips)
Seat 6: Hero ($5.03 in chips)
308f9422: posts small blind $0.02
31a55fda: posts big blind $0.05
*** HOLE CARDS ***
Dealt to b257878a 
Dealt to 308f9422 
Dealt to 31a55fda 
Dealt to ee1f67f7 
Dealt to 8369fc6c 
Dealt to Hero [5d 6s]
ee1f67f7: folds
8369fc6c: folds
Hero: folds
b257878a: raises $5.31 to $5.36 and is all-in
308f9422: folds
31a55fda: folds
Uncalled bet ($5.31) returned to b257878a
*** SHOWDOWN ***
b257878a collected $0.12 from pot
*** SUMMARY ***
Total pot $0.12 | Rake $0 | Jackpot $0 | Bingo $0 | Fortune $0 | Tax $0
Seat 1: b257878a (button) collected ($0.12)
Seat 2: 308f9422 (small blind) folded before Flop
Seat 3: 31a55fda (big blind) folded before Flop
Seat 4: ee1f67f7 folded before Flop (didn't bet)
Seat 5: 8369fc6c folded before Flop (didn't bet)
Seat 6: Hero folded before Flop (didn't bet)


Poker Hand #RC2078544257: Hold'em No Limit ($0.02/$0.05) - 2023/12/22 21:53:50
Table 'RushAndCash801712' 6-max Seat #1 is the button
Seat 1: a07dccc7 ($5 in chips)
Seat 2: 2643d6fa ($5.59 in chips)
Seat 3: Hero ($5.01 in chips)
Seat 4: 9db3bc7b ($10.28 in chips)
Seat 5: 74a53cac ($19.59 in chips)
Seat 6: 2fb7c647 ($2.69 in chips)
2643d6fa: posts small blind $0.02
Hero: posts big blind $0.05
*** HOLE CARDS ***
Dealt to a07dccc7 
Dealt to 2643d6fa 
Dealt to Hero [3c Ad]
Dealt to 9db3bc7b 
Dealt to 74a53cac 
Dealt to 2fb7c647 
9db3bc7b: folds
74a53cac: folds
2fb7c647: folds
a07dccc7: folds
2643d6fa: folds
Uncalled bet ($0.03) returned to Hero
*** SHOWDOWN ***
Hero collected $0.04 from pot
*** SUMMARY ***
Total pot $0.04 | Rake $0 | Jackpot $0 | Bingo $0 | Fortune $0 | Tax $0
Seat 1: a07dccc7 (button) folded before Flop (didn't bet)
Seat 2: 2643d6fa (small blind) folded before Flop
Seat 3: Hero (big blind) collected ($0.04)
Seat 4: 9db3bc7b folded before Flop (didn't bet)
Seat 5: 74a53cac folded before Flop (didn't bet)
Seat 6: 2fb7c647 folded before Flop (didn't bet)


Poker Hand #RC2078544165: Hold'em No Limit ($0.02/$0.05) - 2023/12/22 21:53:43
Table 'RushAndCash801665' 6-max Seat #1 is the button
Seat 1: d82e5b20 ($7.74 in chips)
Seat 2: 9b0ec3a ($16.1 in chips)
Seat 3: 54507167 ($8.11 in chips)
Seat 4: Hero ($5.01 in chips)
Seat 5: 39956d46 ($5 in chips)
Seat 6: 9e4b1c03 ($7.48 in chips)
9b0ec3a: posts small blind $0.02
54507167: posts big blind $0.05
*** HOLE CARDS ***
Dealt to d82e5b20 
Dealt to 9b0ec3a 
Dealt to 54507167 
Dealt to Hero [2d Kc]
Dealt to 39956d46 
Dealt to 9e4b1c03 
Hero: folds
39956d46: folds
9e4b1c03: raises $0.07 to $0.12
d82e5b20: folds
9b0ec3a: folds
54507167: folds
Uncalled bet ($0.07) returned to 9e4b1c03
*** SHOWDOWN ***
9e4b1c03 collected $0.12 from pot
*** SUMMARY ***
Total pot $0.12 | Rake $0 | Jackpot $0 | Bingo $0 | Fortune $0 | Tax $0
Seat 1: d82e5b20 (button) folded before Flop (didn't bet)
Seat 2: 9b0ec3a (small blind) folded before Flop
Seat 3: 54507167 (big blind) folded before Flop
Seat 4: Hero folded before Flop (didn't bet)
Seat 5: 39956d46 folded before Flop (didn't bet)
Seat 6: 9e4b1c03 collected ($0.12)


Poker Hand #RC2078544098: Hold'em No Limit ($0.02/$0.05) - 2023/12/22 21:53:39
Table 'RushAndCash801634' 6-max Seat #1 is the button
Seat 1: Hero ($5.01 in chips)
Seat 2: c90c0909 ($5 in chips)
Seat 3: b45dcd1f ($5.72 in chips)
Seat 4: db264244 ($5.88 in chips)
Seat 5: 404f9df4 ($5 in chips)
Seat 6: e8d24af1 ($5.06 in chips)
c90c0909: posts small blind $0.02
b45dcd1f: posts big blind $0.05
*** HOLE CARDS ***
Dealt to Hero [7s 9h]
Dealt to c90c0909 
Dealt to b45dcd1f 
Dealt to db264244 
Dealt to 404f9df4 
Dealt to e8d24af1 
db264244: folds
404f9df4: raises $0.05 to $0.1
e8d24af1: folds
Hero: folds
c90c0909: folds
b45dcd1f: folds
Uncalled bet ($0.05) returned to 404f9df4
*** SHOWDOWN ***
404f9df4 collected $0.12 from pot
*** SUMMARY ***
Total pot $0.12 | Rake $0 | Jackpot $0 | Bingo $0 | Fortune $0 | Tax $0
Seat 1: Hero (button) folded before Flop (didn't bet)
Seat 2: c90c0909 (small blind) folded before Flop
Seat 3: b45dcd1f (big blind) folded before Flop
Seat 4: db264244 folded before Flop (didn't bet)
Seat 5: 404f9df4 collected ($0.12)
Seat 6: e8d24af1 folded before Flop (didn't bet)


Poker Hand #RC2078543892: Hold'em No Limit ($0.02/$0.05) - 2023/12/22 21:53:27
Table 'RushAndCash801540' 6-max Seat #1 is the button
Seat 1: 3748ad62 ($5.12 in chips)
Seat 2: Hero ($5.03 in chips)
Seat 3: 64f7e138 ($13.15 in chips)
Seat 4: 7c2eba4e ($16.19 in chips)
Seat 5: afc1ca79 ($4.99 in chips)
Seat 6: 8014c02 ($13.51 in chips)
Hero: posts small blind $0.02
64f7e138: posts big blind $0.05
*** HOLE CARDS ***
Dealt to 3748ad62 
Dealt to Hero [Kh 5s]
Dealt to 64f7e138 
Dealt to 7c2eba4e 
Dealt to afc1ca79 
Dealt to 8014c02 
7c2eba4e: folds
afc1ca79: raises $0.06 to $0.11
8014c02: folds
3748ad62: folds
Hero: folds
64f7e138: calls $0.06
*** FLOP *** [Td 2c 8d]
64f7e138: checks
afc1ca79: bets $0.13
64f7e138: calls $0.13
*** TURN *** [Td 2c 8d] [6d]
64f7e138: checks
afc1ca79: checks
*** RIVER *** [Td 2c 8d 6d] [7h]
64f7e138: checks
afc1ca79: checks
64f7e138: shows [8s 7s] (Pair of Eights and Pair of Sevens)
afc1ca79: shows [Ad Qc] (Ace-High)
*** SHOWDOWN ***
64f7e138 collected $0.48 from pot
*** SUMMARY ***
Total pot $0.5 | Rake $0.02 | Jackpot $0 | Bingo $0 | Fortune $0 | Tax $0
Board [Td 2c 8d 6d 7h]
Seat 1: 3748ad62 (button) folded before Flop (didn't bet)
Seat 2: Hero (small blind) folded before Flop
Seat 3: 64f7e138 (big blind) showed [8s 7s] and won ($0.48) with Pair of Eights and Pair of Sevens
Seat 4: 7c2eba4e folded before Flop (didn't bet)
Seat 5: afc1ca79 showed [Ad Qc] and lost with Ace-High
Seat 6: 8014c02 folded before Flop (didn't bet)


Poker Hand #RC2078543829: Hold'em No Limit ($0.02/$0.05) - 2023/12/22 21:53:23
Table 'RushAndCash801509' 6-max Seat #1 is the button
Seat 1: 548ecbec ($8.28 in chips)
Seat 2: 8369fc6c ($6.97 in chips)
Seat 3: cc277349 ($3.69 in chips)
Seat 4: Hero ($5.03 in chips)
Seat 5: d53c4208 ($5.51 in chips)
Seat 6: c53293cf ($6.62 in chips)
8369fc6c: posts small blind $0.02
cc277349: posts big blind $0.05
*** HOLE CARDS ***
Dealt to 548ecbec 
Dealt to 8369fc6c 
Dealt to cc277349 
Dealt to Hero [4h 6c]
Dealt to d53c4208 
Dealt to c53293cf 
Hero: folds
d53c4208: raises $0.07 to $0.12
c53293cf: folds
548ecbec: folds
8369fc6c: folds
cc277349: calls $0.07
*** FLOP *** [Ad 5s 9c]
cc277349: checks
d53c4208: bets $0.11
cc277349: calls $0.11
*** TURN *** [Ad 5s 9c] [2s]
cc277349: checks
d53c4208: bets $0.23
cc277349: folds
Uncalled bet ($0.23) returned to d53c4208
*** SHOWDOWN ***
d53c4208 collected $0.46 from pot
*** SUMMARY ***
Total pot $0.48 | Rake $0.02 | Jackpot $0 | Bingo $0 | Fortune $0 | Tax $0
Board [Ad 5s 9c 2s]
Seat 1: 548ecbec (button) folded before Flop (didn't bet)
Seat 2: 8369fc6c (small blind) folded before Flop
Seat 3: cc277349 (big blind) folded on the Turn
Seat 4: Hero folded before Flop (didn't bet)
Seat 5: d53c4208 won ($0.46)
Seat 6: c53293cf folded before Flop (didn't bet)


Poker Hand #RC2078542755: Hold'em No Limit ($0.02/$0.05) - 2023/12/22 21:52:20
Table 'RushAndCash801023' 6-max Seat #1 is the button
Seat 1: c53293cf ($5.6 in chips)
Seat 2: 521feab9 ($5.07 in chips)
Seat 3: 2f160a64 ($6.96 in chips)
Seat 4: e7ed98a7 ($5 in chips)
Seat 5: Hero ($6.16 in chips)
Seat 6: 4d74ad6d ($6.24 in chips)
521feab9: posts small blind $0.02
2f160a64: posts big blind $0.05
*** HOLE CARDS ***
Dealt to c53293cf 
Dealt to 521feab9 
Dealt to 2f160a64 
Dealt to e7ed98a7 
Dealt to Hero [As 5s]
Dealt to 4d74ad6d 
e7ed98a7: folds
Hero: raises $0.05 to $0.1
4d74ad6d: folds
c53293cf: raises $0.14 to $0.24
521feab9: folds
2f160a64: folds
Hero: calls $0.14
*** FLOP *** [2d Js 4h]
Hero: checks
c53293cf: bets $0.19
Hero: calls $0.19
*** TURN *** [2d Js 4h] [Ts]
Hero: checks
c53293cf: bets $0.7
Hero: calls $0.7
*** RIVER *** [2d Js 4h Ts] [7d]
Hero: checks
c53293cf: bets $1.75
Hero: folds
Uncalled bet ($1.75) returned to c53293cf
*** SHOWDOWN ***
c53293cf collected $2.15 from pot
*** SUMMARY ***
Total pot $2.33 | Rake $0.11 | Jackpot $0.07 | Bingo $0 | Fortune $0 | Tax $0
Board [2d Js 4h Ts 7d]
Seat 1: c53293cf (button) won ($2.15)
Seat 2: 521feab9 (small blind) folded before Flop
Seat 3: 2f160a64 (big blind) folded before Flop
Seat 4: e7ed98a7 folded before Flop (didn't bet)
Seat 5: Hero folded on the River
Seat 6: 4d74ad6d folded before Flop (didn't bet)


Poker Hand #RC2078542676: Hold'em No Limit ($0.02/$0.05) - 2023/12/22 21:52:15
Table 'RushAndCash800985' 6-max Seat #1 is the button
Seat 1: Hero ($6.16 in chips)
Seat 2: e7053968 ($4.02 in chips)
Seat 3: a51bf3f3 ($7.3 in chips)
Seat 4: 5a946c5b ($5.07 in chips)
Seat 5: 7b271292 ($4.62 in chips)
Seat 6: bc12b17 ($5 in chips)
e7053968: posts small blind $0.02
a51bf3f3: posts big blind $0.05
*** HOLE CARDS ***
Dealt to Hero [5s Qh]
Dealt to e7053968 
Dealt to a51bf3f3 
Dealt to 5a946c5b 
Dealt to 7b271292 
Dealt to bc12b17 
5a946c5b: folds
7b271292: raises $0.05 to $0.1
bc12b17: folds
Hero: folds
e7053968: folds
a51bf3f3: folds
Uncalled bet ($0.05) returned to 7b271292
*** SHOWDOWN ***
7b271292 collected $0.12 from pot
*** SUMMARY ***
Total pot $0.12 | Rake $0 | Jackpot $0 | Bingo $0 | Fortune $0 | Tax $0
Seat 1: Hero (button) folded before Flop (didn't bet)
Seat 2: e7053968 (small blind) folded before Flop
Seat 3: a51bf3f3 (big blind) folded before Flop
Seat 4: 5a946c5b folded before Flop (didn't bet)
Seat 5: 7b271292 collected ($0.12)
Seat 6: bc12b17 folded before Flop (didn't bet)


Poker Hand #RC2078542602: Hold'em No Limit ($0.02/$0.05) - 2023/12/22 21:52:11
Table 'RushAndCash800949' 6-max Seat #1 is the button
Seat 1: 1fc1f571 ($17.8 in chips)
Seat 2: Hero ($6.18 in chips)
Seat 3: c8adf5d ($6.53 in chips)
Seat 4: 784b6733 ($5 in chips)
Seat 5: e7562cd9 ($8.21 in chips)
Seat 6: 16665786 ($5 in chips)
Hero: posts small blind $0.02
c8adf5d: posts big blind $0.05
*** HOLE CARDS ***
Dealt to 1fc1f571 
Dealt to Hero [7d Jh]
Dealt to c8adf5d 
Dealt to 784b6733 
Dealt to e7562cd9 
Dealt to 16665786 
784b6733: raises $0.09 to $0.14
e7562cd9: folds
16665786: calls $0.14
1fc1f571: raises $0.47 to $0.61
Hero: folds
c8adf5d: folds
784b6733: folds
16665786: calls $0.47
*** FLOP *** [8s 3d Tc]
16665786: checks
1fc1f571: checks
*** TURN *** [8s 3d Tc] [2h]
16665786: checks
1fc1f571: checks
*** RIVER *** [8s 3d Tc 2h] [6d]
16665786: checks
1fc1f571: checks
16665786: shows [Ac 9s] (Ace-High)
1fc1f571: shows [Ks Ad] (Ace-High)
*** SHOWDOWN ***
1fc1f571 collected $1.36 from pot
*** SUMMARY ***
Total pot $1.43 | Rake $0.07 | Jackpot $0 | Bingo $0 | Fortune $0 | Tax $0
Board [8s 3d Tc 2h 6d]
Seat 1: 1fc1f571 (button) showed [Ks Ad] and won ($1.36) with Ace-High
Seat 2: Hero (small blind) folded before Flop
Seat 3: c8adf5d (big blind) folded before Flop
Seat 4: 784b6733 folded before Flop
Seat 5: e7562cd9 folded before Flop (didn't bet)
Seat 6: 16665786 showed [Ac 9s] and lost with Ace-High


Poker Hand #RC2078542320: Hold'em No Limit ($0.02/$0.05) - 2023/12/22 21:51:56
Table 'RushAndCash800813' 6-max Seat #1 is the button
Seat 1: d2e52b8d ($33.48 in chips)
Seat 2: d71e9094 ($6.16 in chips)
Seat 3: Hero ($6.23 in chips)
Seat 4: d8c6faef ($5.05 in chips)
Seat 5: f2927765 ($6.39 in chips)
Seat 6: 517da49 ($11.17 in chips)
d71e9094: posts small blind $0.02
Hero: posts big blind $0.05
*** HOLE CARDS ***
Dealt to d2e52b8d 
Dealt to d71e9094 
Dealt to Hero [6c 2d]
Dealt to d8c6faef 
Dealt to f2927765 
Dealt to 517da49 
d8c6faef: folds
f2927765: raises $0.05 to $0.1
517da49: calls $0.1
d2e52b8d: folds
d71e9094: calls $0.08
Hero: folds
*** FLOP *** [4s 7d As]
d71e9094: checks
f2927765: bets $0.14
517da49: calls $0.14
d71e9094: folds
*** TURN *** [4s 7d As] [8s]
f2927765: bets $0.32
517da49: folds
Uncalled bet ($0.32) returned to f2927765
*** SHOWDOWN ***
f2927765 collected $0.6 from pot
*** SUMMARY ***
Total pot $0.63 | Rake $0.03 | Jackpot $0 | Bingo $0 | Fortune $0 | Tax $0
Board [4s 7d As 8s]
Seat 1: d2e52b8d (button) folded before Flop (didn't bet)
Seat 2: d71e9094 (small blind) folded on the Flop
Seat 3: Hero (big blind) folded before Flop
Seat 4: d8c6faef folded before Flop (didn't bet)
Seat 5: f2927765 won ($0.6)
Seat 6: 517da49 folded on the Turn


Poker Hand #RC2078542256: Hold'em No Limit ($0.02/$0.05) - 2023/12/22 21:51:52
Table 'RushAndCash800780' 6-max Seat #1 is the button
Seat 1: 1cfe329a ($11.73 in chips)
Seat 2: d42ee966 ($7.15 in chips)
Seat 3: c7be9492 ($5.28 in chips)
Seat 4: ba0591c5 ($5.29 in chips)
Seat 5: Hero ($6.23 in chips)
Seat 6: b1b73f21 ($5.6 in chips)
d42ee966: posts small blind $0.02
c7be9492: posts big blind $0.05
*** HOLE CARDS ***
Dealt to 1cfe329a 
Dealt to d42ee966 
Dealt to c7be9492 
Dealt to ba0591c5 
Dealt to Hero [Th 9s]
Dealt to b1b73f21 
ba0591c5: raises $0.08 to $0.13
Hero: folds
b1b73f21: folds
1cfe329a: raises $0.33 to $0.46
d42ee966: folds
c7be9492: folds
ba0591c5: folds
Uncalled bet ($0.33) returned to 1cfe329a
*** SHOWDOWN ***
1cfe329a collected $0.32 from pot
*** SUMMARY ***
Total pot $0.33 | Rake $0.01 | Jackpot $0 | Bingo $0 | Fortune $0 | Tax $0
Seat 1: 1cfe329a (button) collected ($0.32)
Seat 2: d42ee966 (small blind) folded before Flop
Seat 3: c7be9492 (big blind) folded before Flop
Seat 4: ba0591c5 folded before Flop
Seat 5: Hero folded before Flop (didn't bet)
Seat 6: b1b73f21 folded before Flop (didn't bet)


Poker Hand #RC2078542160: Hold'em No Limit ($0.02/$0.05) - 2023/12/22 21:51:47
Table 'RushAndCash800733' 6-max Seat #1 is the button
Seat 1: Hero ($6.23 in chips)
Seat 2: cf8a8e96 ($8.72 in chips)
Seat 3: 641f40f7 ($5 in chips)
Seat 4: 1e7880dc ($14.62 in chips)
Seat 5: bcaa3feb ($4.93 in chips)
Seat 6: 6d8f3c8f ($6.7 in chips)
cf8a8e96: posts small blind $0.02
641f40f7: posts big blind $0.05
*** HOLE CARDS ***
Dealt to Hero [4s 8c]
Dealt to cf8a8e96 
Dealt to 641f40f7 
Dealt to 1e7880dc 
Dealt to bcaa3feb 
Dealt to 6d8f3c8f 
1e7880dc: folds
bcaa3feb: raises $0.05 to $0.1
6d8f3c8f: folds
Hero: folds
cf8a8e96: calls $0.08
641f40f7: calls $0.05
*** FLOP *** [3d 9c 6h]
cf8a8e96: bets $0.1
641f40f7: folds
bcaa3feb: calls $0.1
*** TURN *** [3d 9c 6h] [3h]
cf8a8e96: bets $0.25
bcaa3feb: calls $0.25
*** RIVER *** [3d 9c 6h 3h] [Jh]
cf8a8e96: bets $0.5
bcaa3feb: raises $1.5 to $2
cf8a8e96: calls $1.5
bcaa3feb: shows [Ad Ts] (Pair of Treys)
cf8a8e96: shows [2c 3c] (Three Treys)
*** SHOWDOWN ***
cf8a8e96 collected $4.78 from pot
*** SUMMARY ***
Total pot $5 | Rake $0.15 | Jackpot $0.07 | Bingo $0 | Fortune $0 | Tax $0
Board [3d 9c 6h 3h Jh]
Seat 1: Hero (button) folded before Flop (didn't bet)
Seat 2: cf8a8e96 (small blind) showed [2c 3c] and won ($4.78) with Three Treys
Seat 3: 641f40f7 (big blind) folded on the Flop
Seat 4: 1e7880dc folded before Flop (didn't bet)
Seat 5: bcaa3feb showed [Ad Ts] and lost with Pair of Treys
Seat 6: 6d8f3c8f folded before Flop (didn't bet)


Poker Hand #RC2078542085: Hold'em No Limit ($0.02/$0.05) - 2023/12/22 21:51:44
Table 'RushAndCash800696' 6-max Seat #1 is the button
Seat 1: 58d49a14 ($4.86 in chips)
Seat 2: Hero ($6.25 in chips)
Seat 3: cf8a8e96 ($8.77 in chips)
Seat 4: ce803d2b ($5.22 in chips)
Seat 5: bcaa3feb ($4.93 in chips)
Seat 6: 15b7de4f ($5 in chips)
Hero: posts small blind $0.02
cf8a8e96: posts big blind $0.05
*** HOLE CARDS ***
Dealt to 58d49a14 
Dealt to Hero [2d Qh]
Dealt to cf8a8e96 
Dealt to ce803d2b 
Dealt to bcaa3feb 
Dealt to 15b7de4f 
ce803d2b: raises $0.05 to $0.1
bcaa3feb: folds
15b7de4f: folds
58d49a14: folds
Hero: folds
cf8a8e96: folds
Uncalled bet ($0.05) returned to ce803d2b
*** SHOWDOWN ***
ce803d2b collected $0.12 from pot
*** SUMMARY ***
Total pot $0.12 | Rake $0 | Jackpot $0 | Bingo $0 | Fortune $0 | Tax $0
Seat 1: 58d49a14 (button) folded before Flop (didn't bet)
Seat 2: Hero (small blind) folded before Flop
Seat 3: cf8a8e96 (big blind) folded before Flop
Seat 4: ce803d2b collected ($0.12)
Seat 5: bcaa3feb folded before Flop (didn't bet)
Seat 6: 15b7de4f folded before Flop (didn't bet)


Poker Hand #RC2078541896: Hold'em No Limit ($0.02/$0.05) - 2023/12/22 21:51:33
Table 'RushAndCash800601' 6-max Seat #1 is the button
Seat 1: Hero ($6.25 in chips)
Seat 2: 89f19970 ($5 in chips)
Seat 3: 16ecd29a ($6.22 in chips)
Seat 4: 34ce5e3 ($6.57 in chips)
Seat 5: 9b0ec3a ($15.94 in chips)
Seat 6: 57896c91 ($6.09 in chips)
89f19970: posts small blind $0.02
16ecd29a: posts big blind $0.05
*** HOLE CARDS ***
Dealt to Hero [7h 9d]
Dealt to 89f19970 
Dealt to 16ecd29a 
Dealt to 34ce5e3 
Dealt to 9b0ec3a 
Dealt to 57896c91 
34ce5e3: raises $0.05 to $0.1
9b0ec3a: folds
57896c91: folds
Hero: folds
89f19970: folds
16ecd29a: raises $0.22 to $0.32
34ce5e3: folds
Uncalled bet ($0.22) returned to 16ecd29a
*** SHOWDOWN ***
16ecd29a collected $0.21 from pot
*** SUMMARY ***
Total pot $0.22 | Rake $0.01 | Jackpot $0 | Bingo $0 | Fortune $0 | Tax $0
Seat 1: Hero (button) folded before Flop (didn't bet)
Seat 2: 89f19970 (small blind) folded before Flop
Seat 3: 16ecd29a (big blind) collected ($0.21)
Seat 4: 34ce5e3 folded before Flop
Seat 5: 9b0ec3a folded before Flop (didn't bet)
Seat 6: 57896c91 folded before Flop (didn't bet)


Poker Hand #RC2078541814: Hold'em No Limit ($0.02/$0.05) - 2023/12/22 21:51:28
Table 'RushAndCash800559' 6-max Seat #1 is the button
Seat 1: 7016689e ($5.38 in chips)
Seat 2: 2c331229 ($2.05 in chips)
Seat 3: 129846c0 ($5 in chips)
Seat 4: e19dee32 ($7.73 in chips)
Seat 5: Hero ($6.25 in chips)
Seat 6: 41270a9a ($5.09 in chips)
2c331229: posts small blind $0.02
129846c0: posts big blind $0.05
*** HOLE CARDS ***
Dealt to 7016689e 
Dealt to 2c331229 
Dealt to 129846c0 
Dealt to e19dee32 
Dealt to Hero [9h Jd]
Dealt to 41270a9a 
e19dee32: folds
Hero: folds
41270a9a: folds
7016689e: folds
2c331229: calls $0.03
129846c0: checks
*** FLOP *** [Ad 7d 6c]
2c331229: checks
129846c0: checks
*** TURN *** [Ad 7d 6c] [Js]
2c331229: checks
129846c0: checks
*** RIVER *** [Ad 7d 6c Js] [4h]
2c331229: checks
129846c0: checks
2c331229: shows [2d 9c] (Ace-High)
129846c0: shows [6d Qd] (Pair of Sixes)
*** SHOWDOWN ***
129846c0 collected $0.1 from pot
*** SUMMARY ***
Total pot $0.1 | Rake $0 | Jackpot $0 | Bingo $0 | Fortune $0 | Tax $0
Board [Ad 7d 6c Js 4h]
Seat 1: 7016689e (button) folded before Flop (didn't bet)
Seat 2: 2c331229 (small blind) showed [2d 9c] and lost with Ace-High
Seat 3: 129846c0 (big blind) showed [6d Qd] and won ($0.1) with Pair of Sixes
Seat 4: e19dee32 folded before Flop (didn't bet)
Seat 5: Hero folded before Flop (didn't bet)
Seat 6: 41270a9a folded before Flop (didn't bet)


Poker Hand #RC2078541195: Hold'em No Limit ($0.02/$0.05) - 2023/12/22 21:50:50
Table 'RushAndCash800258' 6-max Seat #1 is the button
Seat 1: 2588276e ($11.22 in chips)
Seat 2: 1be6b9fd ($16.74 in chips)
Seat 3: Hero ($6.35 in chips)
Seat 4: 1b1efc4 ($4.29 in chips)
Seat 5: 73c8f8b5 ($6.12 in chips)
Seat 6: e19dee32 ($7.62 in chips)
1be6b9fd: posts small blind $0.02
Hero: posts big blind $0.05
*** HOLE CARDS ***
Dealt to 2588276e 
Dealt to 1be6b9fd 
Dealt to Hero [9s 4s]
Dealt to 1b1efc4 
Dealt to 73c8f8b5 
Dealt to e19dee32 
1b1efc4: folds
73c8f8b5: folds
e19dee32: raises $0.05 to $0.1
2588276e: folds
1be6b9fd: folds
Hero: calls $0.05
*** FLOP *** [5d Kh 6c]
Hero: checks
e19dee32: checks
*** TURN *** [5d Kh 6c] [Ks]
Hero: checks
e19dee32: checks
*** RIVER *** [5d Kh 6c Ks] [Jh]
Hero: checks
e19dee32: checks
Hero: shows [9s 4s] (Pair of Kings)
e19dee32: shows [Ts As] (Pair of Kings)
*** SHOWDOWN ***
e19dee32 collected $0.21 from pot
*** SUMMARY ***
Total pot $0.22 | Rake $0.01 | Jackpot $0 | Bingo $0 | Fortune $0 | Tax $0
Board [5d Kh 6c Ks Jh]
Seat 1: 2588276e (button) folded before Flop (didn't bet)
Seat 2: 1be6b9fd (small blind) folded before Flop
Seat 3: Hero (big blind) showed [9s 4s] and lost with Pair of Kings
Seat 4: 1b1efc4 folded before Flop (didn't bet)
Seat 5: 73c8f8b5 folded before Flop (didn't bet)
Seat 6: e19dee32 showed [Ts As] and won ($0.21) with Pair of Kings


Poker Hand #RC2078540930: Hold'em No Limit ($0.02/$0.05) - 2023/12/22 21:50:36
Table 'RushAndCash800134' 6-max Seat #1 is the button
Seat 1: cbc963b8 ($8.17 in chips)
Seat 2: 801c157f ($28.53 in chips)
Seat 3: 6fadee13 ($5.63 in chips)
Seat 4: 1259a422 ($7.46 in chips)
Seat 5: bc26f2e1 ($5.33 in chips)
Seat 6: Hero ($6.35 in chips)
801c157f: posts small blind $0.02
6fadee13: posts big blind $0.05
*** HOLE CARDS ***
Dealt to cbc963b8 
Dealt to 801c157f 
Dealt to 6fadee13 
Dealt to 1259a422 
Dealt to bc26f2e1 
Dealt to Hero [Ac 6c]
1259a422: folds
bc26f2e1: raises $0.1 to $0.15
Hero: folds
cbc963b8: folds
801c157f: folds
6fadee13: folds
Uncalled bet ($0.1) returned to bc26f2e1
*** SHOWDOWN ***
bc26f2e1 collected $0.12 from pot
*** SUMMARY ***
Total pot $0.12 | Rake $0 | Jackpot $0 | Bingo $0 | Fortune $0 | Tax $0
Seat 1: cbc963b8 (button) folded before Flop (didn't bet)
Seat 2: 801c157f (small blind) folded before Flop
Seat 3: 6fadee13 (big blind) folded before Flop
Seat 4: 1259a422 folded before Flop (didn't bet)
Seat 5: bc26f2e1 collected ($0.12)
Seat 6: Hero folded before Flop (didn't bet)


Poker Hand #RC2078540868: Hold'em No Limit ($0.02/$0.05) - 2023/12/22 21:50:32
Table 'RushAndCash800105' 6-max Seat #1 is the button
Seat 1: cc0e5af8 ($5.84 in chips)
Seat 2: 7095bc76 ($11.65 in chips)
Seat 3: 212e12e3 ($5.23 in chips)
Seat 4: 165766e4 ($5 in chips)
Seat 5: Hero ($6.35 in chips)
Seat 6: 88e57a08 ($12.94 in chips)
7095bc76: posts small blind $0.02
212e12e3: posts big blind $0.05
*** HOLE CARDS ***
Dealt to cc0e5af8 
Dealt to 7095bc76 
Dealt to 212e12e3 
Dealt to 165766e4 
Dealt to Hero [Jd 5c]
Dealt to 88e57a08 
165766e4: folds
Hero: folds
88e57a08: raises $0.1 to $0.15
cc0e5af8: calls $0.15
7095bc76: folds
212e12e3: folds
*** FLOP *** [4h 6c 9s]
88e57a08: bets $0.19
cc0e5af8: calls $0.19
*** TURN *** [4h 6c 9s] [5s]
88e57a08: bets $0.57
cc0e5af8: calls $0.57
*** RIVER *** [4h 6c 9s 5s] [Th]
88e57a08: checks
cc0e5af8: checks
88e57a08: shows [Js Ts] (Pair of Tens)
cc0e5af8: shows [8s 6s] (Pair of Sixes)
*** SHOWDOWN ***
88e57a08 collected $1.73 from pot
*** SUMMARY ***
Total pot $1.89 | Rake $0.09 | Jackpot $0.07 | Bingo $0 | Fortune $0 | Tax $0
Board [4h 6c 9s 5s Th]
Seat 1: cc0e5af8 (button) showed [8s 6s] and lost with Pair of Sixes
Seat 2: 7095bc76 (small blind) folded before Flop
Seat 3: 212e12e3 (big blind) folded before Flop
Seat 4: 165766e4 folded before Flop (didn't bet)
Seat 5: Hero folded before Flop (didn't bet)
Seat 6: 88e57a08 showed [Js Ts] and won ($1.73) with Pair of Tens


Poker Hand #RC2078540803: Hold'em No Limit ($0.02/$0.05) - 2023/12/22 21:50:28
Table 'RushAndCash800075' 6-max Seat #1 is the button
Seat 1: 875f34a0 ($22.75 in chips)
Seat 2: 9d93c43e ($5.1 in chips)
Seat 3: 5861f243 ($5.69 in chips)
Seat 4: Hero ($6.35 in chips)
Seat 5: edac6d16 ($5 in chips)
Seat 6: 4a196974 ($5.59 in chips)
9d93c43e: posts small blind $0.02
5861f243: posts big blind $0.05
*** HOLE CARDS ***
Dealt to 875f34a0 
Dealt to 9d93c43e 
Dealt to 5861f243 
Dealt to Hero [6h 3s]
Dealt to edac6d16 
Dealt to 4a196974 
Hero: folds
edac6d16: raises $0.05 to $0.1
4a196974: folds
875f34a0: folds
9d93c43e: folds
5861f243: folds
Uncalled bet ($0.05) returned to edac6d16
*** SHOWDOWN ***
edac6d16 collected $0.12 from pot
*** SUMMARY ***
Total pot $0.12 | Rake $0 | Jackpot $0 | Bingo $0 | Fortune $0 | Tax $0
Seat 1: 875f34a0 (button) folded before Flop (didn't bet)
Seat 2: 9d93c43e (small blind) folded before Flop
Seat 3: 5861f243 (big blind) folded before Flop
Seat 4: Hero folded before Flop (didn't bet)
Seat 5: edac6d16 collected ($0.12)
Seat 6: 4a196974 folded before Flop (didn't bet)


Poker Hand #RC2078540589: Hold'em No Limit ($0.02/$0.05) - 2023/12/22 21:50:16
Table 'RushAndCash799968' 6-max Seat #1 is the button
Seat 1: e1423689 ($5 in chips)
Seat 2: Hero ($6.37 in chips)
Seat 3: f57c6794 ($6.31 in chips)
Seat 4: 8a8eafe4 ($5.87 in chips)
Seat 5: ed53cde8 ($6.83 in chips)
Seat 6: 56d0ca9d ($7.78 in chips)
Hero: posts small blind $0.02
f57c6794: posts big blind $0.05
*** HOLE CARDS ***
Dealt to e1423689 
Dealt to Hero [9d 2c]
Dealt to f57c6794 
Dealt to 8a8eafe4 
Dealt to ed53cde8 
Dealt to 56d0ca9d 
8a8eafe4: folds
ed53cde8: folds
56d0ca9d: folds
e1423689: raises $0.09 to $0.14
Hero: folds
f57c6794: folds
Uncalled bet ($0.09) returned to e1423689
*** SHOWDOWN ***
e1423689 collected $0.12 from pot
*** SUMMARY ***
Total pot $0.12 | Rake $0 | Jackpot $0 | Bingo $0 | Fortune $0 | Tax $0
Seat 1: e1423689 (button) collected ($0.12)
Seat 2: Hero (small blind) folded before Flop
Seat 3: f57c6794 (big blind) folded before Flop
Seat 4: 8a8eafe4 folded before Flop (didn't bet)
Seat 5: ed53cde8 folded before Flop (didn't bet)
Seat 6: 56d0ca9d folded before Flop (didn't bet)


Poker Hand #RC2078540526: Hold'em No Limit ($0.02/$0.05) - 2023/12/22 21:50:13
Table 'RushAndCash799936' 6-max Seat #1 is the button
Seat 1: 777bac87 ($7.25 in chips)
Seat 2: 784b6733 ($5 in chips)
Seat 3: Hero ($6.42 in chips)
Seat 4: 221172f3 ($5 in chips)
Seat 5: 1394bd6b ($10.61 in chips)
Seat 6: 56d0ca9d ($7.78 in chips)
784b6733: posts small blind $0.02
Hero: posts big blind $0.05
*** HOLE CARDS ***
Dealt to 777bac87 
Dealt to 784b6733 
Dealt to Hero [Kd Jc]
Dealt to 221172f3 
Dealt to 1394bd6b 
Dealt to 56d0ca9d 
221172f3: folds
1394bd6b: folds
56d0ca9d: folds
777bac87: raises $0.07 to $0.12
784b6733: folds
Hero: folds
Uncalled bet ($0.07) returned to 777bac87
*** SHOWDOWN ***
777bac87 collected $0.12 from pot
*** SUMMARY ***
Total pot $0.12 | Rake $0 | Jackpot $0 | Bingo $0 | Fortune $0 | Tax $0
Seat 1: 777bac87 (button) collected ($0.12)
Seat 2: 784b6733 (small blind) folded before Flop
Seat 3: Hero (big blind) folded before Flop
Seat 4: 221172f3 folded before Flop (didn't bet)
Seat 5: 1394bd6b folded before Flop (didn't bet)
Seat 6: 56d0ca9d folded before Flop (didn't bet)


Poker Hand #RC2078540459: Hold'em No Limit ($0.02/$0.05) - 2023/12/22 21:50:09
Table 'RushAndCash799902' 6-max Seat #1 is the button
Seat 1: f93190a6 ($8.49 in chips)
Seat 2: bf955ffb ($5.07 in chips)
Seat 3: 8a6d1b ($9.91 in chips)
Seat 4: eab48ced ($5.95 in chips)
Seat 5: 8a9decd1 ($9.44 in chips)
Seat 6: Hero ($6.42 in chips)
bf955ffb: posts small blind $0.02
8a6d1b: posts big blind $0.05
*** HOLE CARDS ***
Dealt to f93190a6 
Dealt to bf955ffb 
Dealt to 8a6d1b 
Dealt to eab48ced 
Dealt to 8a9decd1 
Dealt to Hero [6c Kh]
eab48ced: folds
8a9decd1: folds
Hero: folds
f93190a6: folds
bf955ffb: folds
Uncalled bet ($0.03) returned to 8a6d1b
*** SHOWDOWN ***
8a6d1b collected $0.04 from pot
*** SUMMARY ***
Total pot $0.04 | Rake $0 | Jackpot $0 | Bingo $0 | Fortune $0 | Tax $0
Seat 1: f93190a6 (button) folded before Flop (didn't bet)
Seat 2: bf955ffb (small blind) folded before Flop
Seat 3: 8a6d1b (big blind) collected ($0.04)
Seat 4: eab48ced folded before Flop (didn't bet)
Seat 5: 8a9decd1 folded before Flop (didn't bet)
Seat 6: Hero folded before Flop (didn't bet)


Poker Hand #RC2078540392: Hold'em No Limit ($0.02/$0.05) - 2023/12/22 21:50:06
Table 'RushAndCash799867' 6-max Seat #1 is the button
Seat 1: c0936c93 ($5.79 in chips)
Seat 2: 570cf06f ($4.35 in chips)
Seat 3: d960fc1d ($4.96 in chips)
Seat 4: 921e997e ($6.1 in chips)
Seat 5: Hero ($6.42 in chips)
Seat 6: ed26e80a ($11.84 in chips)
570cf06f: posts small blind $0.02
d960fc1d: posts big blind $0.05
*** HOLE CARDS ***
Dealt to c0936c93 
Dealt to 570cf06f 
Dealt to d960fc1d 
Dealt to 921e997e 
Dealt to Hero [8c 9s]
Dealt to ed26e80a 
921e997e: folds
Hero: folds
ed26e80a: folds
c0936c93: folds
570cf06f: folds
Uncalled bet ($0.03) returned to d960fc1d
*** SHOWDOWN ***
d960fc1d collected $0.04 from pot
*** SUMMARY ***
Total pot $0.04 | Rake $0 | Jackpot $0 | Bingo $0 | Fortune $0 | Tax $0
Seat 1: c0936c93 (button) folded before Flop (didn't bet)
Seat 2: 570cf06f (small blind) folded before Flop
Seat 3: d960fc1d (big blind) collected ($0.04)
Seat 4: 921e997e folded before Flop (didn't bet)
Seat 5: Hero folded before Flop (didn't bet)
Seat 6: ed26e80a folded before Flop (didn't bet)


Poker Hand #RC2078540325: Hold'em No Limit ($0.02/$0.05) - 2023/12/22 21:50:01
Table 'RushAndCash799832' 6-max Seat #1 is the button
Seat 1: ff50af14 ($5.19 in chips)
Seat 2: 886872c9 ($7.24 in chips)
Seat 3: 38e42730 ($8.43 in chips)
Seat 4: Hero ($6.42 in chips)
Seat 5: 92c87aad ($5 in chips)
Seat 6: 113aa2fd ($5.31 in chips)
886872c9: posts small blind $0.02
38e42730: posts big blind $0.05
*** HOLE CARDS ***
Dealt to ff50af14 
Dealt to 886872c9 
Dealt to 38e42730 
Dealt to Hero [Qc Ks]
Dealt to 92c87aad 
Dealt to 113aa2fd 
Hero: folds
92c87aad: folds
113aa2fd: folds
ff50af14: folds
886872c9: folds
Uncalled bet ($0.03) returned to 38e42730
*** SHOWDOWN ***
38e42730 collected $0.04 from pot
*** SUMMARY ***
Total pot $0.04 | Rake $0 | Jackpot $0 | Bingo $0 | Fortune $0 | Tax $0
Seat 1: ff50af14 (button) folded before Flop (didn't bet)
Seat 2: 886872c9 (small blind) folded before Flop
Seat 3: 38e42730 (big blind) collected ($0.04)
Seat 4: Hero folded before Flop (didn't bet)
Seat 5: 92c87aad folded before Flop (didn't bet)
Seat 6: 113aa2fd folded before Flop (didn't bet)


Poker Hand #RC2078540257: Hold'em No Limit ($0.02/$0.05) - 2023/12/22 21:49:58
Table 'RushAndCash799798' 6-max Seat #1 is the button
Seat 1: Hero ($6.42 in chips)
Seat 2: d1b13eba ($5.14 in chips)
Seat 3: ce803d2b ($5.12 in chips)
Seat 4: 1394bd6b ($10.59 in chips)
Seat 5: 9e4b1c03 ($7.32 in chips)
Seat 6: f5ffb37c ($5 in chips)
d1b13eba: posts small blind $0.02
ce803d2b: posts big blind $0.05
*** HOLE CARDS ***
Dealt to Hero [2h 3d]
Dealt to d1b13eba 
Dealt to ce803d2b 
Dealt to 1394bd6b 
Dealt to 9e4b1c03 
Dealt to f5ffb37c 
1394bd6b: folds
9e4b1c03: folds
f5ffb37c: folds
Hero: folds
d1b13eba: raises $0.1 to $0.15
ce803d2b: folds
Uncalled bet ($0.1) returned to d1b13eba
*** SHOWDOWN ***
d1b13eba collected $0.1 from pot
*** SUMMARY ***
Total pot $0.1 | Rake $0 | Jackpot $0 | Bingo $0 | Fortune $0 | Tax $0
Seat 1: Hero (button) folded before Flop (didn't bet)
Seat 2: d1b13eba (small blind) collected ($0.1)
Seat 3: ce803d2b (big blind) folded before Flop
Seat 4: 1394bd6b folded before Flop (didn't bet)
Seat 5: 9e4b1c03 folded before Flop (didn't bet)
Seat 6: f5ffb37c folded before Flop (didn't bet)


Poker Hand #RC2078540082: Hold'em No Limit ($0.02/$0.05) - 2023/12/22 21:49:47
Table 'RushAndCash799715' 6-max Seat #1 is the button
Seat 1: cb16bb03 ($6.78 in chips)
Seat 2: Hero ($6.44 in chips)
Seat 3: 6fadee13 ($5.6 in chips)
Seat 4: 697fb04a ($51.83 in chips)
Seat 5: af92dfc8 ($7.36 in chips)
Seat 6: 4f704fa2 ($5 in chips)
Hero: posts small blind $0.02
6fadee13: posts big blind $0.05
*** HOLE CARDS ***
Dealt to cb16bb03 
Dealt to Hero [2h Jd]
Dealt to 6fadee13 
Dealt to 697fb04a 
Dealt to af92dfc8 
Dealt to 4f704fa2 
697fb04a: folds
af92dfc8: folds
4f704fa2: folds
cb16bb03: raises $0.08 to $0.13
Hero: folds
6fadee13: folds
Uncalled bet ($0.08) returned to cb16bb03
*** SHOWDOWN ***
cb16bb03 collected $0.12 from pot
*** SUMMARY ***
Total pot $0.12 | Rake $0 | Jackpot $0 | Bingo $0 | Fortune $0 | Tax $0
Seat 1: cb16bb03 (button) collected ($0.12)
Seat 2: Hero (small blind) folded before Flop
Seat 3: 6fadee13 (big blind) folded before Flop
Seat 4: 697fb04a folded before Flop (didn't bet)
Seat 5: af92dfc8 folded before Flop (didn't bet)
Seat 6: 4f704fa2 folded before Flop (didn't bet)


Poker Hand #RC2078539454: Hold'em No Limit ($0.02/$0.05) - 2023/12/22 21:49:10
Table 'RushAndCash799427' 6-max Seat #1 is the button
Seat 1: 330b404c ($8.37 in chips)
Seat 2: cb16bb03 ($6.5 in chips)
Seat 3: Hero ($6.75 in chips)
Seat 4: efbf8ee8 ($6.26 in chips)
Seat 5: 622d6af4 ($20.15 in chips)
Seat 6: ea94f4a8 ($4.9 in chips)
cb16bb03: posts small blind $0.02
Hero: posts big blind $0.05
*** HOLE CARDS ***
Dealt to 330b404c 
Dealt to cb16bb03 
Dealt to Hero [Kc 4c]
Dealt to efbf8ee8 
Dealt to 622d6af4 
Dealt to ea94f4a8 
efbf8ee8: folds
622d6af4: folds
ea94f4a8: folds
330b404c: folds
cb16bb03: raises $0.08 to $0.13
Hero: calls $0.08
*** FLOP *** [Ah 6c 4h]
cb16bb03: bets $0.18
Hero: calls $0.18
*** TURN *** [Ah 6c 4h] [8h]
cb16bb03: bets $0.41
Hero: folds
Uncalled bet ($0.41) returned to cb16bb03
*** SHOWDOWN ***
cb16bb03 collected $0.59 from pot
*** SUMMARY ***
Total pot $0.62 | Rake $0.03 | Jackpot $0 | Bingo $0 | Fortune $0 | Tax $0
Board [Ah 6c 4h 8h]
Seat 1: 330b404c (button) folded before Flop (didn't bet)
Seat 2: cb16bb03 (small blind) won ($0.59)
Seat 3: Hero (big blind) folded on the Turn
Seat 4: efbf8ee8 folded before Flop (didn't bet)
Seat 5: 622d6af4 folded before Flop (didn't bet)
Seat 6: ea94f4a8 folded before Flop (didn't bet)


Poker Hand #RC2078539400: Hold'em No Limit ($0.02/$0.05) - 2023/12/22 21:49:07
Table 'RushAndCash799401' 6-max Seat #1 is the button
Seat 1: Hero ($6.75 in chips)
Seat 2: 18aade85 ($4.85 in chips)
Seat 3: 5861f243 ($5.46 in chips)
Seat 4: aa2421a5 ($1.93 in chips)
Seat 5: d45bc7f3 ($6.76 in chips)
Seat 6: 9c51ae09 ($5.12 in chips)
18aade85: posts small blind $0.02
5861f243: posts big blind $0.05
*** HOLE CARDS ***
Dealt to Hero [2c Ad]
Dealt to 18aade85 
Dealt to 5861f243 
Dealt to aa2421a5 
Dealt to d45bc7f3 
Dealt to 9c51ae09 
aa2421a5: folds
d45bc7f3: folds
9c51ae09: raises $0.08 to $0.13
Hero: folds
18aade85: calls $0.11
5861f243: folds
*** FLOP *** [6c 2d Ks]
18aade85: checks
9c51ae09: bets $0.09
18aade85: calls $0.09
*** TURN *** [6c 2d Ks] [9d]
18aade85: bets $0.37
9c51ae09: folds
Uncalled bet ($0.37) returned to 18aade85
*** SHOWDOWN ***
18aade85 collected $0.47 from pot
*** SUMMARY ***
Total pot $0.49 | Rake $0.02 | Jackpot $0 | Bingo $0 | Fortune $0 | Tax $0
Board [6c 2d Ks 9d]
Seat 1: Hero (button) folded before Flop (didn't bet)
Seat 2: 18aade85 (small blind) won ($0.47)
Seat 3: 5861f243 (big blind) folded before Flop
Seat 4: aa2421a5 folded before Flop (didn't bet)
Seat 5: d45bc7f3 folded before Flop (didn't bet)
Seat 6: 9c51ae09 folded on the Turn


Poker Hand #RC2078539315: Hold'em No Limit ($0.02/$0.05) - 2023/12/22 21:49:02
Table 'RushAndCash799359' 6-max Seat #1 is the button
Seat 1: 10def899 ($5.66 in chips)
Seat 2: f64c1e66 ($6.36 in chips)
Seat 3: e91020c6 ($5.11 in chips)
Seat 4: cfacbec5 ($5.3 in chips)
Seat 5: 6ef00a1b ($14.55 in chips)
Seat 6: Hero ($6.75 in chips)
f64c1e66: posts small blind $0.02
e91020c6: posts big blind $0.05
*** HOLE CARDS ***
Dealt to 10def899 
Dealt to f64c1e66 
Dealt to e91020c6 
Dealt to cfacbec5 
Dealt to 6ef00a1b 
Dealt to Hero [5d 6s]
cfacbec5: folds
6ef00a1b: raises $0.08 to $0.13
Hero: folds
10def899: folds
f64c1e66: folds
e91020c6: folds
Uncalled bet ($0.08) returned to 6ef00a1b
*** SHOWDOWN ***
6ef00a1b collected $0.12 from pot
*** SUMMARY ***
Total pot $0.12 | Rake $0 | Jackpot $0 | Bingo $0 | Fortune $0 | Tax $0
Seat 1: 10def899 (button) folded before Flop (didn't bet)
Seat 2: f64c1e66 (small blind) folded before Flop
Seat 3: e91020c6 (big blind) folded before Flop
Seat 4: cfacbec5 folded before Flop (didn't bet)
Seat 5: 6ef00a1b collected ($0.12)
Seat 6: Hero folded before Flop (didn't bet)


Poker Hand #RC2078539243: Hold'em No Limit ($0.02/$0.05) - 2023/12/22 21:48:59
Table 'RushAndCash799324' 6-max Seat #1 is the button
Seat 1: 3d582dec ($5.05 in chips)
Seat 2: 153b1345 ($10.35 in chips)
Seat 3: 2520bab9 ($6.45 in chips)
Seat 4: Hero ($6.75 in chips)
Seat 5: 86ac6ff5 ($4.65 in chips)
Seat 6: 81f9a1e6 ($15.63 in chips)
153b1345: posts small blind $0.02
2520bab9: posts big blind $0.05
*** HOLE CARDS ***
Dealt to 3d582dec 
Dealt to 153b1345 
Dealt to 2520bab9 
Dealt to Hero [2h 9d]
Dealt to 86ac6ff5 
Dealt to 81f9a1e6 
Hero: folds
86ac6ff5: raises $0.05 to $0.1
81f9a1e6: folds
3d582dec: folds
153b1345: folds
2520bab9: calls $0.05
*** FLOP *** [Qs Ah 7d]
2520bab9: checks
86ac6ff5: bets $0.08
2520bab9: calls $0.08
*** TURN *** [Qs Ah 7d] [8c]
2520bab9: checks
86ac6ff5: bets $0.29
2520bab9: calls $0.29
*** RIVER *** [Qs Ah 7d 8c] [Jh]
2520bab9: checks
86ac6ff5: checks
2520bab9: shows [Jc Th] (Pair of Jacks)
86ac6ff5: shows [Kc Ac] (Pair of Aces)
*** SHOWDOWN ***
86ac6ff5 collected $0.92 from pot
*** SUMMARY ***
Total pot $0.96 | Rake $0.04 | Jackpot $0 | Bingo $0 | Fortune $0 | Tax $0
Board [Qs Ah 7d 8c Jh]
Seat 1: 3d582dec (button) folded before Flop (didn't bet)
Seat 2: 153b1345 (small blind) folded before Flop
Seat 3: 2520bab9 (big blind) showed [Jc Th] and lost with Pair of Jacks
Seat 4: Hero folded before Flop (didn't bet)
Seat 5: 86ac6ff5 showed [Kc Ac] and won ($0.92) with Pair of Aces
Seat 6: 81f9a1e6 folded before Flop (didn't bet)


Poker Hand #RC2078539144: Hold'em No Limit ($0.02/$0.05) - 2023/12/22 21:48:53
Table 'RushAndCash799275' 6-max Seat #1 is the button
Seat 1: Hero ($6.75 in chips)
Seat 2: eeb37e34 ($10.33 in chips)
Seat 3: 8db2745e ($5.54 in chips)
Seat 4: 79ed61c1 ($4.07 in chips)
Seat 5: 67175993 ($5 in chips)
Seat 6: c8389234 ($12.35 in chips)
eeb37e34: posts small blind $0.02
8db2745e: posts big blind $0.05
*** HOLE CARDS ***
Dealt to Hero [2d 9c]
Dealt to eeb37e34 
Dealt to 8db2745e 
Dealt to 79ed61c1 
Dealt to 67175993 
Dealt to c8389234 
79ed61c1: raises $0.1 to $0.15
67175993: folds
c8389234: folds
Hero: folds
eeb37e34: folds
8db2745e: calls $0.1
*** FLOP *** [Kc As 8c]
8db2745e: checks
79ed61c1: bets $0.15
8db2745e: folds
Uncalled bet ($0.15) returned to 79ed61c1
*** SHOWDOWN ***
79ed61c1 collected $0.31 from pot
*** SUMMARY ***
Total pot $0.32 | Rake $0.01 | Jackpot $0 | Bingo $0 | Fortune $0 | Tax $0
Board [Kc As 8c]
Seat 1: Hero (button) folded before Flop (didn't bet)
Seat 2: eeb37e34 (small blind) folded before Flop
Seat 3: 8db2745e (big blind) folded on the Flop
Seat 4: 79ed61c1 won ($0.31)
Seat 5: 67175993 folded before Flop (didn't bet)
Seat 6: c8389234 folded before Flop (didn't bet)


Poker Hand #RC2078539048: Hold'em No Limit ($0.02/$0.05) - 2023/12/22 21:48:48
Table 'RushAndCash799230' 6-max Seat #1 is the button
Seat 1: 330b404c ($8.3 in chips)
Seat 2: 11811683 ($7.2 in chips)
Seat 3: 30a2950b ($5.41 in chips)
Seat 4: a0fe182f ($5 in chips)
Seat 5: Hero ($6.75 in chips)
Seat 6: 6d679d40 ($5.86 in chips)
11811683: posts small blind $0.02
30a2950b: posts big blind $0.05
*** HOLE CARDS ***
Dealt to 330b404c 
Dealt to 11811683 
Dealt to 30a2950b 
Dealt to a0fe182f 
Dealt to Hero [7s 2c]
Dealt to 6d679d40 
a0fe182f: folds
Hero: folds
6d679d40: folds
330b404c: folds
11811683: folds
Uncalled bet ($0.03) returned to 30a2950b
*** SHOWDOWN ***
30a2950b collected $0.04 from pot
*** SUMMARY ***
Total pot $0.04 | Rake $0 | Jackpot $0 | Bingo $0 | Fortune $0 | Tax $0
Seat 1: 330b404c (button) folded before Flop (didn't bet)
Seat 2: 11811683 (small blind) folded before Flop
Seat 3: 30a2950b (big blind) collected ($0.04)
Seat 4: a0fe182f folded before Flop (didn't bet)
Seat 5: Hero folded before Flop (didn't bet)
Seat 6: 6d679d40 folded before Flop (didn't bet)


Poker Hand #RC2078538843: Hold'em No Limit ($0.02/$0.05) - 2023/12/22 21:48:36
Table 'RushAndCash799126' 6-max Seat #1 is the button
Seat 1: 521feab9 ($5.49 in chips)
Seat 2: 75597e1b ($4.93 in chips)
Seat 3: Hero ($6.8 in chips)
Seat 4: f9ff013a ($5.34 in chips)
Seat 5: 177da66b ($7.87 in chips)
Seat 6: 6fadee13 ($5.32 in chips)
75597e1b: posts small blind $0.02
Hero: posts big blind $0.05
*** HOLE CARDS ***
Dealt to 521feab9 
Dealt to 75597e1b 
Dealt to Hero [Qc 9s]
Dealt to f9ff013a 
Dealt to 177da66b 
Dealt to 6fadee13 
f9ff013a: folds
177da66b: folds
6fadee13: folds
521feab9: folds
75597e1b: raises $0.08 to $0.13
Hero: folds
Uncalled bet ($0.08) returned to 75597e1b
*** SHOWDOWN ***
75597e1b collected $0.1 from pot
*** SUMMARY ***
Total pot $0.1 | Rake $0 | Jackpot $0 | Bingo $0 | Fortune $0 | Tax $0
Seat 1: 521feab9 (button) folded before Flop (didn't bet)
Seat 2: 75597e1b (small blind) collected ($0.1)
Seat 3: Hero (big blind) folded before Flop
Seat 4: f9ff013a folded before Flop (didn't bet)
Seat 5: 177da66b folded before Flop (didn't bet)
Seat 6: 6fadee13 folded before Flop (didn't bet)


Poker Hand #RC2078538724: Hold'em No Limit ($0.02/$0.05) - 2023/12/22 21:48:29
Table 'RushAndCash799071' 6-max Seat #1 is the button
Seat 1: 5c59e6a6 ($5 in chips)
Seat 2: b257878a ($5.12 in chips)
Seat 3: 9942b4df ($11.97 in chips)
Seat 4: 1259a422 ($7.11 in chips)
Seat 5: Hero ($6.8 in chips)
Seat 6: 9601129f ($10.73 in chips)
b257878a: posts small blind $0.02
9942b4df: posts big blind $0.05
*** HOLE CARDS ***
Dealt to 5c59e6a6 
Dealt to b257878a 
Dealt to 9942b4df 
Dealt to 1259a422 
Dealt to Hero [3d 4h]
Dealt to 9601129f 
1259a422: raises $0.08 to $0.13
Hero: folds
9601129f: folds
5c59e6a6: folds
b257878a: folds
9942b4df: folds
Uncalled bet ($0.08) returned to 1259a422
*** SHOWDOWN ***
1259a422 collected $0.12 from pot
*** SUMMARY ***
Total pot $0.12 | Rake $0 | Jackpot $0 | Bingo $0 | Fortune $0 | Tax $0
Seat 1: 5c59e6a6 (button) folded before Flop (didn't bet)
Seat 2: b257878a (small blind) folded before Flop
Seat 3: 9942b4df (big blind) folded before Flop
Seat 4: 1259a422 collected ($0.12)
Seat 5: Hero folded before Flop (didn't bet)
Seat 6: 9601129f folded before Flop (didn't bet)


Poker Hand #RC2078538656: Hold'em No Limit ($0.02/$0.05) - 2023/12/22 21:48:25
Table 'RushAndCash799040' 6-max Seat #1 is the button
Seat 1: 9c5c9d8 ($5 in chips)
Seat 2: cacef0e ($6.39 in chips)
Seat 3: a1dfe2ad ($6.15 in chips)
Seat 4: f7ea1894 ($6.75 in chips)
Seat 5: Hero ($6.8 in chips)
Seat 6: 49a9584 ($5.84 in chips)
cacef0e: posts small blind $0.02
a1dfe2ad: posts big blind $0.05
*** HOLE CARDS ***
Dealt to 9c5c9d8 
Dealt to cacef0e 
Dealt to a1dfe2ad 
Dealt to f7ea1894 
Dealt to Hero [Jd Ts]
Dealt to 49a9584 
f7ea1894: folds
Hero: folds
49a9584: folds
9c5c9d8: raises $0.08 to $0.13
cacef0e: raises $0.47 to $0.6
a1dfe2ad: folds
9c5c9d8: calls $0.47
*** FLOP *** [3s Kh 3d]
cacef0e: bets $0.42
9c5c9d8: calls $0.42
*** TURN *** [3s Kh 3d] [Tc]
cacef0e: bets $0.69
9c5c9d8: calls $0.69
*** RIVER *** [3s Kh 3d Tc] [5d]
cacef0e: checks
9c5c9d8: bets $3.29 and is all-in
cacef0e: calls $3.29
9c5c9d8: shows [Ah 8h] (Pair of Treys)
cacef0e: shows [Kc Jc] (Pair of Kings and Pair of Treys)
*** SHOWDOWN ***
cacef0e collected $9.83 from pot
*** SUMMARY ***
Total pot $10.05 | Rake $0.15 | Jackpot $0.07 | Bingo $0 | Fortune $0 | Tax $0
Board [3s Kh 3d Tc 5d]
Seat 1: 9c5c9d8 (button) showed [Ah 8h] and lost with Pair of Treys
Seat 2: cacef0e (small blind) showed [Kc Jc] and won ($9.83) with Pair of Kings and Pair of Treys
Seat 3: a1dfe2ad (big blind) folded before Flop
Seat 4: f7ea1894 folded before Flop (didn't bet)
Seat 5: Hero folded before Flop (didn't bet)
Seat 6: 49a9584 folded before Flop (didn't bet)


Poker Hand #RC2078538593: Hold'em No Limit ($0.02/$0.05) - 2023/12/22 21:48:21
Table 'RushAndCash799009' 6-max Seat #1 is the button
Seat 1: 4c0d7324 ($7.45 in chips)
Seat 2: 869465ff ($17 in chips)
Seat 3: 566b7ee3 ($5.12 in chips)
Seat 4: e99cedcc ($6.03 in chips)
Seat 5: Hero ($6.8 in chips)
Seat 6: 8f240b5e ($9.42 in chips)
869465ff: posts small blind $0.02
566b7ee3: posts big blind $0.05
*** HOLE CARDS ***
Dealt to 4c0d7324 
Dealt to 869465ff 
Dealt to 566b7ee3 
Dealt to e99cedcc 
Dealt to Hero [Ac 5h]
Dealt to 8f240b5e 
e99cedcc: folds
Hero: folds
8f240b5e: raises $0.1 to $0.15
4c0d7324: folds
869465ff: folds
566b7ee3: folds
Uncalled bet ($0.1) returned to 8f240b5e
*** SHOWDOWN ***
8f240b5e collected $0.12 from pot
*** SUMMARY ***
Total pot $0.12 | Rake $0 | Jackpot $0 | Bingo $0 | Fortune $0 | Tax $0
Seat 1: 4c0d7324 (button) folded before Flop (didn't bet)
Seat 2: 869465ff (small blind) folded before Flop
Seat 3: 566b7ee3 (big blind) folded before Flop
Seat 4: e99cedcc folded before Flop (didn't bet)
Seat 5: Hero folded before Flop (didn't bet)
Seat 6: 8f240b5e collected ($0.12)


Poker Hand #RC2078538483: Hold'em No Limit ($0.02/$0.05) - 2023/12/22 21:48:15
Table 'RushAndCash798955' 6-max Seat #1 is the button
Seat 1: 29186869 ($0.68 in chips)
Seat 2: Hero ($6.82 in chips)
Seat 3: e3e578eb ($5.07 in chips)
Seat 4: e46f04df ($8.52 in chips)
Seat 5: 4e925dd0 ($5.76 in chips)
Seat 6: f93190a6 ($8.23 in chips)
Hero: posts small blind $0.02
e3e578eb: posts big blind $0.05
*** HOLE CARDS ***
Dealt to 29186869 
Dealt to Hero [Jh 8s]
Dealt to e3e578eb 
Dealt to e46f04df 
Dealt to 4e925dd0 
Dealt to f93190a6 
e46f04df: folds
4e925dd0: folds
f93190a6: raises $0.08 to $0.13
29186869: folds
Hero: folds
e3e578eb: raises $0.47 to $0.6
f93190a6: calls $0.47
*** FLOP *** [7h Js 5s]
e3e578eb: checks
f93190a6: bets $0.7
e3e578eb: folds
Uncalled bet ($0.7) returned to f93190a6
*** SHOWDOWN ***
f93190a6 collected $1.16 from pot
*** SUMMARY ***
Total pot $1.22 | Rake $0.06 | Jackpot $0 | Bingo $0 | Fortune $0 | Tax $0
Board [7h Js 5s]
Seat 1: 29186869 (button) folded before Flop (didn't bet)
Seat 2: Hero (small blind) folded before Flop
Seat 3: e3e578eb (big blind) folded on the Flop
Seat 4: e46f04df folded before Flop (didn't bet)
Seat 5: 4e925dd0 folded before Flop (didn't bet)
Seat 6: f93190a6 won ($1.16)


Poker Hand #RC2078538176: Hold'em No Limit ($0.02/$0.05) - 2023/12/22 21:47:56
Table 'RushAndCash798801' 6-max Seat #1 is the button
Seat 1: eadbd152 ($4.86 in chips)
Seat 2: 538e953f ($5.61 in chips)
Seat 3: Hero ($6.87 in chips)
Seat 4: e46f04df ($8.67 in chips)
Seat 5: d23c04d ($9.08 in chips)
Seat 6: 153b1345 ($10.21 in chips)
538e953f: posts small blind $0.02
Hero: posts big blind $0.05
*** HOLE CARDS ***
Dealt to eadbd152 
Dealt to 538e953f 
Dealt to Hero [Td Ah]
Dealt to e46f04df 
Dealt to d23c04d 
Dealt to 153b1345 
e46f04df: raises $0.1 to $0.15
d23c04d: folds
153b1345: raises $0.3 to $0.45
eadbd152: folds
538e953f: folds
Hero: folds
e46f04df: folds
Uncalled bet ($0.3) returned to 153b1345
*** SHOWDOWN ***
153b1345 collected $0.36 from pot
*** SUMMARY ***
Total pot $0.37 | Rake $0.01 | Jackpot $0 | Bingo $0 | Fortune $0 | Tax $0
Seat 1: eadbd152 (button) folded before Flop (didn't bet)
Seat 2: 538e953f (small blind) folded before Flop
Seat 3: Hero (big blind) folded before Flop
Seat 4: e46f04df folded before Flop
Seat 5: d23c04d folded before Flop (didn't bet)
Seat 6: 153b1345 collected ($0.36)


Poker Hand #RC2078538111: Hold'em No Limit ($0.02/$0.05) - 2023/12/22 21:47:52
Table 'RushAndCash798766' 6-max Seat #1 is the button
Seat 1: fcd47b7a ($2.87 in chips)
Seat 2: Hero ($6.89 in chips)
Seat 3: 4d43d419 ($5 in chips)
Seat 4: deb19c7 ($6.14 in chips)
Seat 5: b4aaf9de ($10.12 in chips)
Seat 6: 71871718 ($2.57 in chips)
Hero: posts small blind $0.02
4d43d419: posts big blind $0.05
*** HOLE CARDS ***
Dealt to fcd47b7a 
Dealt to Hero [7h 4s]
Dealt to 4d43d419 
Dealt to deb19c7 
Dealt to b4aaf9de 
Dealt to 71871718 
deb19c7: folds
b4aaf9de: folds
71871718: folds
fcd47b7a: raises $0.05 to $0.1
Hero: folds
4d43d419: folds
Uncalled bet ($0.05) returned to fcd47b7a
*** SHOWDOWN ***
fcd47b7a collected $0.12 from pot
*** SUMMARY ***
Total pot $0.12 | Rake $0 | Jackpot $0 | Bingo $0 | Fortune $0 | Tax $0
Seat 1: fcd47b7a (button) collected ($0.12)
Seat 2: Hero (small blind) folded before Flop
Seat 3: 4d43d419 (big blind) folded before Flop
Seat 4: deb19c7 folded before Flop (didn't bet)
Seat 5: b4aaf9de folded before Flop (didn't bet)
Seat 6: 71871718 folded before Flop (didn't bet)


Poker Hand #RC2078538051: Hold'em No Limit ($0.02/$0.05) - 2023/12/22 21:47:48
Table 'RushAndCash798735' 6-max Seat #1 is the button
Seat 1: 2c867a7e ($11.4 in chips)
Seat 2: ff50af14 ($5.14 in chips)
Seat 3: 7faa6e20 ($6.46 in chips)
Seat 4: Hero ($6.89 in chips)
Seat 5: b0446474 ($13.03 in chips)
Seat 6: 90a9fad4 ($53.06 in chips)
ff50af14: posts small blind $0.02
7faa6e20: posts big blind $0.05
*** HOLE CARDS ***
Dealt to 2c867a7e 
Dealt to ff50af14 
Dealt to 7faa6e20 
Dealt to Hero [9h Qc]
Dealt to b0446474 
Dealt to 90a9fad4 
Hero: folds
b0446474: folds
90a9fad4: raises $0.07 to $0.12
2c867a7e: folds
ff50af14: folds
7faa6e20: raises $0.26 to $0.38
90a9fad4: folds
Uncalled bet ($0.26) returned to 7faa6e20
*** SHOWDOWN ***
7faa6e20 collected $0.25 from pot
*** SUMMARY ***
Total pot $0.26 | Rake $0.01 | Jackpot $0 | Bingo $0 | Fortune $0 | Tax $0
Seat 1: 2c867a7e (button) folded before Flop (didn't bet)
Seat 2: ff50af14 (small blind) folded before Flop
Seat 3: 7faa6e20 (big blind) collected ($0.25)
Seat 4: Hero folded before Flop (didn't bet)
Seat 5: b0446474 folded before Flop (didn't bet)
Seat 6: 90a9fad4 folded before Flop


Poker Hand #RC2078537874: Hold'em No Limit ($0.02/$0.05) - 2023/12/22 21:47:38
Table 'RushAndCash798648' 6-max Seat #1 is the button
Seat 1: Hero ($6.82 in chips)
Seat 2: bf955ffb ($5.46 in chips)
Seat 3: ea71423 ($5.88 in chips)
Seat 4: ed75fdbb ($6.03 in chips)
Seat 5: 7385f3 ($4.93 in chips)
Seat 6: 2075befd ($5.07 in chips)
bf955ffb: posts small blind $0.02
ea71423: posts big blind $0.05
*** HOLE CARDS ***
Dealt to Hero [7c Kc]
Dealt to bf955ffb 
Dealt to ea71423 
Dealt to ed75fdbb 
Dealt to 7385f3 
Dealt to 2075befd 
ed75fdbb: folds
7385f3: folds
2075befd: folds
Hero: raises $0.08 to $0.13
bf955ffb: folds
ea71423: folds
Uncalled bet ($0.08) returned to Hero
*** SHOWDOWN ***
Hero collected $0.12 from pot
*** SUMMARY ***
Total pot $0.12 | Rake $0 | Jackpot $0 | Bingo $0 | Fortune $0 | Tax $0
Seat 1: Hero (button) collected ($0.12)
Seat 2: bf955ffb (small blind) folded before Flop
Seat 3: ea71423 (big blind) folded before Flop
Seat 4: ed75fdbb folded before Flop (didn't bet)
Seat 5: 7385f3 folded before Flop (didn't bet)
Seat 6: 2075befd folded before Flop (didn't bet)


Poker Hand #RC2078537813: Hold'em No Limit ($0.02/$0.05) - 2023/12/22 21:47:34
Table 'RushAndCash798617' 6-max Seat #1 is the button
Seat 1: 57eb4842 ($5.37 in chips)
Seat 2: 963f3a1f ($2.37 in chips)
Seat 3: 50868c5b ($5.35 in chips)
Seat 4: 7385f3 ($4.93 in chips)
Seat 5: 4069ada7 ($4.97 in chips)
Seat 6: Hero ($6.82 in chips)
963f3a1f: posts small blind $0.02
50868c5b: posts big blind $0.05
*** HOLE CARDS ***
Dealt to 57eb4842 
Dealt to 963f3a1f 
Dealt to 50868c5b 
Dealt to 7385f3 
Dealt to 4069ada7 
Dealt to Hero [8s 9h]
7385f3: folds
4069ada7: folds
Hero: folds
57eb4842: raises $0.08 to $0.13
963f3a1f: folds
50868c5b: folds
Uncalled bet ($0.08) returned to 57eb4842
*** SHOWDOWN ***
57eb4842 collected $0.12 from pot
*** SUMMARY ***
Total pot $0.12 | Rake $0 | Jackpot $0 | Bingo $0 | Fortune $0 | Tax $0
Seat 1: 57eb4842 (button) collected ($0.12)
Seat 2: 963f3a1f (small blind) folded before Flop
Seat 3: 50868c5b (big blind) folded before Flop
Seat 4: 7385f3 folded before Flop (didn't bet)
Seat 5: 4069ada7 folded before Flop (didn't bet)
Seat 6: Hero folded before Flop (didn't bet)


Poker Hand #RC2078537757: Hold'em No Limit ($0.02/$0.05) - 2023/12/22 21:47:30
Table 'RushAndCash798594' 6-max Seat #1 is the button
Seat 1: c23d7305 ($1.52 in chips)
Seat 2: ab4cb6cb ($5 in chips)
Seat 3: 49a9584 ($5.91 in chips)
Seat 4: 8d15f06b ($10.95 in chips)
Seat 5: Hero ($6.82 in chips)
Seat 6: 8802c225 ($5.21 in chips)
ab4cb6cb: posts small blind $0.02
49a9584: posts big blind $0.05
*** HOLE CARDS ***
Dealt to c23d7305 
Dealt to ab4cb6cb 
Dealt to 49a9584 
Dealt to 8d15f06b 
Dealt to Hero [2h Ad]
Dealt to 8802c225 
8d15f06b: folds
Hero: folds
8802c225: raises $0.08 to $0.13
c23d7305: calls $0.13
ab4cb6cb: folds
49a9584: folds
*** FLOP *** [Tc 5s 5c]
8802c225: checks
c23d7305: bets $0.11
8802c225: raises $0.16 to $0.27
c23d7305: calls $0.16
*** TURN *** [Tc 5s 5c] [4s]
8802c225: checks
c23d7305: checks
*** RIVER *** [Tc 5s 5c 4s] [4d]
8802c225: bets $1.12
c23d7305: folds
Uncalled bet ($1.12) returned to 8802c225
*** SHOWDOWN ***
8802c225 collected $0.83 from pot
*** SUMMARY ***
Total pot $0.87 | Rake $0.04 | Jackpot $0 | Bingo $0 | Fortune $0 | Tax $0
Board [Tc 5s 5c 4s 4d]
Seat 1: c23d7305 (button) folded on the River
Seat 2: ab4cb6cb (small blind) folded before Flop
Seat 3: 49a9584 (big blind) folded before Flop
Seat 4: 8d15f06b folded before Flop (didn't bet)
Seat 5: Hero folded before Flop (didn't bet)
Seat 6: 8802c225 won ($0.83)


Poker Hand #RC2078537689: Hold'em No Limit ($0.02/$0.05) - 2023/12/22 21:47:26
Table 'RushAndCash798560' 6-max Seat #1 is the button
Seat 1: 4ef07903 ($5 in chips)
Seat 2: 7c10f852 ($37.15 in chips)
Seat 3: 661ba238 ($5.3 in chips)
Seat 4: Hero ($6.82 in chips)
Seat 5: f4e201f0 ($10.78 in chips)
Seat 6: 2f160a64 ($6.4 in chips)
7c10f852: posts small blind $0.02
661ba238: posts big blind $0.05
*** HOLE CARDS ***
Dealt to 4ef07903 
Dealt to 7c10f852 
Dealt to 661ba238 
Dealt to Hero [2h Kh]
Dealt to f4e201f0 
Dealt to 2f160a64 
Hero: folds
f4e201f0: folds
2f160a64: raises $0.07 to $0.12
4ef07903: folds
7c10f852: calls $0.1
661ba238: folds
*** FLOP *** [Td Qd Ks]
7c10f852: checks
2f160a64: bets $0.1
7c10f852: folds
Uncalled bet ($0.1) returned to 2f160a64
*** SHOWDOWN ***
2f160a64 collected $0.28 from pot
*** SUMMARY ***
Total pot $0.29 | Rake $0.01 | Jackpot $0 | Bingo $0 | Fortune $0 | Tax $0
Board [Td Qd Ks]
Seat 1: 4ef07903 (button) folded before Flop (didn't bet)
Seat 2: 7c10f852 (small blind) folded on the Flop
Seat 3: 661ba238 (big blind) folded before Flop
Seat 4: Hero folded before Flop (didn't bet)
Seat 5: f4e201f0 folded before Flop (didn't bet)
Seat 6: 2f160a64 won ($0.28)


Poker Hand #RC2078537558: Hold'em No Limit ($0.02/$0.05) - 2023/12/22 21:47:17
Table 'RushAndCash798494' 6-max Seat #1 is the button
Seat 1: 23c96099 ($5.07 in chips)
Seat 2: Hero ($6.84 in chips)
Seat 3: ab4cb6cb ($5 in chips)
Seat 4: d32741ba ($7.1 in chips)
Seat 5: 4f704fa2 ($5.07 in chips)
Seat 6: a774641b ($5 in chips)
Hero: posts small blind $0.02
ab4cb6cb: posts big blind $0.05
*** HOLE CARDS ***
Dealt to 23c96099 
Dealt to Hero [8h 7d]
Dealt to ab4cb6cb 
Dealt to d32741ba 
Dealt to 4f704fa2 
Dealt to a774641b 
d32741ba: folds
4f704fa2: folds
a774641b: raises $0.1 to $0.15
23c96099: folds
Hero: folds
ab4cb6cb: folds
Uncalled bet ($0.1) returned to a774641b
*** SHOWDOWN ***
a774641b collected $0.12 from pot
*** SUMMARY ***
Total pot $0.12 | Rake $0 | Jackpot $0 | Bingo $0 | Fortune $0 | Tax $0
Seat 1: 23c96099 (button) folded before Flop (didn't bet)
Seat 2: Hero (small blind) folded before Flop
Seat 3: ab4cb6cb (big blind) folded before Flop
Seat 4: d32741ba folded before Flop (didn't bet)
Seat 5: 4f704fa2 folded before Flop (didn't bet)
Seat 6: a774641b collected ($0.12)


Poker Hand #RC2078537407: Hold'em No Limit ($0.02/$0.05) - 2023/12/22 21:47:06
Table 'RushAndCash798417' 6-max Seat #1 is the button
Seat 1: 8f80311 ($5.26 in chips)
Seat 2: 8db2745e ($5.09 in chips)
Seat 3: Hero ($6.82 in chips)
Seat 4: 4e925dd0 ($6.05 in chips)
Seat 5: 875f34a0 ($25.22 in chips)
Seat 6: 2bb677ff ($4.95 in chips)
8db2745e: posts small blind $0.02
Hero: posts big blind $0.05
*** HOLE CARDS ***
Dealt to 8f80311 
Dealt to 8db2745e 
Dealt to Hero [Th 8c]
Dealt to 4e925dd0 
Dealt to 875f34a0 
Dealt to 2bb677ff 
4e925dd0: folds
875f34a0: folds
2bb677ff: folds
8f80311: folds
8db2745e: folds
Uncalled bet ($0.03) returned to Hero
*** SHOWDOWN ***
Hero collected $0.04 from pot
*** SUMMARY ***
Total pot $0.04 | Rake $0 | Jackpot $0 | Bingo $0 | Fortune $0 | Tax $0
Seat 1: 8f80311 (button) folded before Flop (didn't bet)
Seat 2: 8db2745e (small blind) folded before Flop
Seat 3: Hero (big blind) collected ($0.04)
Seat 4: 4e925dd0 folded before Flop (didn't bet)
Seat 5: 875f34a0 folded before Flop (didn't bet)
Seat 6: 2bb677ff folded before Flop (didn't bet)


Poker Hand #RC2078537319: Hold'em No Limit ($0.02/$0.05) - 2023/12/22 21:47:00
Table 'RushAndCash798374' 6-max Seat #1 is the button
Seat 1: Hero ($6.82 in chips)
Seat 2: 23c96099 ($5.07 in chips)
Seat 3: 6659feae ($3.64 in chips)
Seat 4: 354a07bb ($8.3 in chips)
Seat 5: 8642862c ($5.15 in chips)
Seat 6: ce05a1d5 ($5 in chips)
23c96099: posts small blind $0.02
6659feae: posts big blind $0.05
*** HOLE CARDS ***
Dealt to Hero [3s 6d]
Dealt to 23c96099 
Dealt to 6659feae 
Dealt to 354a07bb 
Dealt to 8642862c 
Dealt to ce05a1d5 
354a07bb: folds
8642862c: folds
ce05a1d5: raises $0.08 to $0.13
Hero: folds
23c96099: folds
6659feae: raises $0.21 to $0.34
ce05a1d5: calls $0.21
*** FLOP *** [7h 2d 9c]
6659feae: bets $0.35
ce05a1d5: folds
Uncalled bet ($0.35) returned to 6659feae
*** SHOWDOWN ***
6659feae collected $0.67 from pot
*** SUMMARY ***
Total pot $0.7 | Rake $0.03 | Jackpot $0 | Bingo $0 | Fortune $0 | Tax $0
Board [7h 2d 9c]
Seat 1: Hero (button) folded before Flop (didn't bet)
Seat 2: 23c96099 (small blind) folded before Flop
Seat 3: 6659feae (big blind) won ($0.67)
Seat 4: 354a07bb folded before Flop (didn't bet)
Seat 5: 8642862c folded before Flop (didn't bet)
Seat 6: ce05a1d5 folded on the Flop


Poker Hand #RC2078537251: Hold'em No Limit ($0.02/$0.05) - 2023/12/22 21:46:57
Table 'RushAndCash798344' 6-max Seat #1 is the button
Seat 1: 993ccadb ($14.11 in chips)
Seat 2: b75c858f ($5 in chips)
Seat 3: e99cedcc ($6.13 in chips)
Seat 4: 29b0f5be ($7.46 in chips)
Seat 5: f704f14d ($2.34 in chips)
Seat 6: Hero ($6.82 in chips)
b75c858f: posts small blind $0.02
e99cedcc: posts big blind $0.05
*** HOLE CARDS ***
Dealt to 993ccadb 
Dealt to b75c858f 
Dealt to e99cedcc 
Dealt to 29b0f5be 
Dealt to f704f14d 
Dealt to Hero [Kh 3s]
29b0f5be: folds
f704f14d: raises $0.1 to $0.15
Hero: folds
993ccadb: folds
b75c858f: folds
e99cedcc: calls $0.1
*** FLOP *** [4h Jh Qh]
e99cedcc: checks
f704f14d: bets $0.16
e99cedcc: folds
Uncalled bet ($0.16) returned to f704f14d
*** SHOWDOWN ***
f704f14d collected $0.31 from pot
*** SUMMARY ***
Total pot $0.32 | Rake $0.01 | Jackpot $0 | Bingo $0 | Fortune $0 | Tax $0
Board [4h Jh Qh]
Seat 1: 993ccadb (button) folded before Flop (didn't bet)
Seat 2: b75c858f (small blind) folded before Flop
Seat 3: e99cedcc (big blind) folded on the Flop
Seat 4: 29b0f5be folded before Flop (didn't bet)
Seat 5: f704f14d won ($0.31)
Seat 6: Hero folded before Flop (didn't bet)


Poker Hand #RC2078537190: Hold'em No Limit ($0.02/$0.05) - 2023/12/22 21:46:53
Table 'RushAndCash798314' 6-max Seat #1 is the button
Seat 1: bc118b95 ($5 in chips)
Seat 2: 91e6539a ($7.21 in chips)
Seat 3: a420712c ($5.66 in chips)
Seat 4: Hero ($6.82 in chips)
Seat 5: 6969351a ($9.38 in chips)
Seat 6: 72e47b5b ($2.58 in chips)
91e6539a: posts small blind $0.02
a420712c: posts big blind $0.05
*** HOLE CARDS ***
Dealt to bc118b95 
Dealt to 91e6539a 
Dealt to a420712c 
Dealt to Hero [7c 8s]
Dealt to 6969351a 
Dealt to 72e47b5b 
Hero: folds
6969351a: raises $0.05 to $0.1
72e47b5b: calls $0.1
bc118b95: folds
91e6539a: folds
a420712c: folds
*** FLOP *** [4h Ah Ts]
6969351a: checks
72e47b5b: checks
*** TURN *** [4h Ah Ts] [Jc]
6969351a: bets $0.21
72e47b5b: calls $0.21
*** RIVER *** [4h Ah Ts Jc] [Kd]
6969351a: bets $0.52
72e47b5b: raises $1.73 to $2.25
6969351a: calls $1.73
72e47b5b: shows [Qs 7s] (Aces-High Straight)
6969351a: shows [Js Qh] (Aces-High Straight)
*** SHOWDOWN ***
6969351a collected $2.49 from pot
72e47b5b collected $2.49 from pot
*** SUMMARY ***
Total pot $5.19 | Rake $0.14 | Jackpot $0.07 | Bingo $0 | Fortune $0 | Tax $0
Board [4h Ah Ts Jc Kd]
Seat 1: bc118b95 (button) folded before Flop (didn't bet)
Seat 2: 91e6539a (small blind) folded before Flop
Seat 3: a420712c (big blind) folded before Flop
Seat 4: Hero folded before Flop (didn't bet)
Seat 5: 6969351a showed [Js Qh] and won ($2.49) with Aces-High Straight
Seat 6: 72e47b5b showed [Qs 7s] and won ($2.49) with Aces-High Straight


Poker Hand #RC2078537102: Hold'em No Limit ($0.02/$0.05) - 2023/12/22 21:46:48
Table 'RushAndCash798272' 6-max Seat #1 is the button
Seat 1: Hero ($6.82 in chips)
Seat 2: 4a196974 ($5.42 in chips)
Seat 3: 532b7af3 ($8.77 in chips)
Seat 4: a411db6 ($2.15 in chips)
Seat 5: 3288926 ($7.23 in chips)
Seat 6: 777bac87 ($7.24 in chips)
4a196974: posts small blind $0.02
532b7af3: posts big blind $0.05
*** HOLE CARDS ***
Dealt to Hero [8c 5h]
Dealt to 4a196974 
Dealt to 532b7af3 
Dealt to a411db6 
Dealt to 3288926 
Dealt to 777bac87 
a411db6: folds
3288926: folds
777bac87: folds
Hero: folds
4a196974: folds
Uncalled bet ($0.03) returned to 532b7af3
*** SHOWDOWN ***
532b7af3 collected $0.04 from pot
*** SUMMARY ***
Total pot $0.04 | Rake $0 | Jackpot $0 | Bingo $0 | Fortune $0 | Tax $0
Seat 1: Hero (button) folded before Flop (didn't bet)
Seat 2: 4a196974 (small blind) folded before Flop
Seat 3: 532b7af3 (big blind) collected ($0.04)
Seat 4: a411db6 folded before Flop (didn't bet)
Seat 5: 3288926 folded before Flop (didn't bet)
Seat 6: 777bac87 folded before Flop (didn't bet)


Poker Hand #RC2078536838: Hold'em No Limit ($0.02/$0.05) - 2023/12/22 21:46:32
Table 'RushAndCash798141' 6-max Seat #1 is the button
Seat 1: 9a957500 ($4.39 in chips)
Seat 2: 8369fc6c ($6.64 in chips)
Seat 3: Hero ($6.87 in chips)
Seat 4: f6b5f68e ($5 in chips)
Seat 5: 7f067c94 ($41.93 in chips)
Seat 6: f3e4b0ce ($1.01 in chips)
8369fc6c: posts small blind $0.02
Hero: posts big blind $0.05
*** HOLE CARDS ***
Dealt to 9a957500 
Dealt to 8369fc6c 
Dealt to Hero [7c 3s]
Dealt to f6b5f68e 
Dealt to 7f067c94 
Dealt to f3e4b0ce 
f6b5f68e: folds
7f067c94: folds
f3e4b0ce: raises $0.08 to $0.13
9a957500: folds
8369fc6c: folds
Hero: folds
Uncalled bet ($0.08) returned to f3e4b0ce
*** SHOWDOWN ***
f3e4b0ce collected $0.12 from pot
*** SUMMARY ***
Total pot $0.12 | Rake $0 | Jackpot $0 | Bingo $0 | Fortune $0 | Tax $0
Seat 1: 9a957500 (button) folded before Flop (didn't bet)
Seat 2: 8369fc6c (small blind) folded before Flop
Seat 3: Hero (big blind) folded before Flop
Seat 4: f6b5f68e folded before Flop (didn't bet)
Seat 5: 7f067c94 folded before Flop (didn't bet)
Seat 6: f3e4b0ce collected ($0.12)


Poker Hand #RC2078536728: Hold'em No Limit ($0.02/$0.05) - 2023/12/22 21:46:26
Table 'RushAndCash798090' 6-max Seat #1 is the button
Seat 1: 3910f1b8 ($4.93 in chips)
Seat 2: 25941725 ($4.74 in chips)
Seat 3: 62b0eed9 ($5 in chips)
Seat 4: 6d50e434 ($3.86 in chips)
Seat 5: Hero ($6.87 in chips)
Seat 6: a90771fe ($10.45 in chips)
25941725: posts small blind $0.02
62b0eed9: posts big blind $0.05
*** HOLE CARDS ***
Dealt to 3910f1b8 
Dealt to 25941725 
Dealt to 62b0eed9 
Dealt to 6d50e434 
Dealt to Hero [9c Ad]
Dealt to a90771fe 
6d50e434: folds
Hero: folds
a90771fe: folds
3910f1b8: folds
25941725: raises $0.07 to $0.12
62b0eed9: raises $0.2 to $0.32
25941725: calls $0.2
*** FLOP *** [2h Ac 7s]
25941725: checks
62b0eed9: bets $0.32
25941725: folds
Uncalled bet ($0.32) returned to 62b0eed9
*** SHOWDOWN ***
62b0eed9 collected $0.61 from pot
*** SUMMARY ***
Total pot $0.64 | Rake $0.03 | Jackpot $0 | Bingo $0 | Fortune $0 | Tax $0
Board [2h Ac 7s]
Seat 1: 3910f1b8 (button) folded before Flop (didn't bet)
Seat 2: 25941725 (small blind) folded on the Flop
Seat 3: 62b0eed9 (big blind) won ($0.61)
Seat 4: 6d50e434 folded before Flop (didn't bet)
Seat 5: Hero folded before Flop (didn't bet)
Seat 6: a90771fe folded before Flop (didn't bet)


Poker Hand #RC2078536641: Hold'em No Limit ($0.02/$0.05) - 2023/12/22 21:46:21
Table 'RushAndCash798049' 6-max Seat #1 is the button
Seat 1: 33091f5 ($5.38 in chips)
Seat 2: Hero ($6.89 in chips)
Seat 3: a20c0bea ($5.16 in chips)
Seat 4: 89dad04f ($9.08 in chips)
Seat 5: 83f47841 ($12.43 in chips)
Seat 6: 6dc2bdd ($3.64 in chips)
Hero: posts small blind $0.02
a20c0bea: posts big blind $0.05
*** HOLE CARDS ***
Dealt to 33091f5 
Dealt to Hero [Ah 6c]
Dealt to a20c0bea 
Dealt to 89dad04f 
Dealt to 83f47841 
Dealt to 6dc2bdd 
89dad04f: folds
83f47841: folds
6dc2bdd: folds
33091f5: folds
Hero: folds
Uncalled bet ($0.03) returned to a20c0bea
*** SHOWDOWN ***
a20c0bea collected $0.04 from pot
*** SUMMARY ***
Total pot $0.04 | Rake $0 | Jackpot $0 | Bingo $0 | Fortune $0 | Tax $0
Seat 1: 33091f5 (button) folded before Flop (didn't bet)
Seat 2: Hero (small blind) folded before Flop
Seat 3: a20c0bea (big blind) collected ($0.04)
Seat 4: 89dad04f folded before Flop (didn't bet)
Seat 5: 83f47841 folded before Flop (didn't bet)
Seat 6: 6dc2bdd folded before Flop (didn't bet)


Poker Hand #RC2078536024: Hold'em No Limit ($0.02/$0.05) - 2023/12/22 21:45:45
Table 'RushAndCash797748' 6-max Seat #1 is the button
Seat 1: 6dc2bdd ($3.84 in chips)
Seat 2: 32c92a7b ($5.25 in chips)
Seat 3: 3b055a50 ($12.69 in chips)
Seat 4: f4b75c57 ($4.19 in chips)
Seat 5: Hero ($6.64 in chips)
Seat 6: 64f7e138 ($14.32 in chips)
32c92a7b: posts small blind $0.02
3b055a50: posts big blind $0.05
*** HOLE CARDS ***
Dealt to 6dc2bdd 
Dealt to 32c92a7b 
Dealt to 3b055a50 
Dealt to f4b75c57 
Dealt to Hero [Ah 3h]
Dealt to 64f7e138 
f4b75c57: folds
Hero: raises $0.05 to $0.1
64f7e138: folds
6dc2bdd: calls $0.1
32c92a7b: folds
3b055a50: folds
*** FLOP *** [Kh 8s Ad]
Hero: bets $0.1
6dc2bdd: calls $0.1
*** TURN *** [Kh 8s Ad] [7s]
Hero: checks
6dc2bdd: checks
*** RIVER *** [Kh 8s Ad 7s] [8d]
Hero: bets $0.24
6dc2bdd: folds
Uncalled bet ($0.24) returned to Hero
*** SHOWDOWN ***
Hero collected $0.45 from pot
*** SUMMARY ***
Total pot $0.47 | Rake $0.02 | Jackpot $0 | Bingo $0 | Fortune $0 | Tax $0
Board [Kh 8s Ad 7s 8d]
Seat 1: 6dc2bdd (button) folded on the River
Seat 2: 32c92a7b (small blind) folded before Flop
Seat 3: 3b055a50 (big blind) folded before Flop
Seat 4: f4b75c57 folded before Flop (didn't bet)
Seat 5: Hero won ($0.45)
Seat 6: 64f7e138 folded before Flop (didn't bet)


Poker Hand #RC2078535954: Hold'em No Limit ($0.02/$0.05) - 2023/12/22 21:45:42
Table 'RushAndCash797716' 6-max Seat #1 is the button
Seat 1: 4305d806 ($4.4 in chips)
Seat 2: 6dc2bdd ($3.86 in chips)
Seat 3: f0040865 ($6.55 in chips)
Seat 4: Hero ($6.64 in chips)
Seat 5: 8626eae9 ($7.33 in chips)
Seat 6: 86ac6ff5 ($3.8 in chips)
6dc2bdd: posts small blind $0.02
f0040865: posts big blind $0.05
*** HOLE CARDS ***
Dealt to 4305d806 
Dealt to 6dc2bdd 
Dealt to f0040865 
Dealt to Hero [6c Tc]
Dealt to 8626eae9 
Dealt to 86ac6ff5 
Hero: folds
8626eae9: folds
86ac6ff5: folds
4305d806: folds
6dc2bdd: folds
Uncalled bet ($0.03) returned to f0040865
*** SHOWDOWN ***
f0040865 collected $0.04 from pot
*** SUMMARY ***
Total pot $0.04 | Rake $0 | Jackpot $0 | Bingo $0 | Fortune $0 | Tax $0
Seat 1: 4305d806 (button) folded before Flop (didn't bet)
Seat 2: 6dc2bdd (small blind) folded before Flop
Seat 3: f0040865 (big blind) collected ($0.04)
Seat 4: Hero folded before Flop (didn't bet)
Seat 5: 8626eae9 folded before Flop (didn't bet)
Seat 6: 86ac6ff5 folded before Flop (didn't bet)


Poker Hand #RC2078535801: Hold'em No Limit ($0.02/$0.05) - 2023/12/22 21:45:33
Table 'RushAndCash797640' 6-max Seat #1 is the button
Seat 1: Hero ($6.64 in chips)
Seat 2: 921e997e ($6.41 in chips)
Seat 3: 3402e890 ($10.11 in chips)
Seat 4: bf28a393 ($5.76 in chips)
Seat 5: c883264a ($13.38 in chips)
Seat 6: b4f829a4 ($5 in chips)
921e997e: posts small blind $0.02
3402e890: posts big blind $0.05
*** HOLE CARDS ***
Dealt to Hero [7s Ts]
Dealt to 921e997e 
Dealt to 3402e890 
Dealt to bf28a393 
Dealt to c883264a 
Dealt to b4f829a4 
bf28a393: raises $0.05 to $0.1
c883264a: folds
b4f829a4: folds
Hero: folds
921e997e: folds
3402e890: folds
Uncalled bet ($0.05) returned to bf28a393
*** SHOWDOWN ***
bf28a393 collected $0.12 from pot
*** SUMMARY ***
Total pot $0.12 | Rake $0 | Jackpot $0 | Bingo $0 | Fortune $0 | Tax $0
Seat 1: Hero (button) folded before Flop (didn't bet)
Seat 2: 921e997e (small blind) folded before Flop
Seat 3: 3402e890 (big blind) folded before Flop
Seat 4: bf28a393 collected ($0.12)
Seat 5: c883264a folded before Flop (didn't bet)
Seat 6: b4f829a4 folded before Flop (didn't bet)


Poker Hand #RC2078534834: Hold'em No Limit ($0.02/$0.05) - 2023/12/22 21:44:40
Table 'RushAndCash797170' 6-max Seat #1 is the button
Seat 1: 9220db62 ($5.31 in chips)
Seat 2: 2d19d9d1 ($5.63 in chips)
Seat 3: Hero ($5.78 in chips)
Seat 4: e24a2fed ($9.96 in chips)
Seat 5: 8db2745e ($5 in chips)
Seat 6: 68c6c5e7 ($27.87 in chips)
2d19d9d1: posts small blind $0.02
Hero: posts big blind $0.05
*** HOLE CARDS ***
Dealt to 9220db62 
Dealt to 2d19d9d1 
Dealt to Hero [5d 4d]
Dealt to e24a2fed 
Dealt to 8db2745e 
Dealt to 68c6c5e7 
e24a2fed: folds
8db2745e: folds
68c6c5e7: folds
9220db62: raises $0.1 to $0.15
2d19d9d1: folds
Hero: calls $0.1
*** FLOP *** [3s 2s Jd]
Hero: checks
9220db62: bets $0.25
Hero: calls $0.25
*** TURN *** [3s 2s Jd] [Jh]
Hero: checks
9220db62: bets $0.6
Hero: calls $0.6
*** RIVER *** [3s 2s Jd Jh] [Ks]
Hero: bets $0.67
9220db62: folds
Uncalled bet ($0.67) returned to Hero
*** SHOWDOWN ***
Hero collected $1.86 from pot
*** SUMMARY ***
Total pot $2.02 | Rake $0.09 | Jackpot $0.07 | Bingo $0 | Fortune $0 | Tax $0
Board [3s 2s Jd Jh Ks]
Seat 1: 9220db62 (button) folded on the River
Seat 2: 2d19d9d1 (small blind) folded before Flop
Seat 3: Hero (big blind) won ($1.86)
Seat 4: e24a2fed folded before Flop (didn't bet)
Seat 5: 8db2745e folded before Flop (didn't bet)
Seat 6: 68c6c5e7 folded before Flop (didn't bet)


Poker Hand #RC2078524472: Hold'em No Limit ($0.02/$0.05) - 2023/12/22 21:44:19
Table 'RushAndCash796988' 6-max Seat #1 is the button
Seat 1: 566b7ee3 ($5.25 in chips)
Seat 2: 93683449 ($6.98 in chips)
Seat 3: c5b816d3 ($5.91 in chips)
Seat 4: Hero ($5.71 in chips)
Seat 5: 93b1a4e4 ($10.64 in chips)
Seat 6: b36a4d43 ($5.96 in chips)
93683449: posts small blind $0.02
c5b816d3: posts big blind $0.05
*** HOLE CARDS ***
Dealt to 566b7ee3 
Dealt to 93683449 
Dealt to c5b816d3 
Dealt to Hero [Th Td]
Dealt to 93b1a4e4 
Dealt to b36a4d43 
Hero: raises $0.05 to $0.1
93b1a4e4: folds
b36a4d43: folds
566b7ee3: folds
93683449: folds
c5b816d3: folds
Uncalled bet ($0.05) returned to Hero
*** SHOWDOWN ***
Hero collected $0.12 from pot
*** SUMMARY ***
Total pot $0.12 | Rake $0 | Jackpot $0 | Bingo $0 | Fortune $0 | Tax $0
Seat 1: 566b7ee3 (button) folded before Flop (didn't bet)
Seat 2: 93683449 (small blind) folded before Flop
Seat 3: c5b816d3 (big blind) folded before Flop
Seat 4: Hero collected ($0.12)
Seat 5: 93b1a4e4 folded before Flop (didn't bet)
Seat 6: b36a4d43 folded before Flop (didn't bet)


Poker Hand #RC2078524302: Hold'em No Limit ($0.02/$0.05) - 2023/12/22 21:44:10
Table 'RushAndCash796905' 6-max Seat #1 is the button
Seat 1: 45008b71 ($2.79 in chips)
Seat 2: Hero ($5.73 in chips)
Seat 3: ed53cde8 ($5.99 in chips)
Seat 4: 2e75ac70 ($3.72 in chips)
Seat 5: c8ce09a2 ($6.95 in chips)
Seat 6: 1e89bda1 ($5.98 in chips)
Hero: posts small blind $0.02
ed53cde8: posts big blind $0.05
*** HOLE CARDS ***
Dealt to 45008b71 
Dealt to Hero [Jc 9h]
Dealt to ed53cde8 
Dealt to 2e75ac70 
Dealt to c8ce09a2 
Dealt to 1e89bda1 
2e75ac70: folds
c8ce09a2: folds
1e89bda1: folds
45008b71: raises $0.05 to $0.1
Hero: folds
ed53cde8: calls $0.05
*** FLOP *** [9c Js 6c]
ed53cde8: checks
45008b71: bets $0.11
ed53cde8: calls $0.11
*** TURN *** [9c Js 6c] [9s]
ed53cde8: checks
45008b71: bets $0.15
ed53cde8: calls $0.15
*** RIVER *** [9c Js 6c 9s] [5c]
ed53cde8: checks
45008b71: checks
ed53cde8: shows [3c Qc] (Queen High Flush)
45008b71: shows [Jd Th] (Pair of Jacks and Pair of Nines)
*** SHOWDOWN ***
ed53cde8 collected $0.71 from pot
*** SUMMARY ***
Total pot $0.74 | Rake $0.03 | Jackpot $0 | Bingo $0 | Fortune $0 | Tax $0
Board [9c Js 6c 9s 5c]
Seat 1: 45008b71 (button) showed [Jd Th] and lost with Pair of Jacks and Pair of Nines
Seat 2: Hero (small blind) folded before Flop
Seat 3: ed53cde8 (big blind) showed [3c Qc] and won ($0.71) with Queen High Flush
Seat 4: 2e75ac70 folded before Flop (didn't bet)
Seat 5: c8ce09a2 folded before Flop (didn't bet)
Seat 6: 1e89bda1 folded before Flop (didn't bet)


Poker Hand #RC2078524243: Hold'em No Limit ($0.02/$0.05) - 2023/12/22 21:44:07
Table 'RushAndCash796876' 6-max Seat #1 is the button
Seat 1: 7c9c11 ($17.31 in chips)
Seat 2: 532b7af3 ($8.67 in chips)
Seat 3: 6659feae ($5.58 in chips)
Seat 4: 53025835 ($5.3 in chips)
Seat 5: Hero ($5.73 in chips)
Seat 6: c8ce09a2 ($6.95 in chips)
532b7af3: posts small blind $0.02
6659feae: posts big blind $0.05
*** HOLE CARDS ***
Dealt to 7c9c11 
Dealt to 532b7af3 
Dealt to 6659feae 
Dealt to 53025835 
Dealt to Hero [5s 4h]
Dealt to c8ce09a2 
53025835: folds
Hero: folds
c8ce09a2: folds
7c9c11: folds
532b7af3: folds
Uncalled bet ($0.03) returned to 6659feae
*** SHOWDOWN ***
6659feae collected $0.04 from pot
*** SUMMARY ***
Total pot $0.04 | Rake $0 | Jackpot $0 | Bingo $0 | Fortune $0 | Tax $0
Seat 1: 7c9c11 (button) folded before Flop (didn't bet)
Seat 2: 532b7af3 (small blind) folded before Flop
Seat 3: 6659feae (big blind) collected ($0.04)
Seat 4: 53025835 folded before Flop (didn't bet)
Seat 5: Hero folded before Flop (didn't bet)
Seat 6: c8ce09a2 folded before Flop (didn't bet)


Poker Hand #RC2078524145: Hold'em No Limit ($0.02/$0.05) - 2023/12/22 21:44:02
Table 'RushAndCash796829' 6-max Seat #1 is the button
Seat 1: 8c562e3a ($5.07 in chips)
Seat 2: d0ea92a4 ($10.1 in chips)
Seat 3: 373bc096 ($8 in chips)
Seat 4: 8f1a23de ($5 in chips)
Seat 5: Hero ($5.73 in chips)
Seat 6: b7c101a2 ($14.55 in chips)
d0ea92a4: posts small blind $0.02
373bc096: posts big blind $0.05
*** HOLE CARDS ***
Dealt to 8c562e3a 
Dealt to d0ea92a4 
Dealt to 373bc096 
Dealt to 8f1a23de 
Dealt to Hero [7h Th]
Dealt to b7c101a2 
8f1a23de: folds
Hero: folds
b7c101a2: raises $0.07 to $0.12
8c562e3a: folds
d0ea92a4: calls $0.1
373bc096: calls $0.07
*** FLOP *** [Jc Ac 6h]
d0ea92a4: checks
373bc096: checks
b7c101a2: checks
*** TURN *** [Jc Ac 6h] [9d]
d0ea92a4: bets $0.18
373bc096: folds
b7c101a2: calls $0.18
*** RIVER *** [Jc Ac 6h 9d] [As]
d0ea92a4: bets $1.28
b7c101a2: calls $1.28
d0ea92a4: shows [Ah Jd] (Aces Full over Jacks)
b7c101a2: shows [Tc Ad] (Three Aces)
*** SHOWDOWN ***
d0ea92a4 collected $3.06 from pot
*** SUMMARY ***
Total pot $3.28 | Rake $0.15 | Jackpot $0.07 | Bingo $0 | Fortune $0 | Tax $0
Board [Jc Ac 6h 9d As]
Seat 1: 8c562e3a (button) folded before Flop (didn't bet)
Seat 2: d0ea92a4 (small blind) showed [Ah Jd] and won ($3.06) with Aces Full over Jacks
Seat 3: 373bc096 (big blind) folded on the Turn
Seat 4: 8f1a23de folded before Flop (didn't bet)
Seat 5: Hero folded before Flop (didn't bet)
Seat 6: b7c101a2 showed [Tc Ad] and lost with Three Aces


Poker Hand #RC2078523996: Hold'em No Limit ($0.02/$0.05) - 2023/12/22 21:43:52
Table 'RushAndCash796753' 6-max Seat #1 is the button
Seat 1: a7226c6 ($6.69 in chips)
Seat 2: a411db6 ($2.15 in chips)
Seat 3: Hero ($5.78 in chips)
Seat 4: 52eb7b3d ($10.61 in chips)
Seat 5: b9870dbd ($5.76 in chips)
Seat 6: 67297113 ($6.73 in chips)
a411db6: posts small blind $0.02
Hero: posts big blind $0.05
*** HOLE CARDS ***
Dealt to a7226c6 
Dealt to a411db6 
Dealt to Hero [7s Qc]
Dealt to 52eb7b3d 
Dealt to b9870dbd 
Dealt to 67297113 
52eb7b3d: folds
b9870dbd: folds
67297113: raises $0.05 to $0.1
a7226c6: folds
a411db6: folds
Hero: folds
Uncalled bet ($0.05) returned to 67297113
*** SHOWDOWN ***
67297113 collected $0.12 from pot
*** SUMMARY ***
Total pot $0.12 | Rake $0 | Jackpot $0 | Bingo $0 | Fortune $0 | Tax $0
Seat 1: a7226c6 (button) folded before Flop (didn't bet)
Seat 2: a411db6 (small blind) folded before Flop
Seat 3: Hero (big blind) folded before Flop
Seat 4: 52eb7b3d folded before Flop (didn't bet)
Seat 5: b9870dbd folded before Flop (didn't bet)
Seat 6: 67297113 collected ($0.12)


Poker Hand #RC2078523701: Hold'em No Limit ($0.02/$0.05) - 2023/12/22 21:43:36
Table 'RushAndCash796609' 6-max Seat #1 is the button
Seat 1: 45bb3f0f ($5.21 in chips)
Seat 2: Hero ($5.8 in chips)
Seat 3: edf930b1 ($5 in chips)
Seat 4: 933d69ee ($9.02 in chips)
Seat 5: 1cfe329a ($10.52 in chips)
Seat 6: 3b055a50 ($13.05 in chips)
Hero: posts small blind $0.02
edf930b1: posts big blind $0.05
*** HOLE CARDS ***
Dealt to 45bb3f0f 
Dealt to Hero [6h 4c]
Dealt to edf930b1 
Dealt to 933d69ee 
Dealt to 1cfe329a 
Dealt to 3b055a50 
933d69ee: folds
1cfe329a: folds
3b055a50: folds
45bb3f0f: raises $0.06 to $0.11
Hero: folds
edf930b1: folds
Uncalled bet ($0.06) returned to 45bb3f0f
*** SHOWDOWN ***
45bb3f0f collected $0.12 from pot
*** SUMMARY ***
Total pot $0.12 | Rake $0 | Jackpot $0 | Bingo $0 | Fortune $0 | Tax $0
Seat 1: 45bb3f0f (button) collected ($0.12)
Seat 2: Hero (small blind) folded before Flop
Seat 3: edf930b1 (big blind) folded before Flop
Seat 4: 933d69ee folded before Flop (didn't bet)
Seat 5: 1cfe329a folded before Flop (didn't bet)
Seat 6: 3b055a50 folded before Flop (didn't bet)


Poker Hand #RC2078523638: Hold'em No Limit ($0.02/$0.05) - 2023/12/22 21:43:32
Table 'RushAndCash796578' 6-max Seat #1 is the button
Seat 1: eadbd152 ($5.53 in chips)
Seat 2: 44e29903 ($6.46 in chips)
Seat 3: 65bf0e13 ($5.38 in chips)
Seat 4: 8c3b130b ($4.06 in chips)
Seat 5: Hero ($5.8 in chips)
Seat 6: 6e04f103 ($5 in chips)
44e29903: posts small blind $0.02
65bf0e13: posts big blind $0.05
*** HOLE CARDS ***
Dealt to eadbd152 
Dealt to 44e29903 
Dealt to 65bf0e13 
Dealt to 8c3b130b 
Dealt to Hero [5h 2s]
Dealt to 6e04f103 
8c3b130b: folds
Hero: folds
6e04f103: folds
eadbd152: raises $0.05 to $0.1
44e29903: calls $0.08
65bf0e13: folds
*** FLOP *** [6d Ts 9s]
44e29903: checks
eadbd152: bets $0.14
44e29903: calls $0.14
*** TURN *** [6d Ts 9s] [2d]
44e29903: checks
eadbd152: checks
*** RIVER *** [6d Ts 9s 2d] [Qd]
44e29903: bets $0.4
eadbd152: calls $0.4
44e29903: shows [Js Ad] (Ace-High)
eadbd152: shows [Th Qc] (Pair of Queens and Pair of Tens)
*** SHOWDOWN ***
eadbd152 collected $1.27 from pot
*** SUMMARY ***
Total pot $1.33 | Rake $0.06 | Jackpot $0 | Bingo $0 | Fortune $0 | Tax $0
Board [6d Ts 9s 2d Qd]
Seat 1: eadbd152 (button) showed [Th Qc] and won ($1.27) with Pair of Queens and Pair of Tens
Seat 2: 44e29903 (small blind) showed [Js Ad] and lost with Ace-High
Seat 3: 65bf0e13 (big blind) folded before Flop
Seat 4: 8c3b130b folded before Flop (didn't bet)
Seat 5: Hero folded before Flop (didn't bet)
Seat 6: 6e04f103 folded before Flop (didn't bet)


Poker Hand #RC2078523584: Hold'em No Limit ($0.02/$0.05) - 2023/12/22 21:43:29
Table 'RushAndCash796552' 6-max Seat #1 is the button
Seat 1: Hero ($5.8 in chips)
Seat 2: b179aebd ($5.8 in chips)
Seat 3: a9abc4b1 ($14.25 in chips)
Seat 4: 74a53cac ($11.68 in chips)
Seat 5: 4520f334 ($4.87 in chips)
Seat 6: 7c10f852 ($38.24 in chips)
b179aebd: posts small blind $0.02
a9abc4b1: posts big blind $0.05
*** HOLE CARDS ***
Dealt to Hero [5s 4d]
Dealt to b179aebd 
Dealt to a9abc4b1 
Dealt to 74a53cac 
Dealt to 4520f334 
Dealt to 7c10f852 
74a53cac: folds
4520f334: folds
7c10f852: raises $0.05 to $0.1
Hero: folds
b179aebd: folds
a9abc4b1: folds
Uncalled bet ($0.05) returned to 7c10f852
*** SHOWDOWN ***
7c10f852 collected $0.12 from pot
*** SUMMARY ***
Total pot $0.12 | Rake $0 | Jackpot $0 | Bingo $0 | Fortune $0 | Tax $0
Seat 1: Hero (button) folded before Flop (didn't bet)
Seat 2: b179aebd (small blind) folded before Flop
Seat 3: a9abc4b1 (big blind) folded before Flop
Seat 4: 74a53cac folded before Flop (didn't bet)
Seat 5: 4520f334 folded before Flop (didn't bet)
Seat 6: 7c10f852 collected ($0.12)


Poker Hand #RC2078523430: Hold'em No Limit ($0.02/$0.05) - 2023/12/22 21:43:21
Table 'RushAndCash796477' 6-max Seat #1 is the button
Seat 1: 61343ab7 ($5 in chips)
Seat 2: f4e201f0 ($5.09 in chips)
Seat 3: f0b0a5f9 ($16.89 in chips)
Seat 4: Hero ($5.8 in chips)
Seat 5: 75f5cb54 ($2.03 in chips)
Seat 6: a4441de9 ($5.98 in chips)
f4e201f0: posts small blind $0.02
f0b0a5f9: posts big blind $0.05
*** HOLE CARDS ***
Dealt to 61343ab7 
Dealt to f4e201f0 
Dealt to f0b0a5f9 
Dealt to Hero [5h 9d]
Dealt to 75f5cb54 
Dealt to a4441de9 
Hero: folds
75f5cb54: folds
a4441de9: folds
61343ab7: folds
f4e201f0: folds
Uncalled bet ($0.03) returned to f0b0a5f9
*** SHOWDOWN ***
f0b0a5f9 collected $0.04 from pot
*** SUMMARY ***
Total pot $0.04 | Rake $0 | Jackpot $0 | Bingo $0 | Fortune $0 | Tax $0
Seat 1: 61343ab7 (button) folded before Flop (didn't bet)
Seat 2: f4e201f0 (small blind) folded before Flop
Seat 3: f0b0a5f9 (big blind) collected ($0.04)
Seat 4: Hero folded before Flop (didn't bet)
Seat 5: 75f5cb54 folded before Flop (didn't bet)
Seat 6: a4441de9 folded before Flop (didn't bet)


Poker Hand #RC2078522328: Hold'em No Limit ($0.02/$0.05) - 2023/12/22 21:42:19
Table 'RushAndCash795952' 6-max Seat #1 is the button
Seat 1: d9ec3117 ($5 in chips)
Seat 2: 4c0d7324 ($9.97 in chips)
Seat 3: 44e29903 ($5.17 in chips)
Seat 4: Hero ($6.28 in chips)
Seat 5: 8c3b130b ($5.03 in chips)
Seat 6: edb6154b ($5.66 in chips)
4c0d7324: posts small blind $0.02
44e29903: posts big blind $0.05
*** HOLE CARDS ***
Dealt to d9ec3117 
Dealt to 4c0d7324 
Dealt to 44e29903 
Dealt to Hero [Jc Tc]
Dealt to 8c3b130b 
Dealt to edb6154b 
Hero: raises $0.05 to $0.1
8c3b130b: calls $0.1
edb6154b: folds
d9ec3117: folds
4c0d7324: folds
44e29903: calls $0.05
*** FLOP *** [Jd Ah Qs]
44e29903: checks
Hero: bets $0.16
8c3b130b: raises $0.22 to $0.38
44e29903: calls $0.38
Hero: calls $0.22
*** TURN *** [Jd Ah Qs] [4h]
44e29903: checks
Hero: checks
8c3b130b: bets $0.49
44e29903: calls $0.49
Hero: folds
*** RIVER *** [Jd Ah Qs 4h] [Qd]
44e29903: bets $4.2 and is all-in
8c3b130b: folds
Uncalled bet ($4.2) returned to 44e29903
*** SHOWDOWN ***
44e29903 collected $2.26 from pot
*** SUMMARY ***
Total pot $2.44 | Rake $0.11 | Jackpot $0.07 | Bingo $0 | Fortune $0 | Tax $0
Board [Jd Ah Qs 4h Qd]
Seat 1: d9ec3117 (button) folded before Flop (didn't bet)
Seat 2: 4c0d7324 (small blind) folded before Flop
Seat 3: 44e29903 (big blind) won ($2.26)
Seat 4: Hero folded on the Turn
Seat 5: 8c3b130b folded on the River
Seat 6: edb6154b folded before Flop (didn't bet)


Poker Hand #RC2078522265: Hold'em No Limit ($0.02/$0.05) - 2023/12/22 21:42:15
Table 'RushAndCash795923' 6-max Seat #1 is the button
Seat 1: a3f6014b ($6.87 in chips)
Seat 2: f3e4b0ce ($1.49 in chips)
Seat 3: d6d8d23b ($9.64 in chips)
Seat 4: Hero ($6.28 in chips)
Seat 5: ca0b098f ($5.16 in chips)
Seat 6: ea9bed4a ($5 in chips)
f3e4b0ce: posts small blind $0.02
d6d8d23b: posts big blind $0.05
*** HOLE CARDS ***
Dealt to a3f6014b 
Dealt to f3e4b0ce 
Dealt to d6d8d23b 
Dealt to Hero [7h 2c]
Dealt to ca0b098f 
Dealt to ea9bed4a 
Hero: folds
ca0b098f: folds
ea9bed4a: raises $0.1 to $0.15
a3f6014b: folds
f3e4b0ce: folds
d6d8d23b: folds
Uncalled bet ($0.1) returned to ea9bed4a
*** SHOWDOWN ***
ea9bed4a collected $0.12 from pot
*** SUMMARY ***
Total pot $0.12 | Rake $0 | Jackpot $0 | Bingo $0 | Fortune $0 | Tax $0
Seat 1: a3f6014b (button) folded before Flop (didn't bet)
Seat 2: f3e4b0ce (small blind) folded before Flop
Seat 3: d6d8d23b (big blind) folded before Flop
Seat 4: Hero folded before Flop (didn't bet)
Seat 5: ca0b098f folded before Flop (didn't bet)
Seat 6: ea9bed4a collected ($0.12)


Poker Hand #RC2078522176: Hold'em No Limit ($0.02/$0.05) - 2023/12/22 21:42:10
Table 'RushAndCash795881' 6-max Seat #1 is the button
Seat 1: 373bc096 ($7.19 in chips)
Seat 2: 4e925dd0 ($5 in chips)
Seat 3: 954d1f7b ($12.65 in chips)
Seat 4: Hero ($6.28 in chips)
Seat 5: ed53cde8 ($5.91 in chips)
Seat 6: 749b142c ($5.28 in chips)
4e925dd0: posts small blind $0.02
954d1f7b: posts big blind $0.05
*** HOLE CARDS ***
Dealt to 373bc096 
Dealt to 4e925dd0 
Dealt to 954d1f7b 
Dealt to Hero [5d 2h]
Dealt to ed53cde8 
Dealt to 749b142c 
Hero: folds
ed53cde8: folds
749b142c: raises $0.06 to $0.11
373bc096: folds
4e925dd0: folds
954d1f7b: folds
Uncalled bet ($0.06) returned to 749b142c
*** SHOWDOWN ***
749b142c collected $0.12 from pot
*** SUMMARY ***
Total pot $0.12 | Rake $0 | Jackpot $0 | Bingo $0 | Fortune $0 | Tax $0
Seat 1: 373bc096 (button) folded before Flop (didn't bet)
Seat 2: 4e925dd0 (small blind) folded before Flop
Seat 3: 954d1f7b (big blind) folded before Flop
Seat 4: Hero folded before Flop (didn't bet)
Seat 5: ed53cde8 folded before Flop (didn't bet)
Seat 6: 749b142c collected ($0.12)


Poker Hand #RC2078522064: Hold'em No Limit ($0.02/$0.05) - 2023/12/22 21:42:04
Table 'RushAndCash795828' 6-max Seat #1 is the button
Seat 1: 2f160a64 ($5.29 in chips)
Seat 2: Hero ($6.3 in chips)
Seat 3: ae67cc8b ($6.13 in chips)
Seat 4: e99cedcc ($5.37 in chips)
Seat 5: 57896c91 ($5.97 in chips)
Seat 6: 6db75c19 ($11.49 in chips)
Hero: posts small blind $0.02
ae67cc8b: posts big blind $0.05
*** HOLE CARDS ***
Dealt to 2f160a64 
Dealt to Hero [Qs 4s]
Dealt to ae67cc8b 
Dealt to e99cedcc 
Dealt to 57896c91 
Dealt to 6db75c19 
e99cedcc: folds
57896c91: folds
6db75c19: folds
2f160a64: folds
Hero: folds
Uncalled bet ($0.03) returned to ae67cc8b
*** SHOWDOWN ***
ae67cc8b collected $0.04 from pot
*** SUMMARY ***
Total pot $0.04 | Rake $0 | Jackpot $0 | Bingo $0 | Fortune $0 | Tax $0
Seat 1: 2f160a64 (button) folded before Flop (didn't bet)
Seat 2: Hero (small blind) folded before Flop
Seat 3: ae67cc8b (big blind) collected ($0.04)
Seat 4: e99cedcc folded before Flop (didn't bet)
Seat 5: 57896c91 folded before Flop (didn't bet)
Seat 6: 6db75c19 folded before Flop (didn't bet)


Poker Hand #RC2078521873: Hold'em No Limit ($0.02/$0.05) - 2023/12/22 21:41:53
Table 'RushAndCash795740' 6-max Seat #1 is the button
Seat 1: 8e0f056d ($8.31 in chips)
Seat 2: 42e18915 ($7.37 in chips)
Seat 3: Hero ($6.35 in chips)
Seat 4: 75f5cb54 ($2.49 in chips)
Seat 5: af1e12c2 ($5 in chips)
Seat 6: 90a9fad4 ($51.91 in chips)
42e18915: posts small blind $0.02
Hero: posts big blind $0.05
*** HOLE CARDS ***
Dealt to 8e0f056d 
Dealt to 42e18915 
Dealt to Hero [Qs 6d]
Dealt to 75f5cb54 
Dealt to af1e12c2 
Dealt to 90a9fad4 
75f5cb54: folds
af1e12c2: raises $0.08 to $0.13
90a9fad4: folds
8e0f056d: folds
42e18915: folds
Hero: folds
Uncalled bet ($0.08) returned to af1e12c2
*** SHOWDOWN ***
af1e12c2 collected $0.12 from pot
*** SUMMARY ***
Total pot $0.12 | Rake $0 | Jackpot $0 | Bingo $0 | Fortune $0 | Tax $0
Seat 1: 8e0f056d (button) folded before Flop (didn't bet)
Seat 2: 42e18915 (small blind) folded before Flop
Seat 3: Hero (big blind) folded before Flop
Seat 4: 75f5cb54 folded before Flop (didn't bet)
Seat 5: af1e12c2 collected ($0.12)
Seat 6: 90a9fad4 folded before Flop (didn't bet)


Poker Hand #RC2078521814: Hold'em No Limit ($0.02/$0.05) - 2023/12/22 21:41:50
Table 'RushAndCash795713' 6-max Seat #1 is the button
Seat 1: Hero ($6.35 in chips)
Seat 2: 18c8fa56 ($5.23 in chips)
Seat 3: e65ad772 ($16.04 in chips)
Seat 4: 6e872e9c ($17.36 in chips)
Seat 5: 5d17419b ($5.45 in chips)
Seat 6: acefe34e ($5.21 in chips)
18c8fa56: posts small blind $0.02
e65ad772: posts big blind $0.05
*** HOLE CARDS ***
Dealt to Hero [8d 7c]
Dealt to 18c8fa56 
Dealt to e65ad772 
Dealt to 6e872e9c 
Dealt to 5d17419b 
Dealt to acefe34e 
6e872e9c: raises $0.08 to $0.13
5d17419b: folds
acefe34e: folds
Hero: folds
18c8fa56: folds
e65ad772: folds
Uncalled bet ($0.08) returned to 6e872e9c
*** SHOWDOWN ***
6e872e9c collected $0.12 from pot
*** SUMMARY ***
Total pot $0.12 | Rake $0 | Jackpot $0 | Bingo $0 | Fortune $0 | Tax $0
Seat 1: Hero (button) folded before Flop (didn't bet)
Seat 2: 18c8fa56 (small blind) folded before Flop
Seat 3: e65ad772 (big blind) folded before Flop
Seat 4: 6e872e9c collected ($0.12)
Seat 5: 5d17419b folded before Flop (didn't bet)
Seat 6: acefe34e folded before Flop (didn't bet)


Poker Hand #RC2078521242: Hold'em No Limit ($0.02/$0.05) - 2023/12/22 21:41:18
Table 'RushAndCash795437' 6-max Seat #1 is the button
Seat 1: bf8416dc ($3.01 in chips)
Seat 2: acefe34e ($5.07 in chips)
Seat 3: b77cfdca ($5.07 in chips)
Seat 4: 91937678 ($5.08 in chips)
Seat 5: c2f3e299 ($6.65 in chips)
Seat 6: Hero ($6.45 in chips)
acefe34e: posts small blind $0.02
b77cfdca: posts big blind $0.05
*** HOLE CARDS ***
Dealt to bf8416dc 
Dealt to acefe34e 
Dealt to b77cfdca 
Dealt to 91937678 
Dealt to c2f3e299 
Dealt to Hero [Ad 8d]
91937678: folds
c2f3e299: folds
Hero: raises $0.05 to $0.1
bf8416dc: folds
acefe34e: raises $0.45 to $0.55
b77cfdca: folds
Hero: folds
Uncalled bet ($0.45) returned to acefe34e
*** SHOWDOWN ***
acefe34e collected $0.24 from pot
*** SUMMARY ***
Total pot $0.25 | Rake $0.01 | Jackpot $0 | Bingo $0 | Fortune $0 | Tax $0
Seat 1: bf8416dc (button) folded before Flop (didn't bet)
Seat 2: acefe34e (small blind) collected ($0.24)
Seat 3: b77cfdca (big blind) folded before Flop
Seat 4: 91937678 folded before Flop (didn't bet)
Seat 5: c2f3e299 folded before Flop (didn't bet)
Seat 6: Hero folded before Flop


Poker Hand #RC2078521180: Hold'em No Limit ($0.02/$0.05) - 2023/12/22 21:41:15
Table 'RushAndCash795408' 6-max Seat #1 is the button
Seat 1: 8ff4ca07 ($5 in chips)
Seat 2: e6f6623d ($4.45 in chips)
Seat 3: 7466ff6a ($17.01 in chips)
Seat 4: ff6f425f ($5 in chips)
Seat 5: Hero ($6.45 in chips)
Seat 6: 8c3b130b ($5.26 in chips)
e6f6623d: posts small blind $0.02
7466ff6a: posts big blind $0.05
*** HOLE CARDS ***
Dealt to 8ff4ca07 
Dealt to e6f6623d 
Dealt to 7466ff6a 
Dealt to ff6f425f 
Dealt to Hero [Ks 3d]
Dealt to 8c3b130b 
ff6f425f: folds
Hero: folds
8c3b130b: calls $0.05
8ff4ca07: folds
e6f6623d: raises $0.1 to $0.15
7466ff6a: folds
8c3b130b: calls $0.1
*** FLOP *** [6s 8s Td]
e6f6623d: bets $0.18
8c3b130b: calls $0.18
*** TURN *** [6s 8s Td] [5s]
e6f6623d: bets $0.36
8c3b130b: folds
Uncalled bet ($0.36) returned to e6f6623d
*** SHOWDOWN ***
e6f6623d collected $0.68 from pot
*** SUMMARY ***
Total pot $0.71 | Rake $0.03 | Jackpot $0 | Bingo $0 | Fortune $0 | Tax $0
Board [6s 8s Td 5s]
Seat 1: 8ff4ca07 (button) folded before Flop (didn't bet)
Seat 2: e6f6623d (small blind) won ($0.68)
Seat 3: 7466ff6a (big blind) folded before Flop
Seat 4: ff6f425f folded before Flop (didn't bet)
Seat 5: Hero folded before Flop (didn't bet)
Seat 6: 8c3b130b folded on the Turn


Poker Hand #RC2078521114: Hold'em No Limit ($0.02/$0.05) - 2023/12/22 21:41:11
Table 'RushAndCash795377' 6-max Seat #1 is the button
Seat 1: 18f0f05c ($9.99 in chips)
Seat 2: 83f47841 ($11.56 in chips)
Seat 3: e6f6623d ($4.5 in chips)
Seat 4: Hero ($6.45 in chips)
Seat 5: 8a1c58b7 ($13.22 in chips)
Seat 6: 1826138f ($5.07 in chips)
83f47841: posts small blind $0.02
e6f6623d: posts big blind $0.05
*** HOLE CARDS ***
Dealt to 18f0f05c 
Dealt to 83f47841 
Dealt to e6f6623d 
Dealt to Hero [9c 2s]
Dealt to 8a1c58b7 
Dealt to 1826138f 
Hero: folds
8a1c58b7: folds
1826138f: folds
18f0f05c: raises $0.06 to $0.11
83f47841: raises $0.21 to $0.32
e6f6623d: folds
18f0f05c: folds
Uncalled bet ($0.21) returned to 83f47841
*** SHOWDOWN ***
83f47841 collected $0.26 from pot
*** SUMMARY ***
Total pot $0.27 | Rake $0.01 | Jackpot $0 | Bingo $0 | Fortune $0 | Tax $0
Seat 1: 18f0f05c (button) folded before Flop
Seat 2: 83f47841 (small blind) collected ($0.26)
Seat 3: e6f6623d (big blind) folded before Flop
Seat 4: Hero folded before Flop (didn't bet)
Seat 5: 8a1c58b7 folded before Flop (didn't bet)
Seat 6: 1826138f folded before Flop (didn't bet)


Poker Hand #RC2078521023: Hold'em No Limit ($0.02/$0.05) - 2023/12/22 21:41:07
Table 'RushAndCash795334' 6-max Seat #1 is the button
Seat 1: Hero ($6.45 in chips)
Seat 2: 886872c9 ($7.7 in chips)
Seat 3: dd325814 ($1.9 in chips)
Seat 4: e1380a89 ($3.63 in chips)
Seat 5: 16ecd29a ($6.01 in chips)
Seat 6: 64a4f489 ($6.26 in chips)
886872c9: posts small blind $0.02
dd325814: posts big blind $0.05
*** HOLE CARDS ***
Dealt to Hero [8d 6s]
Dealt to 886872c9 
Dealt to dd325814 
Dealt to e1380a89 
Dealt to 16ecd29a 
Dealt to 64a4f489 
e1380a89: folds
16ecd29a: folds
64a4f489: raises $0.07 to $0.12
Hero: folds
886872c9: folds
dd325814: folds
Uncalled bet ($0.07) returned to 64a4f489
*** SHOWDOWN ***
64a4f489 collected $0.12 from pot
*** SUMMARY ***
Total pot $0.12 | Rake $0 | Jackpot $0 | Bingo $0 | Fortune $0 | Tax $0
Seat 1: Hero (button) folded before Flop (didn't bet)
Seat 2: 886872c9 (small blind) folded before Flop
Seat 3: dd325814 (big blind) folded before Flop
Seat 4: e1380a89 folded before Flop (didn't bet)
Seat 5: 16ecd29a folded before Flop (didn't bet)
Seat 6: 64a4f489 collected ($0.12)


Poker Hand #RC2078519369: Hold'em No Limit ($0.02/$0.05) - 2023/12/22 21:39:35
Table 'RushAndCash794530' 6-max Seat #1 is the button
Seat 1: 23c96099 ($7.37 in chips)
Seat 2: e1380a89 ($3.35 in chips)
Seat 3: Hero ($6.65 in chips)
Seat 4: 532b7af3 ($10.94 in chips)
Seat 5: eaff818f ($6.26 in chips)
Seat 6: a420712c ($6.16 in chips)
e1380a89: posts small blind $0.02
Hero: posts big blind $0.05
*** HOLE CARDS ***
Dealt to 23c96099 
Dealt to e1380a89 
Dealt to Hero [Ad Qh]
Dealt to 532b7af3 
Dealt to eaff818f 
Dealt to a420712c 
532b7af3: folds
eaff818f: raises $0.05 to $0.1
a420712c: folds
23c96099: folds
e1380a89: calls $0.08
Hero: calls $0.05
*** FLOP *** [3h Qs 5c]
e1380a89: checks
Hero: checks
eaff818f: checks
*** TURN *** [3h Qs 5c] [Ks]
e1380a89: checks
Hero: checks
eaff818f: checks
*** RIVER *** [3h Qs 5c Ks] [8s]
e1380a89: checks
Hero: bets $0.1
eaff818f: folds
e1380a89: calls $0.1
Hero: shows [Ad Qh] (Pair of Queens)
e1380a89: shows [8d 8c] (Three Eights)
*** SHOWDOWN ***
e1380a89 collected $0.48 from pot
*** SUMMARY ***
Total pot $0.5 | Rake $0.02 | Jackpot $0 | Bingo $0 | Fortune $0 | Tax $0
Board [3h Qs 5c Ks 8s]
Seat 1: 23c96099 (button) folded before Flop (didn't bet)
Seat 2: e1380a89 (small blind) showed [8d 8c] and won ($0.48) with Three Eights
Seat 3: Hero (big blind) showed [Ad Qh] and lost with Pair of Queens
Seat 4: 532b7af3 folded before Flop (didn't bet)
Seat 5: eaff818f folded on the River
Seat 6: a420712c folded before Flop (didn't bet)


Poker Hand #RC2078518950: Hold'em No Limit ($0.02/$0.05) - 2023/12/22 21:39:13
Table 'RushAndCash794330' 6-max Seat #1 is the button
Seat 1: bc118b95 ($5.66 in chips)
Seat 2: Hero ($6.6 in chips)
Seat 3: 2f160a64 ($5.4 in chips)
Seat 4: cb45aeb2 ($5.07 in chips)
Seat 5: fc51e784 ($4.98 in chips)
Seat 6: 3402e890 ($5.86 in chips)
Hero: posts small blind $0.02
2f160a64: posts big blind $0.05
*** HOLE CARDS ***
Dealt to bc118b95 
Dealt to Hero [7s 7d]
Dealt to 2f160a64 
Dealt to cb45aeb2 
Dealt to fc51e784 
Dealt to 3402e890 
cb45aeb2: folds
fc51e784: folds
3402e890: folds
bc118b95: folds
Hero: raises $0.1 to $0.15
2f160a64: folds
Uncalled bet ($0.1) returned to Hero
*** SHOWDOWN ***
Hero collected $0.1 from pot
*** SUMMARY ***
Total pot $0.1 | Rake $0 | Jackpot $0 | Bingo $0 | Fortune $0 | Tax $0
Seat 1: bc118b95 (button) folded before Flop (didn't bet)
Seat 2: Hero (small blind) collected ($0.1)
Seat 3: 2f160a64 (big blind) folded before Flop
Seat 4: cb45aeb2 folded before Flop (didn't bet)
Seat 5: fc51e784 folded before Flop (didn't bet)
Seat 6: 3402e890 folded before Flop (didn't bet)


Poker Hand #RC2078518879: Hold'em No Limit ($0.02/$0.05) - 2023/12/22 21:39:09
Table 'RushAndCash794296' 6-max Seat #1 is the button
Seat 1: fc51e784 ($4.98 in chips)
Seat 2: ad0bb92a ($4.53 in chips)
Seat 3: 3d929f9f ($10.15 in chips)
Seat 4: ea5a6534 ($5.42 in chips)
Seat 5: 391fe85a ($5.02 in chips)
Seat 6: Hero ($6.6 in chips)
ad0bb92a: posts small blind $0.02
3d929f9f: posts big blind $0.05
*** HOLE CARDS ***
Dealt to fc51e784 
Dealt to ad0bb92a 
Dealt to 3d929f9f 
Dealt to ea5a6534 
Dealt to 391fe85a 
Dealt to Hero [Ac 8d]
ea5a6534: raises $0.06 to $0.11
391fe85a: folds
Hero: folds
fc51e784: folds
ad0bb92a: folds
3d929f9f: folds
Uncalled bet ($0.06) returned to ea5a6534
*** SHOWDOWN ***
ea5a6534 collected $0.12 from pot
*** SUMMARY ***
Total pot $0.12 | Rake $0 | Jackpot $0 | Bingo $0 | Fortune $0 | Tax $0
Seat 1: fc51e784 (button) folded before Flop (didn't bet)
Seat 2: ad0bb92a (small blind) folded before Flop
Seat 3: 3d929f9f (big blind) folded before Flop
Seat 4: ea5a6534 collected ($0.12)
Seat 5: 391fe85a folded before Flop (didn't bet)
Seat 6: Hero folded before Flop (didn't bet)


Poker Hand #RC2078518776: Hold'em No Limit ($0.02/$0.05) - 2023/12/22 21:39:04
Table 'RushAndCash794245' 6-max Seat #1 is the button
Seat 1: Hero ($6.6 in chips)
Seat 2: 8db2745e ($5.16 in chips)
Seat 3: b7c101a2 ($12.91 in chips)
Seat 4: 80af7fe3 ($5.01 in chips)
Seat 5: bacb0059 ($4.13 in chips)
Seat 6: 5d55167a ($7.09 in chips)
8db2745e: posts small blind $0.02
b7c101a2: posts big blind $0.05
*** HOLE CARDS ***
Dealt to Hero [5s 4c]
Dealt to 8db2745e 
Dealt to b7c101a2 
Dealt to 80af7fe3 
Dealt to bacb0059 
Dealt to 5d55167a 
80af7fe3: folds
bacb0059: folds
5d55167a: raises $0.1 to $0.15
Hero: folds
8db2745e: folds
b7c101a2: calls $0.1
*** FLOP *** [6c 3h 8d]
b7c101a2: checks
5d55167a: checks
*** TURN *** [6c 3h 8d] [Kd]
b7c101a2: bets $0.16
5d55167a: calls $0.16
*** RIVER *** [6c 3h 8d Kd] [5d]
b7c101a2: checks
5d55167a: bets $0.32
b7c101a2: folds
Uncalled bet ($0.32) returned to 5d55167a
b7c101a2: shows [6h] (Pair of Sixes)
*** SHOWDOWN ***
5d55167a collected $0.61 from pot
*** SUMMARY ***
Total pot $0.64 | Rake $0.03 | Jackpot $0 | Bingo $0 | Fortune $0 | Tax $0
Board [6c 3h 8d Kd 5d]
Seat 1: Hero (button) folded before Flop (didn't bet)
Seat 2: 8db2745e (small blind) folded before Flop
Seat 3: b7c101a2 (big blind) folded on the River
Seat 4: 80af7fe3 folded before Flop (didn't bet)
Seat 5: bacb0059 folded before Flop (didn't bet)
Seat 6: 5d55167a won ($0.61)


Poker Hand #RC2078518446: Hold'em No Limit ($0.02/$0.05) - 2023/12/22 21:38:45
Table 'RushAndCash794094' 6-max Seat #1 is the button
Seat 1: f30308e3 ($5 in chips)
Seat 2: Hero ($6.62 in chips)
Seat 3: ac89ef05 ($4.62 in chips)
Seat 4: 34886d8c ($5.14 in chips)
Seat 5: 3402e890 ($5.86 in chips)
Seat 6: 317ccf77 ($5.79 in chips)
Hero: posts small blind $0.02
ac89ef05: posts big blind $0.05
*** HOLE CARDS ***
Dealt to f30308e3 
Dealt to Hero [3h 8h]
Dealt to ac89ef05 
Dealt to 34886d8c 
Dealt to 3402e890 
Dealt to 317ccf77 
34886d8c: folds
3402e890: folds
317ccf77: folds
f30308e3: folds
Hero: folds
Uncalled bet ($0.03) returned to ac89ef05
*** SHOWDOWN ***
ac89ef05 collected $0.04 from pot
*** SUMMARY ***
Total pot $0.04 | Rake $0 | Jackpot $0 | Bingo $0 | Fortune $0 | Tax $0
Seat 1: f30308e3 (button) folded before Flop (didn't bet)
Seat 2: Hero (small blind) folded before Flop
Seat 3: ac89ef05 (big blind) collected ($0.04)
Seat 4: 34886d8c folded before Flop (didn't bet)
Seat 5: 3402e890 folded before Flop (didn't bet)
Seat 6: 317ccf77 folded before Flop (didn't bet)


Poker Hand #RC2078518290: Hold'em No Limit ($0.02/$0.05) - 2023/12/22 21:38:37
Table 'RushAndCash794020' 6-max Seat #1 is the button
Seat 1: 834fcc3f ($7.72 in chips)
Seat 2: b01c40bf ($20.11 in chips)
Seat 3: Hero ($6.67 in chips)
Seat 4: e24a2fed ($10.37 in chips)
Seat 5: b8e0eed ($5.45 in chips)
Seat 6: f0e3b048 ($5.51 in chips)
b01c40bf: posts small blind $0.02
Hero: posts big blind $0.05
*** HOLE CARDS ***
Dealt to 834fcc3f 
Dealt to b01c40bf 
Dealt to Hero [9s Jd]
Dealt to e24a2fed 
Dealt to b8e0eed 
Dealt to f0e3b048 
e24a2fed: folds
b8e0eed: folds
f0e3b048: folds
834fcc3f: raises $0.07 to $0.12
b01c40bf: folds
Hero: folds
Uncalled bet ($0.07) returned to 834fcc3f
*** SHOWDOWN ***
834fcc3f collected $0.12 from pot
*** SUMMARY ***
Total pot $0.12 | Rake $0 | Jackpot $0 | Bingo $0 | Fortune $0 | Tax $0
Seat 1: 834fcc3f (button) collected ($0.12)
Seat 2: b01c40bf (small blind) folded before Flop
Seat 3: Hero (big blind) folded before Flop
Seat 4: e24a2fed folded before Flop (didn't bet)
Seat 5: b8e0eed folded before Flop (didn't bet)
Seat 6: f0e3b048 folded before Flop (didn't bet)


Poker Hand #RC2078518190: Hold'em No Limit ($0.02/$0.05) - 2023/12/22 21:38:31
Table 'RushAndCash793979' 6-max Seat #1 is the button
Seat 1: b2bf2645 ($5.11 in chips)
Seat 2: 69eae1f2 ($6.92 in chips)
Seat 3: aa667d33 ($5.86 in chips)
Seat 4: Hero ($6.67 in chips)
Seat 5: 9bd4cbdf ($5.71 in chips)
Seat 6: 9220db62 ($5.06 in chips)
69eae1f2: posts small blind $0.02
aa667d33: posts big blind $0.05
*** HOLE CARDS ***
Dealt to b2bf2645 
Dealt to 69eae1f2 
Dealt to aa667d33 
Dealt to Hero [2h 6s]
Dealt to 9bd4cbdf 
Dealt to 9220db62 
Hero: folds
9bd4cbdf: raises $0.05 to $0.1
9220db62: raises $0.2 to $0.3
b2bf2645: folds
69eae1f2: folds
aa667d33: folds
9bd4cbdf: calls $0.2
*** FLOP *** [4s 5h 2s]
9bd4cbdf: checks
9220db62: checks
*** TURN *** [4s 5h 2s] [8h]
9bd4cbdf: checks
9220db62: checks
*** RIVER *** [4s 5h 2s 8h] [3s]
9bd4cbdf: checks
9220db62: checks
9bd4cbdf: shows [Jd Th] (Jack-High)
9220db62: shows [Qc Ks] (King-High)
*** SHOWDOWN ***
9220db62 collected $0.64 from pot
*** SUMMARY ***
Total pot $0.67 | Rake $0.03 | Jackpot $0 | Bingo $0 | Fortune $0 | Tax $0
Board [4s 5h 2s 8h 3s]
Seat 1: b2bf2645 (button) folded before Flop (didn't bet)
Seat 2: 69eae1f2 (small blind) folded before Flop
Seat 3: aa667d33 (big blind) folded before Flop
Seat 4: Hero folded before Flop (didn't bet)
Seat 5: 9bd4cbdf showed [Jd Th] and lost with Jack-High
Seat 6: 9220db62 showed [Qc Ks] and won ($0.64) with King-High


Poker Hand #RC2078518123: Hold'em No Limit ($0.02/$0.05) - 2023/12/22 21:38:28
Table 'RushAndCash793945' 6-max Seat #1 is the button
Seat 1: 7810e6bd ($15.99 in chips)
Seat 2: 6029883b ($9.17 in chips)
Seat 3: fa93749b ($9.59 in chips)
Seat 4: 35f7fbd3 ($9.56 in chips)
Seat 5: 37e2503b ($6.23 in chips)
Seat 6: Hero ($6.67 in chips)
6029883b: posts small blind $0.02
fa93749b: posts big blind $0.05
*** HOLE CARDS ***
Dealt to 7810e6bd 
Dealt to 6029883b 
Dealt to fa93749b 
Dealt to 35f7fbd3 
Dealt to 37e2503b 
Dealt to Hero [8h Qs]
35f7fbd3: folds
37e2503b: folds
Hero: folds
7810e6bd: folds
6029883b: raises $0.1 to $0.15
fa93749b: folds
Uncalled bet ($0.1) returned to 6029883b
*** SHOWDOWN ***
6029883b collected $0.1 from pot
*** SUMMARY ***
Total pot $0.1 | Rake $0 | Jackpot $0 | Bingo $0 | Fortune $0 | Tax $0
Seat 1: 7810e6bd (button) folded before Flop (didn't bet)
Seat 2: 6029883b (small blind) collected ($0.1)
Seat 3: fa93749b (big blind) folded before Flop
Seat 4: 35f7fbd3 folded before Flop (didn't bet)
Seat 5: 37e2503b folded before Flop (didn't bet)
Seat 6: Hero folded before Flop (didn't bet)


Poker Hand #RC2078518067: Hold'em No Limit ($0.02/$0.05) - 2023/12/22 21:38:24
Table 'RushAndCash793919' 6-max Seat #1 is the button
Seat 1: 5d317abf ($14.93 in chips)
Seat 2: 1ab06c8f ($5.63 in chips)
Seat 3: 525db62f ($16.26 in chips)
Seat 4: Hero ($6.67 in chips)
Seat 5: f6f7aa18 ($6.31 in chips)
Seat 6: 7b437e57 ($5 in chips)
1ab06c8f: posts small blind $0.02
525db62f: posts big blind $0.05
*** HOLE CARDS ***
Dealt to 5d317abf 
Dealt to 1ab06c8f 
Dealt to 525db62f 
Dealt to Hero [3d Kc]
Dealt to f6f7aa18 
Dealt to 7b437e57 
Hero: folds
f6f7aa18: folds
7b437e57: raises $0.08 to $0.13
5d317abf: folds
1ab06c8f: folds
525db62f: folds
Uncalled bet ($0.08) returned to 7b437e57
*** SHOWDOWN ***
7b437e57 collected $0.12 from pot
*** SUMMARY ***
Total pot $0.12 | Rake $0 | Jackpot $0 | Bingo $0 | Fortune $0 | Tax $0
Seat 1: 5d317abf (button) folded before Flop (didn't bet)
Seat 2: 1ab06c8f (small blind) folded before Flop
Seat 3: 525db62f (big blind) folded before Flop
Seat 4: Hero folded before Flop (didn't bet)
Seat 5: f6f7aa18 folded before Flop (didn't bet)
Seat 6: 7b437e57 collected ($0.12)


Poker Hand #RC2078518002: Hold'em No Limit ($0.02/$0.05) - 2023/12/22 21:38:21
Table 'RushAndCash793887' 6-max Seat #1 is the button
Seat 1: 7b437e57 ($5 in chips)
Seat 2: 4fedcb8f ($5.56 in chips)
Seat 3: 5861f243 ($5.11 in chips)
Seat 4: 83f47841 ($7.22 in chips)
Seat 5: Hero ($6.67 in chips)
Seat 6: 8acef960 ($4.24 in chips)
4fedcb8f: posts small blind $0.02
5861f243: posts big blind $0.05
*** HOLE CARDS ***
Dealt to 7b437e57 
Dealt to 4fedcb8f 
Dealt to 5861f243 
Dealt to 83f47841 
Dealt to Hero [Kc 9h]
Dealt to 8acef960 
83f47841: folds
Hero: folds
8acef960: folds
7b437e57: folds
4fedcb8f: raises $0.08 to $0.13
5861f243: folds
Uncalled bet ($0.08) returned to 4fedcb8f
*** SHOWDOWN ***
4fedcb8f collected $0.1 from pot
*** SUMMARY ***
Total pot $0.1 | Rake $0 | Jackpot $0 | Bingo $0 | Fortune $0 | Tax $0
Seat 1: 7b437e57 (button) folded before Flop (didn't bet)
Seat 2: 4fedcb8f (small blind) collected ($0.1)
Seat 3: 5861f243 (big blind) folded before Flop
Seat 4: 83f47841 folded before Flop (didn't bet)
Seat 5: Hero folded before Flop (didn't bet)
Seat 6: 8acef960 folded before Flop (didn't bet)


Poker Hand #RC2078517736: Hold'em No Limit ($0.02/$0.05) - 2023/12/22 21:38:07
Table 'RushAndCash793756' 6-max Seat #1 is the button
Seat 1: 37863cfe ($4.83 in chips)
Seat 2: Hero ($6.62 in chips)
Seat 3: fcb65fa9 ($2.45 in chips)
Seat 4: f58a969e ($10.27 in chips)
Seat 5: 95bbee71 ($5 in chips)
Seat 6: bc7afeb2 ($5.04 in chips)
Hero: posts small blind $0.02
fcb65fa9: posts big blind $0.05
*** HOLE CARDS ***
Dealt to 37863cfe 
Dealt to Hero [Ad 8c]
Dealt to fcb65fa9 
Dealt to f58a969e 
Dealt to 95bbee71 
Dealt to bc7afeb2 
f58a969e: folds
95bbee71: folds
bc7afeb2: folds
37863cfe: folds
Hero: raises $0.1 to $0.15
fcb65fa9: folds
Uncalled bet ($0.1) returned to Hero
*** SHOWDOWN ***
Hero collected $0.1 from pot
*** SUMMARY ***
Total pot $0.1 | Rake $0 | Jackpot $0 | Bingo $0 | Fortune $0 | Tax $0
Seat 1: 37863cfe (button) folded before Flop (didn't bet)
Seat 2: Hero (small blind) collected ($0.1)
Seat 3: fcb65fa9 (big blind) folded before Flop
Seat 4: f58a969e folded before Flop (didn't bet)
Seat 5: 95bbee71 folded before Flop (didn't bet)
Seat 6: bc7afeb2 folded before Flop (didn't bet)


Poker Hand #RC2078517666: Hold'em No Limit ($0.02/$0.05) - 2023/12/22 21:38:03
Table 'RushAndCash793724' 6-max Seat #1 is the button
Seat 1: Hero ($6.62 in chips)
Seat 2: 5a946c5b ($5.11 in chips)
Seat 3: b88dbe00 ($6.01 in chips)
Seat 4: 463feb61 ($9.21 in chips)
Seat 5: dc851cb6 ($5.82 in chips)
Seat 6: 8e0f056d ($8.65 in chips)
5a946c5b: posts small blind $0.02
b88dbe00: posts big blind $0.05
*** HOLE CARDS ***
Dealt to Hero [5h 3h]
Dealt to 5a946c5b 
Dealt to b88dbe00 
Dealt to 463feb61 
Dealt to dc851cb6 
Dealt to 8e0f056d 
463feb61: folds
dc851cb6: raises $0.05 to $0.1
8e0f056d: calls $0.1
Hero: folds
5a946c5b: folds
b88dbe00: folds
*** FLOP *** [9s Td 5c]
dc851cb6: checks
8e0f056d: checks
*** TURN *** [9s Td 5c] [As]
dc851cb6: bets $0.09
8e0f056d: folds
Uncalled bet ($0.09) returned to dc851cb6
*** SHOWDOWN ***
dc851cb6 collected $0.26 from pot
*** SUMMARY ***
Total pot $0.27 | Rake $0.01 | Jackpot $0 | Bingo $0 | Fortune $0 | Tax $0
Board [9s Td 5c As]
Seat 1: Hero (button) folded before Flop (didn't bet)
Seat 2: 5a946c5b (small blind) folded before Flop
Seat 3: b88dbe00 (big blind) folded before Flop
Seat 4: 463feb61 folded before Flop (didn't bet)
Seat 5: dc851cb6 won ($0.26)
Seat 6: 8e0f056d folded on the Turn


Poker Hand #RC2078517372: Hold'em No Limit ($0.02/$0.05) - 2023/12/22 21:37:47
Table 'RushAndCash793580' 6-max Seat #1 is the button
Seat 1: 4af1c8bb ($11.3 in chips)
Seat 2: 3a55a6df ($12.59 in chips)
Seat 3: Hero ($6.67 in chips)
Seat 4: 7961accb ($5.21 in chips)
Seat 5: 459d0f5c ($5.02 in chips)
Seat 6: 9601129f ($4.93 in chips)
3a55a6df: posts small blind $0.02
Hero: posts big blind $0.05
*** HOLE CARDS ***
Dealt to 4af1c8bb 
Dealt to 3a55a6df 
Dealt to Hero [Ks 7s]
Dealt to 7961accb 
Dealt to 459d0f5c 
Dealt to 9601129f 
7961accb: folds
459d0f5c: folds
9601129f: raises $0.1 to $0.15
4af1c8bb: folds
3a55a6df: raises $0.35 to $0.5
Hero: folds
9601129f: calls $0.35
*** FLOP *** [Kd 4d 8s]
3a55a6df: checks
9601129f: checks
*** TURN *** [Kd 4d 8s] [9c]
3a55a6df: bets $0.53
9601129f: calls $0.53
*** RIVER *** [Kd 4d 8s 9c] [Th]
3a55a6df: bets $0.7
9601129f: calls $0.7
3a55a6df: shows [Tc Ac] (Pair of Tens)
9601129f: shows [9h 8h] (Pair of Nines and Pair of Eights)
*** SHOWDOWN ***
9601129f collected $3.24 from pot
*** SUMMARY ***
Total pot $3.51 | Rake $0.2 | Jackpot $0.07 | Bingo $0 | Fortune $0 | Tax $0
Board [Kd 4d 8s 9c Th]
Seat 1: 4af1c8bb (button) folded before Flop (didn't bet)
Seat 2: 3a55a6df (small blind) showed [Tc Ac] and lost with Pair of Tens
Seat 3: Hero (big blind) folded before Flop
Seat 4: 7961accb folded before Flop (didn't bet)
Seat 5: 459d0f5c folded before Flop (didn't bet)
Seat 6: 9601129f showed [9h 8h] and won ($3.24) with Pair of Nines and Pair of Eights


Poker Hand #RC2078517287: Hold'em No Limit ($0.02/$0.05) - 2023/12/22 21:37:43
Table 'RushAndCash793536' 6-max Seat #1 is the button
Seat 1: 72f7386e ($17.26 in chips)
Seat 2: ae32912c ($5.18 in chips)
Seat 3: 62357227 ($5 in chips)
Seat 4: c2f3e299 ($7.08 in chips)
Seat 5: 2994a563 ($4.5 in chips)
Seat 6: Hero ($6.67 in chips)
ae32912c: posts small blind $0.02
62357227: posts big blind $0.05
*** HOLE CARDS ***
Dealt to 72f7386e 
Dealt to ae32912c 
Dealt to 62357227 
Dealt to c2f3e299 
Dealt to 2994a563 
Dealt to Hero [2s 5h]
c2f3e299: folds
2994a563: raises $0.05 to $0.1
Hero: folds
72f7386e: folds
ae32912c: folds
62357227: raises $0.17 to $0.27
2994a563: folds
Uncalled bet ($0.17) returned to 62357227
*** SHOWDOWN ***
62357227 collected $0.21 from pot
*** SUMMARY ***
Total pot $0.22 | Rake $0.01 | Jackpot $0 | Bingo $0 | Fortune $0 | Tax $0
Seat 1: 72f7386e (button) folded before Flop (didn't bet)
Seat 2: ae32912c (small blind) folded before Flop
Seat 3: 62357227 (big blind) collected ($0.21)
Seat 4: c2f3e299 folded before Flop (didn't bet)
Seat 5: 2994a563 folded before Flop
Seat 6: Hero folded before Flop (didn't bet)


Poker Hand #RC2078517157: Hold'em No Limit ($0.02/$0.05) - 2023/12/22 21:37:35
Table 'RushAndCash793471' 6-max Seat #1 is the button
Seat 1: 153b1345 ($5 in chips)
Seat 2: f06064a0 ($5 in chips)
Seat 3: 459d0f5c ($5 in chips)
Seat 4: 9942b4df ($5.37 in chips)
Seat 5: Hero ($6.67 in chips)
Seat 6: 9386dd90 ($5.69 in chips)
f06064a0: posts small blind $0.02
459d0f5c: posts big blind $0.05
*** HOLE CARDS ***
Dealt to 153b1345 
Dealt to f06064a0 
Dealt to 459d0f5c 
Dealt to 9942b4df 
Dealt to Hero [7h 5s]
Dealt to 9386dd90 
9942b4df: folds
Hero: folds
9386dd90: folds
153b1345: folds
f06064a0: folds
Uncalled bet ($0.03) returned to 459d0f5c
*** SHOWDOWN ***
459d0f5c collected $0.04 from pot
*** SUMMARY ***
Total pot $0.04 | Rake $0 | Jackpot $0 | Bingo $0 | Fortune $0 | Tax $0
Seat 1: 153b1345 (button) folded before Flop (didn't bet)
Seat 2: f06064a0 (small blind) folded before Flop
Seat 3: 459d0f5c (big blind) collected ($0.04)
Seat 4: 9942b4df folded before Flop (didn't bet)
Seat 5: Hero folded before Flop (didn't bet)
Seat 6: 9386dd90 folded before Flop (didn't bet)


Poker Hand #RC2078517040: Hold'em No Limit ($0.02/$0.05) - 2023/12/22 21:37:28
Table 'RushAndCash793412' 6-max Seat #1 is the button
Seat 1: 6ea11ecf ($7.25 in chips)
Seat 2: f93190a6 ($5.13 in chips)
Seat 3: 4fedcb8f ($5.66 in chips)
Seat 4: Hero ($6.67 in chips)
Seat 5: 90b5844 ($1.49 in chips)
Seat 6: bb096a6e ($6.09 in chips)
f93190a6: posts small blind $0.02
4fedcb8f: posts big blind $0.05
*** HOLE CARDS ***
Dealt to 6ea11ecf 
Dealt to f93190a6 
Dealt to 4fedcb8f 
Dealt to Hero [Kc Td]
Dealt to 90b5844 
Dealt to bb096a6e 
Hero: folds
90b5844: raises $0.05 to $0.1
bb096a6e: folds
6ea11ecf: folds
f93190a6: calls $0.08
4fedcb8f: folds
*** FLOP *** [Ks 7h Tc]
f93190a6: checks
90b5844: bets $0.13
f93190a6: calls $0.13
*** TURN *** [Ks 7h Tc] [3d]
f93190a6: checks
90b5844: bets $0.39
f93190a6: calls $0.39
*** RIVER *** [Ks 7h Tc 3d] [4h]
f93190a6: checks
90b5844: bets $0.87 and is all-in
f93190a6: calls $0.87
90b5844: shows [Ac Qs] (Ace-High)
f93190a6: shows [Th Jd] (Pair of Tens)
*** SHOWDOWN ***
f93190a6 collected $2.82 from pot
*** SUMMARY ***
Total pot $3.03 | Rake $0.14 | Jackpot $0.07 | Bingo $0 | Fortune $0 | Tax $0
Board [Ks 7h Tc 3d 4h]
Seat 1: 6ea11ecf (button) folded before Flop (didn't bet)
Seat 2: f93190a6 (small blind) showed [Th Jd] and won ($2.82) with Pair of Tens
Seat 3: 4fedcb8f (big blind) folded before Flop
Seat 4: Hero folded before Flop (didn't bet)
Seat 5: 90b5844 showed [Ac Qs] and lost with Ace-High
Seat 6: bb096a6e folded before Flop (didn't bet)


Poker Hand #RC2078516317: Hold'em No Limit ($0.02/$0.05) - 2023/12/22 21:36:48
Table 'RushAndCash793088' 6-max Seat #1 is the button
Seat 1: df439f39 ($5.89 in chips)
Seat 2: 6ea11ecf ($7.35 in chips)
Seat 3: Hero ($6.17 in chips)
Seat 4: fa93749b ($8.67 in chips)
Seat 5: 2856cf54 ($4.81 in chips)
Seat 6: 90b5844 ($1.94 in chips)
6ea11ecf: posts small blind $0.02
Hero: posts big blind $0.05
*** HOLE CARDS ***
Dealt to df439f39 
Dealt to 6ea11ecf 
Dealt to Hero [8c Ac]
Dealt to fa93749b 
Dealt to 2856cf54 
Dealt to 90b5844 
fa93749b: folds
2856cf54: folds
90b5844: raises $0.05 to $0.1
df439f39: folds
6ea11ecf: calls $0.08
Hero: calls $0.05
*** FLOP *** [Ad 4s 9c]
6ea11ecf: checks
Hero: checks
90b5844: checks
*** TURN *** [Ad 4s 9c] [Tc]
6ea11ecf: checks
Hero: bets $0.15
90b5844: calls $0.15
6ea11ecf: folds
*** RIVER *** [Ad 4s 9c Tc] [Th]
Hero: bets $0.2
90b5844: calls $0.2
Hero: shows [8c Ac] (Pair of Aces and Pair of Tens)
90b5844: shows [Qs Qd] (Pair of Queens and Pair of Tens)
*** SHOWDOWN ***
Hero collected $0.95 from pot
*** SUMMARY ***
Total pot $1 | Rake $0.05 | Jackpot $0 | Bingo $0 | Fortune $0 | Tax $0
Board [Ad 4s 9c Tc Th]
Seat 1: df439f39 (button) folded before Flop (didn't bet)
Seat 2: 6ea11ecf (small blind) folded on the Turn
Seat 3: Hero (big blind) showed [8c Ac] and won ($0.95) with Pair of Aces and Pair of Tens
Seat 4: fa93749b folded before Flop (didn't bet)
Seat 5: 2856cf54 folded before Flop (didn't bet)
Seat 6: 90b5844 showed [Qs Qd] and lost with Pair of Queens and Pair of Tens


Poker Hand #RC2078516194: Hold'em No Limit ($0.02/$0.05) - 2023/12/22 21:36:41
Table 'RushAndCash793037' 6-max Seat #1 is the button
Seat 1: Hero ($6.17 in chips)
Seat 2: 9f59b76d ($5.02 in chips)
Seat 3: eaff818f ($6.6 in chips)
Seat 4: f8f3fa91 ($5.24 in chips)
Seat 5: 9a72cd2d ($7.78 in chips)
Seat 6: 29b0f5be ($7.38 in chips)
9f59b76d: posts small blind $0.02
eaff818f: posts big blind $0.05
*** HOLE CARDS ***
Dealt to Hero [Ad 3h]
Dealt to 9f59b76d 
Dealt to eaff818f 
Dealt to f8f3fa91 
Dealt to 9a72cd2d 
Dealt to 29b0f5be 
f8f3fa91: folds
9a72cd2d: raises $0.1 to $0.15
29b0f5be: folds
Hero: folds
9f59b76d: folds
eaff818f: folds
Uncalled bet ($0.1) returned to 9a72cd2d
*** SHOWDOWN ***
9a72cd2d collected $0.12 from pot
*** SUMMARY ***
Total pot $0.12 | Rake $0 | Jackpot $0 | Bingo $0 | Fortune $0 | Tax $0
Seat 1: Hero (button) folded before Flop (didn't bet)
Seat 2: 9f59b76d (small blind) folded before Flop
Seat 3: eaff818f (big blind) folded before Flop
Seat 4: f8f3fa91 folded before Flop (didn't bet)
Seat 5: 9a72cd2d collected ($0.12)
Seat 6: 29b0f5be folded before Flop (didn't bet)


Poker Hand #RC2078515978: Hold'em No Limit ($0.02/$0.05) - 2023/12/22 21:36:29
Table 'RushAndCash792943' 6-max Seat #1 is the button
Seat 1: 311eeba4 ($17.63 in chips)
Seat 2: Hero ($6.19 in chips)
Seat 3: c883264a ($10.3 in chips)
Seat 4: fdc2d3ba ($12.6 in chips)
Seat 5: ea71423 ($6.26 in chips)
Seat 6: 2075befd ($5.02 in chips)
Hero: posts small blind $0.02
c883264a: posts big blind $0.05
*** HOLE CARDS ***
Dealt to 311eeba4 
Dealt to Hero [6s Jh]
Dealt to c883264a 
Dealt to fdc2d3ba 
Dealt to ea71423 
Dealt to 2075befd 
fdc2d3ba: raises $0.08 to $0.13
ea71423: calls $0.13
2075befd: folds
311eeba4: folds
Hero: folds
c883264a: folds
*** FLOP *** [3d Kh Td]
fdc2d3ba: checks
ea71423: bets $0.25
fdc2d3ba: raises $0.63 to $0.88
ea71423: folds
Uncalled bet ($0.63) returned to fdc2d3ba
*** SHOWDOWN ***
fdc2d3ba collected $0.79 from pot
*** SUMMARY ***
Total pot $0.83 | Rake $0.04 | Jackpot $0 | Bingo $0 | Fortune $0 | Tax $0
Board [3d Kh Td]
Seat 1: 311eeba4 (button) folded before Flop (didn't bet)
Seat 2: Hero (small blind) folded before Flop
Seat 3: c883264a (big blind) folded before Flop
Seat 4: fdc2d3ba won ($0.79)
Seat 5: ea71423 folded on the Flop
Seat 6: 2075befd folded before Flop (didn't bet)


Poker Hand #RC2078515906: Hold'em No Limit ($0.02/$0.05) - 2023/12/22 21:36:24
Table 'RushAndCash792912' 6-max Seat #1 is the button
Seat 1: 7c950e30 ($9.52 in chips)
Seat 2: 7b437e57 ($5.02 in chips)
Seat 3: a615a9f6 ($12.45 in chips)
Seat 4: Hero ($6.19 in chips)
Seat 5: 851fc2ef ($8.07 in chips)
Seat 6: e4d2f8b7 ($10.01 in chips)
7b437e57: posts small blind $0.02
a615a9f6: posts big blind $0.05
*** HOLE CARDS ***
Dealt to 7c950e30 
Dealt to 7b437e57 
Dealt to a615a9f6 
Dealt to Hero [Jc 9s]
Dealt to 851fc2ef 
Dealt to e4d2f8b7 
Hero: folds
851fc2ef: raises $0.08 to $0.13
e4d2f8b7: folds
7c950e30: raises $0.25 to $0.38
7b437e57: folds
a615a9f6: folds
851fc2ef: calls $0.25
*** FLOP *** [Kd Qd 5c]
851fc2ef: checks
7c950e30: bets $0.21
851fc2ef: folds
Uncalled bet ($0.21) returned to 7c950e30
*** SHOWDOWN ***
7c950e30 collected $0.78 from pot
*** SUMMARY ***
Total pot $0.83 | Rake $0.05 | Jackpot $0 | Bingo $0 | Fortune $0 | Tax $0
Board [Kd Qd 5c]
Seat 1: 7c950e30 (button) won ($0.78)
Seat 2: 7b437e57 (small blind) folded before Flop
Seat 3: a615a9f6 (big blind) folded before Flop
Seat 4: Hero folded before Flop (didn't bet)
Seat 5: 851fc2ef folded on the Flop
Seat 6: e4d2f8b7 folded before Flop (didn't bet)


Poker Hand #RC2078515835: Hold'em No Limit ($0.02/$0.05) - 2023/12/22 21:36:21
Table 'RushAndCash792883' 6-max Seat #1 is the button
Seat 1: faf7185e ($1.99 in chips)
Seat 2: 34668455 ($3.02 in chips)
Seat 3: d6c4e270 ($3.25 in chips)
Seat 4: 1394bd6b ($5.96 in chips)
Seat 5: eaff818f ($6.6 in chips)
Seat 6: Hero ($6.19 in chips)
34668455: posts small blind $0.02
d6c4e270: posts big blind $0.05
*** HOLE CARDS ***
Dealt to faf7185e 
Dealt to 34668455 
Dealt to d6c4e270 
Dealt to 1394bd6b 
Dealt to eaff818f 
Dealt to Hero [7h Jc]
1394bd6b: folds
eaff818f: folds
Hero: folds
faf7185e: folds
34668455: folds
Uncalled bet ($0.03) returned to d6c4e270
*** SHOWDOWN ***
d6c4e270 collected $0.04 from pot
*** SUMMARY ***
Total pot $0.04 | Rake $0 | Jackpot $0 | Bingo $0 | Fortune $0 | Tax $0
Seat 1: faf7185e (button) folded before Flop (didn't bet)
Seat 2: 34668455 (small blind) folded before Flop
Seat 3: d6c4e270 (big blind) collected ($0.04)
Seat 4: 1394bd6b folded before Flop (didn't bet)
Seat 5: eaff818f folded before Flop (didn't bet)
Seat 6: Hero folded before Flop (didn't bet)


Poker Hand #RC2078515598: Hold'em No Limit ($0.02/$0.05) - 2023/12/22 21:36:08
Table 'RushAndCash792771' 6-max Seat #1 is the button
Seat 1: Hero ($6.12 in chips)
Seat 2: 7728b936 ($5 in chips)
Seat 3: f0b0a5f9 ($16.11 in chips)
Seat 4: d2739eda ($4.1 in chips)
Seat 5: ea5a6534 ($5 in chips)
Seat 6: 548ecbec ($5.28 in chips)
7728b936: posts small blind $0.02
f0b0a5f9: posts big blind $0.05
*** HOLE CARDS ***
Dealt to Hero [Kc 4c]
Dealt to 7728b936 
Dealt to f0b0a5f9 
Dealt to d2739eda 
Dealt to ea5a6534 
Dealt to 548ecbec 
d2739eda: folds
ea5a6534: folds
548ecbec: folds
Hero: raises $0.08 to $0.13
7728b936: folds
f0b0a5f9: folds
Uncalled bet ($0.08) returned to Hero
*** SHOWDOWN ***
Hero collected $0.12 from pot
*** SUMMARY ***
Total pot $0.12 | Rake $0 | Jackpot $0 | Bingo $0 | Fortune $0 | Tax $0
Seat 1: Hero (button) collected ($0.12)
Seat 2: 7728b936 (small blind) folded before Flop
Seat 3: f0b0a5f9 (big blind) folded before Flop
Seat 4: d2739eda folded before Flop (didn't bet)
Seat 5: ea5a6534 folded before Flop (didn't bet)
Seat 6: 548ecbec folded before Flop (didn't bet)


Poker Hand #RC2078515527: Hold'em No Limit ($0.02/$0.05) - 2023/12/22 21:36:04
Table 'RushAndCash792735' 6-max Seat #1 is the button
Seat 1: 7d88bcbc ($6.2 in chips)
Seat 2: d32741ba ($7.48 in chips)
Seat 3: 2d19d9d1 ($5 in chips)
Seat 4: 6b2f8b43 ($4.7 in chips)
Seat 5: Hero ($6.12 in chips)
Seat 6: 9f59b76d ($5.02 in chips)
d32741ba: posts small blind $0.02
2d19d9d1: posts big blind $0.05
*** HOLE CARDS ***
Dealt to 7d88bcbc 
Dealt to d32741ba 
Dealt to 2d19d9d1 
Dealt to 6b2f8b43 
Dealt to Hero [8d Kh]
Dealt to 9f59b76d 
6b2f8b43: raises $0.05 to $0.1
Hero: folds
9f59b76d: folds
7d88bcbc: folds
d32741ba: folds
2d19d9d1: folds
Uncalled bet ($0.05) returned to 6b2f8b43
*** SHOWDOWN ***
6b2f8b43 collected $0.12 from pot
*** SUMMARY ***
Total pot $0.12 | Rake $0 | Jackpot $0 | Bingo $0 | Fortune $0 | Tax $0
Seat 1: 7d88bcbc (button) folded before Flop (didn't bet)
Seat 2: d32741ba (small blind) folded before Flop
Seat 3: 2d19d9d1 (big blind) folded before Flop
Seat 4: 6b2f8b43 collected ($0.12)
Seat 5: Hero folded before Flop (didn't bet)
Seat 6: 9f59b76d folded before Flop (didn't bet)


Poker Hand #RC2078515376: Hold'em No Limit ($0.02/$0.05) - 2023/12/22 21:35:56
Table 'RushAndCash792666' 6-max Seat #1 is the button
Seat 1: b2bf2645 ($5 in chips)
Seat 2: 69eae1f2 ($6.4 in chips)
Seat 3: Hero ($6.1 in chips)
Seat 4: 130f7150 ($6.25 in chips)
Seat 5: 851fc2ef ($8.07 in chips)
Seat 6: f73ad9cd ($5 in chips)
69eae1f2: posts small blind $0.02
Hero: posts big blind $0.05
*** HOLE CARDS ***
Dealt to b2bf2645 
Dealt to 69eae1f2 
Dealt to Hero [5s Kd]
Dealt to 130f7150 
Dealt to 851fc2ef 
Dealt to f73ad9cd 
130f7150: folds
851fc2ef: folds
f73ad9cd: folds
b2bf2645: folds
69eae1f2: folds
Uncalled bet ($0.03) returned to Hero
*** SHOWDOWN ***
Hero collected $0.04 from pot
*** SUMMARY ***
Total pot $0.04 | Rake $0 | Jackpot $0 | Bingo $0 | Fortune $0 | Tax $0
Seat 1: b2bf2645 (button) folded before Flop (didn't bet)
Seat 2: 69eae1f2 (small blind) folded before Flop
Seat 3: Hero (big blind) collected ($0.04)
Seat 4: 130f7150 folded before Flop (didn't bet)
Seat 5: 851fc2ef folded before Flop (didn't bet)
Seat 6: f73ad9cd folded before Flop (didn't bet)


Poker Hand #RC2078515299: Hold'em No Limit ($0.02/$0.05) - 2023/12/22 21:35:51
Table 'RushAndCash792633' 6-max Seat #1 is the button
Seat 1: 2861b620 ($3.44 in chips)
Seat 2: Hero ($6.12 in chips)
Seat 3: 6c424f5a ($6.16 in chips)
Seat 4: bfc64a4a ($4.98 in chips)
Seat 5: 4cfc823 ($5.09 in chips)
Seat 6: 8eb71456 ($14.12 in chips)
Hero: posts small blind $0.02
6c424f5a: posts big blind $0.05
*** HOLE CARDS ***
Dealt to 2861b620 
Dealt to Hero [8d 6c]
Dealt to 6c424f5a 
Dealt to bfc64a4a 
Dealt to 4cfc823 
Dealt to 8eb71456 
bfc64a4a: folds
4cfc823: folds
8eb71456: folds
2861b620: folds
Hero: folds
Uncalled bet ($0.03) returned to 6c424f5a
*** SHOWDOWN ***
6c424f5a collected $0.04 from pot
*** SUMMARY ***
Total pot $0.04 | Rake $0 | Jackpot $0 | Bingo $0 | Fortune $0 | Tax $0
Seat 1: 2861b620 (button) folded before Flop (didn't bet)
Seat 2: Hero (small blind) folded before Flop
Seat 3: 6c424f5a (big blind) collected ($0.04)
Seat 4: bfc64a4a folded before Flop (didn't bet)
Seat 5: 4cfc823 folded before Flop (didn't bet)
Seat 6: 8eb71456 folded before Flop (didn't bet)


Poker Hand #RC2078515238: Hold'em No Limit ($0.02/$0.05) - 2023/12/22 21:35:48
Table 'RushAndCash792608' 6-max Seat #1 is the button
Seat 1: 90a9fad4 ($46.22 in chips)
Seat 2: 2856cf54 ($4.95 in chips)
Seat 3: 3d929f9f ($10.3 in chips)
Seat 4: acc9d31d ($5.72 in chips)
Seat 5: d45bc7f3 ($6.71 in chips)
Seat 6: Hero ($6.12 in chips)
2856cf54: posts small blind $0.02
3d929f9f: posts big blind $0.05
*** HOLE CARDS ***
Dealt to 90a9fad4 
Dealt to 2856cf54 
Dealt to 3d929f9f 
Dealt to acc9d31d 
Dealt to d45bc7f3 
Dealt to Hero [6h 7d]
acc9d31d: folds
d45bc7f3: raises $0.08 to $0.13
Hero: folds
90a9fad4: raises $0.24 to $0.37
2856cf54: folds
3d929f9f: folds
d45bc7f3: raises $0.69 to $1.06
90a9fad4: raises $15.19 to $16.25
d45bc7f3: calls $5.65 and is all-in
Uncalled bet ($9.54) returned to 90a9fad4
90a9fad4: shows [Ac Ad]
d45bc7f3: shows [Ks Ah]
*** FLOP *** [2c Qc 2d]
*** TURN *** [2c Qc 2d] [4s]
*** RIVER *** [2c Qc 2d 4s] [3d]
*** SHOWDOWN ***
90a9fad4 collected $13.27 from pot
*** SUMMARY ***
Total pot $13.49 | Rake $0.15 | Jackpot $0.07 | Bingo $0 | Fortune $0 | Tax $0
Board [2c Qc 2d 4s 3d]
Seat 1: 90a9fad4 (button) showed [Ac Ad] and won ($13.27) with Pair of Aces and Pair of Twos
Seat 2: 2856cf54 (small blind) folded before Flop
Seat 3: 3d929f9f (big blind) folded before Flop
Seat 4: acc9d31d folded before Flop (didn't bet)
Seat 5: d45bc7f3 showed [Ks Ah] and lost with Pair of Twos
Seat 6: Hero folded before Flop (didn't bet)


Poker Hand #RC2078515140: Hold'em No Limit ($0.02/$0.05) - 2023/12/22 21:35:42
Table 'RushAndCash792562' 6-max Seat #1 is the button
Seat 1: 6a898db1 ($6.15 in chips)
Seat 2: 494d7c43 ($8.04 in chips)
Seat 3: acefe839 ($18.6 in chips)
Seat 4: e527ebf4 ($7.89 in chips)
Seat 5: 921e997e ($8.16 in chips)
Seat 6: Hero ($6.12 in chips)
494d7c43: posts small blind $0.02
acefe839: posts big blind $0.05
*** HOLE CARDS ***
Dealt to 6a898db1 
Dealt to 494d7c43 
Dealt to acefe839 
Dealt to e527ebf4 
Dealt to 921e997e 
Dealt to Hero [5h Qh]
e527ebf4: raises $0.1 to $0.15
921e997e: raises $0.3 to $0.45
Hero: folds
6a898db1: folds
494d7c43: folds
acefe839: folds
e527ebf4: folds
Uncalled bet ($0.3) returned to 921e997e
*** SHOWDOWN ***
921e997e collected $0.35 from pot
*** SUMMARY ***
Total pot $0.37 | Rake $0.02 | Jackpot $0 | Bingo $0 | Fortune $0 | Tax $0
Seat 1: 6a898db1 (button) folded before Flop (didn't bet)
Seat 2: 494d7c43 (small blind) folded before Flop
Seat 3: acefe839 (big blind) folded before Flop
Seat 4: e527ebf4 folded before Flop
Seat 5: 921e997e collected ($0.35)
Seat 6: Hero folded before Flop (didn't bet)


Poker Hand #RC2078514764: Hold'em No Limit ($0.02/$0.05) - 2023/12/22 21:35:21
Table 'RushAndCash792381' 6-max Seat #1 is the button
Seat 1: c90310eb ($3.69 in chips)
Seat 2: f73ad9cd ($5.07 in chips)
Seat 3: f7ea1894 ($5 in chips)
Seat 4: 7157dd36 ($7.44 in chips)
Seat 5: Hero ($6.22 in chips)
Seat 6: 494d7c43 ($7.81 in chips)
f73ad9cd: posts small blind $0.02
f7ea1894: posts big blind $0.05
*** HOLE CARDS ***
Dealt to c90310eb 
Dealt to f73ad9cd 
Dealt to f7ea1894 
Dealt to 7157dd36 
Dealt to Hero [Jc Qh]
Dealt to 494d7c43 
7157dd36: folds
Hero: raises $0.05 to $0.1
494d7c43: calls $0.1
c90310eb: folds
f73ad9cd: folds
f7ea1894: folds
*** FLOP *** [4c 3d 9d]
Hero: checks
494d7c43: bets $0.14
Hero: folds
Uncalled bet ($0.14) returned to 494d7c43
*** SHOWDOWN ***
494d7c43 collected $0.26 from pot
*** SUMMARY ***
Total pot $0.27 | Rake $0.01 | Jackpot $0 | Bingo $0 | Fortune $0 | Tax $0
Board [4c 3d 9d]
Seat 1: c90310eb (button) folded before Flop (didn't bet)
Seat 2: f73ad9cd (small blind) folded before Flop
Seat 3: f7ea1894 (big blind) folded before Flop
Seat 4: 7157dd36 folded before Flop (didn't bet)
Seat 5: Hero folded on the Flop
Seat 6: 494d7c43 won ($0.26)


Poker Hand #RC2078514680: Hold'em No Limit ($0.02/$0.05) - 2023/12/22 21:35:17
Table 'RushAndCash792340' 6-max Seat #1 is the button
Seat 1: adc999b ($17.36 in chips)
Seat 2: 6e609dc6 ($5.99 in chips)
Seat 3: b8d8e3a7 ($8.33 in chips)
Seat 4: 6551e7ca ($5.97 in chips)
Seat 5: 8eb71456 ($14.12 in chips)
Seat 6: Hero ($6.22 in chips)
6e609dc6: posts small blind $0.02
b8d8e3a7: posts big blind $0.05
*** HOLE CARDS ***
Dealt to adc999b 
Dealt to 6e609dc6 
Dealt to b8d8e3a7 
Dealt to 6551e7ca 
Dealt to 8eb71456 
Dealt to Hero [As 4c]
6551e7ca: folds
8eb71456: folds
Hero: folds
adc999b: folds
6e609dc6: folds
Uncalled bet ($0.03) returned to b8d8e3a7
*** SHOWDOWN ***
b8d8e3a7 collected $0.04 from pot
*** SUMMARY ***
Total pot $0.04 | Rake $0 | Jackpot $0 | Bingo $0 | Fortune $0 | Tax $0
Seat 1: adc999b (button) folded before Flop (didn't bet)
Seat 2: 6e609dc6 (small blind) folded before Flop
Seat 3: b8d8e3a7 (big blind) collected ($0.04)
Seat 4: 6551e7ca folded before Flop (didn't bet)
Seat 5: 8eb71456 folded before Flop (didn't bet)
Seat 6: Hero folded before Flop (didn't bet)


Poker Hand #RC2078514592: Hold'em No Limit ($0.02/$0.05) - 2023/12/22 21:35:12
Table 'RushAndCash792299' 6-max Seat #1 is the button
Seat 1: Hero ($6.22 in chips)
Seat 2: 175b9638 ($6.62 in chips)
Seat 3: a4441de9 ($6.01 in chips)
Seat 4: 60bb15f4 ($5.81 in chips)
Seat 5: a420712c ($7.43 in chips)
Seat 6: c0d3508b ($4.27 in chips)
175b9638: posts small blind $0.02
a4441de9: posts big blind $0.05
*** HOLE CARDS ***
Dealt to Hero [8c 9d]
Dealt to 175b9638 
Dealt to a4441de9 
Dealt to 60bb15f4 
Dealt to a420712c 
Dealt to c0d3508b 
60bb15f4: folds
a420712c: folds
c0d3508b: raises $0.1 to $0.15
Hero: folds
175b9638: folds
a4441de9: folds
Uncalled bet ($0.1) returned to c0d3508b
*** SHOWDOWN ***
c0d3508b collected $0.12 from pot
*** SUMMARY ***
Total pot $0.12 | Rake $0 | Jackpot $0 | Bingo $0 | Fortune $0 | Tax $0
Seat 1: Hero (button) folded before Flop (didn't bet)
Seat 2: 175b9638 (small blind) folded before Flop
Seat 3: a4441de9 (big blind) folded before Flop
Seat 4: 60bb15f4 folded before Flop (didn't bet)
Seat 5: a420712c folded before Flop (didn't bet)
Seat 6: c0d3508b collected ($0.12)


Poker Hand #RC2078513930: Hold'em No Limit ($0.02/$0.05) - 2023/12/22 21:34:34
Table 'RushAndCash791997' 6-max Seat #1 is the button
Seat 1: dbe8d3d8 ($5.27 in chips)
Seat 2: 65358b0f ($4.51 in chips)
Seat 3: Hero ($6.32 in chips)
Seat 4: a4441de9 ($5.9 in chips)
Seat 5: 2b9f6a0 ($6.19 in chips)
Seat 6: 8927103f ($4.21 in chips)
65358b0f: posts small blind $0.02
Hero: posts big blind $0.05
*** HOLE CARDS ***
Dealt to dbe8d3d8 
Dealt to 65358b0f 
Dealt to Hero [Ks Jh]
Dealt to a4441de9 
Dealt to 2b9f6a0 
Dealt to 8927103f 
a4441de9: raises $0.05 to $0.1
2b9f6a0: folds
8927103f: folds
dbe8d3d8: folds
65358b0f: folds
Hero: calls $0.05
*** FLOP *** [5c 4c 9h]
Hero: checks
a4441de9: checks
*** TURN *** [5c 4c 9h] [5d]
Hero: checks
a4441de9: checks
*** RIVER *** [5c 4c 9h 5d] [8h]
Hero: checks
a4441de9: checks
Hero: shows [Ks Jh] (Pair of Fives)
a4441de9: shows [Ah Qh] (Pair of Fives)
*** SHOWDOWN ***
a4441de9 collected $0.21 from pot
*** SUMMARY ***
Total pot $0.22 | Rake $0.01 | Jackpot $0 | Bingo $0 | Fortune $0 | Tax $0
Board [5c 4c 9h 5d 8h]
Seat 1: dbe8d3d8 (button) folded before Flop (didn't bet)
Seat 2: 65358b0f (small blind) folded before Flop
Seat 3: Hero (big blind) showed [Ks Jh] and lost with Pair of Fives
Seat 4: a4441de9 showed [Ah Qh] and won ($0.21) with Pair of Fives
Seat 5: 2b9f6a0 folded before Flop (didn't bet)
Seat 6: 8927103f folded before Flop (didn't bet)


Poker Hand #RC2078513858: Hold'em No Limit ($0.02/$0.05) - 2023/12/22 21:34:30
Table 'RushAndCash791966' 6-max Seat #1 is the button
Seat 1: e24a2fed ($11.08 in chips)
Seat 2: Hero ($6.34 in chips)
Seat 3: 6bc8336e ($5.52 in chips)
Seat 4: 130f7150 ($6 in chips)
Seat 5: 1719c1d9 ($6.7 in chips)
Seat 6: 76a1de63 ($4.46 in chips)
Hero: posts small blind $0.02
6bc8336e: posts big blind $0.05
*** HOLE CARDS ***
Dealt to e24a2fed 
Dealt to Hero [8d Js]
Dealt to 6bc8336e 
Dealt to 130f7150 
Dealt to 1719c1d9 
Dealt to 76a1de63 
130f7150: raises $0.05 to $0.1
1719c1d9: folds
76a1de63: folds
e24a2fed: folds
Hero: folds
6bc8336e: folds
Uncalled bet ($0.05) returned to 130f7150
*** SHOWDOWN ***
130f7150 collected $0.12 from pot
*** SUMMARY ***
Total pot $0.12 | Rake $0 | Jackpot $0 | Bingo $0 | Fortune $0 | Tax $0
Seat 1: e24a2fed (button) folded before Flop (didn't bet)
Seat 2: Hero (small blind) folded before Flop
Seat 3: 6bc8336e (big blind) folded before Flop
Seat 4: 130f7150 collected ($0.12)
Seat 5: 1719c1d9 folded before Flop (didn't bet)
Seat 6: 76a1de63 folded before Flop (didn't bet)


Poker Hand #RC2078513756: Hold'em No Limit ($0.02/$0.05) - 2023/12/22 21:34:24
Table 'RushAndCash791915' 6-max Seat #1 is the button
Seat 1: f2c162d4 ($5.57 in chips)
Seat 2: 4fcbfbdc ($8.38 in chips)
Seat 3: f6b5f68e ($8.94 in chips)
Seat 4: Hero ($6.34 in chips)
Seat 5: d82e5b20 ($5 in chips)
Seat 6: b6052383 ($5.11 in chips)
4fcbfbdc: posts small blind $0.02
f6b5f68e: posts big blind $0.05
*** HOLE CARDS ***
Dealt to f2c162d4 
Dealt to 4fcbfbdc 
Dealt to f6b5f68e 
Dealt to Hero [2c Ks]
Dealt to d82e5b20 
Dealt to b6052383 
Hero: folds
d82e5b20: raises $0.05 to $0.1
b6052383: folds
f2c162d4: folds
4fcbfbdc: folds
f6b5f68e: folds
Uncalled bet ($0.05) returned to d82e5b20
*** SHOWDOWN ***
d82e5b20 collected $0.12 from pot
*** SUMMARY ***
Total pot $0.12 | Rake $0 | Jackpot $0 | Bingo $0 | Fortune $0 | Tax $0
Seat 1: f2c162d4 (button) folded before Flop (didn't bet)
Seat 2: 4fcbfbdc (small blind) folded before Flop
Seat 3: f6b5f68e (big blind) folded before Flop
Seat 4: Hero folded before Flop (didn't bet)
Seat 5: d82e5b20 collected ($0.12)
Seat 6: b6052383 folded before Flop (didn't bet)


Poker Hand #RC2078513516: Hold'em No Limit ($0.02/$0.05) - 2023/12/22 21:34:10
Table 'RushAndCash791800' 6-max Seat #1 is the button
Seat 1: 548ecbec ($5 in chips)
Seat 2: ddbe951e ($10.64 in chips)
Seat 3: 23c96099 ($7.42 in chips)
Seat 4: 70f1d0b3 ($6.36 in chips)
Seat 5: 6f212319 ($5 in chips)
Seat 6: Hero ($6.27 in chips)
ddbe951e: posts small blind $0.02
23c96099: posts big blind $0.05
*** HOLE CARDS ***
Dealt to 548ecbec 
Dealt to ddbe951e 
Dealt to 23c96099 
Dealt to 70f1d0b3 
Dealt to 6f212319 
Dealt to Hero [Th Jh]
70f1d0b3: folds
6f212319: folds
Hero: raises $0.05 to $0.1
548ecbec: folds
ddbe951e: folds
23c96099: folds
Uncalled bet ($0.05) returned to Hero
*** SHOWDOWN ***
Hero collected $0.12 from pot
*** SUMMARY ***
Total pot $0.12 | Rake $0 | Jackpot $0 | Bingo $0 | Fortune $0 | Tax $0
Seat 1: 548ecbec (button) folded before Flop (didn't bet)
Seat 2: ddbe951e (small blind) folded before Flop
Seat 3: 23c96099 (big blind) folded before Flop
Seat 4: 70f1d0b3 folded before Flop (didn't bet)
Seat 5: 6f212319 folded before Flop (didn't bet)
Seat 6: Hero collected ($0.12)


Poker Hand #RC2078513333: Hold'em No Limit ($0.02/$0.05) - 2023/12/22 21:33:59
Table 'RushAndCash791713' 6-max Seat #1 is the button
Seat 1: Hero ($6.2 in chips)
Seat 2: 29b0f5be ($6.47 in chips)
Seat 3: 84d4f92c ($7.16 in chips)
Seat 4: 56c183ba ($5.16 in chips)
Seat 5: 763a1258 ($5 in chips)
Seat 6: 3a55a6df ($10.99 in chips)
29b0f5be: posts small blind $0.02
84d4f92c: posts big blind $0.05
*** HOLE CARDS ***
Dealt to Hero [7d Qd]
Dealt to 29b0f5be 
Dealt to 84d4f92c 
Dealt to 56c183ba 
Dealt to 763a1258 
Dealt to 3a55a6df 
56c183ba: folds
763a1258: folds
3a55a6df: folds
Hero: raises $0.08 to $0.13
29b0f5be: folds
84d4f92c: folds
Uncalled bet ($0.08) returned to Hero
*** SHOWDOWN ***
Hero collected $0.12 from pot
*** SUMMARY ***
Total pot $0.12 | Rake $0 | Jackpot $0 | Bingo $0 | Fortune $0 | Tax $0
Seat 1: Hero (button) collected ($0.12)
Seat 2: 29b0f5be (small blind) folded before Flop
Seat 3: 84d4f92c (big blind) folded before Flop
Seat 4: 56c183ba folded before Flop (didn't bet)
Seat 5: 763a1258 folded before Flop (didn't bet)
Seat 6: 3a55a6df folded before Flop (didn't bet)


Poker Hand #RC2078513068: Hold'em No Limit ($0.02/$0.05) - 2023/12/22 21:33:44
Table 'RushAndCash791582' 6-max Seat #1 is the button
Seat 1: 5ea4ec81 ($5.69 in chips)
Seat 2: Hero ($6.25 in chips)
Seat 3: 3a55a6df ($10.94 in chips)
Seat 4: b31920b7 ($5 in chips)
Seat 5: ea1839a2 ($2.17 in chips)
Seat 6: a2a9ef51 ($5.31 in chips)
Hero: posts small blind $0.02
3a55a6df: posts big blind $0.05
*** HOLE CARDS ***
Dealt to 5ea4ec81 
Dealt to Hero [5c 3c]
Dealt to 3a55a6df 
Dealt to b31920b7 
Dealt to ea1839a2 
Dealt to a2a9ef51 
b31920b7: folds
ea1839a2: folds
a2a9ef51: folds
5ea4ec81: folds
Hero: calls $0.03
3a55a6df: raises $0.15 to $0.2
Hero: folds
Uncalled bet ($0.15) returned to 3a55a6df
*** SHOWDOWN ***
3a55a6df collected $0.1 from pot
*** SUMMARY ***
Total pot $0.1 | Rake $0 | Jackpot $0 | Bingo $0 | Fortune $0 | Tax $0
Seat 1: 5ea4ec81 (button) folded before Flop (didn't bet)
Seat 2: Hero (small blind) folded before Flop
Seat 3: 3a55a6df (big blind) collected ($0.1)
Seat 4: b31920b7 folded before Flop (didn't bet)
Seat 5: ea1839a2 folded before Flop (didn't bet)
Seat 6: a2a9ef51 folded before Flop (didn't bet)


Poker Hand #RC2078512343: Hold'em No Limit ($0.02/$0.05) - 2023/12/22 21:33:03
Table 'RushAndCash791244' 6-max Seat #1 is the button
Seat 1: 6ffefba2 ($7.92 in chips)
Seat 2: 19d300cc ($6.21 in chips)
Seat 3: Hero ($6.38 in chips)
Seat 4: b179aebd ($5.41 in chips)
Seat 5: 2bb677ff ($4.2 in chips)
Seat 6: f0b0a5f9 ($15.24 in chips)
19d300cc: posts small blind $0.02
Hero: posts big blind $0.05
*** HOLE CARDS ***
Dealt to 6ffefba2 
Dealt to 19d300cc 
Dealt to Hero [As 3c]
Dealt to b179aebd 
Dealt to 2bb677ff 
Dealt to f0b0a5f9 
b179aebd: folds
2bb677ff: folds
f0b0a5f9: folds
6ffefba2: raises $0.08 to $0.13
19d300cc: calls $0.11
Hero: calls $0.08
*** FLOP *** [7c 8c 5h]
19d300cc: checks
Hero: checks
6ffefba2: bets $0.19
19d300cc: calls $0.19
Hero: folds
*** TURN *** [7c 8c 5h] [Js]
19d300cc: checks
6ffefba2: bets $0.23
19d300cc: calls $0.23
*** RIVER *** [7c 8c 5h Js] [Qc]
19d300cc: checks
6ffefba2: checks
19d300cc: shows [7s Ks] (Pair of Sevens)
6ffefba2: shows [Td 8d] (Pair of Eights)
*** SHOWDOWN ***
6ffefba2 collected $1.17 from pot
*** SUMMARY ***
Total pot $1.23 | Rake $0.06 | Jackpot $0 | Bingo $0 | Fortune $0 | Tax $0
Board [7c 8c 5h Js Qc]
Seat 1: 6ffefba2 (button) showed [Td 8d] and won ($1.17) with Pair of Eights
Seat 2: 19d300cc (small blind) showed [7s Ks] and lost with Pair of Sevens
Seat 3: Hero (big blind) folded on the Flop
Seat 4: b179aebd folded before Flop (didn't bet)
Seat 5: 2bb677ff folded before Flop (didn't bet)
Seat 6: f0b0a5f9 folded before Flop (didn't bet)


Poker Hand #RC2078512277: Hold'em No Limit ($0.02/$0.05) - 2023/12/22 21:33:00
Table 'RushAndCash791212' 6-max Seat #1 is the button
Seat 1: b9aa0c94 ($8.65 in chips)
Seat 2: e519a9e8 ($20.67 in chips)
Seat 3: 19d300cc ($6.26 in chips)
Seat 4: 6d80256d ($5 in chips)
Seat 5: Hero ($6.38 in chips)
Seat 6: 2bb677ff ($4.2 in chips)
e519a9e8: posts small blind $0.02
19d300cc: posts big blind $0.05
*** HOLE CARDS ***
Dealt to b9aa0c94 
Dealt to e519a9e8 
Dealt to 19d300cc 
Dealt to 6d80256d 
Dealt to Hero [Tc Jh]
Dealt to 2bb677ff 
6d80256d: folds
Hero: folds
2bb677ff: folds
b9aa0c94: raises $0.1 to $0.15
e519a9e8: folds
19d300cc: folds
Uncalled bet ($0.1) returned to b9aa0c94
*** SHOWDOWN ***
b9aa0c94 collected $0.12 from pot
*** SUMMARY ***
Total pot $0.12 | Rake $0 | Jackpot $0 | Bingo $0 | Fortune $0 | Tax $0
Seat 1: b9aa0c94 (button) collected ($0.12)
Seat 2: e519a9e8 (small blind) folded before Flop
Seat 3: 19d300cc (big blind) folded before Flop
Seat 4: 6d80256d folded before Flop (didn't bet)
Seat 5: Hero folded before Flop (didn't bet)
Seat 6: 2bb677ff folded before Flop (didn't bet)


Poker Hand #RC2078511975: Hold'em No Limit ($0.02/$0.05) - 2023/12/22 21:32:42
Table 'RushAndCash791071' 6-max Seat #1 is the button
Seat 1: 68c6c5e7 ($27.46 in chips)
Seat 2: 50cbc258 ($9.23 in chips)
Seat 3: d74d8525 ($5 in chips)
Seat 4: Hero ($6.48 in chips)
Seat 5: 2861b620 ($3.14 in chips)
Seat 6: 641aff0 ($6.47 in chips)
50cbc258: posts small blind $0.02
d74d8525: posts big blind $0.05
*** HOLE CARDS ***
Dealt to 68c6c5e7 
Dealt to 50cbc258 
Dealt to d74d8525 
Dealt to Hero [5s 4s]
Dealt to 2861b620 
Dealt to 641aff0 
Hero: raises $0.05 to $0.1
2861b620: folds
641aff0: folds
68c6c5e7: raises $0.3 to $0.4
50cbc258: folds
d74d8525: folds
Hero: folds
Uncalled bet ($0.3) returned to 68c6c5e7
*** SHOWDOWN ***
68c6c5e7 collected $0.26 from pot
*** SUMMARY ***
Total pot $0.27 | Rake $0.01 | Jackpot $0 | Bingo $0 | Fortune $0 | Tax $0
Seat 1: 68c6c5e7 (button) collected ($0.26)
Seat 2: 50cbc258 (small blind) folded before Flop
Seat 3: d74d8525 (big blind) folded before Flop
Seat 4: Hero folded before Flop
Seat 5: 2861b620 folded before Flop (didn't bet)
Seat 6: 641aff0 folded before Flop (didn't bet)


Poker Hand #RC2078511894: Hold'em No Limit ($0.02/$0.05) - 2023/12/22 21:32:38
Table 'RushAndCash791034' 6-max Seat #1 is the button
Seat 1: c9dcc850 ($7.39 in chips)
Seat 2: 9b2d2337 ($22.45 in chips)
Seat 3: 37b9c97 ($5.24 in chips)
Seat 4: Hero ($6.48 in chips)
Seat 5: 5ea4ec81 ($6.95 in chips)
Seat 6: ef1573b1 ($7.8 in chips)
9b2d2337: posts small blind $0.02
37b9c97: posts big blind $0.05
*** HOLE CARDS ***
Dealt to c9dcc850 
Dealt to 9b2d2337 
Dealt to 37b9c97 
Dealt to Hero [Jc 6h]
Dealt to 5ea4ec81 
Dealt to ef1573b1 
Hero: folds
5ea4ec81: folds
ef1573b1: folds
c9dcc850: folds
9b2d2337: folds
Uncalled bet ($0.03) returned to 37b9c97
*** SHOWDOWN ***
37b9c97 collected $0.04 from pot
*** SUMMARY ***
Total pot $0.04 | Rake $0 | Jackpot $0 | Bingo $0 | Fortune $0 | Tax $0
Seat 1: c9dcc850 (button) folded before Flop (didn't bet)
Seat 2: 9b2d2337 (small blind) folded before Flop
Seat 3: 37b9c97 (big blind) collected ($0.04)
Seat 4: Hero folded before Flop (didn't bet)
Seat 5: 5ea4ec81 folded before Flop (didn't bet)
Seat 6: ef1573b1 folded before Flop (didn't bet)


Poker Hand #RC2078511702: Hold'em No Limit ($0.02/$0.05) - 2023/12/22 21:32:27
Table 'RushAndCash790943' 6-max Seat #1 is the button
Seat 1: b179aebd ($5.28 in chips)
Seat 2: Hero ($6.5 in chips)
Seat 3: 6ffefba2 ($8.04 in chips)
Seat 4: f9adeea ($5 in chips)
Seat 5: 6186df3d ($7.03 in chips)
Seat 6: 84dda8d8 ($6.53 in chips)
Hero: posts small blind $0.02
6ffefba2: posts big blind $0.05
*** HOLE CARDS ***
Dealt to b179aebd 
Dealt to Hero [Jh 7s]
Dealt to 6ffefba2 
Dealt to f9adeea 
Dealt to 6186df3d 
Dealt to 84dda8d8 
f9adeea: folds
6186df3d: folds
84dda8d8: folds
b179aebd: raises $0.07 to $0.12
Hero: folds
6ffefba2: calls $0.07
*** FLOP *** [Jd 8s 3s]
6ffefba2: checks
b179aebd: bets $0.09
6ffefba2: folds
Uncalled bet ($0.09) returned to b179aebd
*** SHOWDOWN ***
b179aebd collected $0.25 from pot
*** SUMMARY ***
Total pot $0.26 | Rake $0.01 | Jackpot $0 | Bingo $0 | Fortune $0 | Tax $0
Board [Jd 8s 3s]
Seat 1: b179aebd (button) won ($0.25)
Seat 2: Hero (small blind) folded before Flop
Seat 3: 6ffefba2 (big blind) folded on the Flop
Seat 4: f9adeea folded before Flop (didn't bet)
Seat 5: 6186df3d folded before Flop (didn't bet)
Seat 6: 84dda8d8 folded before Flop (didn't bet)


Poker Hand #RC2078511646: Hold'em No Limit ($0.02/$0.05) - 2023/12/22 21:32:24
Table 'RushAndCash790915' 6-max Seat #1 is the button
Seat 1: d23c04d ($7.1 in chips)
Seat 2: 7c9c11 ($5.84 in chips)
Seat 3: 933d69ee ($8.45 in chips)
Seat 4: Hero ($6.5 in chips)
Seat 5: e194bfc6 ($10.5 in chips)
Seat 6: 41270a9a ($5.23 in chips)
7c9c11: posts small blind $0.02
933d69ee: posts big blind $0.05
*** HOLE CARDS ***
Dealt to d23c04d 
Dealt to 7c9c11 
Dealt to 933d69ee 
Dealt to Hero [4d 3c]
Dealt to e194bfc6 
Dealt to 41270a9a 
Hero: folds
e194bfc6: folds
41270a9a: folds
d23c04d: raises $0.1 to $0.15
7c9c11: folds
933d69ee: calls $0.1
*** FLOP *** [9c 8d 7s]
933d69ee: checks
d23c04d: bets $0.16
933d69ee: raises $0.32 to $0.48
d23c04d: raises $1.02 to $1.5
933d69ee: folds
Uncalled bet ($1.02) returned to d23c04d
*** SHOWDOWN ***
d23c04d collected $1.22 from pot
*** SUMMARY ***
Total pot $1.28 | Rake $0.06 | Jackpot $0 | Bingo $0 | Fortune $0 | Tax $0
Board [9c 8d 7s]
Seat 1: d23c04d (button) won ($1.22)
Seat 2: 7c9c11 (small blind) folded before Flop
Seat 3: 933d69ee (big blind) folded on the Flop
Seat 4: Hero folded before Flop (didn't bet)
Seat 5: e194bfc6 folded before Flop (didn't bet)
Seat 6: 41270a9a folded before Flop (didn't bet)


Poker Hand #RC2078511419: Hold'em No Limit ($0.02/$0.05) - 2023/12/22 21:32:11
Table 'RushAndCash790805' 6-max Seat #1 is the button
Seat 1: acefe34e ($6.72 in chips)
Seat 2: 39e048a4 ($7.6 in chips)
Seat 3: Hero ($6.55 in chips)
Seat 4: dbe8d3d8 ($5.39 in chips)
Seat 5: adc999b ($16.66 in chips)
Seat 6: ff5dd678 ($3.38 in chips)
39e048a4: posts small blind $0.02
Hero: posts big blind $0.05
*** HOLE CARDS ***
Dealt to acefe34e 
Dealt to 39e048a4 
Dealt to Hero [8d As]
Dealt to dbe8d3d8 
Dealt to adc999b 
Dealt to ff5dd678 
dbe8d3d8: folds
adc999b: folds
ff5dd678: calls $0.05
acefe34e: folds
39e048a4: raises $0.15 to $0.2
Hero: folds
ff5dd678: calls $0.15
*** FLOP *** [6c Ks Qc]
39e048a4: bets $0.16
ff5dd678: folds
Uncalled bet ($0.16) returned to 39e048a4
*** SHOWDOWN ***
39e048a4 collected $0.43 from pot
*** SUMMARY ***
Total pot $0.45 | Rake $0.02 | Jackpot $0 | Bingo $0 | Fortune $0 | Tax $0
Board [6c Ks Qc]
Seat 1: acefe34e (button) folded before Flop (didn't bet)
Seat 2: 39e048a4 (small blind) won ($0.43)
Seat 3: Hero (big blind) folded before Flop
Seat 4: dbe8d3d8 folded before Flop (didn't bet)
Seat 5: adc999b folded before Flop (didn't bet)
Seat 6: ff5dd678 folded on the Flop


Poker Hand #RC2078511154: Hold'em No Limit ($0.02/$0.05) - 2023/12/22 21:31:55
Table 'RushAndCash790679' 6-max Seat #1 is the button
Seat 1: Hero ($6.48 in chips)
Seat 2: c581b38e ($6.27 in chips)
Seat 3: d6126048 ($8.67 in chips)
Seat 4: 3e455537 ($5.16 in chips)
Seat 5: 893f08ec ($6.56 in chips)
Seat 6: 7961accb ($5.52 in chips)
c581b38e: posts small blind $0.02
d6126048: posts big blind $0.05
*** HOLE CARDS ***
Dealt to Hero [Th Ks]
Dealt to c581b38e 
Dealt to d6126048 
Dealt to 3e455537 
Dealt to 893f08ec 
Dealt to 7961accb 
3e455537: folds
893f08ec: folds
7961accb: folds
Hero: raises $0.08 to $0.13
c581b38e: folds
d6126048: folds
Uncalled bet ($0.08) returned to Hero
*** SHOWDOWN ***
Hero collected $0.12 from pot
*** SUMMARY ***
Total pot $0.12 | Rake $0 | Jackpot $0 | Bingo $0 | Fortune $0 | Tax $0
Seat 1: Hero (button) collected ($0.12)
Seat 2: c581b38e (small blind) folded before Flop
Seat 3: d6126048 (big blind) folded before Flop
Seat 4: 3e455537 folded before Flop (didn't bet)
Seat 5: 893f08ec folded before Flop (didn't bet)
Seat 6: 7961accb folded before Flop (didn't bet)


Poker Hand #RC2078511073: Hold'em No Limit ($0.02/$0.05) - 2023/12/22 21:31:50
Table 'RushAndCash790639' 6-max Seat #1 is the button
Seat 1: d82e5b20 ($5 in chips)
Seat 2: dc7cff29 ($11.81 in chips)
Seat 3: d2e52b8d ($20.79 in chips)
Seat 4: c4c1c89a ($5.12 in chips)
Seat 5: 869465ff ($17.47 in chips)
Seat 6: Hero ($6.48 in chips)
dc7cff29: posts small blind $0.02
d2e52b8d: posts big blind $0.05
*** HOLE CARDS ***
Dealt to d82e5b20 
Dealt to dc7cff29 
Dealt to d2e52b8d 
Dealt to c4c1c89a 
Dealt to 869465ff 
Dealt to Hero [2h 7c]
c4c1c89a: folds
869465ff: folds
Hero: folds
d82e5b20: folds
dc7cff29: folds
Uncalled bet ($0.03) returned to d2e52b8d
*** SHOWDOWN ***
d2e52b8d collected $0.04 from pot
*** SUMMARY ***
Total pot $0.04 | Rake $0 | Jackpot $0 | Bingo $0 | Fortune $0 | Tax $0
Seat 1: d82e5b20 (button) folded before Flop (didn't bet)
Seat 2: dc7cff29 (small blind) folded before Flop
Seat 3: d2e52b8d (big blind) collected ($0.04)
Seat 4: c4c1c89a folded before Flop (didn't bet)
Seat 5: 869465ff folded before Flop (didn't bet)
Seat 6: Hero folded before Flop (didn't bet)


Poker Hand #RC2078510882: Hold'em No Limit ($0.02/$0.05) - 2023/12/22 21:31:40
Table 'RushAndCash790547' 6-max Seat #1 is the button
Seat 1: 610bd7fc ($11.17 in chips)
Seat 2: fc3cdab5 ($1.31 in chips)
Seat 3: b8cfe296 ($3.56 in chips)
Seat 4: 80af7fe3 ($4.52 in chips)
Seat 5: Hero ($6.41 in chips)
Seat 6: f2c162d4 ($5.62 in chips)
fc3cdab5: posts small blind $0.02
b8cfe296: posts big blind $0.05
*** HOLE CARDS ***
Dealt to 610bd7fc 
Dealt to fc3cdab5 
Dealt to b8cfe296 
Dealt to 80af7fe3 
Dealt to Hero [5d Ad]
Dealt to f2c162d4 
80af7fe3: folds
Hero: raises $0.05 to $0.1
f2c162d4: folds
610bd7fc: folds
fc3cdab5: folds
b8cfe296: folds
Uncalled bet ($0.05) returned to Hero
*** SHOWDOWN ***
Hero collected $0.12 from pot
*** SUMMARY ***
Total pot $0.12 | Rake $0 | Jackpot $0 | Bingo $0 | Fortune $0 | Tax $0
Seat 1: 610bd7fc (button) folded before Flop (didn't bet)
Seat 2: fc3cdab5 (small blind) folded before Flop
Seat 3: b8cfe296 (big blind) folded before Flop
Seat 4: 80af7fe3 folded before Flop (didn't bet)
Seat 5: Hero collected ($0.12)
Seat 6: f2c162d4 folded before Flop (didn't bet)


Poker Hand #RC2078510137: Hold'em No Limit ($0.02/$0.05) - 2023/12/22 21:30:57
Table 'RushAndCash790193' 6-max Seat #1 is the button
Seat 1: Hero ($5.69 in chips)
Seat 2: 7c2eba4e ($7.61 in chips)
Seat 3: eb944e6 ($5.51 in chips)
Seat 4: 80af7fe3 ($5.16 in chips)
Seat 5: 75597e1b ($4.41 in chips)
Seat 6: 9b2d2337 ($22.5 in chips)
7c2eba4e: posts small blind $0.02
eb944e6: posts big blind $0.05
*** HOLE CARDS ***
Dealt to Hero [6s 6h]
Dealt to 7c2eba4e 
Dealt to eb944e6 
Dealt to 80af7fe3 
Dealt to 75597e1b 
Dealt to 9b2d2337 
80af7fe3: raises $0.08 to $0.13
75597e1b: folds
9b2d2337: folds
Hero: calls $0.13
7c2eba4e: folds
eb944e6: calls $0.08
*** FLOP *** [Kc 6d 4s]
eb944e6: checks
80af7fe3: bets $0.15
Hero: calls $0.15
eb944e6: folds
*** TURN *** [Kc 6d 4s] [Jc]
80af7fe3: bets $0.36
Hero: raises $0.46 to $0.82
80af7fe3: folds
Uncalled bet ($0.46) returned to Hero
*** SHOWDOWN ***
Hero collected $1.36 from pot
*** SUMMARY ***
Total pot $1.43 | Rake $0.07 | Jackpot $0 | Bingo $0 | Fortune $0 | Tax $0
Board [Kc 6d 4s Jc]
Seat 1: Hero (button) won ($1.36)
Seat 2: 7c2eba4e (small blind) folded before Flop
Seat 3: eb944e6 (big blind) folded on the Flop
Seat 4: 80af7fe3 folded on the Turn
Seat 5: 75597e1b folded before Flop (didn't bet)
Seat 6: 9b2d2337 folded before Flop (didn't bet)


Poker Hand #RC2078509482: Hold'em No Limit ($0.02/$0.05) - 2023/12/22 21:30:20
Table 'RushAndCash789860' 6-max Seat #1 is the button
Seat 1: 91e6539a ($6.73 in chips)
Seat 2: Hero ($5.38 in chips)
Seat 3: 53442c3b ($10.51 in chips)
Seat 4: 7016689e ($5 in chips)
Seat 5: 834fcc3f ($5 in chips)
Seat 6: e1380a89 ($4.58 in chips)
Hero: posts small blind $0.02
53442c3b: posts big blind $0.05
*** HOLE CARDS ***
Dealt to 91e6539a 
Dealt to Hero [Qs Ah]
Dealt to 53442c3b 
Dealt to 7016689e 
Dealt to 834fcc3f 
Dealt to e1380a89 
7016689e: raises $0.08 to $0.13
834fcc3f: folds
e1380a89: folds
91e6539a: folds
Hero: calls $0.11
53442c3b: folds
*** FLOP *** [6d 2s 6h]
Hero: checks
7016689e: bets $0.16
Hero: calls $0.16
*** TURN *** [6d 2s 6h] [4d]
Hero: checks
7016689e: checks
*** RIVER *** [6d 2s 6h 4d] [Jd]
Hero: checks
7016689e: checks
Hero: shows [Qs Ah] (Pair of Sixes)
7016689e: shows [Qd Kh] (Pair of Sixes)
*** SHOWDOWN ***
Hero collected $0.6 from pot
*** SUMMARY ***
Total pot $0.63 | Rake $0.03 | Jackpot $0 | Bingo $0 | Fortune $0 | Tax $0
Board [6d 2s 6h 4d Jd]
Seat 1: 91e6539a (button) folded before Flop (didn't bet)
Seat 2: Hero (small blind) showed [Qs Ah] and won ($0.6) with Pair of Sixes
Seat 3: 53442c3b (big blind) folded before Flop
Seat 4: 7016689e showed [Qd Kh] and lost with Pair of Sixes
Seat 5: 834fcc3f folded before Flop (didn't bet)
Seat 6: e1380a89 folded before Flop (didn't bet)


Poker Hand #RC2078509343: Hold'em No Limit ($0.02/$0.05) - 2023/12/22 21:30:12
Table 'RushAndCash789793' 6-max Seat #1 is the button
Seat 1: 6ea11ecf ($7.72 in chips)
Seat 2: fffa524d ($5.91 in chips)
Seat 3: Hero ($5.36 in chips)
Seat 4: d50b3b7c ($5.05 in chips)
Seat 5: 3160ff3c ($14.31 in chips)
Seat 6: 4fcbfbdc ($10.13 in chips)
fffa524d: posts small blind $0.02
Hero: posts big blind $0.05
*** HOLE CARDS ***
Dealt to 6ea11ecf 
Dealt to fffa524d 
Dealt to Hero [6c 7h]
Dealt to d50b3b7c 
Dealt to 3160ff3c 
Dealt to 4fcbfbdc 
d50b3b7c: folds
3160ff3c: folds
4fcbfbdc: folds
6ea11ecf: folds
fffa524d: folds
Uncalled bet ($0.03) returned to Hero
*** SHOWDOWN ***
Hero collected $0.04 from pot
*** SUMMARY ***
Total pot $0.04 | Rake $0 | Jackpot $0 | Bingo $0 | Fortune $0 | Tax $0
Seat 1: 6ea11ecf (button) folded before Flop (didn't bet)
Seat 2: fffa524d (small blind) folded before Flop
Seat 3: Hero (big blind) collected ($0.04)
Seat 4: d50b3b7c folded before Flop (didn't bet)
Seat 5: 3160ff3c folded before Flop (didn't bet)
Seat 6: 4fcbfbdc folded before Flop (didn't bet)


Poker Hand #RC2078509243: Hold'em No Limit ($0.02/$0.05) - 2023/12/22 21:30:07
Table 'RushAndCash789745' 6-max Seat #1 is the button
Seat 1: e24a2fed ($10.01 in chips)
Seat 2: 83f47841 ($7.15 in chips)
Seat 3: d74d8525 ($6.31 in chips)
Seat 4: 91937678 ($4.19 in chips)
Seat 5: cf6f5635 ($5.17 in chips)
Seat 6: Hero ($5.36 in chips)
83f47841: posts small blind $0.02
d74d8525: posts big blind $0.05
*** HOLE CARDS ***
Dealt to e24a2fed 
Dealt to 83f47841 
Dealt to d74d8525 
Dealt to 91937678 
Dealt to cf6f5635 
Dealt to Hero [8d 3c]
91937678: raises $0.1 to $0.15
cf6f5635: folds
Hero: folds
e24a2fed: folds
83f47841: folds
d74d8525: folds
Uncalled bet ($0.1) returned to 91937678
*** SHOWDOWN ***
91937678 collected $0.12 from pot
*** SUMMARY ***
Total pot $0.12 | Rake $0 | Jackpot $0 | Bingo $0 | Fortune $0 | Tax $0
Seat 1: e24a2fed (button) folded before Flop (didn't bet)
Seat 2: 83f47841 (small blind) folded before Flop
Seat 3: d74d8525 (big blind) folded before Flop
Seat 4: 91937678 collected ($0.12)
Seat 5: cf6f5635 folded before Flop (didn't bet)
Seat 6: Hero folded before Flop (didn't bet)


Poker Hand #RC2078509094: Hold'em No Limit ($0.02/$0.05) - 2023/12/22 21:29:58
Table 'RushAndCash789674' 6-max Seat #1 is the button
Seat 1: 61dc9b78 ($4.27 in chips)
Seat 2: a2fed278 ($5 in chips)
Seat 3: b8e0eed ($5.87 in chips)
Seat 4: 21073025 ($18.42 in chips)
Seat 5: Hero ($5.36 in chips)
Seat 6: c9dcc850 ($7.23 in chips)
a2fed278: posts small blind $0.02
b8e0eed: posts big blind $0.05
*** HOLE CARDS ***
Dealt to 61dc9b78 
Dealt to a2fed278 
Dealt to b8e0eed 
Dealt to 21073025 
Dealt to Hero [8d Qd]
Dealt to c9dcc850 
21073025: folds
Hero: folds
c9dcc850: folds
61dc9b78: folds
a2fed278: folds
Uncalled bet ($0.03) returned to b8e0eed
*** SHOWDOWN ***
b8e0eed collected $0.04 from pot
*** SUMMARY ***
Total pot $0.04 | Rake $0 | Jackpot $0 | Bingo $0 | Fortune $0 | Tax $0
Seat 1: 61dc9b78 (button) folded before Flop (didn't bet)
Seat 2: a2fed278 (small blind) folded before Flop
Seat 3: b8e0eed (big blind) collected ($0.04)
Seat 4: 21073025 folded before Flop (didn't bet)
Seat 5: Hero folded before Flop (didn't bet)
Seat 6: c9dcc850 folded before Flop (didn't bet)


Poker Hand #RC2078508103: Hold'em No Limit ($0.02/$0.05) - 2023/12/22 21:29:01
Table 'RushAndCash789195' 6-max Seat #1 is the button
Seat 1: f6b5f68e ($9.13 in chips)
Seat 2: 61dc9b78 ($4.61 in chips)
Seat 3: 58864a6e ($17.77 in chips)
Seat 4: Hero ($5 in chips)
Seat 5: 11676b65 ($8.59 in chips)
Seat 6: 40810c68 ($5.3 in chips)
61dc9b78: posts small blind $0.02
58864a6e: posts big blind $0.05
*** HOLE CARDS ***
Dealt to f6b5f68e 
Dealt to 61dc9b78 
Dealt to 58864a6e 
Dealt to Hero [Tc Td]
Dealt to 11676b65 
Dealt to 40810c68 
Hero: raises $0.05 to $0.1
11676b65: folds
40810c68: folds
f6b5f68e: folds
61dc9b78: calls $0.08
58864a6e: folds
*** FLOP *** [6s Qd 6c]
61dc9b78: bets $0.09
Hero: calls $0.09
*** TURN *** [6s Qd 6c] [6h]
61dc9b78: bets $0.15
Hero: calls $0.15
*** RIVER *** [6s Qd 6c 6h] [3c]
61dc9b78: checks
Hero: checks
61dc9b78: shows [3h 3s] (Sixes Full over Treys)
Hero: shows [Tc Td] (Sixes Full over Tens)
*** SHOWDOWN ***
Hero collected $0.7 from pot
*** SUMMARY ***
Total pot $0.73 | Rake $0.03 | Jackpot $0 | Bingo $0 | Fortune $0 | Tax $0
Board [6s Qd 6c 6h 3c]
Seat 1: f6b5f68e (button) folded before Flop (didn't bet)
Seat 2: 61dc9b78 (small blind) showed [3h 3s] and lost with Sixes Full over Treys
Seat 3: 58864a6e (big blind) folded before Flop
Seat 4: Hero showed [Tc Td] and won ($0.7) with Sixes Full over Tens
Seat 5: 11676b65 folded before Flop (didn't bet)
Seat 6: 40810c68 folded before Flop (didn't bet)


Poker Hand #RC2078507357: Hold'em No Limit ($0.02/$0.05) - 2023/12/22 21:28:16
Table 'RushAndCash788847' 6-max Seat #1 is the button
Seat 1: Hero ($5.07 in chips)
Seat 2: f6aba64b ($4.35 in chips)
Seat 3: 1f9b16cf ($5.89 in chips)
Seat 4: 7c9c11 ($5 in chips)
Seat 5: 6186df3d ($5.96 in chips)
Seat 6: f60e42f0 ($8.83 in chips)
f6aba64b: posts small blind $0.02
1f9b16cf: posts big blind $0.05
*** HOLE CARDS ***
Dealt to Hero [Ts Ah]
Dealt to f6aba64b 
Dealt to 1f9b16cf 
Dealt to 7c9c11 
Dealt to 6186df3d 
Dealt to f60e42f0 
7c9c11: folds
6186df3d: folds
f60e42f0: raises $0.08 to $0.13
Hero: calls $0.13
f6aba64b: folds
1f9b16cf: calls $0.08
*** FLOP *** [9d 4h Js]
1f9b16cf: checks
f60e42f0: checks
Hero: checks
*** TURN *** [9d 4h Js] [7d]
1f9b16cf: checks
f60e42f0: bets $0.21
Hero: folds
1f9b16cf: calls $0.21
*** RIVER *** [9d 4h Js 7d] [Tc]
1f9b16cf: checks
f60e42f0: checks
1f9b16cf: shows [Qs 8c] (Queens-High Straight)
f60e42f0: shows [Ks 7s] (Pair of Sevens)
*** SHOWDOWN ***
1f9b16cf collected $0.79 from pot
*** SUMMARY ***
Total pot $0.83 | Rake $0.04 | Jackpot $0 | Bingo $0 | Fortune $0 | Tax $0
Board [9d 4h Js 7d Tc]
Seat 1: Hero (button) folded on the Turn
Seat 2: f6aba64b (small blind) folded before Flop
Seat 3: 1f9b16cf (big blind) showed [Qs 8c] and won ($0.79) with Queens-High Straight
Seat 4: 7c9c11 folded before Flop (didn't bet)
Seat 5: 6186df3d folded before Flop (didn't bet)
Seat 6: f60e42f0 showed [Ks 7s] and lost with Pair of Sevens


Poker Hand #RC2078507149: Hold'em No Limit ($0.02/$0.05) - 2023/12/22 21:28:03
Table 'RushAndCash788755' 6-max Seat #1 is the button
Seat 1: f0040865 ($5 in chips)
Seat 2: Hero ($5.09 in chips)
Seat 3: 3091c4e7 ($5.51 in chips)
Seat 4: 5d732d5e ($5.83 in chips)
Seat 5: d020413c ($1.53 in chips)
Seat 6: 9f1bebfb ($4.93 in chips)
Hero: posts small blind $0.02
3091c4e7: posts big blind $0.05
*** HOLE CARDS ***
Dealt to f0040865 
Dealt to Hero [8h Th]
Dealt to 3091c4e7 
Dealt to 5d732d5e 
Dealt to d020413c 
Dealt to 9f1bebfb 
5d732d5e: folds
d020413c: raises $1.48 to $1.53 and is all-in
9f1bebfb: folds
f0040865: folds
Hero: folds
3091c4e7: folds
Uncalled bet ($1.48) returned to d020413c
*** SHOWDOWN ***
d020413c collected $0.12 from pot
*** SUMMARY ***
Total pot $0.12 | Rake $0 | Jackpot $0 | Bingo $0 | Fortune $0 | Tax $0
Seat 1: f0040865 (button) folded before Flop (didn't bet)
Seat 2: Hero (small blind) folded before Flop
Seat 3: 3091c4e7 (big blind) folded before Flop
Seat 4: 5d732d5e folded before Flop (didn't bet)
Seat 5: d020413c collected ($0.12)
Seat 6: 9f1bebfb folded before Flop (didn't bet)


Poker Hand #RC2078507012: Hold'em No Limit ($0.02/$0.05) - 2023/12/22 21:27:55
Table 'RushAndCash788696' 6-max Seat #1 is the button
Seat 1: 3be4aa6b ($5.19 in chips)
Seat 2: 2d19d9d1 ($5.46 in chips)
Seat 3: Hero ($5.07 in chips)
Seat 4: beea6e5f ($5.02 in chips)
Seat 5: a1dfe2ad ($10.59 in chips)
Seat 6: c44d0590 ($6.73 in chips)
2d19d9d1: posts small blind $0.02
Hero: posts big blind $0.05
*** HOLE CARDS ***
Dealt to 3be4aa6b 
Dealt to 2d19d9d1 
Dealt to Hero [9c Jh]
Dealt to beea6e5f 
Dealt to a1dfe2ad 
Dealt to c44d0590 
beea6e5f: folds
a1dfe2ad: folds
c44d0590: folds
3be4aa6b: folds
2d19d9d1: folds
Uncalled bet ($0.03) returned to Hero
*** SHOWDOWN ***
Hero collected $0.04 from pot
*** SUMMARY ***
Total pot $0.04 | Rake $0 | Jackpot $0 | Bingo $0 | Fortune $0 | Tax $0
Seat 1: 3be4aa6b (button) folded before Flop (didn't bet)
Seat 2: 2d19d9d1 (small blind) folded before Flop
Seat 3: Hero (big blind) collected ($0.04)
Seat 4: beea6e5f folded before Flop (didn't bet)
Seat 5: a1dfe2ad folded before Flop (didn't bet)
Seat 6: c44d0590 folded before Flop (didn't bet)


Poker Hand #RC2078506947: Hold'em No Limit ($0.02/$0.05) - 2023/12/22 21:27:52
Table 'RushAndCash788668' 6-max Seat #1 is the button
Seat 1: e69446ee ($9.52 in chips)
Seat 2: 5cb14769 ($5 in chips)
Seat 3: 69eae1f2 ($5 in chips)
Seat 4: Hero ($5.07 in chips)
Seat 5: 869465ff ($17.56 in chips)
Seat 6: 102e4185 ($5.94 in chips)
5cb14769: posts small blind $0.02
69eae1f2: posts big blind $0.05
*** HOLE CARDS ***
Dealt to e69446ee 
Dealt to 5cb14769 
Dealt to 69eae1f2 
Dealt to Hero [6h Kh]
Dealt to 869465ff 
Dealt to 102e4185 
Hero: folds
869465ff: folds
102e4185: folds
e69446ee: folds
5cb14769: folds
Uncalled bet ($0.03) returned to 69eae1f2
*** SHOWDOWN ***
69eae1f2 collected $0.04 from pot
*** SUMMARY ***
Total pot $0.04 | Rake $0 | Jackpot $0 | Bingo $0 | Fortune $0 | Tax $0
Seat 1: e69446ee (button) folded before Flop (didn't bet)
Seat 2: 5cb14769 (small blind) folded before Flop
Seat 3: 69eae1f2 (big blind) collected ($0.04)
Seat 4: Hero folded before Flop (didn't bet)
Seat 5: 869465ff folded before Flop (didn't bet)
Seat 6: 102e4185 folded before Flop (didn't bet)


Poker Hand #RC2078506853: Hold'em No Limit ($0.02/$0.05) - 2023/12/22 21:27:46
Table 'RushAndCash788626' 6-max Seat #1 is the button
Seat 1: 22751e36 ($6.46 in chips)
Seat 2: a61e93fb ($9.71 in chips)
Seat 3: d0b2d784 ($8.86 in chips)
Seat 4: 605ca6ae ($12.34 in chips)
Seat 5: Hero ($5.07 in chips)
Seat 6: f6f7aa18 ($5.1 in chips)
a61e93fb: posts small blind $0.02
d0b2d784: posts big blind $0.05
*** HOLE CARDS ***
Dealt to 22751e36 
Dealt to a61e93fb 
Dealt to d0b2d784 
Dealt to 605ca6ae 
Dealt to Hero [5h 6h]
Dealt to f6f7aa18 
605ca6ae: raises $0.06 to $0.11
Hero: folds
f6f7aa18: folds
22751e36: calls $0.11
a61e93fb: folds
d0b2d784: folds
*** FLOP *** [9d 8h Tc]
605ca6ae: checks
22751e36: bets $0.15
605ca6ae: raises $0.45 to $0.6
22751e36: raises $5.75 to $6.35 and is all-in
605ca6ae: folds
Uncalled bet ($5.75) returned to 22751e36
*** SHOWDOWN ***
22751e36 collected $1.42 from pot
*** SUMMARY ***
Total pot $1.49 | Rake $0.07 | Jackpot $0 | Bingo $0 | Fortune $0 | Tax $0
Board [9d 8h Tc]
Seat 1: 22751e36 (button) won ($1.42)
Seat 2: a61e93fb (small blind) folded before Flop
Seat 3: d0b2d784 (big blind) folded before Flop
Seat 4: 605ca6ae folded on the Flop
Seat 5: Hero folded before Flop (didn't bet)
Seat 6: f6f7aa18 folded before Flop (didn't bet)


Poker Hand #RC2078506570: Hold'em No Limit ($0.02/$0.05) - 2023/12/22 21:27:30
Table 'RushAndCash788496' 6-max Seat #1 is the button
Seat 1: aa6d4c49 ($15.63 in chips)
Seat 2: 37863cfe ($5.53 in chips)
Seat 3: 360d3b25 ($6.23 in chips)
Seat 4: Hero ($5 in chips)
Seat 5: 42e18915 ($4.67 in chips)
Seat 6: 4c691fe1 ($4.75 in chips)
37863cfe: posts small blind $0.02
360d3b25: posts big blind $0.05
*** HOLE CARDS ***
Dealt to aa6d4c49 
Dealt to 37863cfe 
Dealt to 360d3b25 
Dealt to Hero [As Jc]
Dealt to 42e18915 
Dealt to 4c691fe1 
Hero: raises $0.05 to $0.1
42e18915: folds
4c691fe1: folds
aa6d4c49: folds
37863cfe: folds
360d3b25: folds
Uncalled bet ($0.05) returned to Hero
*** SHOWDOWN ***
Hero collected $0.12 from pot
*** SUMMARY ***
Total pot $0.12 | Rake $0 | Jackpot $0 | Bingo $0 | Fortune $0 | Tax $0
Seat 1: aa6d4c49 (button) folded before Flop (didn't bet)
Seat 2: 37863cfe (small blind) folded before Flop
Seat 3: 360d3b25 (big blind) folded before Flop
Seat 4: Hero collected ($0.12)
Seat 5: 42e18915 folded before Flop (didn't bet)
Seat 6: 4c691fe1 folded before Flop (didn't bet)


Poker Hand #RC2078506501: Hold'em No Limit ($0.02/$0.05) - 2023/12/22 21:27:26
Table 'RushAndCash788463' 6-max Seat #1 is the button
Seat 1: Hero ($5 in chips)
Seat 2: 294d35ce ($17.17 in chips)
Seat 3: 45392e2c ($17.92 in chips)
Seat 4: d2739eda ($4.22 in chips)
Seat 5: 779c14aa ($5.07 in chips)
Seat 6: 3a9b3c34 ($3.36 in chips)
294d35ce: posts small blind $0.02
45392e2c: posts big blind $0.05
*** HOLE CARDS ***
Dealt to Hero [3c 9h]
Dealt to 294d35ce 
Dealt to 45392e2c 
Dealt to d2739eda 
Dealt to 779c14aa 
Dealt to 3a9b3c34 
d2739eda: folds
779c14aa: folds
3a9b3c34: raises $0.07 to $0.12
Hero: folds
294d35ce: folds
45392e2c: calls $0.07
*** FLOP *** [As 5h Qc]
45392e2c: checks
3a9b3c34: checks
*** TURN *** [As 5h Qc] [Qs]
45392e2c: checks
3a9b3c34: bets $0.07
45392e2c: calls $0.07
*** RIVER *** [As 5h Qc Qs] [9d]
45392e2c: checks
3a9b3c34: checks
45392e2c: shows [3h Ah] (Pair of Aces and Pair of Queens)
3a9b3c34: shows [Jc 8c] (Pair of Queens)
*** SHOWDOWN ***
45392e2c collected $0.38 from pot
*** SUMMARY ***
Total pot $0.4 | Rake $0.02 | Jackpot $0 | Bingo $0 | Fortune $0 | Tax $0
Board [As 5h Qc Qs 9d]
Seat 1: Hero (button) folded before Flop (didn't bet)
Seat 2: 294d35ce (small blind) folded before Flop
Seat 3: 45392e2c (big blind) showed [3h Ah] and won ($0.38) with Pair of Aces and Pair of Queens
Seat 4: d2739eda folded before Flop (didn't bet)
Seat 5: 779c14aa folded before Flop (didn't bet)
Seat 6: 3a9b3c34 showed [Jc 8c] and lost with Pair of Queens


Poker Hand #RC2078506283: Hold'em No Limit ($0.02/$0.05) - 2023/12/22 21:27:13
Table 'RushAndCash788360' 6-max Seat #1 is the button
Seat 1: 1719c1d9 ($6.18 in chips)
Seat 2: Hero ($5 in chips)
Seat 3: 9e1809b2 ($3.84 in chips)
Seat 4: d45bc7f3 ($7.1 in chips)
Seat 5: ad0bb92a ($4.67 in chips)
Seat 6: 6ffefba2 ($6.02 in chips)
Hero: posts small blind $0.02
9e1809b2: posts big blind $0.05
*** HOLE CARDS ***
Dealt to 1719c1d9 
Dealt to Hero [3d Js]
Dealt to 9e1809b2 
Dealt to d45bc7f3 
Dealt to ad0bb92a 
Dealt to 6ffefba2 
d45bc7f3: raises $0.06 to $0.11
ad0bb92a: calls $0.11
6ffefba2: folds
1719c1d9: calls $0.11
Hero: folds
9e1809b2: folds
*** FLOP *** [9s 4s 5h]
d45bc7f3: checks
ad0bb92a: checks
1719c1d9: bets $0.28
d45bc7f3: folds
ad0bb92a: folds
Uncalled bet ($0.28) returned to 1719c1d9
*** SHOWDOWN ***
1719c1d9 collected $0.38 from pot
*** SUMMARY ***
Total pot $0.4 | Rake $0.02 | Jackpot $0 | Bingo $0 | Fortune $0 | Tax $0
Board [9s 4s 5h]
Seat 1: 1719c1d9 (button) won ($0.38)
Seat 2: Hero (small blind) folded before Flop
Seat 3: 9e1809b2 (big blind) folded before Flop
Seat 4: d45bc7f3 folded on the Flop
Seat 5: ad0bb92a folded on the Flop
Seat 6: 6ffefba2 folded before Flop (didn't bet)


Poker Hand #RC2078505999: Hold'em No Limit ($0.02/$0.05) - 2023/12/22 21:26:56
Table 'RushAndCash788229' 6-max Seat #1 is the button
Seat 1: 9119f364 ($4.09 in chips)
Seat 2: 13f0d1ae ($2.64 in chips)
Seat 3: Hero ($5 in chips)
Seat 4: 26ab7735 ($5.02 in chips)
Seat 5: 4c691fe1 ($4.82 in chips)
Seat 6: a638a3a8 ($7.59 in chips)
13f0d1ae: posts small blind $0.02
Hero: posts big blind $0.05
*** HOLE CARDS ***
Dealt to 9119f364 
Dealt to 13f0d1ae 
Dealt to Hero [Td 4d]
Dealt to 26ab7735 
Dealt to 4c691fe1 
Dealt to a638a3a8 
26ab7735: folds
4c691fe1: folds
a638a3a8: folds
9119f364: raises $0.09 to $0.14
13f0d1ae: calls $0.12
Hero: folds
*** FLOP *** [7s Qd Ac]
13f0d1ae: checks
9119f364: bets $0.11
13f0d1ae: folds
Uncalled bet ($0.11) returned to 9119f364
*** SHOWDOWN ***
9119f364 collected $0.32 from pot
*** SUMMARY ***
Total pot $0.33 | Rake $0.01 | Jackpot $0 | Bingo $0 | Fortune $0 | Tax $0
Board [7s Qd Ac]
Seat 1: 9119f364 (button) won ($0.32)
Seat 2: 13f0d1ae (small blind) folded on the Flop
Seat 3: Hero (big blind) folded before Flop
Seat 4: 26ab7735 folded before Flop (didn't bet)
Seat 5: 4c691fe1 folded before Flop (didn't bet)
Seat 6: a638a3a8 folded before Flop (didn't bet)


Poker Hand #RC2078505820: Hold'em No Limit ($0.02/$0.05) - 2023/12/22 21:26:46
Table 'RushAndCash788144' 6-max Seat #1 is the button
Seat 1: c15106a4 ($4.98 in chips)
Seat 2: 697fb04a ($46.93 in chips)
Seat 3: 18a5c767 ($5.02 in chips)
Seat 4: Hero ($5 in chips)
Seat 5: d2e52b8d ($19.31 in chips)
Seat 6: 67297113 ($5.15 in chips)
697fb04a: posts small blind $0.02
18a5c767: posts big blind $0.05
*** HOLE CARDS ***
Dealt to c15106a4 
Dealt to 697fb04a 
Dealt to 18a5c767 
Dealt to Hero [Jc 2c]
Dealt to d2e52b8d 
Dealt to 67297113 
Hero: folds
d2e52b8d: raises $0.05 to $0.1
67297113: folds
c15106a4: folds
697fb04a: folds
18a5c767: calls $0.05
*** FLOP *** [Kh Td Ks]
18a5c767: checks
d2e52b8d: bets $0.05
18a5c767: raises $0.2 to $0.25
d2e52b8d: calls $0.2
*** TURN *** [Kh Td Ks] [4s]
18a5c767: checks
d2e52b8d: checks
*** RIVER *** [Kh Td Ks 4s] [7d]
18a5c767: checks
d2e52b8d: bets $0.75
18a5c767: folds
Uncalled bet ($0.75) returned to d2e52b8d
*** SHOWDOWN ***
d2e52b8d collected $0.69 from pot
*** SUMMARY ***
Total pot $0.72 | Rake $0.03 | Jackpot $0 | Bingo $0 | Fortune $0 | Tax $0
Board [Kh Td Ks 4s 7d]
Seat 1: c15106a4 (button) folded before Flop (didn't bet)
Seat 2: 697fb04a (small blind) folded before Flop
Seat 3: 18a5c767 (big blind) folded on the River
Seat 4: Hero folded before Flop (didn't bet)
Seat 5: d2e52b8d won ($0.69)
Seat 6: 67297113 folded before Flop (didn't bet)


Poker Hand #RC2078505752: Hold'em No Limit ($0.02/$0.05) - 2023/12/22 21:26:42
Table 'RushAndCash788113' 6-max Seat #1 is the button
Seat 1: 56c183ba ($4.93 in chips)
Seat 2: f6f7aa18 ($5.22 in chips)
Seat 3: ee1f67f7 ($5.33 in chips)
Seat 4: 3056048f ($5.67 in chips)
Seat 5: 23800d75 ($6.93 in chips)
Seat 6: Hero ($5 in chips)
f6f7aa18: posts small blind $0.02
ee1f67f7: posts big blind $0.05
*** HOLE CARDS ***
Dealt to 56c183ba 
Dealt to f6f7aa18 
Dealt to ee1f67f7 
Dealt to 3056048f 
Dealt to 23800d75 
Dealt to Hero [2s Qd]
3056048f: raises $0.06 to $0.11
23800d75: folds
Hero: folds
56c183ba: folds
f6f7aa18: folds
ee1f67f7: folds
Uncalled bet ($0.06) returned to 3056048f
*** SHOWDOWN ***
3056048f collected $0.12 from pot
*** SUMMARY ***
Total pot $0.12 | Rake $0 | Jackpot $0 | Bingo $0 | Fortune $0 | Tax $0
Seat 1: 56c183ba (button) folded before Flop (didn't bet)
Seat 2: f6f7aa18 (small blind) folded before Flop
Seat 3: ee1f67f7 (big blind) folded before Flop
Seat 4: 3056048f collected ($0.12)
Seat 5: 23800d75 folded before Flop (didn't bet)
Seat 6: Hero folded before Flop (didn't bet)


Poker Hand #RC2078505658: Hold'em No Limit ($0.02/$0.05) - 2023/12/22 21:26:37
Table 'RushAndCash788071' 6-max Seat #1 is the button
Seat 1: 311eeba4 ($12.51 in chips)
Seat 2: 5d732d5e ($6.55 in chips)
Seat 3: 373bc096 ($5.05 in chips)
Seat 4: 91937678 ($4.93 in chips)
Seat 5: c9dcc850 ($7.55 in chips)
Seat 6: Hero ($5 in chips)
5d732d5e: posts small blind $0.02
373bc096: posts big blind $0.05
*** HOLE CARDS ***
Dealt to 311eeba4 
Dealt to 5d732d5e 
Dealt to 373bc096 
Dealt to 91937678 
Dealt to c9dcc850 
Dealt to Hero [3d Js]
91937678: folds
c9dcc850: raises $0.06 to $0.11
Hero: folds
311eeba4: folds
5d732d5e: folds
373bc096: folds
Uncalled bet ($0.06) returned to c9dcc850
*** SHOWDOWN ***
c9dcc850 collected $0.12 from pot
*** SUMMARY ***
Total pot $0.12 | Rake $0 | Jackpot $0 | Bingo $0 | Fortune $0 | Tax $0
Seat 1: 311eeba4 (button) folded before Flop (didn't bet)
Seat 2: 5d732d5e (small blind) folded before Flop
Seat 3: 373bc096 (big blind) folded before Flop
Seat 4: 91937678 folded before Flop (didn't bet)
Seat 5: c9dcc850 collected ($0.12)
Seat 6: Hero folded before Flop (didn't bet)


Poker Hand #RC2078505505: Hold'em No Limit ($0.02/$0.05) - 2023/12/22 21:26:28
Table 'RushAndCash788000' 6-max Seat #1 is the button
Seat 1: Hero ($5 in chips)
Seat 2: 84d4f92c ($6.02 in chips)
Seat 3: ce1aa7a ($5.14 in chips)
Seat 4: 5d55167a ($8.89 in chips)
Seat 5: 851fc2ef ($5.68 in chips)
Seat 6: f71b25e9 ($5.91 in chips)
84d4f92c: posts small blind $0.02
ce1aa7a: posts big blind $0.05
*** HOLE CARDS ***
Dealt to Hero [Ks 7h]
Dealt to 84d4f92c 
Dealt to ce1aa7a 
Dealt to 5d55167a 
Dealt to 851fc2ef 
Dealt to f71b25e9 
5d55167a: folds
851fc2ef: raises $0.08 to $0.13
f71b25e9: folds
Hero: folds
84d4f92c: folds
ce1aa7a: folds
Uncalled bet ($0.08) returned to 851fc2ef
*** SHOWDOWN ***
851fc2ef collected $0.12 from pot
*** SUMMARY ***
Total pot $0.12 | Rake $0 | Jackpot $0 | Bingo $0 | Fortune $0 | Tax $0
Seat 1: Hero (button) folded before Flop (didn't bet)
Seat 2: 84d4f92c (small blind) folded before Flop
Seat 3: ce1aa7a (big blind) folded before Flop
Seat 4: 5d55167a folded before Flop (didn't bet)
Seat 5: 851fc2ef collected ($0.12)
Seat 6: f71b25e9 folded before Flop (didn't bet)


Poker Hand #RC2078505406: Hold'em No Limit ($0.02/$0.05) - 2023/12/22 21:26:23
Table 'RushAndCash787953' 6-max Seat #1 is the button
Seat 1: e5b5763b ($6.87 in chips)
Seat 2: Hero ($5.02 in chips)
Seat 3: 59ef18cb ($1.69 in chips)
Seat 4: 97e7da6 ($5.98 in chips)
Seat 5: ee1f67f7 ($5.38 in chips)
Seat 6: 220b0aae ($11.21 in chips)
Hero: posts small blind $0.02
59ef18cb: posts big blind $0.05
*** HOLE CARDS ***
Dealt to e5b5763b 
Dealt to Hero [Td 5d]
Dealt to 59ef18cb 
Dealt to 97e7da6 
Dealt to ee1f67f7 
Dealt to 220b0aae 
97e7da6: folds
ee1f67f7: folds
220b0aae: folds
e5b5763b: folds
Hero: folds
Uncalled bet ($0.03) returned to 59ef18cb
*** SHOWDOWN ***
59ef18cb collected $0.04 from pot
*** SUMMARY ***
Total pot $0.04 | Rake $0 | Jackpot $0 | Bingo $0 | Fortune $0 | Tax $0
Seat 1: e5b5763b (button) folded before Flop (didn't bet)
Seat 2: Hero (small blind) folded before Flop
Seat 3: 59ef18cb (big blind) collected ($0.04)
Seat 4: 97e7da6 folded before Flop (didn't bet)
Seat 5: ee1f67f7 folded before Flop (didn't bet)
Seat 6: 220b0aae folded before Flop (didn't bet)


Poker Hand #RC2078505278: Hold'em No Limit ($0.02/$0.05) - 2023/12/22 21:26:16
Table 'RushAndCash787893' 6-max Seat #1 is the button
Seat 1: 3df6f82d ($1.71 in chips)
Seat 2: 55f8abbc ($8.24 in chips)
Seat 3: Hero ($5 in chips)
Seat 4: 294d35ce ($17.17 in chips)
Seat 5: d2e52b8d ($19.46 in chips)
Seat 6: 91937678 ($4.93 in chips)
55f8abbc: posts small blind $0.02
Hero: posts big blind $0.05
*** HOLE CARDS ***
Dealt to 3df6f82d 
Dealt to 55f8abbc 
Dealt to Hero [Ks Js]
Dealt to 294d35ce 
Dealt to d2e52b8d 
Dealt to 91937678 
294d35ce: folds
d2e52b8d: folds
91937678: folds
3df6f82d: folds
55f8abbc: folds
Uncalled bet ($0.03) returned to Hero
*** SHOWDOWN ***
Hero collected $0.04 from pot
*** SUMMARY ***
Total pot $0.04 | Rake $0 | Jackpot $0 | Bingo $0 | Fortune $0 | Tax $0
Seat 1: 3df6f82d (button) folded before Flop (didn't bet)
Seat 2: 55f8abbc (small blind) folded before Flop
Seat 3: Hero (big blind) collected ($0.04)
Seat 4: 294d35ce folded before Flop (didn't bet)
Seat 5: d2e52b8d folded before Flop (didn't bet)
Seat 6: 91937678 folded before Flop (didn't bet)


Poker Hand #RC2078505202: Hold'em No Limit ($0.02/$0.05) - 2023/12/22 21:26:12
Table 'RushAndCash787858' 6-max Seat #1 is the button
Seat 1: 3d929f9f ($8.13 in chips)
Seat 2: 52f74b76 ($6.37 in chips)
Seat 3: a2ebb3c7 ($5.31 in chips)
Seat 4: Hero ($5 in chips)
Seat 5: 3dc18159 ($6.99 in chips)
Seat 6: 4fcbfbdc ($9.68 in chips)
52f74b76: posts small blind $0.02
a2ebb3c7: posts big blind $0.05
*** HOLE CARDS ***
Dealt to 3d929f9f 
Dealt to 52f74b76 
Dealt to a2ebb3c7 
Dealt to Hero [Ts 9h]
Dealt to 3dc18159 
Dealt to 4fcbfbdc 
Hero: folds
3dc18159: folds
4fcbfbdc: folds
3d929f9f: folds
52f74b76: folds
Uncalled bet ($0.03) returned to a2ebb3c7
*** SHOWDOWN ***
a2ebb3c7 collected $0.04 from pot
*** SUMMARY ***
Total pot $0.04 | Rake $0 | Jackpot $0 | Bingo $0 | Fortune $0 | Tax $0
Seat 1: 3d929f9f (button) folded before Flop (didn't bet)
Seat 2: 52f74b76 (small blind) folded before Flop
Seat 3: a2ebb3c7 (big blind) collected ($0.04)
Seat 4: Hero folded before Flop (didn't bet)
Seat 5: 3dc18159 folded before Flop (didn't bet)
Seat 6: 4fcbfbdc folded before Flop (didn't bet)


Poker Hand #RC2078505050: Hold'em No Limit ($0.02/$0.05) - 2023/12/22 21:26:03
Table 'RushAndCash787782' 6-max Seat #1 is the button
Seat 1: 7418c0c4 ($5.44 in chips)
Seat 2: 93b1a4e4 ($10.64 in chips)
Seat 3: 1f9b16cf ($5.57 in chips)
Seat 4: 4b46876e ($8.22 in chips)
Seat 5: Hero ($5 in chips)
Seat 6: fffa524d ($5 in chips)
93b1a4e4: posts small blind $0.02
1f9b16cf: posts big blind $0.05
*** HOLE CARDS ***
Dealt to 7418c0c4 
Dealt to 93b1a4e4 
Dealt to 1f9b16cf 
Dealt to 4b46876e 
Dealt to Hero [Tc 8c]
Dealt to fffa524d 
4b46876e: folds
Hero: folds
fffa524d: folds
7418c0c4: raises $0.07 to $0.12
93b1a4e4: folds
1f9b16cf: raises $0.33 to $0.45
7418c0c4: folds
Uncalled bet ($0.33) returned to 1f9b16cf
*** SHOWDOWN ***
1f9b16cf collected $0.25 from pot
*** SUMMARY ***
Total pot $0.26 | Rake $0.01 | Jackpot $0 | Bingo $0 | Fortune $0 | Tax $0
Seat 1: 7418c0c4 (button) folded before Flop
Seat 2: 93b1a4e4 (small blind) folded before Flop
Seat 3: 1f9b16cf (big blind) collected ($0.25)
Seat 4: 4b46876e folded before Flop (didn't bet)
Seat 5: Hero folded before Flop (didn't bet)
Seat 6: fffa524d folded before Flop (didn't bet)


Poker Hand #RC2078504986: Hold'em No Limit ($0.02/$0.05) - 2023/12/22 21:26:00
Table 'RushAndCash787749' 6-max Seat #1 is the button
Seat 1: cd339031 ($8 in chips)
Seat 2: 22818fb2 ($8.09 in chips)
Seat 3: 2c88a657 ($5.47 in chips)
Seat 4: Hero ($5 in chips)
Seat 5: c6bf1d22 ($13.14 in chips)
Seat 6: 7c950e30 ($9.03 in chips)
22818fb2: posts small blind $0.02
2c88a657: posts big blind $0.05
*** HOLE CARDS ***
Dealt to cd339031 
Dealt to 22818fb2 
Dealt to 2c88a657 
Dealt to Hero [9d 3h]
Dealt to c6bf1d22 
Dealt to 7c950e30 
Hero: folds
c6bf1d22: raises $0.06 to $0.11
7c950e30: folds
cd339031: folds
22818fb2: folds
2c88a657: calls $0.06
*** FLOP *** [3c Js 4c]
2c88a657: checks
c6bf1d22: checks
*** TURN *** [3c Js 4c] [8h]
2c88a657: checks
c6bf1d22: checks
*** RIVER *** [3c Js 4c 8h] [2d]
2c88a657: checks
c6bf1d22: checks
2c88a657: shows [8d 6h] (Pair of Eights)
c6bf1d22: shows [Qh Th] (Queen-High)
*** SHOWDOWN ***
2c88a657 collected $0.23 from pot
*** SUMMARY ***
Total pot $0.24 | Rake $0.01 | Jackpot $0 | Bingo $0 | Fortune $0 | Tax $0
Board [3c Js 4c 8h 2d]
Seat 1: cd339031 (button) folded before Flop (didn't bet)
Seat 2: 22818fb2 (small blind) folded before Flop
Seat 3: 2c88a657 (big blind) showed [8d 6h] and won ($0.23) with Pair of Eights
Seat 4: Hero folded before Flop (didn't bet)
Seat 5: c6bf1d22 showed [Qh Th] and lost with Queen-High
Seat 6: 7c950e30 folded before Flop (didn't bet)


Poker Hand #RC2078504915: Hold'em No Limit ($0.02/$0.05) - 2023/12/22 21:25:56
Table 'RushAndCash787714' 6-max Seat #1 is the button
Seat 1: 697fb04a ($47.03 in chips)
Seat 2: edb6154b ($6.58 in chips)
Seat 3: f266e6e1 ($1.35 in chips)
Seat 4: Hero ($5 in chips)
Seat 5: 6ff1e240 ($9.3 in chips)
Seat 6: 257cb6ea ($5.04 in chips)
edb6154b: posts small blind $0.02
f266e6e1: posts big blind $0.05
*** HOLE CARDS ***
Dealt to 697fb04a 
Dealt to edb6154b 
Dealt to f266e6e1 
Dealt to Hero [6d 8d]
Dealt to 6ff1e240 
Dealt to 257cb6ea 
Hero: folds
6ff1e240: folds
257cb6ea: folds
697fb04a: raises $0.05 to $0.1
edb6154b: raises $0.45 to $0.55
f266e6e1: folds
697fb04a: folds
Uncalled bet ($0.45) returned to edb6154b
*** SHOWDOWN ***
edb6154b collected $0.24 from pot
*** SUMMARY ***
Total pot $0.25 | Rake $0.01 | Jackpot $0 | Bingo $0 | Fortune $0 | Tax $0
Seat 1: 697fb04a (button) folded before Flop
Seat 2: edb6154b (small blind) collected ($0.24)
Seat 3: f266e6e1 (big blind) folded before Flop
Seat 4: Hero folded before Flop (didn't bet)
Seat 5: 6ff1e240 folded before Flop (didn't bet)
Seat 6: 257cb6ea folded before Flop (didn't bet)


Poker Hand #RC2078504839: Hold'em No Limit ($0.02/$0.05) - 2023/12/22 21:25:51
Table 'RushAndCash787676' 6-max Seat #1 is the button
Seat 1: Hero ($5 in chips)
Seat 2: 6c7c67da ($5 in chips)
Seat 3: a638a3a8 ($7.5 in chips)
Seat 4: 1259a422 ($5.46 in chips)
Seat 5: 7af43182 ($5.32 in chips)
Seat 6: ffe24a9e ($5.17 in chips)
6c7c67da: posts small blind $0.02
a638a3a8: posts big blind $0.05
*** HOLE CARDS ***
Dealt to Hero [9h 8c]
Dealt to 6c7c67da 
Dealt to a638a3a8 
Dealt to 1259a422 
Dealt to 7af43182 
Dealt to ffe24a9e 
1259a422: folds
7af43182: folds
ffe24a9e: raises $0.05 to $0.1
Hero: folds
6c7c67da: calls $0.08
a638a3a8: folds
*** FLOP *** [2h 3c 9s]
6c7c67da: checks
ffe24a9e: checks
*** TURN *** [2h 3c 9s] [9c]
6c7c67da: checks
ffe24a9e: checks
*** RIVER *** [2h 3c 9s 9c] [4d]
6c7c67da: checks
ffe24a9e: checks
6c7c67da: shows [8s Ks] (Pair of Nines)
ffe24a9e: shows [6h 8h] (Pair of Nines)
*** SHOWDOWN ***
6c7c67da collected $0.24 from pot
*** SUMMARY ***
Total pot $0.25 | Rake $0.01 | Jackpot $0 | Bingo $0 | Fortune $0 | Tax $0
Board [2h 3c 9s 9c 4d]
Seat 1: Hero (button) folded before Flop (didn't bet)
Seat 2: 6c7c67da (small blind) showed [8s Ks] and won ($0.24) with Pair of Nines
Seat 3: a638a3a8 (big blind) folded before Flop
Seat 4: 1259a422 folded before Flop (didn't bet)
Seat 5: 7af43182 folded before Flop (didn't bet)
Seat 6: ffe24a9e showed [6h 8h] and lost with Pair of Nines


Poker Hand #RC2078484612: Hold'em No Limit ($0.02/$0.05) - 2023/12/22 21:25:39
Table 'RushAndCash787573' 6-max Seat #1 is the button
Seat 1: 44681c1f ($5 in chips)
Seat 2: f71b25e9 ($5.07 in chips)
Seat 3: Hero ($5 in chips)
Seat 4: 91937678 ($4.93 in chips)
Seat 5: fc7e8623 ($5.45 in chips)
Seat 6: 38e42730 ($9.18 in chips)
f71b25e9: posts small blind $0.02
Hero: posts big blind $0.05
*** HOLE CARDS ***
Dealt to 44681c1f 
Dealt to f71b25e9 
Dealt to Hero [2d Kd]
Dealt to 91937678 
Dealt to fc7e8623 
Dealt to 38e42730 
91937678: folds
fc7e8623: folds
38e42730: folds
44681c1f: raises $0.08 to $0.13
f71b25e9: raises $0.43 to $0.56
Hero: folds
44681c1f: calls $0.43
*** FLOP *** [5h 7d Ks]
f71b25e9: bets $0.39
44681c1f: calls $0.39
*** TURN *** [5h 7d Ks] [2s]
f71b25e9: bets $0.98
44681c1f: folds
Uncalled bet ($0.98) returned to f71b25e9
*** SHOWDOWN ***
f71b25e9 collected $1.79 from pot
*** SUMMARY ***
Total pot $1.95 | Rake $0.09 | Jackpot $0.07 | Bingo $0 | Fortune $0 | Tax $0
Board [5h 7d Ks 2s]
Seat 1: 44681c1f (button) folded on the Turn
Seat 2: f71b25e9 (small blind) won ($1.79)
Seat 3: Hero (big blind) folded before Flop
Seat 4: 91937678 folded before Flop (didn't bet)
Seat 5: fc7e8623 folded before Flop (didn't bet)
Seat 6: 38e42730 folded before Flop (didn't bet)


Poker Hand #RC2078484375: Hold'em No Limit ($0.02/$0.05) - 2023/12/22 21:25:25
Table 'RushAndCash787469' 6-max Seat #1 is the button
Seat 1: 40c4a4f ($9.7 in chips)
Seat 2: Hero ($5 in chips)
Seat 3: a8629ffc ($5 in chips)
Seat 4: ad0bb92a ($4.74 in chips)
Seat 5: 801c157f ($23.33 in chips)
Seat 6: 4d8d4585 ($7.78 in chips)
Hero: posts small blind $0.02
a8629ffc: posts big blind $0.05
*** HOLE CARDS ***
Dealt to 40c4a4f 
Dealt to Hero [Kd 8d]
Dealt to a8629ffc 
Dealt to ad0bb92a 
Dealt to 801c157f 
Dealt to 4d8d4585 
ad0bb92a: folds
801c157f: raises $0.05 to $0.1
4d8d4585: folds
40c4a4f: calls $0.1
Hero: folds
a8629ffc: folds
*** FLOP *** [9h 9c 2c]
801c157f: bets $0.09
40c4a4f: folds
Uncalled bet ($0.09) returned to 801c157f
*** SHOWDOWN ***
801c157f collected $0.26 from pot
*** SUMMARY ***
Total pot $0.27 | Rake $0.01 | Jackpot $0 | Bingo $0 | Fortune $0 | Tax $0
Board [9h 9c 2c]
Seat 1: 40c4a4f (button) folded on the Flop
Seat 2: Hero (small blind) folded before Flop
Seat 3: a8629ffc (big blind) folded before Flop
Seat 4: ad0bb92a folded before Flop (didn't bet)
Seat 5: 801c157f won ($0.26)
Seat 6: 4d8d4585 folded before Flop (didn't bet)


