Poker Hand #RC2094844442: Hold'em No Limit ($0.02/$0.05) - 2023/12/27 22:15:47
Table 'RushAndCash3836058' 6-max Seat #1 is the button
Seat 1: 13a066a4 ($4.2 in chips)
Seat 2: 87bb2e36 ($5 in chips)
Seat 3: e407d343 ($4.76 in chips)
Seat 4: fe238212 ($2.34 in chips)
Seat 5: 3f587bf6 ($18.19 in chips)
Seat 6: Hero ($10.31 in chips)
87bb2e36: posts small blind $0.02
e407d343: posts big blind $0.05
*** HOLE CARDS ***
Dealt to 13a066a4 
Dealt to 87bb2e36 
Dealt to e407d343 
Dealt to fe238212 
Dealt to 3f587bf6 
Dealt to Hero [As Ad]
fe238212: folds
3f587bf6: folds
Hero: raises $0.05 to $0.1
13a066a4: raises $0.21 to $0.31
87bb2e36: folds
e407d343: folds
Hero: raises $10 to $10.31 and is all-in
13a066a4: calls $3.89 and is all-in
Uncalled bet ($6.11) returned to Hero
Hero: shows [As Ad]
13a066a4: shows [Jc Jd]
*** FLOP *** [Qh Qc 4c]
*** TURN *** [Qh Qc 4c] [Kh]
*** RIVER *** [Qh Qc 4c Kh] [Qs]
*** SHOWDOWN ***
Hero collected $8.25 from pot
*** SUMMARY ***
Total pot $8.47 | Rake $0.15 | Jackpot $0.07 | Bingo $0 | Fortune $0 | Tax $0
Board [Qh Qc 4c Kh Qs]
Seat 1: 13a066a4 (button) showed [Jc Jd] and lost with Queens Full over Jacks
Seat 2: 87bb2e36 (small blind) folded before Flop
Seat 3: e407d343 (big blind) folded before Flop
Seat 4: fe238212 folded before Flop (didn't bet)
Seat 5: 3f587bf6 folded before Flop (didn't bet)
Seat 6: Hero showed [As Ad] and won ($8.25) with Queens Full over Aces


Poker Hand #RC2094844340: Hold'em No Limit ($0.02/$0.05) - 2023/12/27 22:15:43
Table 'RushAndCash3836007' 6-max Seat #1 is the button
Seat 1: Hero ($10.31 in chips)
Seat 2: c28bae97 ($5.58 in chips)
Seat 3: 42b8649c ($6.81 in chips)
Seat 4: 1dd8423b ($6.2 in chips)
Seat 5: e11b6f8f ($18.39 in chips)
Seat 6: 24921fc1 ($5.08 in chips)
c28bae97: posts small blind $0.02
42b8649c: posts big blind $0.05
*** HOLE CARDS ***
Dealt to Hero [3d Qh]
Dealt to c28bae97 
Dealt to 42b8649c 
Dealt to 1dd8423b 
Dealt to e11b6f8f 
Dealt to 24921fc1 
1dd8423b: raises $0.05 to $0.1
e11b6f8f: folds
24921fc1: calls $0.1
Hero: folds
c28bae97: folds
42b8649c: folds
*** FLOP *** [5s 8s 6h]
1dd8423b: checks
24921fc1: checks
*** TURN *** [5s 8s 6h] [As]
1dd8423b: bets $0.21
24921fc1: folds
Uncalled bet ($0.21) returned to 1dd8423b
*** SHOWDOWN ***
1dd8423b collected $0.26 from pot
*** SUMMARY ***
Total pot $0.27 | Rake $0.01 | Jackpot $0 | Bingo $0 | Fortune $0 | Tax $0
Board [5s 8s 6h As]
Seat 1: Hero (button) folded before Flop (didn't bet)
Seat 2: c28bae97 (small blind) folded before Flop
Seat 3: 42b8649c (big blind) folded before Flop
Seat 4: 1dd8423b won ($0.26)
Seat 5: e11b6f8f folded before Flop (didn't bet)
Seat 6: 24921fc1 folded on the Turn


Poker Hand #RC2094844222: Hold'em No Limit ($0.02/$0.05) - 2023/12/27 22:15:37
Table 'RushAndCash3835949' 6-max Seat #1 is the button
Seat 1: bef73bda ($5.69 in chips)
Seat 2: c4d14388 ($5.31 in chips)
Seat 3: 915714ab ($5.23 in chips)
Seat 4: Hero ($10.31 in chips)
Seat 5: f7d792af ($11.23 in chips)
Seat 6: 6d629bd ($13.61 in chips)
c4d14388: posts small blind $0.02
915714ab: posts big blind $0.05
*** HOLE CARDS ***
Dealt to bef73bda 
Dealt to c4d14388 
Dealt to 915714ab 
Dealt to Hero [Jh 3d]
Dealt to f7d792af 
Dealt to 6d629bd 
Hero: folds
f7d792af: folds
6d629bd: raises $0.08 to $0.13
bef73bda: folds
c4d14388: folds
915714ab: folds
Uncalled bet ($0.08) returned to 6d629bd
*** SHOWDOWN ***
6d629bd collected $0.12 from pot
*** SUMMARY ***
Total pot $0.12 | Rake $0 | Jackpot $0 | Bingo $0 | Fortune $0 | Tax $0
Seat 1: bef73bda (button) folded before Flop (didn't bet)
Seat 2: c4d14388 (small blind) folded before Flop
Seat 3: 915714ab (big blind) folded before Flop
Seat 4: Hero folded before Flop (didn't bet)
Seat 5: f7d792af folded before Flop (didn't bet)
Seat 6: 6d629bd collected ($0.12)


Poker Hand #RC2094844003: Hold'em No Limit ($0.02/$0.05) - 2023/12/27 22:15:28
Table 'RushAndCash3835834' 6-max Seat #1 is the button
Seat 1: 61737da3 ($5.01 in chips)
Seat 2: aab4cc64 ($9 in chips)
Seat 3: Hero ($10.36 in chips)
Seat 4: 94d0dba4 ($4.86 in chips)
Seat 5: 5e22d2c4 ($14.92 in chips)
Seat 6: bf40740f ($5.77 in chips)
aab4cc64: posts small blind $0.02
Hero: posts big blind $0.05
*** HOLE CARDS ***
Dealt to 61737da3 
Dealt to aab4cc64 
Dealt to Hero [5c 2d]
Dealt to 94d0dba4 
Dealt to 5e22d2c4 
Dealt to bf40740f 
94d0dba4: folds
5e22d2c4: folds
bf40740f: raises $0.1 to $0.15
61737da3: folds
aab4cc64: folds
Hero: folds
Uncalled bet ($0.1) returned to bf40740f
*** SHOWDOWN ***
bf40740f collected $0.12 from pot
*** SUMMARY ***
Total pot $0.12 | Rake $0 | Jackpot $0 | Bingo $0 | Fortune $0 | Tax $0
Seat 1: 61737da3 (button) folded before Flop (didn't bet)
Seat 2: aab4cc64 (small blind) folded before Flop
Seat 3: Hero (big blind) folded before Flop
Seat 4: 94d0dba4 folded before Flop (didn't bet)
Seat 5: 5e22d2c4 folded before Flop (didn't bet)
Seat 6: bf40740f collected ($0.12)


Poker Hand #RC2094843914: Hold'em No Limit ($0.02/$0.05) - 2023/12/27 22:15:24
Table 'RushAndCash3835789' 6-max Seat #1 is the button
Seat 1: db2cb10b ($5 in chips)
Seat 2: 3c4b44b7 ($7.48 in chips)
Seat 3: bef73bda ($5.67 in chips)
Seat 4: Hero ($10.36 in chips)
Seat 5: 7a63b7cf ($6.19 in chips)
Seat 6: 3d0cb27e ($4.83 in chips)
3c4b44b7: posts small blind $0.02
bef73bda: posts big blind $0.05
*** HOLE CARDS ***
Dealt to db2cb10b 
Dealt to 3c4b44b7 
Dealt to bef73bda 
Dealt to Hero [4h Jh]
Dealt to 7a63b7cf 
Dealt to 3d0cb27e 
Hero: folds
7a63b7cf: folds
3d0cb27e: folds
db2cb10b: folds
3c4b44b7: folds
Uncalled bet ($0.03) returned to bef73bda
*** SHOWDOWN ***
bef73bda collected $0.04 from pot
*** SUMMARY ***
Total pot $0.04 | Rake $0 | Jackpot $0 | Bingo $0 | Fortune $0 | Tax $0
Seat 1: db2cb10b (button) folded before Flop (didn't bet)
Seat 2: 3c4b44b7 (small blind) folded before Flop
Seat 3: bef73bda (big blind) collected ($0.04)
Seat 4: Hero folded before Flop (didn't bet)
Seat 5: 7a63b7cf folded before Flop (didn't bet)
Seat 6: 3d0cb27e folded before Flop (didn't bet)


Poker Hand #RC2094843731: Hold'em No Limit ($0.02/$0.05) - 2023/12/27 22:15:17
Table 'RushAndCash3835694' 6-max Seat #1 is the button
Seat 1: c8fcf0e7 ($5.94 in chips)
Seat 2: 2e1c2eb ($16.33 in chips)
Seat 3: 56977ca6 ($2.61 in chips)
Seat 4: f24b7b85 ($6.6 in chips)
Seat 5: a0bd868c ($6.46 in chips)
Seat 6: Hero ($10.29 in chips)
2e1c2eb: posts small blind $0.02
56977ca6: posts big blind $0.05
*** HOLE CARDS ***
Dealt to c8fcf0e7 
Dealt to 2e1c2eb 
Dealt to 56977ca6 
Dealt to f24b7b85 
Dealt to a0bd868c 
Dealt to Hero [As Jd]
f24b7b85: folds
a0bd868c: folds
Hero: raises $0.05 to $0.1
c8fcf0e7: folds
2e1c2eb: folds
56977ca6: folds
Uncalled bet ($0.05) returned to Hero
*** SHOWDOWN ***
Hero collected $0.12 from pot
*** SUMMARY ***
Total pot $0.12 | Rake $0 | Jackpot $0 | Bingo $0 | Fortune $0 | Tax $0
Seat 1: c8fcf0e7 (button) folded before Flop (didn't bet)
Seat 2: 2e1c2eb (small blind) folded before Flop
Seat 3: 56977ca6 (big blind) folded before Flop
Seat 4: f24b7b85 folded before Flop (didn't bet)
Seat 5: a0bd868c folded before Flop (didn't bet)
Seat 6: Hero collected ($0.12)


Poker Hand #RC2094843533: Hold'em No Limit ($0.02/$0.05) - 2023/12/27 22:15:07
Table 'RushAndCash3835599' 6-max Seat #1 is the button
Seat 1: d107e328 ($5.13 in chips)
Seat 2: Hero ($10.31 in chips)
Seat 3: 62ba1d96 ($5.47 in chips)
Seat 4: 5d31ed85 ($6.93 in chips)
Seat 5: 5afcbbc7 ($8.6 in chips)
Seat 6: fbad1ce9 ($1.99 in chips)
Hero: posts small blind $0.02
62ba1d96: posts big blind $0.05
*** HOLE CARDS ***
Dealt to d107e328 
Dealt to Hero [9c Td]
Dealt to 62ba1d96 
Dealt to 5d31ed85 
Dealt to 5afcbbc7 
Dealt to fbad1ce9 
5d31ed85: folds
5afcbbc7: folds
fbad1ce9: folds
d107e328: folds
Hero: folds
Uncalled bet ($0.03) returned to 62ba1d96
*** SHOWDOWN ***
62ba1d96 collected $0.04 from pot
*** SUMMARY ***
Total pot $0.04 | Rake $0 | Jackpot $0 | Bingo $0 | Fortune $0 | Tax $0
Seat 1: d107e328 (button) folded before Flop (didn't bet)
Seat 2: Hero (small blind) folded before Flop
Seat 3: 62ba1d96 (big blind) collected ($0.04)
Seat 4: 5d31ed85 folded before Flop (didn't bet)
Seat 5: 5afcbbc7 folded before Flop (didn't bet)
Seat 6: fbad1ce9 folded before Flop (didn't bet)


Poker Hand #RC2094843459: Hold'em No Limit ($0.02/$0.05) - 2023/12/27 22:15:03
Table 'RushAndCash3835562' 6-max Seat #1 is the button
Seat 1: 899569f8 ($18.85 in chips)
Seat 2: 14483e43 ($5.32 in chips)
Seat 3: 1679c576 ($13.21 in chips)
Seat 4: d2efd8c2 ($5.76 in chips)
Seat 5: 9353f664 ($5.14 in chips)
Seat 6: Hero ($10.31 in chips)
14483e43: posts small blind $0.02
1679c576: posts big blind $0.05
*** HOLE CARDS ***
Dealt to 899569f8 
Dealt to 14483e43 
Dealt to 1679c576 
Dealt to d2efd8c2 
Dealt to 9353f664 
Dealt to Hero [Kd 7c]
d2efd8c2: folds
9353f664: folds
Hero: folds
899569f8: folds
14483e43: folds
Uncalled bet ($0.03) returned to 1679c576
*** SHOWDOWN ***
1679c576 collected $0.04 from pot
*** SUMMARY ***
Total pot $0.04 | Rake $0 | Jackpot $0 | Bingo $0 | Fortune $0 | Tax $0
Seat 1: 899569f8 (button) folded before Flop (didn't bet)
Seat 2: 14483e43 (small blind) folded before Flop
Seat 3: 1679c576 (big blind) collected ($0.04)
Seat 4: d2efd8c2 folded before Flop (didn't bet)
Seat 5: 9353f664 folded before Flop (didn't bet)
Seat 6: Hero folded before Flop (didn't bet)


Poker Hand #RC2094843384: Hold'em No Limit ($0.02/$0.05) - 2023/12/27 22:14:59
Table 'RushAndCash3835523' 6-max Seat #1 is the button
Seat 1: Hero ($10.31 in chips)
Seat 2: 2b0178d8 ($5.66 in chips)
Seat 3: 899569f8 ($18.9 in chips)
Seat 4: 14483e43 ($5.32 in chips)
Seat 5: 55008161 ($7.53 in chips)
Seat 6: 3f656d80 ($5.06 in chips)
2b0178d8: posts small blind $0.02
899569f8: posts big blind $0.05
*** HOLE CARDS ***
Dealt to Hero [Jh 7d]
Dealt to 2b0178d8 
Dealt to 899569f8 
Dealt to 14483e43 
Dealt to 55008161 
Dealt to 3f656d80 
14483e43: folds
55008161: raises $0.05 to $0.1
3f656d80: folds
Hero: folds
2b0178d8: folds
899569f8: folds
Uncalled bet ($0.05) returned to 55008161
*** SHOWDOWN ***
55008161 collected $0.12 from pot
*** SUMMARY ***
Total pot $0.12 | Rake $0 | Jackpot $0 | Bingo $0 | Fortune $0 | Tax $0
Seat 1: Hero (button) folded before Flop (didn't bet)
Seat 2: 2b0178d8 (small blind) folded before Flop
Seat 3: 899569f8 (big blind) folded before Flop
Seat 4: 14483e43 folded before Flop (didn't bet)
Seat 5: 55008161 collected ($0.12)
Seat 6: 3f656d80 folded before Flop (didn't bet)


Poker Hand #RC2094843308: Hold'em No Limit ($0.02/$0.05) - 2023/12/27 22:14:56
Table 'RushAndCash3835487' 6-max Seat #1 is the button
Seat 1: Hero ($10.31 in chips)
Seat 2: f05dee9b ($7.04 in chips)
Seat 3: 1f27167 ($2.91 in chips)
Seat 4: 78123e35 ($27.96 in chips)
Seat 5: a0bd868c ($6.48 in chips)
Seat 6: 55008161 ($7.53 in chips)
f05dee9b: posts small blind $0.02
1f27167: posts big blind $0.05
*** HOLE CARDS ***
Dealt to Hero [6c Ts]
Dealt to f05dee9b 
Dealt to 1f27167 
Dealt to 78123e35 
Dealt to a0bd868c 
Dealt to 55008161 
78123e35: raises $0.05 to $0.1
a0bd868c: folds
55008161: folds
Hero: folds
f05dee9b: folds
1f27167: folds
Uncalled bet ($0.05) returned to 78123e35
*** SHOWDOWN ***
78123e35 collected $0.12 from pot
*** SUMMARY ***
Total pot $0.12 | Rake $0 | Jackpot $0 | Bingo $0 | Fortune $0 | Tax $0
Seat 1: Hero (button) folded before Flop (didn't bet)
Seat 2: f05dee9b (small blind) folded before Flop
Seat 3: 1f27167 (big blind) folded before Flop
Seat 4: 78123e35 collected ($0.12)
Seat 5: a0bd868c folded before Flop (didn't bet)
Seat 6: 55008161 folded before Flop (didn't bet)


Poker Hand #RC2094843229: Hold'em No Limit ($0.02/$0.05) - 2023/12/27 22:14:52
Table 'RushAndCash3835447' 6-max Seat #1 is the button
Seat 1: ff5a5c5b ($4.68 in chips)
Seat 2: 84f0c36 ($5 in chips)
Seat 3: 44d00ada ($2.45 in chips)
Seat 4: c237804a ($5 in chips)
Seat 5: edafcfad ($9.67 in chips)
Seat 6: Hero ($10.31 in chips)
84f0c36: posts small blind $0.02
44d00ada: posts big blind $0.05
*** HOLE CARDS ***
Dealt to ff5a5c5b 
Dealt to 84f0c36 
Dealt to 44d00ada 
Dealt to c237804a 
Dealt to edafcfad 
Dealt to Hero [3c 8s]
c237804a: raises $0.1 to $0.15
edafcfad: folds
Hero: folds
ff5a5c5b: folds
84f0c36: folds
44d00ada: folds
Uncalled bet ($0.1) returned to c237804a
*** SHOWDOWN ***
c237804a collected $0.12 from pot
*** SUMMARY ***
Total pot $0.12 | Rake $0 | Jackpot $0 | Bingo $0 | Fortune $0 | Tax $0
Seat 1: ff5a5c5b (button) folded before Flop (didn't bet)
Seat 2: 84f0c36 (small blind) folded before Flop
Seat 3: 44d00ada (big blind) folded before Flop
Seat 4: c237804a collected ($0.12)
Seat 5: edafcfad folded before Flop (didn't bet)
Seat 6: Hero folded before Flop (didn't bet)


Poker Hand #RC2094843143: Hold'em No Limit ($0.02/$0.05) - 2023/12/27 22:14:49
Table 'RushAndCash3835404' 6-max Seat #1 is the button
Seat 1: d5e6701e ($2.97 in chips)
Seat 2: 3fefe89c ($4.51 in chips)
Seat 3: 49066cb ($5 in chips)
Seat 4: 4329ea35 ($2.19 in chips)
Seat 5: Hero ($10.31 in chips)
Seat 6: ed2c1b45 ($8.59 in chips)
3fefe89c: posts small blind $0.02
49066cb: posts big blind $0.05
*** HOLE CARDS ***
Dealt to d5e6701e 
Dealt to 3fefe89c 
Dealt to 49066cb 
Dealt to 4329ea35 
Dealt to Hero [Kd 5h]
Dealt to ed2c1b45 
4329ea35: folds
Hero: folds
ed2c1b45: raises $0.05 to $0.1
d5e6701e: calls $0.1
3fefe89c: raises $0.46 to $0.56
49066cb: folds
ed2c1b45: folds
d5e6701e: folds
Uncalled bet ($0.46) returned to 3fefe89c
*** SHOWDOWN ***
3fefe89c collected $0.34 from pot
*** SUMMARY ***
Total pot $0.35 | Rake $0.01 | Jackpot $0 | Bingo $0 | Fortune $0 | Tax $0
Seat 1: d5e6701e (button) folded before Flop
Seat 2: 3fefe89c (small blind) collected ($0.34)
Seat 3: 49066cb (big blind) folded before Flop
Seat 4: 4329ea35 folded before Flop (didn't bet)
Seat 5: Hero folded before Flop (didn't bet)
Seat 6: ed2c1b45 folded before Flop


Poker Hand #RC2094842137: Hold'em No Limit ($0.02/$0.05) - 2023/12/27 22:14:03
Table 'RushAndCash3834914' 6-max Seat #1 is the button
Seat 1: 928be40e ($6.18 in chips)
Seat 2: d5e6701e ($2.58 in chips)
Seat 3: Hero ($10.42 in chips)
Seat 4: 55b00465 ($7.66 in chips)
Seat 5: 1d555d84 ($10.33 in chips)
Seat 6: 93b2065f ($5.99 in chips)
d5e6701e: posts small blind $0.02
Hero: posts big blind $0.05
*** HOLE CARDS ***
Dealt to 928be40e 
Dealt to d5e6701e 
Dealt to Hero [Th Jh]
Dealt to 55b00465 
Dealt to 1d555d84 
Dealt to 93b2065f 
55b00465: folds
1d555d84: folds
93b2065f: raises $0.06 to $0.11
928be40e: folds
d5e6701e: calls $0.09
Hero: calls $0.06
*** FLOP *** [As Qc Jc]
d5e6701e: checks
Hero: checks
93b2065f: checks
*** TURN *** [As Qc Jc] [Ah]
d5e6701e: checks
Hero: checks
93b2065f: bets $0.2
d5e6701e: calls $0.2
Hero: folds
*** RIVER *** [As Qc Jc Ah] [6h]
d5e6701e: checks
93b2065f: checks
d5e6701e: shows [6d Ad] (Aces Full over Sixes)
93b2065f: shows [8c 7c] (Pair of Aces)
*** SHOWDOWN ***
d5e6701e collected $0.7 from pot
*** SUMMARY ***
Total pot $0.73 | Rake $0.03 | Jackpot $0 | Bingo $0 | Fortune $0 | Tax $0
Board [As Qc Jc Ah 6h]
Seat 1: 928be40e (button) folded before Flop (didn't bet)
Seat 2: d5e6701e (small blind) showed [6d Ad] and won ($0.7) with Aces Full over Sixes
Seat 3: Hero (big blind) folded on the Turn
Seat 4: 55b00465 folded before Flop (didn't bet)
Seat 5: 1d555d84 folded before Flop (didn't bet)
Seat 6: 93b2065f showed [8c 7c] and lost with Pair of Aces


Poker Hand #RC2094842052: Hold'em No Limit ($0.02/$0.05) - 2023/12/27 22:14:00
Table 'RushAndCash3834872' 6-max Seat #1 is the button
Seat 1: ffa5fca5 ($5.07 in chips)
Seat 2: Hero ($10.44 in chips)
Seat 3: 5a470fb9 ($9.43 in chips)
Seat 4: d565a4f6 ($5.22 in chips)
Seat 5: f100600f ($10.26 in chips)
Seat 6: 74254aff ($9.83 in chips)
Hero: posts small blind $0.02
5a470fb9: posts big blind $0.05
*** HOLE CARDS ***
Dealt to ffa5fca5 
Dealt to Hero [8c 7s]
Dealt to 5a470fb9 
Dealt to d565a4f6 
Dealt to f100600f 
Dealt to 74254aff 
d565a4f6: raises $0.05 to $0.1
f100600f: folds
74254aff: folds
ffa5fca5: folds
Hero: folds
5a470fb9: folds
Uncalled bet ($0.05) returned to d565a4f6
*** SHOWDOWN ***
d565a4f6 collected $0.12 from pot
*** SUMMARY ***
Total pot $0.12 | Rake $0 | Jackpot $0 | Bingo $0 | Fortune $0 | Tax $0
Seat 1: ffa5fca5 (button) folded before Flop (didn't bet)
Seat 2: Hero (small blind) folded before Flop
Seat 3: 5a470fb9 (big blind) folded before Flop
Seat 4: d565a4f6 collected ($0.12)
Seat 5: f100600f folded before Flop (didn't bet)
Seat 6: 74254aff folded before Flop (didn't bet)


Poker Hand #RC2094841967: Hold'em No Limit ($0.02/$0.05) - 2023/12/27 22:13:55
Table 'RushAndCash3834831' 6-max Seat #1 is the button
Seat 1: 475d8f40 ($5.11 in chips)
Seat 2: 56c46917 ($4.88 in chips)
Seat 3: 514e1523 ($5 in chips)
Seat 4: Hero ($10.44 in chips)
Seat 5: b881f476 ($5.49 in chips)
Seat 6: 31595d9f ($5 in chips)
56c46917: posts small blind $0.02
514e1523: posts big blind $0.05
*** HOLE CARDS ***
Dealt to 475d8f40 
Dealt to 56c46917 
Dealt to 514e1523 
Dealt to Hero [8d 3d]
Dealt to b881f476 
Dealt to 31595d9f 
Hero: folds
b881f476: folds
31595d9f: folds
475d8f40: folds
56c46917: raises $0.05 to $0.1
514e1523: folds
Uncalled bet ($0.05) returned to 56c46917
*** SHOWDOWN ***
56c46917 collected $0.1 from pot
*** SUMMARY ***
Total pot $0.1 | Rake $0 | Jackpot $0 | Bingo $0 | Fortune $0 | Tax $0
Seat 1: 475d8f40 (button) folded before Flop (didn't bet)
Seat 2: 56c46917 (small blind) collected ($0.1)
Seat 3: 514e1523 (big blind) folded before Flop
Seat 4: Hero folded before Flop (didn't bet)
Seat 5: b881f476 folded before Flop (didn't bet)
Seat 6: 31595d9f folded before Flop (didn't bet)


Poker Hand #RC2094841844: Hold'em No Limit ($0.02/$0.05) - 2023/12/27 22:13:50
Table 'RushAndCash3834772' 6-max Seat #1 is the button
Seat 1: 1e5c9655 ($5.2 in chips)
Seat 2: a19c8d21 ($10.62 in chips)
Seat 3: 28f6306d ($13.83 in chips)
Seat 4: 3e24d35f ($5.47 in chips)
Seat 5: Hero ($10.44 in chips)
Seat 6: 99702706 ($5.07 in chips)
a19c8d21: posts small blind $0.02
28f6306d: posts big blind $0.05
*** HOLE CARDS ***
Dealt to 1e5c9655 
Dealt to a19c8d21 
Dealt to 28f6306d 
Dealt to 3e24d35f 
Dealt to Hero [8c 3h]
Dealt to 99702706 
3e24d35f: folds
Hero: folds
99702706: folds
1e5c9655: raises $0.1 to $0.15
a19c8d21: folds
28f6306d: folds
Uncalled bet ($0.1) returned to 1e5c9655
*** SHOWDOWN ***
1e5c9655 collected $0.12 from pot
*** SUMMARY ***
Total pot $0.12 | Rake $0 | Jackpot $0 | Bingo $0 | Fortune $0 | Tax $0
Seat 1: 1e5c9655 (button) collected ($0.12)
Seat 2: a19c8d21 (small blind) folded before Flop
Seat 3: 28f6306d (big blind) folded before Flop
Seat 4: 3e24d35f folded before Flop (didn't bet)
Seat 5: Hero folded before Flop (didn't bet)
Seat 6: 99702706 folded before Flop (didn't bet)


Poker Hand #RC2094841698: Hold'em No Limit ($0.02/$0.05) - 2023/12/27 22:13:43
Table 'RushAndCash3834698' 6-max Seat #1 is the button
Seat 1: 9f83857b ($5.74 in chips)
Seat 2: Hero ($10.46 in chips)
Seat 3: 273fe21e ($5.92 in chips)
Seat 4: 8279270c ($5.1 in chips)
Seat 5: c9f00b4c ($7.7 in chips)
Seat 6: b565ed7b ($5.81 in chips)
Hero: posts small blind $0.02
273fe21e: posts big blind $0.05
*** HOLE CARDS ***
Dealt to 9f83857b 
Dealt to Hero [Js 2h]
Dealt to 273fe21e 
Dealt to 8279270c 
Dealt to c9f00b4c 
Dealt to b565ed7b 
8279270c: folds
c9f00b4c: folds
b565ed7b: folds
9f83857b: folds
Hero: folds
Uncalled bet ($0.03) returned to 273fe21e
*** SHOWDOWN ***
273fe21e collected $0.04 from pot
*** SUMMARY ***
Total pot $0.04 | Rake $0 | Jackpot $0 | Bingo $0 | Fortune $0 | Tax $0
Seat 1: 9f83857b (button) folded before Flop (didn't bet)
Seat 2: Hero (small blind) folded before Flop
Seat 3: 273fe21e (big blind) collected ($0.04)
Seat 4: 8279270c folded before Flop (didn't bet)
Seat 5: c9f00b4c folded before Flop (didn't bet)
Seat 6: b565ed7b folded before Flop (didn't bet)


Poker Hand #RC2094841590: Hold'em No Limit ($0.02/$0.05) - 2023/12/27 22:13:38
Table 'RushAndCash3834641' 6-max Seat #1 is the button
Seat 1: Hero ($10.46 in chips)
Seat 2: 142c5286 ($5.58 in chips)
Seat 3: 8472bf2c ($3.06 in chips)
Seat 4: 57060320 ($5.31 in chips)
Seat 5: eeb4ff60 ($5.3 in chips)
Seat 6: 5623d13a ($4.36 in chips)
142c5286: posts small blind $0.02
8472bf2c: posts big blind $0.05
*** HOLE CARDS ***
Dealt to Hero [Qc 4d]
Dealt to 142c5286 
Dealt to 8472bf2c 
Dealt to 57060320 
Dealt to eeb4ff60 
Dealt to 5623d13a 
57060320: folds
eeb4ff60: folds
5623d13a: folds
Hero: folds
142c5286: raises $0.1 to $0.15
8472bf2c: folds
Uncalled bet ($0.1) returned to 142c5286
*** SHOWDOWN ***
142c5286 collected $0.1 from pot
*** SUMMARY ***
Total pot $0.1 | Rake $0 | Jackpot $0 | Bingo $0 | Fortune $0 | Tax $0
Seat 1: Hero (button) folded before Flop (didn't bet)
Seat 2: 142c5286 (small blind) collected ($0.1)
Seat 3: 8472bf2c (big blind) folded before Flop
Seat 4: 57060320 folded before Flop (didn't bet)
Seat 5: eeb4ff60 folded before Flop (didn't bet)
Seat 6: 5623d13a folded before Flop (didn't bet)


Poker Hand #RC2094841352: Hold'em No Limit ($0.02/$0.05) - 2023/12/27 22:13:28
Table 'RushAndCash3834520' 6-max Seat #1 is the button
Seat 1: b51671a0 ($4.99 in chips)
Seat 2: Hero ($10.48 in chips)
Seat 3: fe897f4b ($6.47 in chips)
Seat 4: 97aed9d4 ($26.65 in chips)
Seat 5: 869cd4a ($7.63 in chips)
Seat 6: b39f1ef2 ($5.14 in chips)
Hero: posts small blind $0.02
fe897f4b: posts big blind $0.05
*** HOLE CARDS ***
Dealt to b51671a0 
Dealt to Hero [Tc Ac]
Dealt to fe897f4b 
Dealt to 97aed9d4 
Dealt to 869cd4a 
Dealt to b39f1ef2 
97aed9d4: folds
869cd4a: folds
b39f1ef2: raises $0.08 to $0.13
b51671a0: raises $0.22 to $0.35
Hero: folds
fe897f4b: folds
b39f1ef2: folds
Uncalled bet ($0.22) returned to b51671a0
*** SHOWDOWN ***
b51671a0 collected $0.32 from pot
*** SUMMARY ***
Total pot $0.33 | Rake $0.01 | Jackpot $0 | Bingo $0 | Fortune $0 | Tax $0
Seat 1: b51671a0 (button) collected ($0.32)
Seat 2: Hero (small blind) folded before Flop
Seat 3: fe897f4b (big blind) folded before Flop
Seat 4: 97aed9d4 folded before Flop (didn't bet)
Seat 5: 869cd4a folded before Flop (didn't bet)
Seat 6: b39f1ef2 folded before Flop


Poker Hand #RC2094841157: Hold'em No Limit ($0.02/$0.05) - 2023/12/27 22:13:19
Table 'RushAndCash3834426' 6-max Seat #1 is the button
Seat 1: 542733f5 ($5.04 in chips)
Seat 2: 1341969f ($4.37 in chips)
Seat 3: Hero ($10.46 in chips)
Seat 4: 87bb2e36 ($5.06 in chips)
Seat 5: 87a8079f ($5.37 in chips)
Seat 6: c74fefbb ($5.12 in chips)
1341969f: posts small blind $0.02
Hero: posts big blind $0.05
*** HOLE CARDS ***
Dealt to 542733f5 
Dealt to 1341969f 
Dealt to Hero [Ad 4d]
Dealt to 87bb2e36 
Dealt to 87a8079f 
Dealt to c74fefbb 
87bb2e36: folds
87a8079f: folds
c74fefbb: folds
542733f5: folds
1341969f: folds
Uncalled bet ($0.03) returned to Hero
*** SHOWDOWN ***
Hero collected $0.04 from pot
*** SUMMARY ***
Total pot $0.04 | Rake $0 | Jackpot $0 | Bingo $0 | Fortune $0 | Tax $0
Seat 1: 542733f5 (button) folded before Flop (didn't bet)
Seat 2: 1341969f (small blind) folded before Flop
Seat 3: Hero (big blind) collected ($0.04)
Seat 4: 87bb2e36 folded before Flop (didn't bet)
Seat 5: 87a8079f folded before Flop (didn't bet)
Seat 6: c74fefbb folded before Flop (didn't bet)


Poker Hand #RC2094840526: Hold'em No Limit ($0.02/$0.05) - 2023/12/27 22:12:52
Table 'RushAndCash3834130' 6-max Seat #1 is the button
Seat 1: a1e6400e ($7.17 in chips)
Seat 2: 1ab58622 ($5.58 in chips)
Seat 3: 23defde5 ($9.53 in chips)
Seat 4: e72137e2 ($34.69 in chips)
Seat 5: 23d3ca5e ($18.49 in chips)
Seat 6: Hero ($10.56 in chips)
1ab58622: posts small blind $0.02
23defde5: posts big blind $0.05
*** HOLE CARDS ***
Dealt to a1e6400e 
Dealt to 1ab58622 
Dealt to 23defde5 
Dealt to e72137e2 
Dealt to 23d3ca5e 
Dealt to Hero [Jd Kh]
e72137e2: folds
23d3ca5e: folds
Hero: raises $0.05 to $0.1
a1e6400e: folds
1ab58622: folds
23defde5: calls $0.05
*** FLOP *** [3h As 7s]
23defde5: bets $0.11
Hero: folds
Uncalled bet ($0.11) returned to 23defde5
*** SHOWDOWN ***
23defde5 collected $0.21 from pot
*** SUMMARY ***
Total pot $0.22 | Rake $0.01 | Jackpot $0 | Bingo $0 | Fortune $0 | Tax $0
Board [3h As 7s]
Seat 1: a1e6400e (button) folded before Flop (didn't bet)
Seat 2: 1ab58622 (small blind) folded before Flop
Seat 3: 23defde5 (big blind) won ($0.21)
Seat 4: e72137e2 folded before Flop (didn't bet)
Seat 5: 23d3ca5e folded before Flop (didn't bet)
Seat 6: Hero folded on the Flop


Poker Hand #RC2094840263: Hold'em No Limit ($0.02/$0.05) - 2023/12/27 22:12:41
Table 'RushAndCash3834001' 6-max Seat #1 is the button
Seat 1: c0af341d ($3.89 in chips)
Seat 2: 1341969f ($4.44 in chips)
Seat 3: Hero ($10.54 in chips)
Seat 4: c9cc4342 ($7.97 in chips)
Seat 5: f052f779 ($5.12 in chips)
Seat 6: fc8bd592 ($4.99 in chips)
1341969f: posts small blind $0.02
Hero: posts big blind $0.05
*** HOLE CARDS ***
Dealt to c0af341d 
Dealt to 1341969f 
Dealt to Hero [6d 8h]
Dealt to c9cc4342 
Dealt to f052f779 
Dealt to fc8bd592 
c9cc4342: folds
f052f779: folds
fc8bd592: folds
c0af341d: folds
1341969f: folds
Uncalled bet ($0.03) returned to Hero
*** SHOWDOWN ***
Hero collected $0.04 from pot
*** SUMMARY ***
Total pot $0.04 | Rake $0 | Jackpot $0 | Bingo $0 | Fortune $0 | Tax $0
Seat 1: c0af341d (button) folded before Flop (didn't bet)
Seat 2: 1341969f (small blind) folded before Flop
Seat 3: Hero (big blind) collected ($0.04)
Seat 4: c9cc4342 folded before Flop (didn't bet)
Seat 5: f052f779 folded before Flop (didn't bet)
Seat 6: fc8bd592 folded before Flop (didn't bet)


Poker Hand #RC2094840006: Hold'em No Limit ($0.02/$0.05) - 2023/12/27 22:12:28
Table 'RushAndCash3833875' 6-max Seat #1 is the button
Seat 1: 4cab3524 ($5.45 in chips)
Seat 2: Hero ($10.56 in chips)
Seat 3: a6ae07 ($5 in chips)
Seat 4: 77c268f7 ($5.4 in chips)
Seat 5: 26f4d9dd ($5 in chips)
Seat 6: 4e0362a4 ($12.62 in chips)
Hero: posts small blind $0.02
a6ae07: posts big blind $0.05
*** HOLE CARDS ***
Dealt to 4cab3524 
Dealt to Hero [Ah 6s]
Dealt to a6ae07 
Dealt to 77c268f7 
Dealt to 26f4d9dd 
Dealt to 4e0362a4 
77c268f7: folds
26f4d9dd: raises $0.06 to $0.11
4e0362a4: folds
4cab3524: folds
Hero: folds
a6ae07: folds
Uncalled bet ($0.06) returned to 26f4d9dd
*** SHOWDOWN ***
26f4d9dd collected $0.12 from pot
*** SUMMARY ***
Total pot $0.12 | Rake $0 | Jackpot $0 | Bingo $0 | Fortune $0 | Tax $0
Seat 1: 4cab3524 (button) folded before Flop (didn't bet)
Seat 2: Hero (small blind) folded before Flop
Seat 3: a6ae07 (big blind) folded before Flop
Seat 4: 77c268f7 folded before Flop (didn't bet)
Seat 5: 26f4d9dd collected ($0.12)
Seat 6: 4e0362a4 folded before Flop (didn't bet)


Poker Hand #RC2094839918: Hold'em No Limit ($0.02/$0.05) - 2023/12/27 22:12:25
Table 'RushAndCash3833830' 6-max Seat #1 is the button
Seat 1: 3f010145 ($3.35 in chips)
Seat 2: 3215507b ($5.36 in chips)
Seat 3: cf9e2d1c ($4.58 in chips)
Seat 4: Hero ($10.56 in chips)
Seat 5: 28426cde ($6.95 in chips)
Seat 6: cffa41d9 ($4.79 in chips)
3215507b: posts small blind $0.02
cf9e2d1c: posts big blind $0.05
*** HOLE CARDS ***
Dealt to 3f010145 
Dealt to 3215507b 
Dealt to cf9e2d1c 
Dealt to Hero [9d 3s]
Dealt to 28426cde 
Dealt to cffa41d9 
Hero: folds
28426cde: folds
cffa41d9: raises $0.08 to $0.13
3f010145: folds
3215507b: folds
cf9e2d1c: folds
Uncalled bet ($0.08) returned to cffa41d9
*** SHOWDOWN ***
cffa41d9 collected $0.12 from pot
*** SUMMARY ***
Total pot $0.12 | Rake $0 | Jackpot $0 | Bingo $0 | Fortune $0 | Tax $0
Seat 1: 3f010145 (button) folded before Flop (didn't bet)
Seat 2: 3215507b (small blind) folded before Flop
Seat 3: cf9e2d1c (big blind) folded before Flop
Seat 4: Hero folded before Flop (didn't bet)
Seat 5: 28426cde folded before Flop (didn't bet)
Seat 6: cffa41d9 collected ($0.12)


Poker Hand #RC2094839842: Hold'em No Limit ($0.02/$0.05) - 2023/12/27 22:12:21
Table 'RushAndCash3833791' 6-max Seat #1 is the button
Seat 1: 3bac05b2 ($5.14 in chips)
Seat 2: 3f010145 ($3.37 in chips)
Seat 3: cffa41d9 ($4.84 in chips)
Seat 4: Hero ($10.56 in chips)
Seat 5: b565ed7b ($5.25 in chips)
Seat 6: d244a6e ($5.87 in chips)
3f010145: posts small blind $0.02
cffa41d9: posts big blind $0.05
*** HOLE CARDS ***
Dealt to 3bac05b2 
Dealt to 3f010145 
Dealt to cffa41d9 
Dealt to Hero [Jd 2h]
Dealt to b565ed7b 
Dealt to d244a6e 
Hero: folds
b565ed7b: folds
d244a6e: folds
3bac05b2: raises $0.08 to $0.13
3f010145: folds
cffa41d9: folds
Uncalled bet ($0.08) returned to 3bac05b2
*** SHOWDOWN ***
3bac05b2 collected $0.12 from pot
*** SUMMARY ***
Total pot $0.12 | Rake $0 | Jackpot $0 | Bingo $0 | Fortune $0 | Tax $0
Seat 1: 3bac05b2 (button) collected ($0.12)
Seat 2: 3f010145 (small blind) folded before Flop
Seat 3: cffa41d9 (big blind) folded before Flop
Seat 4: Hero folded before Flop (didn't bet)
Seat 5: b565ed7b folded before Flop (didn't bet)
Seat 6: d244a6e folded before Flop (didn't bet)


Poker Hand #RC2094839259: Hold'em No Limit ($0.02/$0.05) - 2023/12/27 22:11:54
Table 'RushAndCash3833512' 6-max Seat #1 is the button
Seat 1: 11634403 ($6.33 in chips)
Seat 2: 74c2f2d2 ($5 in chips)
Seat 3: 5d917fde ($5 in chips)
Seat 4: Hero ($10.49 in chips)
Seat 5: a16594e6 ($11.48 in chips)
Seat 6: 74254aff ($5 in chips)
74c2f2d2: posts small blind $0.02
5d917fde: posts big blind $0.05
*** HOLE CARDS ***
Dealt to 11634403 
Dealt to 74c2f2d2 
Dealt to 5d917fde 
Dealt to Hero [6d 6h]
Dealt to a16594e6 
Dealt to 74254aff 
Hero: raises $0.05 to $0.1
a16594e6: folds
74254aff: folds
11634403: folds
74c2f2d2: folds
5d917fde: folds
Uncalled bet ($0.05) returned to Hero
*** SHOWDOWN ***
Hero collected $0.12 from pot
*** SUMMARY ***
Total pot $0.12 | Rake $0 | Jackpot $0 | Bingo $0 | Fortune $0 | Tax $0
Seat 1: 11634403 (button) folded before Flop (didn't bet)
Seat 2: 74c2f2d2 (small blind) folded before Flop
Seat 3: 5d917fde (big blind) folded before Flop
Seat 4: Hero collected ($0.12)
Seat 5: a16594e6 folded before Flop (didn't bet)
Seat 6: 74254aff folded before Flop (didn't bet)


Poker Hand #RC2094839180: Hold'em No Limit ($0.02/$0.05) - 2023/12/27 22:11:50
Table 'RushAndCash3833475' 6-max Seat #1 is the button
Seat 1: 6bcfb94d ($5.52 in chips)
Seat 2: b565ed7b ($5.02 in chips)
Seat 3: 4145b204 ($7.83 in chips)
Seat 4: Hero ($10.49 in chips)
Seat 5: 451260ed ($5.22 in chips)
Seat 6: 46ea31ba ($6.26 in chips)
b565ed7b: posts small blind $0.02
4145b204: posts big blind $0.05
*** HOLE CARDS ***
Dealt to 6bcfb94d 
Dealt to b565ed7b 
Dealt to 4145b204 
Dealt to Hero [4c 6h]
Dealt to 451260ed 
Dealt to 46ea31ba 
Hero: folds
451260ed: raises $0.07 to $0.12
46ea31ba: folds
6bcfb94d: folds
b565ed7b: raises $0.36 to $0.48
4145b204: folds
451260ed: folds
Uncalled bet ($0.36) returned to b565ed7b
*** SHOWDOWN ***
b565ed7b collected $0.28 from pot
*** SUMMARY ***
Total pot $0.29 | Rake $0.01 | Jackpot $0 | Bingo $0 | Fortune $0 | Tax $0
Seat 1: 6bcfb94d (button) folded before Flop (didn't bet)
Seat 2: b565ed7b (small blind) collected ($0.28)
Seat 3: 4145b204 (big blind) folded before Flop
Seat 4: Hero folded before Flop (didn't bet)
Seat 5: 451260ed folded before Flop
Seat 6: 46ea31ba folded before Flop (didn't bet)


Poker Hand #RC2094839079: Hold'em No Limit ($0.02/$0.05) - 2023/12/27 22:11:46
Table 'RushAndCash3833423' 6-max Seat #1 is the button
Seat 1: f1812546 ($6.67 in chips)
Seat 2: 5038d288 ($4.05 in chips)
Seat 3: Hero ($10.54 in chips)
Seat 4: d1e8d844 ($5.05 in chips)
Seat 5: 4d3c02b4 ($5.71 in chips)
Seat 6: c7d29ab9 ($5 in chips)
5038d288: posts small blind $0.02
Hero: posts big blind $0.05
*** HOLE CARDS ***
Dealt to f1812546 
Dealt to 5038d288 
Dealt to Hero [Jc 2d]
Dealt to d1e8d844 
Dealt to 4d3c02b4 
Dealt to c7d29ab9 
d1e8d844: folds
4d3c02b4: folds
c7d29ab9: folds
f1812546: folds
5038d288: calls $0.03
Hero: checks
*** FLOP *** [Qs 6h 4d]
5038d288: bets $0.05
Hero: folds
Uncalled bet ($0.05) returned to 5038d288
*** SHOWDOWN ***
5038d288 collected $0.1 from pot
*** SUMMARY ***
Total pot $0.1 | Rake $0 | Jackpot $0 | Bingo $0 | Fortune $0 | Tax $0
Board [Qs 6h 4d]
Seat 1: f1812546 (button) folded before Flop (didn't bet)
Seat 2: 5038d288 (small blind) won ($0.1)
Seat 3: Hero (big blind) folded on the Flop
Seat 4: d1e8d844 folded before Flop (didn't bet)
Seat 5: 4d3c02b4 folded before Flop (didn't bet)
Seat 6: c7d29ab9 folded before Flop (didn't bet)


Poker Hand #RC2094839005: Hold'em No Limit ($0.02/$0.05) - 2023/12/27 22:11:43
Table 'RushAndCash3833389' 6-max Seat #1 is the button
Seat 1: Hero ($10.54 in chips)
Seat 2: 31d20a36 ($12.47 in chips)
Seat 3: d747766a ($3.67 in chips)
Seat 4: 30ae2e52 ($5.24 in chips)
Seat 5: b565ed7b ($5.07 in chips)
Seat 6: ffa5fca5 ($5 in chips)
31d20a36: posts small blind $0.02
d747766a: posts big blind $0.05
*** HOLE CARDS ***
Dealt to Hero [2h 9h]
Dealt to 31d20a36 
Dealt to d747766a 
Dealt to 30ae2e52 
Dealt to b565ed7b 
Dealt to ffa5fca5 
30ae2e52: folds
b565ed7b: folds
ffa5fca5: raises $0.07 to $0.12
Hero: folds
31d20a36: folds
d747766a: folds
Uncalled bet ($0.07) returned to ffa5fca5
*** SHOWDOWN ***
ffa5fca5 collected $0.12 from pot
*** SUMMARY ***
Total pot $0.12 | Rake $0 | Jackpot $0 | Bingo $0 | Fortune $0 | Tax $0
Seat 1: Hero (button) folded before Flop (didn't bet)
Seat 2: 31d20a36 (small blind) folded before Flop
Seat 3: d747766a (big blind) folded before Flop
Seat 4: 30ae2e52 folded before Flop (didn't bet)
Seat 5: b565ed7b folded before Flop (didn't bet)
Seat 6: ffa5fca5 collected ($0.12)


Poker Hand #RC2094838937: Hold'em No Limit ($0.02/$0.05) - 2023/12/27 22:11:39
Table 'RushAndCash3833354' 6-max Seat #1 is the button
Seat 1: Hero ($10.54 in chips)
Seat 2: 971781e9 ($11.65 in chips)
Seat 3: a8f5e89e ($5 in chips)
Seat 4: 1e710d8 ($18.75 in chips)
Seat 5: 30d7a069 ($4.61 in chips)
Seat 6: b0596725 ($5.05 in chips)
971781e9: posts small blind $0.02
a8f5e89e: posts big blind $0.05
*** HOLE CARDS ***
Dealt to Hero [9c Kh]
Dealt to 971781e9 
Dealt to a8f5e89e 
Dealt to 1e710d8 
Dealt to 30d7a069 
Dealt to b0596725 
1e710d8: folds
30d7a069: folds
b0596725: raises $0.05 to $0.1
Hero: folds
971781e9: folds
a8f5e89e: folds
Uncalled bet ($0.05) returned to b0596725
*** SHOWDOWN ***
b0596725 collected $0.12 from pot
*** SUMMARY ***
Total pot $0.12 | Rake $0 | Jackpot $0 | Bingo $0 | Fortune $0 | Tax $0
Seat 1: Hero (button) folded before Flop (didn't bet)
Seat 2: 971781e9 (small blind) folded before Flop
Seat 3: a8f5e89e (big blind) folded before Flop
Seat 4: 1e710d8 folded before Flop (didn't bet)
Seat 5: 30d7a069 folded before Flop (didn't bet)
Seat 6: b0596725 collected ($0.12)


Poker Hand #RC2094838850: Hold'em No Limit ($0.02/$0.05) - 2023/12/27 22:11:35
Table 'RushAndCash3833311' 6-max Seat #1 is the button
Seat 1: b4a89eae ($2.2 in chips)
Seat 2: a02b33db ($2.78 in chips)
Seat 3: 48e189fe ($5.09 in chips)
Seat 4: a4d57c0 ($7.62 in chips)
Seat 5: b44ef436 ($15.31 in chips)
Seat 6: Hero ($10.54 in chips)
a02b33db: posts small blind $0.02
48e189fe: posts big blind $0.05
*** HOLE CARDS ***
Dealt to b4a89eae 
Dealt to a02b33db 
Dealt to 48e189fe 
Dealt to a4d57c0 
Dealt to b44ef436 
Dealt to Hero [3d 8h]
a4d57c0: folds
b44ef436: folds
Hero: folds
b4a89eae: folds
a02b33db: folds
Uncalled bet ($0.03) returned to 48e189fe
*** SHOWDOWN ***
48e189fe collected $0.04 from pot
*** SUMMARY ***
Total pot $0.04 | Rake $0 | Jackpot $0 | Bingo $0 | Fortune $0 | Tax $0
Seat 1: b4a89eae (button) folded before Flop (didn't bet)
Seat 2: a02b33db (small blind) folded before Flop
Seat 3: 48e189fe (big blind) collected ($0.04)
Seat 4: a4d57c0 folded before Flop (didn't bet)
Seat 5: b44ef436 folded before Flop (didn't bet)
Seat 6: Hero folded before Flop (didn't bet)


Poker Hand #RC2094838770: Hold'em No Limit ($0.02/$0.05) - 2023/12/27 22:11:31
Table 'RushAndCash3833269' 6-max Seat #1 is the button
Seat 1: 6bcfb94d ($5.52 in chips)
Seat 2: c03393aa ($9.93 in chips)
Seat 3: 7d92d461 ($5.05 in chips)
Seat 4: Hero ($10.54 in chips)
Seat 5: 9d9f8e48 ($7.47 in chips)
Seat 6: 3fefe89c ($4.88 in chips)
c03393aa: posts small blind $0.02
7d92d461: posts big blind $0.05
*** HOLE CARDS ***
Dealt to 6bcfb94d 
Dealt to c03393aa 
Dealt to 7d92d461 
Dealt to Hero [8d 5d]
Dealt to 9d9f8e48 
Dealt to 3fefe89c 
Hero: folds
9d9f8e48: raises $0.06 to $0.11
3fefe89c: folds
6bcfb94d: folds
c03393aa: folds
7d92d461: raises $0.34 to $0.45
9d9f8e48: calls $0.34
*** FLOP *** [Kd 9d 7c]
7d92d461: checks
9d9f8e48: bets $0.46
7d92d461: folds
Uncalled bet ($0.46) returned to 9d9f8e48
*** SHOWDOWN ***
9d9f8e48 collected $0.88 from pot
*** SUMMARY ***
Total pot $0.92 | Rake $0.04 | Jackpot $0 | Bingo $0 | Fortune $0 | Tax $0
Board [Kd 9d 7c]
Seat 1: 6bcfb94d (button) folded before Flop (didn't bet)
Seat 2: c03393aa (small blind) folded before Flop
Seat 3: 7d92d461 (big blind) folded on the Flop
Seat 4: Hero folded before Flop (didn't bet)
Seat 5: 9d9f8e48 won ($0.88)
Seat 6: 3fefe89c folded before Flop (didn't bet)


Poker Hand #RC2094838690: Hold'em No Limit ($0.02/$0.05) - 2023/12/27 22:11:27
Table 'RushAndCash3833228' 6-max Seat #1 is the button
Seat 1: 2acc0b0d ($5.53 in chips)
Seat 2: d44076ec ($5.8 in chips)
Seat 3: 7be8413b ($5 in chips)
Seat 4: 704f8e60 ($3.39 in chips)
Seat 5: Hero ($10.54 in chips)
Seat 6: c34e5e03 ($14.78 in chips)
d44076ec: posts small blind $0.02
7be8413b: posts big blind $0.05
*** HOLE CARDS ***
Dealt to 2acc0b0d 
Dealt to d44076ec 
Dealt to 7be8413b 
Dealt to 704f8e60 
Dealt to Hero [8h Qc]
Dealt to c34e5e03 
704f8e60: raises $0.05 to $0.1
Hero: folds
c34e5e03: folds
2acc0b0d: folds
d44076ec: folds
7be8413b: folds
Uncalled bet ($0.05) returned to 704f8e60
*** SHOWDOWN ***
704f8e60 collected $0.12 from pot
*** SUMMARY ***
Total pot $0.12 | Rake $0 | Jackpot $0 | Bingo $0 | Fortune $0 | Tax $0
Seat 1: 2acc0b0d (button) folded before Flop (didn't bet)
Seat 2: d44076ec (small blind) folded before Flop
Seat 3: 7be8413b (big blind) folded before Flop
Seat 4: 704f8e60 collected ($0.12)
Seat 5: Hero folded before Flop (didn't bet)
Seat 6: c34e5e03 folded before Flop (didn't bet)


Poker Hand #RC2094838617: Hold'em No Limit ($0.02/$0.05) - 2023/12/27 22:11:23
Table 'RushAndCash3833191' 6-max Seat #1 is the button
Seat 1: c8fcf0e7 ($6.14 in chips)
Seat 2: 510778cf ($6.48 in chips)
Seat 3: ab59cb2 ($5.25 in chips)
Seat 4: Hero ($10.54 in chips)
Seat 5: b563a56d ($3.76 in chips)
Seat 6: 48e189fe ($5.09 in chips)
510778cf: posts small blind $0.02
ab59cb2: posts big blind $0.05
*** HOLE CARDS ***
Dealt to c8fcf0e7 
Dealt to 510778cf 
Dealt to ab59cb2 
Dealt to Hero [9c Ks]
Dealt to b563a56d 
Dealt to 48e189fe 
Hero: folds
b563a56d: folds
48e189fe: folds
c8fcf0e7: raises $0.1 to $0.15
510778cf: folds
ab59cb2: calls $0.1
*** FLOP *** [6h 4c Qs]
ab59cb2: checks
c8fcf0e7: checks
*** TURN *** [6h 4c Qs] [Jh]
ab59cb2: bets $0.16
c8fcf0e7: folds
Uncalled bet ($0.16) returned to ab59cb2
*** SHOWDOWN ***
ab59cb2 collected $0.31 from pot
*** SUMMARY ***
Total pot $0.32 | Rake $0.01 | Jackpot $0 | Bingo $0 | Fortune $0 | Tax $0
Board [6h 4c Qs Jh]
Seat 1: c8fcf0e7 (button) folded on the Turn
Seat 2: 510778cf (small blind) folded before Flop
Seat 3: ab59cb2 (big blind) won ($0.31)
Seat 4: Hero folded before Flop (didn't bet)
Seat 5: b563a56d folded before Flop (didn't bet)
Seat 6: 48e189fe folded before Flop (didn't bet)


Poker Hand #RC2094838540: Hold'em No Limit ($0.02/$0.05) - 2023/12/27 22:11:19
Table 'RushAndCash3833153' 6-max Seat #1 is the button
Seat 1: 48e189fe ($5.09 in chips)
Seat 2: 7a543f94 ($10.29 in chips)
Seat 3: 60afb67e ($3.68 in chips)
Seat 4: Hero ($10.54 in chips)
Seat 5: a4c223ac ($4.76 in chips)
Seat 6: e7b47e59 ($5.84 in chips)
7a543f94: posts small blind $0.02
60afb67e: posts big blind $0.05
*** HOLE CARDS ***
Dealt to 48e189fe 
Dealt to 7a543f94 
Dealt to 60afb67e 
Dealt to Hero [2h 5c]
Dealt to a4c223ac 
Dealt to e7b47e59 
Hero: folds
a4c223ac: raises $0.1 to $0.15
e7b47e59: raises $0.3 to $0.45
48e189fe: folds
7a543f94: calls $0.43
60afb67e: folds
a4c223ac: raises $1.4 to $1.85
e7b47e59: folds
7a543f94: folds
Uncalled bet ($1.4) returned to a4c223ac
*** SHOWDOWN ***
a4c223ac collected $1.33 from pot
*** SUMMARY ***
Total pot $1.4 | Rake $0.07 | Jackpot $0 | Bingo $0 | Fortune $0 | Tax $0
Seat 1: 48e189fe (button) folded before Flop (didn't bet)
Seat 2: 7a543f94 (small blind) folded before Flop
Seat 3: 60afb67e (big blind) folded before Flop
Seat 4: Hero folded before Flop (didn't bet)
Seat 5: a4c223ac collected ($1.33)
Seat 6: e7b47e59 folded before Flop


Poker Hand #RC2094838444: Hold'em No Limit ($0.02/$0.05) - 2023/12/27 22:11:16
Table 'RushAndCash3833104' 6-max Seat #1 is the button
Seat 1: 9b8d2d21 ($12.03 in chips)
Seat 2: 55b00465 ($7.98 in chips)
Seat 3: cf341e6 ($6.96 in chips)
Seat 4: 827ebdaf ($5.24 in chips)
Seat 5: Hero ($10.54 in chips)
Seat 6: 5e46be01 ($5.07 in chips)
55b00465: posts small blind $0.02
cf341e6: posts big blind $0.05
*** HOLE CARDS ***
Dealt to 9b8d2d21 
Dealt to 55b00465 
Dealt to cf341e6 
Dealt to 827ebdaf 
Dealt to Hero [8s 4c]
Dealt to 5e46be01 
827ebdaf: folds
Hero: folds
5e46be01: folds
9b8d2d21: folds
55b00465: folds
Uncalled bet ($0.03) returned to cf341e6
*** SHOWDOWN ***
cf341e6 collected $0.04 from pot
*** SUMMARY ***
Total pot $0.04 | Rake $0 | Jackpot $0 | Bingo $0 | Fortune $0 | Tax $0
Seat 1: 9b8d2d21 (button) folded before Flop (didn't bet)
Seat 2: 55b00465 (small blind) folded before Flop
Seat 3: cf341e6 (big blind) collected ($0.04)
Seat 4: 827ebdaf folded before Flop (didn't bet)
Seat 5: Hero folded before Flop (didn't bet)
Seat 6: 5e46be01 folded before Flop (didn't bet)


Poker Hand #RC2094838286: Hold'em No Limit ($0.02/$0.05) - 2023/12/27 22:11:08
Table 'RushAndCash3833025' 6-max Seat #1 is the button
Seat 1: 3aa9afed ($4.68 in chips)
Seat 2: f3804046 ($5 in chips)
Seat 3: 3fdbaf1e ($8.89 in chips)
Seat 4: f62f437 ($3.27 in chips)
Seat 5: 802b86d ($5.2 in chips)
Seat 6: Hero ($10.54 in chips)
f3804046: posts small blind $0.02
3fdbaf1e: posts big blind $0.05
*** HOLE CARDS ***
Dealt to 3aa9afed 
Dealt to f3804046 
Dealt to 3fdbaf1e 
Dealt to f62f437 
Dealt to 802b86d 
Dealt to Hero [Qd 9d]
f62f437: raises $0.08 to $0.13
802b86d: folds
Hero: folds
3aa9afed: calls $0.13
f3804046: calls $0.11
3fdbaf1e: folds
*** FLOP *** [Ks 5h Ad]
f3804046: checks
f62f437: checks
3aa9afed: bets $0.3
f3804046: folds
f62f437: calls $0.3
*** TURN *** [Ks 5h Ad] [Jd]
f62f437: checks
3aa9afed: bets $0.35
f62f437: raises $0.87 to $1.22
3aa9afed: calls $0.87
*** RIVER *** [Ks 5h Ad Jd] [6d]
f62f437: bets $1.62 and is all-in
3aa9afed: calls $1.62
f62f437: shows [Ac As] (Three Aces)
3aa9afed: shows [Qc Kd] (Pair of Kings)
*** SHOWDOWN ***
f62f437 collected $6.5 from pot
*** SUMMARY ***
Total pot $6.72 | Rake $0.15 | Jackpot $0.07 | Bingo $0 | Fortune $0 | Tax $0
Board [Ks 5h Ad Jd 6d]
Seat 1: 3aa9afed (button) showed [Qc Kd] and lost with Pair of Kings
Seat 2: f3804046 (small blind) folded on the Flop
Seat 3: 3fdbaf1e (big blind) folded before Flop
Seat 4: f62f437 showed [Ac As] and won ($6.5) with Three Aces
Seat 5: 802b86d folded before Flop (didn't bet)
Seat 6: Hero folded before Flop (didn't bet)


Poker Hand #RC2094838217: Hold'em No Limit ($0.02/$0.05) - 2023/12/27 22:11:04
Table 'RushAndCash3832992' 6-max Seat #1 is the button
Seat 1: 7865c4a1 ($4.12 in chips)
Seat 2: 66647495 ($6 in chips)
Seat 3: Hero ($10.59 in chips)
Seat 4: efb57da7 ($5.48 in chips)
Seat 5: 55f410e5 ($1.88 in chips)
Seat 6: 3215507b ($5.34 in chips)
66647495: posts small blind $0.02
Hero: posts big blind $0.05
*** HOLE CARDS ***
Dealt to 7865c4a1 
Dealt to 66647495 
Dealt to Hero [7s Tc]
Dealt to efb57da7 
Dealt to 55f410e5 
Dealt to 3215507b 
efb57da7: folds
55f410e5: folds
3215507b: folds
7865c4a1: raises $0.1 to $0.15
66647495: folds
Hero: folds
Uncalled bet ($0.1) returned to 7865c4a1
*** SHOWDOWN ***
7865c4a1 collected $0.12 from pot
*** SUMMARY ***
Total pot $0.12 | Rake $0 | Jackpot $0 | Bingo $0 | Fortune $0 | Tax $0
Seat 1: 7865c4a1 (button) collected ($0.12)
Seat 2: 66647495 (small blind) folded before Flop
Seat 3: Hero (big blind) folded before Flop
Seat 4: efb57da7 folded before Flop (didn't bet)
Seat 5: 55f410e5 folded before Flop (didn't bet)
Seat 6: 3215507b folded before Flop (didn't bet)


Poker Hand #RC2094838138: Hold'em No Limit ($0.02/$0.05) - 2023/12/27 22:11:01
Table 'RushAndCash3832955' 6-max Seat #1 is the button
Seat 1: Hero ($10.59 in chips)
Seat 2: 2f8a4c7c ($5.17 in chips)
Seat 3: 3c4b44b7 ($7.53 in chips)
Seat 4: 517ef6f4 ($3.92 in chips)
Seat 5: 96f5939b ($8.47 in chips)
Seat 6: 3fdbaf1e ($8.89 in chips)
2f8a4c7c: posts small blind $0.02
3c4b44b7: posts big blind $0.05
*** HOLE CARDS ***
Dealt to Hero [4s Qd]
Dealt to 2f8a4c7c 
Dealt to 3c4b44b7 
Dealt to 517ef6f4 
Dealt to 96f5939b 
Dealt to 3fdbaf1e 
517ef6f4: raises $0.05 to $0.1
96f5939b: folds
3fdbaf1e: folds
Hero: folds
2f8a4c7c: folds
3c4b44b7: folds
Uncalled bet ($0.05) returned to 517ef6f4
*** SHOWDOWN ***
517ef6f4 collected $0.12 from pot
*** SUMMARY ***
Total pot $0.12 | Rake $0 | Jackpot $0 | Bingo $0 | Fortune $0 | Tax $0
Seat 1: Hero (button) folded before Flop (didn't bet)
Seat 2: 2f8a4c7c (small blind) folded before Flop
Seat 3: 3c4b44b7 (big blind) folded before Flop
Seat 4: 517ef6f4 collected ($0.12)
Seat 5: 96f5939b folded before Flop (didn't bet)
Seat 6: 3fdbaf1e folded before Flop (didn't bet)


Poker Hand #RC2094838062: Hold'em No Limit ($0.02/$0.05) - 2023/12/27 22:10:57
Table 'RushAndCash3832918' 6-max Seat #1 is the button
Seat 1: b881f476 ($5 in chips)
Seat 2: 6ff240fb ($5.16 in chips)
Seat 3: 1fcde9d3 ($5 in chips)
Seat 4: 68cad945 ($5.07 in chips)
Seat 5: 2e1c2eb ($12.64 in chips)
Seat 6: Hero ($10.59 in chips)
6ff240fb: posts small blind $0.02
1fcde9d3: posts big blind $0.05
*** HOLE CARDS ***
Dealt to b881f476 
Dealt to 6ff240fb 
Dealt to 1fcde9d3 
Dealt to 68cad945 
Dealt to 2e1c2eb 
Dealt to Hero [7s Ad]
68cad945: folds
2e1c2eb: raises $0.05 to $0.1
Hero: folds
b881f476: folds
6ff240fb: folds
1fcde9d3: folds
Uncalled bet ($0.05) returned to 2e1c2eb
*** SHOWDOWN ***
2e1c2eb collected $0.12 from pot
*** SUMMARY ***
Total pot $0.12 | Rake $0 | Jackpot $0 | Bingo $0 | Fortune $0 | Tax $0
Seat 1: b881f476 (button) folded before Flop (didn't bet)
Seat 2: 6ff240fb (small blind) folded before Flop
Seat 3: 1fcde9d3 (big blind) folded before Flop
Seat 4: 68cad945 folded before Flop (didn't bet)
Seat 5: 2e1c2eb collected ($0.12)
Seat 6: Hero folded before Flop (didn't bet)


Poker Hand #RC2094837994: Hold'em No Limit ($0.02/$0.05) - 2023/12/27 22:10:53
Table 'RushAndCash3832886' 6-max Seat #1 is the button
Seat 1: Hero ($10.59 in chips)
Seat 2: 7b1a98a9 ($5.73 in chips)
Seat 3: 956ca50b ($2.94 in chips)
Seat 4: 5dc26a6f ($5.38 in chips)
Seat 5: 2a630d ($4.64 in chips)
Seat 6: 6440ee1f ($5.23 in chips)
7b1a98a9: posts small blind $0.02
956ca50b: posts big blind $0.05
*** HOLE CARDS ***
Dealt to Hero [Qs 9d]
Dealt to 7b1a98a9 
Dealt to 956ca50b 
Dealt to 5dc26a6f 
Dealt to 2a630d 
Dealt to 6440ee1f 
5dc26a6f: calls $0.05
2a630d: raises $0.09 to $0.14
6440ee1f: folds
Hero: folds
7b1a98a9: folds
956ca50b: folds
5dc26a6f: calls $0.09
*** FLOP *** [Kc 7c Ac]
5dc26a6f: bets $0.27
2a630d: raises $0.45 to $0.72
5dc26a6f: folds
Uncalled bet ($0.45) returned to 2a630d
*** SHOWDOWN ***
2a630d collected $0.85 from pot
*** SUMMARY ***
Total pot $0.89 | Rake $0.04 | Jackpot $0 | Bingo $0 | Fortune $0 | Tax $0
Board [Kc 7c Ac]
Seat 1: Hero (button) folded before Flop (didn't bet)
Seat 2: 7b1a98a9 (small blind) folded before Flop
Seat 3: 956ca50b (big blind) folded before Flop
Seat 4: 5dc26a6f folded on the Flop
Seat 5: 2a630d won ($0.85)
Seat 6: 6440ee1f folded before Flop (didn't bet)


Poker Hand #RC2094837864: Hold'em No Limit ($0.02/$0.05) - 2023/12/27 22:10:47
Table 'RushAndCash3832821' 6-max Seat #1 is the button
Seat 1: 2e1c2eb ($12.64 in chips)
Seat 2: Hero ($10.61 in chips)
Seat 3: b24c3de2 ($5.08 in chips)
Seat 4: 46c7c1bc ($10.82 in chips)
Seat 5: e4528ee4 ($9.85 in chips)
Seat 6: bffbc071 ($5 in chips)
Hero: posts small blind $0.02
b24c3de2: posts big blind $0.05
*** HOLE CARDS ***
Dealt to 2e1c2eb 
Dealt to Hero [6s Ah]
Dealt to b24c3de2 
Dealt to 46c7c1bc 
Dealt to e4528ee4 
Dealt to bffbc071 
46c7c1bc: folds
e4528ee4: folds
bffbc071: folds
2e1c2eb: folds
Hero: folds
Uncalled bet ($0.03) returned to b24c3de2
*** SHOWDOWN ***
b24c3de2 collected $0.04 from pot
*** SUMMARY ***
Total pot $0.04 | Rake $0 | Jackpot $0 | Bingo $0 | Fortune $0 | Tax $0
Seat 1: 2e1c2eb (button) folded before Flop (didn't bet)
Seat 2: Hero (small blind) folded before Flop
Seat 3: b24c3de2 (big blind) collected ($0.04)
Seat 4: 46c7c1bc folded before Flop (didn't bet)
Seat 5: e4528ee4 folded before Flop (didn't bet)
Seat 6: bffbc071 folded before Flop (didn't bet)


Poker Hand #RC2094837507: Hold'em No Limit ($0.02/$0.05) - 2023/12/27 22:10:31
Table 'RushAndCash3832653' 6-max Seat #1 is the button
Seat 1: f73f3360 ($5.16 in chips)
Seat 2: 5038d288 ($4.12 in chips)
Seat 3: 55790f5a ($2.84 in chips)
Seat 4: 572253fd ($5.02 in chips)
Seat 5: 2a55aa6 ($13.13 in chips)
Seat 6: Hero ($10.61 in chips)
5038d288: posts small blind $0.02
55790f5a: posts big blind $0.05
*** HOLE CARDS ***
Dealt to f73f3360 
Dealt to 5038d288 
Dealt to 55790f5a 
Dealt to 572253fd 
Dealt to 2a55aa6 
Dealt to Hero [7c 8c]
572253fd: folds
2a55aa6: folds
Hero: folds
f73f3360: folds
5038d288: folds
Uncalled bet ($0.03) returned to 55790f5a
*** SHOWDOWN ***
55790f5a collected $0.04 from pot
*** SUMMARY ***
Total pot $0.04 | Rake $0 | Jackpot $0 | Bingo $0 | Fortune $0 | Tax $0
Seat 1: f73f3360 (button) folded before Flop (didn't bet)
Seat 2: 5038d288 (small blind) folded before Flop
Seat 3: 55790f5a (big blind) collected ($0.04)
Seat 4: 572253fd folded before Flop (didn't bet)
Seat 5: 2a55aa6 folded before Flop (didn't bet)
Seat 6: Hero folded before Flop (didn't bet)


Poker Hand #RC2094837254: Hold'em No Limit ($0.02/$0.05) - 2023/12/27 22:10:19
Table 'RushAndCash3832540' 6-max Seat #1 is the button
Seat 1: f62f437 ($3.34 in chips)
Seat 2: f8e9924c ($10.8 in chips)
Seat 3: Hero ($10.59 in chips)
Seat 4: 2f8a4c7c ($5.27 in chips)
Seat 5: 30d7a069 ($5.09 in chips)
Seat 6: 245c8e5d ($5.22 in chips)
f8e9924c: posts small blind $0.02
Hero: posts big blind $0.05
*** HOLE CARDS ***
Dealt to f62f437 
Dealt to f8e9924c 
Dealt to Hero [7c Td]
Dealt to 2f8a4c7c 
Dealt to 30d7a069 
Dealt to 245c8e5d 
2f8a4c7c: folds
30d7a069: folds
245c8e5d: folds
f62f437: folds
f8e9924c: folds
Uncalled bet ($0.03) returned to Hero
*** SHOWDOWN ***
Hero collected $0.04 from pot
*** SUMMARY ***
Total pot $0.04 | Rake $0 | Jackpot $0 | Bingo $0 | Fortune $0 | Tax $0
Seat 1: f62f437 (button) folded before Flop (didn't bet)
Seat 2: f8e9924c (small blind) folded before Flop
Seat 3: Hero (big blind) collected ($0.04)
Seat 4: 2f8a4c7c folded before Flop (didn't bet)
Seat 5: 30d7a069 folded before Flop (didn't bet)
Seat 6: 245c8e5d folded before Flop (didn't bet)


Poker Hand #RC2094837133: Hold'em No Limit ($0.02/$0.05) - 2023/12/27 22:10:13
Table 'RushAndCash3832483' 6-max Seat #1 is the button
Seat 1: 8c13f88f ($7.72 in chips)
Seat 2: 31d20a36 ($12.64 in chips)
Seat 3: 511b4884 ($5.44 in chips)
Seat 4: 7cfb91ba ($5.14 in chips)
Seat 5: Hero ($10.59 in chips)
Seat 6: f24b7b85 ($7.34 in chips)
31d20a36: posts small blind $0.02
511b4884: posts big blind $0.05
*** HOLE CARDS ***
Dealt to 8c13f88f 
Dealt to 31d20a36 
Dealt to 511b4884 
Dealt to 7cfb91ba 
Dealt to Hero [Ac 5h]
Dealt to f24b7b85 
7cfb91ba: folds
Hero: folds
f24b7b85: folds
8c13f88f: raises $0.08 to $0.13
31d20a36: folds
511b4884: calls $0.08
*** FLOP *** [3s Tc 8s]
511b4884: checks
8c13f88f: bets $0.15
511b4884: folds
Uncalled bet ($0.15) returned to 8c13f88f
*** SHOWDOWN ***
8c13f88f collected $0.27 from pot
*** SUMMARY ***
Total pot $0.28 | Rake $0.01 | Jackpot $0 | Bingo $0 | Fortune $0 | Tax $0
Board [3s Tc 8s]
Seat 1: 8c13f88f (button) won ($0.27)
Seat 2: 31d20a36 (small blind) folded before Flop
Seat 3: 511b4884 (big blind) folded on the Flop
Seat 4: 7cfb91ba folded before Flop (didn't bet)
Seat 5: Hero folded before Flop (didn't bet)
Seat 6: f24b7b85 folded before Flop (didn't bet)


Poker Hand #RC2094837059: Hold'em No Limit ($0.02/$0.05) - 2023/12/27 22:10:10
Table 'RushAndCash3832450' 6-max Seat #1 is the button
Seat 1: ab155035 ($3.7 in chips)
Seat 2: 9a86c0e4 ($8.33 in chips)
Seat 3: 3742af02 ($9.92 in chips)
Seat 4: 685cd23 ($4.31 in chips)
Seat 5: Hero ($10.59 in chips)
Seat 6: 11433c46 ($4.63 in chips)
9a86c0e4: posts small blind $0.02
3742af02: posts big blind $0.05
*** HOLE CARDS ***
Dealt to ab155035 
Dealt to 9a86c0e4 
Dealt to 3742af02 
Dealt to 685cd23 
Dealt to Hero [3s 9c]
Dealt to 11433c46 
685cd23: folds
Hero: folds
11433c46: raises $0.07 to $0.12
ab155035: folds
9a86c0e4: folds
3742af02: folds
Uncalled bet ($0.07) returned to 11433c46
*** SHOWDOWN ***
11433c46 collected $0.12 from pot
*** SUMMARY ***
Total pot $0.12 | Rake $0 | Jackpot $0 | Bingo $0 | Fortune $0 | Tax $0
Seat 1: ab155035 (button) folded before Flop (didn't bet)
Seat 2: 9a86c0e4 (small blind) folded before Flop
Seat 3: 3742af02 (big blind) folded before Flop
Seat 4: 685cd23 folded before Flop (didn't bet)
Seat 5: Hero folded before Flop (didn't bet)
Seat 6: 11433c46 collected ($0.12)


Poker Hand #RC2094836982: Hold'em No Limit ($0.02/$0.05) - 2023/12/27 22:10:06
Table 'RushAndCash3832415' 6-max Seat #1 is the button
Seat 1: 94d693b2 ($7.61 in chips)
Seat 2: 29a92f58 ($13.28 in chips)
Seat 3: ef0ec9d9 ($7.18 in chips)
Seat 4: Hero ($10.59 in chips)
Seat 5: 5eae1fce ($7.54 in chips)
Seat 6: 7ac4c2d5 ($6.67 in chips)
29a92f58: posts small blind $0.02
ef0ec9d9: posts big blind $0.05
*** HOLE CARDS ***
Dealt to 94d693b2 
Dealt to 29a92f58 
Dealt to ef0ec9d9 
Dealt to Hero [3h 6h]
Dealt to 5eae1fce 
Dealt to 7ac4c2d5 
Hero: folds
5eae1fce: folds
7ac4c2d5: folds
94d693b2: folds
29a92f58: folds
Uncalled bet ($0.03) returned to ef0ec9d9
*** SHOWDOWN ***
ef0ec9d9 collected $0.04 from pot
*** SUMMARY ***
Total pot $0.04 | Rake $0 | Jackpot $0 | Bingo $0 | Fortune $0 | Tax $0
Seat 1: 94d693b2 (button) folded before Flop (didn't bet)
Seat 2: 29a92f58 (small blind) folded before Flop
Seat 3: ef0ec9d9 (big blind) collected ($0.04)
Seat 4: Hero folded before Flop (didn't bet)
Seat 5: 5eae1fce folded before Flop (didn't bet)
Seat 6: 7ac4c2d5 folded before Flop (didn't bet)


Poker Hand #RC2094836271: Hold'em No Limit ($0.02/$0.05) - 2023/12/27 22:09:33
Table 'RushAndCash3832070' 6-max Seat #1 is the button
Seat 1: d747766a ($3.67 in chips)
Seat 2: Hero ($10.72 in chips)
Seat 3: f33e82d8 ($9.41 in chips)
Seat 4: 6d629bd ($10 in chips)
Seat 5: 7e2dd2a2 ($8.68 in chips)
Seat 6: a564255e ($10.08 in chips)
Hero: posts small blind $0.02
f33e82d8: posts big blind $0.05
*** HOLE CARDS ***
Dealt to d747766a 
Dealt to Hero [9h 5h]
Dealt to f33e82d8 
Dealt to 6d629bd 
Dealt to 7e2dd2a2 
Dealt to a564255e 
6d629bd: folds
7e2dd2a2: folds
a564255e: folds
d747766a: folds
Hero: raises $0.08 to $0.13
f33e82d8: calls $0.08
*** FLOP *** [9s Qs 4s]
Hero: checks
f33e82d8: bets $0.09
Hero: folds
Uncalled bet ($0.09) returned to f33e82d8
*** SHOWDOWN ***
f33e82d8 collected $0.25 from pot
*** SUMMARY ***
Total pot $0.26 | Rake $0.01 | Jackpot $0 | Bingo $0 | Fortune $0 | Tax $0
Board [9s Qs 4s]
Seat 1: d747766a (button) folded before Flop (didn't bet)
Seat 2: Hero (small blind) folded on the Flop
Seat 3: f33e82d8 (big blind) won ($0.25)
Seat 4: 6d629bd folded before Flop (didn't bet)
Seat 5: 7e2dd2a2 folded before Flop (didn't bet)
Seat 6: a564255e folded before Flop (didn't bet)


Poker Hand #RC2094836131: Hold'em No Limit ($0.02/$0.05) - 2023/12/27 22:09:26
Table 'RushAndCash3832000' 6-max Seat #1 is the button
Seat 1: f73f3360 ($5.21 in chips)
Seat 2: Hero ($10.74 in chips)
Seat 3: a1e6400e ($6.5 in chips)
Seat 4: fa338ba2 ($3.55 in chips)
Seat 5: 4c5efad8 ($7.37 in chips)
Seat 6: 781281cd ($14.76 in chips)
Hero: posts small blind $0.02
a1e6400e: posts big blind $0.05
*** HOLE CARDS ***
Dealt to f73f3360 
Dealt to Hero [Ts Qd]
Dealt to a1e6400e 
Dealt to fa338ba2 
Dealt to 4c5efad8 
Dealt to 781281cd 
fa338ba2: raises $0.06 to $0.11
4c5efad8: folds
781281cd: folds
f73f3360: folds
Hero: folds
a1e6400e: folds
Uncalled bet ($0.06) returned to fa338ba2
*** SHOWDOWN ***
fa338ba2 collected $0.12 from pot
*** SUMMARY ***
Total pot $0.12 | Rake $0 | Jackpot $0 | Bingo $0 | Fortune $0 | Tax $0
Seat 1: f73f3360 (button) folded before Flop (didn't bet)
Seat 2: Hero (small blind) folded before Flop
Seat 3: a1e6400e (big blind) folded before Flop
Seat 4: fa338ba2 collected ($0.12)
Seat 5: 4c5efad8 folded before Flop (didn't bet)
Seat 6: 781281cd folded before Flop (didn't bet)


Poker Hand #RC2094836053: Hold'em No Limit ($0.02/$0.05) - 2023/12/27 22:09:23
Table 'RushAndCash3831965' 6-max Seat #1 is the button
Seat 1: 6d629bd ($10.02 in chips)
Seat 2: d1151834 ($4.62 in chips)
Seat 3: 5e0c61d6 ($6.44 in chips)
Seat 4: c28bae97 ($5.48 in chips)
Seat 5: 4c5efad8 ($7.37 in chips)
Seat 6: Hero ($10.74 in chips)
d1151834: posts small blind $0.02
5e0c61d6: posts big blind $0.05
*** HOLE CARDS ***
Dealt to 6d629bd 
Dealt to d1151834 
Dealt to 5e0c61d6 
Dealt to c28bae97 
Dealt to 4c5efad8 
Dealt to Hero [5s 8c]
c28bae97: raises $0.05 to $0.1
4c5efad8: folds
Hero: folds
6d629bd: folds
d1151834: raises $0.3 to $0.4
5e0c61d6: folds
c28bae97: folds
Uncalled bet ($0.3) returned to d1151834
*** SHOWDOWN ***
d1151834 collected $0.24 from pot
*** SUMMARY ***
Total pot $0.25 | Rake $0.01 | Jackpot $0 | Bingo $0 | Fortune $0 | Tax $0
Seat 1: 6d629bd (button) folded before Flop (didn't bet)
Seat 2: d1151834 (small blind) collected ($0.24)
Seat 3: 5e0c61d6 (big blind) folded before Flop
Seat 4: c28bae97 folded before Flop
Seat 5: 4c5efad8 folded before Flop (didn't bet)
Seat 6: Hero folded before Flop (didn't bet)


Poker Hand #RC2094835934: Hold'em No Limit ($0.02/$0.05) - 2023/12/27 22:09:17
Table 'RushAndCash3831909' 6-max Seat #1 is the button
Seat 1: e4bc673d ($6.25 in chips)
Seat 2: fd2b9b76 ($5.25 in chips)
Seat 3: b19b0d12 ($16.8 in chips)
Seat 4: 3b064713 ($3.15 in chips)
Seat 5: Hero ($10.74 in chips)
Seat 6: a3ae3500 ($4.16 in chips)
fd2b9b76: posts small blind $0.02
b19b0d12: posts big blind $0.05
*** HOLE CARDS ***
Dealt to e4bc673d 
Dealt to fd2b9b76 
Dealt to b19b0d12 
Dealt to 3b064713 
Dealt to Hero [6s 3h]
Dealt to a3ae3500 
3b064713: folds
Hero: folds
a3ae3500: folds
e4bc673d: folds
fd2b9b76: folds
Uncalled bet ($0.03) returned to b19b0d12
*** SHOWDOWN ***
b19b0d12 collected $0.04 from pot
*** SUMMARY ***
Total pot $0.04 | Rake $0 | Jackpot $0 | Bingo $0 | Fortune $0 | Tax $0
Seat 1: e4bc673d (button) folded before Flop (didn't bet)
Seat 2: fd2b9b76 (small blind) folded before Flop
Seat 3: b19b0d12 (big blind) collected ($0.04)
Seat 4: 3b064713 folded before Flop (didn't bet)
Seat 5: Hero folded before Flop (didn't bet)
Seat 6: a3ae3500 folded before Flop (didn't bet)


Poker Hand #RC2094835865: Hold'em No Limit ($0.02/$0.05) - 2023/12/27 22:09:14
Table 'RushAndCash3831874' 6-max Seat #1 is the button
Seat 1: Hero ($10.74 in chips)
Seat 2: d94cce2e ($5.42 in chips)
Seat 3: 2e3df286 ($7.11 in chips)
Seat 4: 9de73b0 ($4.93 in chips)
Seat 5: 61bf7d9e ($6.35 in chips)
Seat 6: d747766a ($3.74 in chips)
d94cce2e: posts small blind $0.02
2e3df286: posts big blind $0.05
*** HOLE CARDS ***
Dealt to Hero [9h 5s]
Dealt to d94cce2e 
Dealt to 2e3df286 
Dealt to 9de73b0 
Dealt to 61bf7d9e 
Dealt to d747766a 
9de73b0: folds
61bf7d9e: folds
d747766a: folds
Hero: folds
d94cce2e: raises $0.1 to $0.15
2e3df286: folds
Uncalled bet ($0.1) returned to d94cce2e
*** SHOWDOWN ***
d94cce2e collected $0.1 from pot
*** SUMMARY ***
Total pot $0.1 | Rake $0 | Jackpot $0 | Bingo $0 | Fortune $0 | Tax $0
Seat 1: Hero (button) folded before Flop (didn't bet)
Seat 2: d94cce2e (small blind) collected ($0.1)
Seat 3: 2e3df286 (big blind) folded before Flop
Seat 4: 9de73b0 folded before Flop (didn't bet)
Seat 5: 61bf7d9e folded before Flop (didn't bet)
Seat 6: d747766a folded before Flop (didn't bet)


Poker Hand #RC2094835749: Hold'em No Limit ($0.02/$0.05) - 2023/12/27 22:09:09
Table 'RushAndCash3831817' 6-max Seat #1 is the button
Seat 1: 3c85d52b ($5 in chips)
Seat 2: 66b6d542 ($5 in chips)
Seat 3: Hero ($10.79 in chips)
Seat 4: a19c8d21 ($8.95 in chips)
Seat 5: d94cce2e ($5.42 in chips)
Seat 6: 6e3662da ($6.59 in chips)
66b6d542: posts small blind $0.02
Hero: posts big blind $0.05
*** HOLE CARDS ***
Dealt to 3c85d52b 
Dealt to 66b6d542 
Dealt to Hero [Jh 5s]
Dealt to a19c8d21 
Dealt to d94cce2e 
Dealt to 6e3662da 
a19c8d21: raises $0.1 to $0.15
d94cce2e: folds
6e3662da: calls $0.15
3c85d52b: folds
66b6d542: folds
Hero: folds
*** FLOP *** [8c 7c 3d]
a19c8d21: checks
6e3662da: checks
*** TURN *** [8c 7c 3d] [Ks]
a19c8d21: bets $0.28
6e3662da: calls $0.28
*** RIVER *** [8c 7c 3d Ks] [Kd]
a19c8d21: bets $0.93
6e3662da: folds
Uncalled bet ($0.93) returned to a19c8d21
*** SHOWDOWN ***
a19c8d21 collected $0.89 from pot
*** SUMMARY ***
Total pot $0.93 | Rake $0.04 | Jackpot $0 | Bingo $0 | Fortune $0 | Tax $0
Board [8c 7c 3d Ks Kd]
Seat 1: 3c85d52b (button) folded before Flop (didn't bet)
Seat 2: 66b6d542 (small blind) folded before Flop
Seat 3: Hero (big blind) folded before Flop
Seat 4: a19c8d21 won ($0.89)
Seat 5: d94cce2e folded before Flop (didn't bet)
Seat 6: 6e3662da folded on the River


Poker Hand #RC2094835540: Hold'em No Limit ($0.02/$0.05) - 2023/12/27 22:08:58
Table 'RushAndCash3831722' 6-max Seat #1 is the button
Seat 1: 1500d168 ($1.81 in chips)
Seat 2: Hero ($10.81 in chips)
Seat 3: b51671a0 ($4.35 in chips)
Seat 4: 5310b3a9 ($4.83 in chips)
Seat 5: f100600f ($9.02 in chips)
Seat 6: 6db2b6b4 ($0.94 in chips)
Hero: posts small blind $0.02
b51671a0: posts big blind $0.05
*** HOLE CARDS ***
Dealt to 1500d168 
Dealt to Hero [8s Kc]
Dealt to b51671a0 
Dealt to 5310b3a9 
Dealt to f100600f 
Dealt to 6db2b6b4 
5310b3a9: folds
f100600f: folds
6db2b6b4: raises $0.1 to $0.15
1500d168: calls $0.15
Hero: folds
b51671a0: folds
*** FLOP *** [3c 7d Js]
6db2b6b4: checks
1500d168: bets $0.19
6db2b6b4: raises $0.6 to $0.79 and is all-in
1500d168: calls $0.6
6db2b6b4: shows [Ah 9s] (Ace-High)
1500d168: shows [Kh Jh] (Pair of Jacks)
1500d168: Chooses to EV Cashout 
*** TURN *** [3c 7d Js] [6d]
1500d168: Pays Cashout Risk ($0.1)
1500d168: Chooses to EV Cashout 
*** RIVER *** [3c 7d Js 6d] [6c]
1500d168: Pays Cashout Risk ($0.11)
*** SHOWDOWN ***
1500d168 collected $1.79 from pot
*** SUMMARY ***
Total pot $1.95 | Rake $0.09 | Jackpot $0.07 | Bingo $0 | Fortune $0 | Tax $0
Board [3c 7d Js 6d 6c]
Seat 1: 1500d168 (button) showed [Kh Jh] and won ($1.79) with Pair of Jacks and Pair of Sixes, Cashout Risk ($0.21)
Seat 2: Hero (small blind) folded before Flop
Seat 3: b51671a0 (big blind) folded before Flop
Seat 4: 5310b3a9 folded before Flop (didn't bet)
Seat 5: f100600f folded before Flop (didn't bet)
Seat 6: 6db2b6b4 showed [Ah 9s] and lost with Pair of Sixes


Poker Hand #RC2094835465: Hold'em No Limit ($0.02/$0.05) - 2023/12/27 22:08:54
Table 'RushAndCash3831688' 6-max Seat #1 is the button
Seat 1: 616ddc49 ($4.67 in chips)
Seat 2: f2144920 ($5 in chips)
Seat 3: fda11e6a ($4.98 in chips)
Seat 4: 48e90abf ($5.99 in chips)
Seat 5: e35d6e2e ($6.23 in chips)
Seat 6: Hero ($10.81 in chips)
f2144920: posts small blind $0.02
fda11e6a: posts big blind $0.05
*** HOLE CARDS ***
Dealt to 616ddc49 
Dealt to f2144920 
Dealt to fda11e6a 
Dealt to 48e90abf 
Dealt to e35d6e2e 
Dealt to Hero [5h Qs]
48e90abf: folds
e35d6e2e: folds
Hero: folds
616ddc49: raises $0.08 to $0.13
f2144920: folds
fda11e6a: folds
Uncalled bet ($0.08) returned to 616ddc49
*** SHOWDOWN ***
616ddc49 collected $0.12 from pot
*** SUMMARY ***
Total pot $0.12 | Rake $0 | Jackpot $0 | Bingo $0 | Fortune $0 | Tax $0
Seat 1: 616ddc49 (button) collected ($0.12)
Seat 2: f2144920 (small blind) folded before Flop
Seat 3: fda11e6a (big blind) folded before Flop
Seat 4: 48e90abf folded before Flop (didn't bet)
Seat 5: e35d6e2e folded before Flop (didn't bet)
Seat 6: Hero folded before Flop (didn't bet)


Poker Hand #RC2094835389: Hold'em No Limit ($0.02/$0.05) - 2023/12/27 22:08:50
Table 'RushAndCash3831653' 6-max Seat #1 is the button
Seat 1: a4c223ac ($4.86 in chips)
Seat 2: cffa41d9 ($4.62 in chips)
Seat 3: c03393aa ($7.91 in chips)
Seat 4: 6207e1fe ($5.15 in chips)
Seat 5: 6431e365 ($13.33 in chips)
Seat 6: Hero ($10.81 in chips)
cffa41d9: posts small blind $0.02
c03393aa: posts big blind $0.05
*** HOLE CARDS ***
Dealt to a4c223ac 
Dealt to cffa41d9 
Dealt to c03393aa 
Dealt to 6207e1fe 
Dealt to 6431e365 
Dealt to Hero [6s Qd]
6207e1fe: folds
6431e365: raises $0.07 to $0.12
Hero: folds
a4c223ac: folds
cffa41d9: folds
c03393aa: folds
Uncalled bet ($0.07) returned to 6431e365
*** SHOWDOWN ***
6431e365 collected $0.12 from pot
*** SUMMARY ***
Total pot $0.12 | Rake $0 | Jackpot $0 | Bingo $0 | Fortune $0 | Tax $0
Seat 1: a4c223ac (button) folded before Flop (didn't bet)
Seat 2: cffa41d9 (small blind) folded before Flop
Seat 3: c03393aa (big blind) folded before Flop
Seat 4: 6207e1fe folded before Flop (didn't bet)
Seat 5: 6431e365 collected ($0.12)
Seat 6: Hero folded before Flop (didn't bet)


Poker Hand #RC2094835279: Hold'em No Limit ($0.02/$0.05) - 2023/12/27 22:08:45
Table 'RushAndCash3831601' 6-max Seat #1 is the button
Seat 1: 384d6fac ($9 in chips)
Seat 2: f100600f ($8.97 in chips)
Seat 3: 589cc4e2 ($16.92 in chips)
Seat 4: f05dee9b ($7.84 in chips)
Seat 5: Hero ($10.81 in chips)
Seat 6: d312bd1 ($6.75 in chips)
f100600f: posts small blind $0.02
589cc4e2: posts big blind $0.05
*** HOLE CARDS ***
Dealt to 384d6fac 
Dealt to f100600f 
Dealt to 589cc4e2 
Dealt to f05dee9b 
Dealt to Hero [4c Qh]
Dealt to d312bd1 
f05dee9b: folds
Hero: folds
d312bd1: folds
384d6fac: folds
f100600f: raises $0.1 to $0.15
589cc4e2: folds
Uncalled bet ($0.1) returned to f100600f
*** SHOWDOWN ***
f100600f collected $0.1 from pot
*** SUMMARY ***
Total pot $0.1 | Rake $0 | Jackpot $0 | Bingo $0 | Fortune $0 | Tax $0
Seat 1: 384d6fac (button) folded before Flop (didn't bet)
Seat 2: f100600f (small blind) collected ($0.1)
Seat 3: 589cc4e2 (big blind) folded before Flop
Seat 4: f05dee9b folded before Flop (didn't bet)
Seat 5: Hero folded before Flop (didn't bet)
Seat 6: d312bd1 folded before Flop (didn't bet)


Poker Hand #RC2094835200: Hold'em No Limit ($0.02/$0.05) - 2023/12/27 22:08:42
Table 'RushAndCash3831569' 6-max Seat #1 is the button
Seat 1: Hero ($10.81 in chips)
Seat 2: 5edbcb03 ($9.29 in chips)
Seat 3: 14483e43 ($6.11 in chips)
Seat 4: 4c5efad8 ($7.07 in chips)
Seat 5: 9ae5ba4f ($5 in chips)
Seat 6: c4d14388 ($5.09 in chips)
5edbcb03: posts small blind $0.02
14483e43: posts big blind $0.05
*** HOLE CARDS ***
Dealt to Hero [Qc 5h]
Dealt to 5edbcb03 
Dealt to 14483e43 
Dealt to 4c5efad8 
Dealt to 9ae5ba4f 
Dealt to c4d14388 
4c5efad8: raises $0.06 to $0.11
9ae5ba4f: calls $0.11
c4d14388: folds
Hero: folds
5edbcb03: folds
14483e43: folds
*** FLOP *** [6c 7h 2c]
4c5efad8: bets $0.15
9ae5ba4f: calls $0.15
*** TURN *** [6c 7h 2c] [3d]
4c5efad8: checks
9ae5ba4f: checks
*** RIVER *** [6c 7h 2c 3d] [7d]
4c5efad8: bets $0.46
9ae5ba4f: folds
Uncalled bet ($0.46) returned to 4c5efad8
*** SHOWDOWN ***
4c5efad8 collected $0.56 from pot
*** SUMMARY ***
Total pot $0.59 | Rake $0.03 | Jackpot $0 | Bingo $0 | Fortune $0 | Tax $0
Board [6c 7h 2c 3d 7d]
Seat 1: Hero (button) folded before Flop (didn't bet)
Seat 2: 5edbcb03 (small blind) folded before Flop
Seat 3: 14483e43 (big blind) folded before Flop
Seat 4: 4c5efad8 won ($0.56)
Seat 5: 9ae5ba4f folded on the River
Seat 6: c4d14388 folded before Flop (didn't bet)


Poker Hand #RC2094835123: Hold'em No Limit ($0.02/$0.05) - 2023/12/27 22:08:38
Table 'RushAndCash3831532' 6-max Seat #1 is the button
Seat 1: f1591abc ($17.56 in chips)
Seat 2: eeb4ff60 ($5 in chips)
Seat 3: 8e1e4bb4 ($7.74 in chips)
Seat 4: Hero ($10.81 in chips)
Seat 5: e35d6e2e ($6.23 in chips)
Seat 6: 5670c48b ($5.08 in chips)
eeb4ff60: posts small blind $0.02
8e1e4bb4: posts big blind $0.05
*** HOLE CARDS ***
Dealt to f1591abc 
Dealt to eeb4ff60 
Dealt to 8e1e4bb4 
Dealt to Hero [8h 6d]
Dealt to e35d6e2e 
Dealt to 5670c48b 
Hero: folds
e35d6e2e: folds
5670c48b: folds
f1591abc: raises $0.05 to $0.1
eeb4ff60: folds
8e1e4bb4: folds
Uncalled bet ($0.05) returned to f1591abc
*** SHOWDOWN ***
f1591abc collected $0.12 from pot
*** SUMMARY ***
Total pot $0.12 | Rake $0 | Jackpot $0 | Bingo $0 | Fortune $0 | Tax $0
Seat 1: f1591abc (button) collected ($0.12)
Seat 2: eeb4ff60 (small blind) folded before Flop
Seat 3: 8e1e4bb4 (big blind) folded before Flop
Seat 4: Hero folded before Flop (didn't bet)
Seat 5: e35d6e2e folded before Flop (didn't bet)
Seat 6: 5670c48b folded before Flop (didn't bet)


Poker Hand #RC2094804595: Hold'em No Limit ($0.02/$0.05) - 2023/12/27 22:08:13
Table 'RushAndCash3831289' 6-max Seat #1 is the button
Seat 1: 475d8f40 ($5 in chips)
Seat 2: 19553e89 ($5 in chips)
Seat 3: Hero ($10.62 in chips)
Seat 4: 74c2f2d2 ($5.46 in chips)
Seat 5: eaa97e93 ($7.5 in chips)
Seat 6: 82961c60 ($5.38 in chips)
19553e89: posts small blind $0.02
Hero: posts big blind $0.05
*** HOLE CARDS ***
Dealt to 475d8f40 
Dealt to 19553e89 
Dealt to Hero [Ad 3d]
Dealt to 74c2f2d2 
Dealt to eaa97e93 
Dealt to 82961c60 
74c2f2d2: folds
eaa97e93: folds
82961c60: folds
475d8f40: folds
19553e89: raises $0.08 to $0.13
Hero: calls $0.08
*** FLOP *** [Qh Ts 5d]
19553e89: bets $0.08
Hero: raises $0.13 to $0.21
19553e89: folds
Uncalled bet ($0.13) returned to Hero
*** SHOWDOWN ***
Hero collected $0.4 from pot
*** SUMMARY ***
Total pot $0.42 | Rake $0.02 | Jackpot $0 | Bingo $0 | Fortune $0 | Tax $0
Board [Qh Ts 5d]
Seat 1: 475d8f40 (button) folded before Flop (didn't bet)
Seat 2: 19553e89 (small blind) folded on the Flop
Seat 3: Hero (big blind) won ($0.4)
Seat 4: 74c2f2d2 folded before Flop (didn't bet)
Seat 5: eaa97e93 folded before Flop (didn't bet)
Seat 6: 82961c60 folded before Flop (didn't bet)


Poker Hand #RC2094804501: Hold'em No Limit ($0.02/$0.05) - 2023/12/27 22:08:09
Table 'RushAndCash3831245' 6-max Seat #1 is the button
Seat 1: d648759 ($20.56 in chips)
Seat 2: d5e6701e ($1.83 in chips)
Seat 3: cbe5518b ($13.35 in chips)
Seat 4: 44161807 ($5.45 in chips)
Seat 5: Hero ($10.62 in chips)
Seat 6: 1b33f895 ($5.57 in chips)
d5e6701e: posts small blind $0.02
cbe5518b: posts big blind $0.05
*** HOLE CARDS ***
Dealt to d648759 
Dealt to d5e6701e 
Dealt to cbe5518b 
Dealt to 44161807 
Dealt to Hero [2d 5h]
Dealt to 1b33f895 
44161807: folds
Hero: folds
1b33f895: folds
d648759: raises $0.08 to $0.13
d5e6701e: folds
cbe5518b: folds
Uncalled bet ($0.08) returned to d648759
*** SHOWDOWN ***
d648759 collected $0.12 from pot
*** SUMMARY ***
Total pot $0.12 | Rake $0 | Jackpot $0 | Bingo $0 | Fortune $0 | Tax $0
Seat 1: d648759 (button) collected ($0.12)
Seat 2: d5e6701e (small blind) folded before Flop
Seat 3: cbe5518b (big blind) folded before Flop
Seat 4: 44161807 folded before Flop (didn't bet)
Seat 5: Hero folded before Flop (didn't bet)
Seat 6: 1b33f895 folded before Flop (didn't bet)


Poker Hand #RC2094804421: Hold'em No Limit ($0.02/$0.05) - 2023/12/27 22:08:05
Table 'RushAndCash3831207' 6-max Seat #1 is the button
Seat 1: 9a86c0e4 ($7.91 in chips)
Seat 2: 4270bd16 ($7.45 in chips)
Seat 3: e4bc673d ($6.23 in chips)
Seat 4: bc97b5d0 ($6.02 in chips)
Seat 5: Hero ($10.62 in chips)
Seat 6: 80bc4dbd ($6.97 in chips)
4270bd16: posts small blind $0.02
e4bc673d: posts big blind $0.05
*** HOLE CARDS ***
Dealt to 9a86c0e4 
Dealt to 4270bd16 
Dealt to e4bc673d 
Dealt to bc97b5d0 
Dealt to Hero [6h Ks]
Dealt to 80bc4dbd 
bc97b5d0: folds
Hero: folds
80bc4dbd: raises $0.08 to $0.13
9a86c0e4: folds
4270bd16: raises $0.29 to $0.42
e4bc673d: folds
80bc4dbd: calls $0.29
*** FLOP *** [2h 5c 2c]
4270bd16: bets $0.59
80bc4dbd: folds
Uncalled bet ($0.59) returned to 4270bd16
*** SHOWDOWN ***
4270bd16 collected $0.84 from pot
*** SUMMARY ***
Total pot $0.89 | Rake $0.05 | Jackpot $0 | Bingo $0 | Fortune $0 | Tax $0
Board [2h 5c 2c]
Seat 1: 9a86c0e4 (button) folded before Flop (didn't bet)
Seat 2: 4270bd16 (small blind) won ($0.84)
Seat 3: e4bc673d (big blind) folded before Flop
Seat 4: bc97b5d0 folded before Flop (didn't bet)
Seat 5: Hero folded before Flop (didn't bet)
Seat 6: 80bc4dbd folded on the Flop


Poker Hand #RC2094804285: Hold'em No Limit ($0.02/$0.05) - 2023/12/27 22:07:59
Table 'RushAndCash3831146' 6-max Seat #1 is the button
Seat 1: 10815671 ($9.15 in chips)
Seat 2: Hero ($10.64 in chips)
Seat 3: d648759 ($20.61 in chips)
Seat 4: c03393aa ($7.7 in chips)
Seat 5: c74fefbb ($5.11 in chips)
Seat 6: c8fcf0e7 ($5.89 in chips)
Hero: posts small blind $0.02
d648759: posts big blind $0.05
*** HOLE CARDS ***
Dealt to 10815671 
Dealt to Hero [Kh 4c]
Dealt to d648759 
Dealt to c03393aa 
Dealt to c74fefbb 
Dealt to c8fcf0e7 
c03393aa: raises $0.05 to $0.1
c74fefbb: folds
c8fcf0e7: folds
10815671: folds
Hero: folds
d648759: folds
Uncalled bet ($0.05) returned to c03393aa
*** SHOWDOWN ***
c03393aa collected $0.12 from pot
*** SUMMARY ***
Total pot $0.12 | Rake $0 | Jackpot $0 | Bingo $0 | Fortune $0 | Tax $0
Seat 1: 10815671 (button) folded before Flop (didn't bet)
Seat 2: Hero (small blind) folded before Flop
Seat 3: d648759 (big blind) folded before Flop
Seat 4: c03393aa collected ($0.12)
Seat 5: c74fefbb folded before Flop (didn't bet)
Seat 6: c8fcf0e7 folded before Flop (didn't bet)


Poker Hand #RC2094804023: Hold'em No Limit ($0.02/$0.05) - 2023/12/27 22:07:46
Table 'RushAndCash3831028' 6-max Seat #1 is the button
Seat 1: 4aa82e45 ($7.04 in chips)
Seat 2: 5670c48b ($5.25 in chips)
Seat 3: 1cd4b990 ($4.14 in chips)
Seat 4: Hero ($10.57 in chips)
Seat 5: 57ba2dfd ($8.37 in chips)
Seat 6: 40e2ea8e ($7.93 in chips)
5670c48b: posts small blind $0.02
1cd4b990: posts big blind $0.05
*** HOLE CARDS ***
Dealt to 4aa82e45 
Dealt to 5670c48b 
Dealt to 1cd4b990 
Dealt to Hero [4c 4s]
Dealt to 57ba2dfd 
Dealt to 40e2ea8e 
Hero: raises $0.05 to $0.1
57ba2dfd: folds
40e2ea8e: folds
4aa82e45: folds
5670c48b: folds
1cd4b990: folds
Uncalled bet ($0.05) returned to Hero
*** SHOWDOWN ***
Hero collected $0.12 from pot
*** SUMMARY ***
Total pot $0.12 | Rake $0 | Jackpot $0 | Bingo $0 | Fortune $0 | Tax $0
Seat 1: 4aa82e45 (button) folded before Flop (didn't bet)
Seat 2: 5670c48b (small blind) folded before Flop
Seat 3: 1cd4b990 (big blind) folded before Flop
Seat 4: Hero collected ($0.12)
Seat 5: 57ba2dfd folded before Flop (didn't bet)
Seat 6: 40e2ea8e folded before Flop (didn't bet)


Poker Hand #RC2094803726: Hold'em No Limit ($0.02/$0.05) - 2023/12/27 22:07:33
Table 'RushAndCash3830888' 6-max Seat #1 is the button
Seat 1: e4528ee4 ($9.88 in chips)
Seat 2: 48e90abf ($6.03 in chips)
Seat 3: Hero ($10.62 in chips)
Seat 4: c7d29ab9 ($6.05 in chips)
Seat 5: fe238212 ($3.66 in chips)
Seat 6: 5e0c61d6 ($7.39 in chips)
48e90abf: posts small blind $0.02
Hero: posts big blind $0.05
*** HOLE CARDS ***
Dealt to e4528ee4 
Dealt to 48e90abf 
Dealt to Hero [Qd 8c]
Dealt to c7d29ab9 
Dealt to fe238212 
Dealt to 5e0c61d6 
c7d29ab9: folds
fe238212: folds
5e0c61d6: folds
e4528ee4: folds
48e90abf: raises $0.1 to $0.15
Hero: folds
Uncalled bet ($0.1) returned to 48e90abf
*** SHOWDOWN ***
48e90abf collected $0.1 from pot
*** SUMMARY ***
Total pot $0.1 | Rake $0 | Jackpot $0 | Bingo $0 | Fortune $0 | Tax $0
Seat 1: e4528ee4 (button) folded before Flop (didn't bet)
Seat 2: 48e90abf (small blind) collected ($0.1)
Seat 3: Hero (big blind) folded before Flop
Seat 4: c7d29ab9 folded before Flop (didn't bet)
Seat 5: fe238212 folded before Flop (didn't bet)
Seat 6: 5e0c61d6 folded before Flop (didn't bet)


Poker Hand #RC2094803634: Hold'em No Limit ($0.02/$0.05) - 2023/12/27 22:07:28
Table 'RushAndCash3830844' 6-max Seat #1 is the button
Seat 1: Hero ($10.62 in chips)
Seat 2: ec20e0ee ($6.98 in chips)
Seat 3: 5038d288 ($4.33 in chips)
Seat 4: 8279270c ($5.5 in chips)
Seat 5: cdb234d7 ($5.76 in chips)
Seat 6: 361db037 ($4.75 in chips)
ec20e0ee: posts small blind $0.02
5038d288: posts big blind $0.05
*** HOLE CARDS ***
Dealt to Hero [Th 4d]
Dealt to ec20e0ee 
Dealt to 5038d288 
Dealt to 8279270c 
Dealt to cdb234d7 
Dealt to 361db037 
8279270c: folds
cdb234d7: raises $0.06 to $0.11
361db037: folds
Hero: folds
ec20e0ee: folds
5038d288: folds
Uncalled bet ($0.06) returned to cdb234d7
*** SHOWDOWN ***
cdb234d7 collected $0.12 from pot
*** SUMMARY ***
Total pot $0.12 | Rake $0 | Jackpot $0 | Bingo $0 | Fortune $0 | Tax $0
Seat 1: Hero (button) folded before Flop (didn't bet)
Seat 2: ec20e0ee (small blind) folded before Flop
Seat 3: 5038d288 (big blind) folded before Flop
Seat 4: 8279270c folded before Flop (didn't bet)
Seat 5: cdb234d7 collected ($0.12)
Seat 6: 361db037 folded before Flop (didn't bet)


Poker Hand #RC2094803555: Hold'em No Limit ($0.02/$0.05) - 2023/12/27 22:07:24
Table 'RushAndCash3830805' 6-max Seat #1 is the button
Seat 1: Hero ($10.62 in chips)
Seat 2: 143f7b2f ($3.77 in chips)
Seat 3: 30d7a069 ($5.65 in chips)
Seat 4: 3679dcf2 ($6.81 in chips)
Seat 5: d7b73e59 ($5.64 in chips)
Seat 6: e3d1a324 ($5.84 in chips)
143f7b2f: posts small blind $0.02
30d7a069: posts big blind $0.05
*** HOLE CARDS ***
Dealt to Hero [7s 2s]
Dealt to 143f7b2f 
Dealt to 30d7a069 
Dealt to 3679dcf2 
Dealt to d7b73e59 
Dealt to e3d1a324 
3679dcf2: raises $0.06 to $0.11
d7b73e59: raises $0.29 to $0.4
e3d1a324: folds
Hero: folds
143f7b2f: folds
30d7a069: folds
3679dcf2: folds
Uncalled bet ($0.29) returned to d7b73e59
*** SHOWDOWN ***
d7b73e59 collected $0.28 from pot
*** SUMMARY ***
Total pot $0.29 | Rake $0.01 | Jackpot $0 | Bingo $0 | Fortune $0 | Tax $0
Seat 1: Hero (button) folded before Flop (didn't bet)
Seat 2: 143f7b2f (small blind) folded before Flop
Seat 3: 30d7a069 (big blind) folded before Flop
Seat 4: 3679dcf2 folded before Flop
Seat 5: d7b73e59 collected ($0.28)
Seat 6: e3d1a324 folded before Flop (didn't bet)


Poker Hand #RC2094803439: Hold'em No Limit ($0.02/$0.05) - 2023/12/27 22:07:18
Table 'RushAndCash3830748' 6-max Seat #1 is the button
Seat 1: bc79e3f1 ($17.97 in chips)
Seat 2: Hero ($10.64 in chips)
Seat 3: 592b7a18 ($5.86 in chips)
Seat 4: 1325fa5a ($5.6 in chips)
Seat 5: 8279270c ($5.5 in chips)
Seat 6: 3ea707b7 ($5.14 in chips)
Hero: posts small blind $0.02
592b7a18: posts big blind $0.05
*** HOLE CARDS ***
Dealt to bc79e3f1 
Dealt to Hero [3h 2d]
Dealt to 592b7a18 
Dealt to 1325fa5a 
Dealt to 8279270c 
Dealt to 3ea707b7 
1325fa5a: raises $0.05 to $0.1
8279270c: folds
3ea707b7: folds
bc79e3f1: calls $0.1
Hero: folds
592b7a18: folds
*** FLOP *** [Qc 3d 6d]
1325fa5a: checks
bc79e3f1: checks
*** TURN *** [Qc 3d 6d] [Kc]
1325fa5a: bets $0.05
bc79e3f1: calls $0.05
*** RIVER *** [Qc 3d 6d Kc] [9s]
1325fa5a: bets $0.28
bc79e3f1: folds
Uncalled bet ($0.28) returned to 1325fa5a
*** SHOWDOWN ***
1325fa5a collected $0.36 from pot
*** SUMMARY ***
Total pot $0.37 | Rake $0.01 | Jackpot $0 | Bingo $0 | Fortune $0 | Tax $0
Board [Qc 3d 6d Kc 9s]
Seat 1: bc79e3f1 (button) folded on the River
Seat 2: Hero (small blind) folded before Flop
Seat 3: 592b7a18 (big blind) folded before Flop
Seat 4: 1325fa5a won ($0.36)
Seat 5: 8279270c folded before Flop (didn't bet)
Seat 6: 3ea707b7 folded before Flop (didn't bet)


Poker Hand #RC2094803362: Hold'em No Limit ($0.02/$0.05) - 2023/12/27 22:07:15
Table 'RushAndCash3830710' 6-max Seat #1 is the button
Seat 1: 945a5eb8 ($5 in chips)
Seat 2: a5aa7de ($4.8 in chips)
Seat 3: bfa824ef ($4.84 in chips)
Seat 4: ae5a46b0 ($6.44 in chips)
Seat 5: bc79e3f1 ($17.97 in chips)
Seat 6: Hero ($10.64 in chips)
a5aa7de: posts small blind $0.02
bfa824ef: posts big blind $0.05
*** HOLE CARDS ***
Dealt to 945a5eb8 
Dealt to a5aa7de 
Dealt to bfa824ef 
Dealt to ae5a46b0 
Dealt to bc79e3f1 
Dealt to Hero [3s 7d]
ae5a46b0: folds
bc79e3f1: folds
Hero: folds
945a5eb8: folds
a5aa7de: folds
Uncalled bet ($0.03) returned to bfa824ef
*** SHOWDOWN ***
bfa824ef collected $0.04 from pot
*** SUMMARY ***
Total pot $0.04 | Rake $0 | Jackpot $0 | Bingo $0 | Fortune $0 | Tax $0
Seat 1: 945a5eb8 (button) folded before Flop (didn't bet)
Seat 2: a5aa7de (small blind) folded before Flop
Seat 3: bfa824ef (big blind) collected ($0.04)
Seat 4: ae5a46b0 folded before Flop (didn't bet)
Seat 5: bc79e3f1 folded before Flop (didn't bet)
Seat 6: Hero folded before Flop (didn't bet)


Poker Hand #RC2094803276: Hold'em No Limit ($0.02/$0.05) - 2023/12/27 22:07:11
Table 'RushAndCash3830668' 6-max Seat #1 is the button
Seat 1: a891845b ($5.43 in chips)
Seat 2: 251d3082 ($5 in chips)
Seat 3: f35b3ca8 ($6.2 in chips)
Seat 4: Hero ($10.64 in chips)
Seat 5: b2082962 ($5.15 in chips)
Seat 6: 69f7ac74 ($17.2 in chips)
251d3082: posts small blind $0.02
f35b3ca8: posts big blind $0.05
*** HOLE CARDS ***
Dealt to a891845b 
Dealt to 251d3082 
Dealt to f35b3ca8 
Dealt to Hero [2h 3s]
Dealt to b2082962 
Dealt to 69f7ac74 
Hero: folds
b2082962: folds
69f7ac74: folds
a891845b: folds
251d3082: folds
Uncalled bet ($0.03) returned to f35b3ca8
*** SHOWDOWN ***
f35b3ca8 collected $0.04 from pot
*** SUMMARY ***
Total pot $0.04 | Rake $0 | Jackpot $0 | Bingo $0 | Fortune $0 | Tax $0
Seat 1: a891845b (button) folded before Flop (didn't bet)
Seat 2: 251d3082 (small blind) folded before Flop
Seat 3: f35b3ca8 (big blind) collected ($0.04)
Seat 4: Hero folded before Flop (didn't bet)
Seat 5: b2082962 folded before Flop (didn't bet)
Seat 6: 69f7ac74 folded before Flop (didn't bet)


Poker Hand #RC2094803187: Hold'em No Limit ($0.02/$0.05) - 2023/12/27 22:07:07
Table 'RushAndCash3830625' 6-max Seat #1 is the button
Seat 1: 62f3707a ($7.55 in chips)
Seat 2: 593ac210 ($5.16 in chips)
Seat 3: b74177f1 ($5.07 in chips)
Seat 4: Hero ($10.64 in chips)
Seat 5: 1b28deb0 ($5.32 in chips)
Seat 6: bfec306f ($5.31 in chips)
593ac210: posts small blind $0.02
b74177f1: posts big blind $0.05
*** HOLE CARDS ***
Dealt to 62f3707a 
Dealt to 593ac210 
Dealt to b74177f1 
Dealt to Hero [4c 6s]
Dealt to 1b28deb0 
Dealt to bfec306f 
Hero: folds
1b28deb0: folds
bfec306f: folds
62f3707a: raises $0.05 to $0.1
593ac210: calls $0.08
b74177f1: folds
*** FLOP *** [3c 3s Ac]
593ac210: checks
62f3707a: bets $0.08
593ac210: calls $0.08
*** TURN *** [3c 3s Ac] [Kc]
593ac210: checks
62f3707a: checks
*** RIVER *** [3c 3s Ac Kc] [4d]
593ac210: checks
62f3707a: checks
593ac210: shows [2c 2h] (Pair of Treys and Pair of Twos)
62f3707a: shows [Ks 9s] (Pair of Kings and Pair of Treys)
*** SHOWDOWN ***
62f3707a collected $0.39 from pot
*** SUMMARY ***
Total pot $0.41 | Rake $0.02 | Jackpot $0 | Bingo $0 | Fortune $0 | Tax $0
Board [3c 3s Ac Kc 4d]
Seat 1: 62f3707a (button) showed [Ks 9s] and won ($0.39) with Pair of Kings and Pair of Treys
Seat 2: 593ac210 (small blind) showed [2c 2h] and lost with Pair of Treys and Pair of Twos
Seat 3: b74177f1 (big blind) folded before Flop
Seat 4: Hero folded before Flop (didn't bet)
Seat 5: 1b28deb0 folded before Flop (didn't bet)
Seat 6: bfec306f folded before Flop (didn't bet)


Poker Hand #RC2094803031: Hold'em No Limit ($0.02/$0.05) - 2023/12/27 22:06:59
Table 'RushAndCash3830552' 6-max Seat #1 is the button
Seat 1: 5fc0c0b6 ($5 in chips)
Seat 2: 3ea707b7 ($5 in chips)
Seat 3: Hero ($10.69 in chips)
Seat 4: da556f42 ($5.87 in chips)
Seat 5: d747766a ($4.06 in chips)
Seat 6: 63ca922b ($5.33 in chips)
3ea707b7: posts small blind $0.02
Hero: posts big blind $0.05
*** HOLE CARDS ***
Dealt to 5fc0c0b6 
Dealt to 3ea707b7 
Dealt to Hero [5c Qh]
Dealt to da556f42 
Dealt to d747766a 
Dealt to 63ca922b 
da556f42: folds
d747766a: folds
63ca922b: folds
5fc0c0b6: calls $0.05
3ea707b7: folds
Hero: checks
*** FLOP *** [5d 8c As]
Hero: checks
5fc0c0b6: bets $0.12
Hero: folds
Uncalled bet ($0.12) returned to 5fc0c0b6
*** SHOWDOWN ***
5fc0c0b6 collected $0.12 from pot
*** SUMMARY ***
Total pot $0.12 | Rake $0 | Jackpot $0 | Bingo $0 | Fortune $0 | Tax $0
Board [5d 8c As]
Seat 1: 5fc0c0b6 (button) won ($0.12)
Seat 2: 3ea707b7 (small blind) folded before Flop
Seat 3: Hero (big blind) folded on the Flop
Seat 4: da556f42 folded before Flop (didn't bet)
Seat 5: d747766a folded before Flop (didn't bet)
Seat 6: 63ca922b folded before Flop (didn't bet)


Poker Hand #RC2094802373: Hold'em No Limit ($0.02/$0.05) - 2023/12/27 22:06:27
Table 'RushAndCash3830242' 6-max Seat #1 is the button
Seat 1: fbad1ce9 ($2.94 in chips)
Seat 2: 3d24497a ($11.23 in chips)
Seat 3: Hero ($10.84 in chips)
Seat 4: 33ba077d ($5 in chips)
Seat 5: 469fe577 ($5.95 in chips)
Seat 6: f35b3ca8 ($6.04 in chips)
3d24497a: posts small blind $0.02
Hero: posts big blind $0.05
*** HOLE CARDS ***
Dealt to fbad1ce9 
Dealt to 3d24497a 
Dealt to Hero [Td Ad]
Dealt to 33ba077d 
Dealt to 469fe577 
Dealt to f35b3ca8 
33ba077d: folds
469fe577: folds
f35b3ca8: raises $0.1 to $0.15
fbad1ce9: folds
3d24497a: folds
Hero: calls $0.1
*** FLOP *** [5c Qc 5s]
Hero: checks
f35b3ca8: bets $0.16
Hero: folds
Uncalled bet ($0.16) returned to f35b3ca8
*** SHOWDOWN ***
f35b3ca8 collected $0.31 from pot
*** SUMMARY ***
Total pot $0.32 | Rake $0.01 | Jackpot $0 | Bingo $0 | Fortune $0 | Tax $0
Board [5c Qc 5s]
Seat 1: fbad1ce9 (button) folded before Flop (didn't bet)
Seat 2: 3d24497a (small blind) folded before Flop
Seat 3: Hero (big blind) folded on the Flop
Seat 4: 33ba077d folded before Flop (didn't bet)
Seat 5: 469fe577 folded before Flop (didn't bet)
Seat 6: f35b3ca8 won ($0.31)


Poker Hand #RC2094802291: Hold'em No Limit ($0.02/$0.05) - 2023/12/27 22:06:24
Table 'RushAndCash3830202' 6-max Seat #1 is the button
Seat 1: 8ac40a2f ($5.05 in chips)
Seat 2: 1e5c9655 ($5.06 in chips)
Seat 3: 748bef6 ($7.37 in chips)
Seat 4: 1f8f446a ($8.35 in chips)
Seat 5: bc97b5d0 ($6.85 in chips)
Seat 6: Hero ($10.84 in chips)
1e5c9655: posts small blind $0.02
748bef6: posts big blind $0.05
*** HOLE CARDS ***
Dealt to 8ac40a2f 
Dealt to 1e5c9655 
Dealt to 748bef6 
Dealt to 1f8f446a 
Dealt to bc97b5d0 
Dealt to Hero [8h Tc]
1f8f446a: folds
bc97b5d0: folds
Hero: folds
8ac40a2f: folds
1e5c9655: folds
Uncalled bet ($0.03) returned to 748bef6
*** SHOWDOWN ***
748bef6 collected $0.04 from pot
*** SUMMARY ***
Total pot $0.04 | Rake $0 | Jackpot $0 | Bingo $0 | Fortune $0 | Tax $0
Seat 1: 8ac40a2f (button) folded before Flop (didn't bet)
Seat 2: 1e5c9655 (small blind) folded before Flop
Seat 3: 748bef6 (big blind) collected ($0.04)
Seat 4: 1f8f446a folded before Flop (didn't bet)
Seat 5: bc97b5d0 folded before Flop (didn't bet)
Seat 6: Hero folded before Flop (didn't bet)


Poker Hand #RC2094802204: Hold'em No Limit ($0.02/$0.05) - 2023/12/27 22:06:20
Table 'RushAndCash3830160' 6-max Seat #1 is the button
Seat 1: 56977ca6 ($4.93 in chips)
Seat 2: 1e38fa90 ($5.39 in chips)
Seat 3: c1959558 ($5.53 in chips)
Seat 4: 8dc4f307 ($7.06 in chips)
Seat 5: 53d86a23 ($6.77 in chips)
Seat 6: Hero ($10.84 in chips)
1e38fa90: posts small blind $0.02
c1959558: posts big blind $0.05
*** HOLE CARDS ***
Dealt to 56977ca6 
Dealt to 1e38fa90 
Dealt to c1959558 
Dealt to 8dc4f307 
Dealt to 53d86a23 
Dealt to Hero [Th 8d]
8dc4f307: folds
53d86a23: folds
Hero: folds
56977ca6: folds
1e38fa90: raises $0.06 to $0.11
c1959558: folds
Uncalled bet ($0.06) returned to 1e38fa90
*** SHOWDOWN ***
1e38fa90 collected $0.1 from pot
*** SUMMARY ***
Total pot $0.1 | Rake $0 | Jackpot $0 | Bingo $0 | Fortune $0 | Tax $0
Seat 1: 56977ca6 (button) folded before Flop (didn't bet)
Seat 2: 1e38fa90 (small blind) collected ($0.1)
Seat 3: c1959558 (big blind) folded before Flop
Seat 4: 8dc4f307 folded before Flop (didn't bet)
Seat 5: 53d86a23 folded before Flop (didn't bet)
Seat 6: Hero folded before Flop (didn't bet)


Poker Hand #RC2094802116: Hold'em No Limit ($0.02/$0.05) - 2023/12/27 22:06:16
Table 'RushAndCash3830119' 6-max Seat #1 is the button
Seat 1: 66b6d542 ($5.43 in chips)
Seat 2: 35855412 ($5.95 in chips)
Seat 3: 66001850 ($5 in chips)
Seat 4: d1151834 ($3.9 in chips)
Seat 5: 6d462730 ($11.23 in chips)
Seat 6: Hero ($10.84 in chips)
35855412: posts small blind $0.02
66001850: posts big blind $0.05
*** HOLE CARDS ***
Dealt to 66b6d542 
Dealt to 35855412 
Dealt to 66001850 
Dealt to d1151834 
Dealt to 6d462730 
Dealt to Hero [9d 3c]
d1151834: raises $0.07 to $0.12
6d462730: folds
Hero: folds
66b6d542: folds
35855412: folds
66001850: folds
Uncalled bet ($0.07) returned to d1151834
*** SHOWDOWN ***
d1151834 collected $0.12 from pot
*** SUMMARY ***
Total pot $0.12 | Rake $0 | Jackpot $0 | Bingo $0 | Fortune $0 | Tax $0
Seat 1: 66b6d542 (button) folded before Flop (didn't bet)
Seat 2: 35855412 (small blind) folded before Flop
Seat 3: 66001850 (big blind) folded before Flop
Seat 4: d1151834 collected ($0.12)
Seat 5: 6d462730 folded before Flop (didn't bet)
Seat 6: Hero folded before Flop (didn't bet)


Poker Hand #RC2094802037: Hold'em No Limit ($0.02/$0.05) - 2023/12/27 22:06:12
Table 'RushAndCash3830080' 6-max Seat #1 is the button
Seat 1: a0c39214 ($5.32 in chips)
Seat 2: 46c7c1bc ($10.42 in chips)
Seat 3: f18ae513 ($3.07 in chips)
Seat 4: Hero ($10.84 in chips)
Seat 5: 2f8a4c7c ($5.26 in chips)
Seat 6: 3679dcf2 ($6.72 in chips)
46c7c1bc: posts small blind $0.02
f18ae513: posts big blind $0.05
*** HOLE CARDS ***
Dealt to a0c39214 
Dealt to 46c7c1bc 
Dealt to f18ae513 
Dealt to Hero [2d Kc]
Dealt to 2f8a4c7c 
Dealt to 3679dcf2 
Hero: folds
2f8a4c7c: folds
3679dcf2: raises $0.08 to $0.13
a0c39214: folds
46c7c1bc: folds
f18ae513: folds
Uncalled bet ($0.08) returned to 3679dcf2
*** SHOWDOWN ***
3679dcf2 collected $0.12 from pot
*** SUMMARY ***
Total pot $0.12 | Rake $0 | Jackpot $0 | Bingo $0 | Fortune $0 | Tax $0
Seat 1: a0c39214 (button) folded before Flop (didn't bet)
Seat 2: 46c7c1bc (small blind) folded before Flop
Seat 3: f18ae513 (big blind) folded before Flop
Seat 4: Hero folded before Flop (didn't bet)
Seat 5: 2f8a4c7c folded before Flop (didn't bet)
Seat 6: 3679dcf2 collected ($0.12)


Poker Hand #RC2094801957: Hold'em No Limit ($0.02/$0.05) - 2023/12/27 22:06:08
Table 'RushAndCash3830041' 6-max Seat #1 is the button
Seat 1: Hero ($10.84 in chips)
Seat 2: 87bd6620 ($6.16 in chips)
Seat 3: 3f010145 ($5 in chips)
Seat 4: e75cdf96 ($4.8 in chips)
Seat 5: 594f16dd ($5.64 in chips)
Seat 6: 3b59ca4e ($7.07 in chips)
87bd6620: posts small blind $0.02
3f010145: posts big blind $0.05
*** HOLE CARDS ***
Dealt to Hero [6s Ah]
Dealt to 87bd6620 
Dealt to 3f010145 
Dealt to e75cdf96 
Dealt to 594f16dd 
Dealt to 3b59ca4e 
e75cdf96: folds
594f16dd: folds
3b59ca4e: raises $0.06 to $0.11
Hero: folds
87bd6620: folds
3f010145: folds
Uncalled bet ($0.06) returned to 3b59ca4e
*** SHOWDOWN ***
3b59ca4e collected $0.12 from pot
*** SUMMARY ***
Total pot $0.12 | Rake $0 | Jackpot $0 | Bingo $0 | Fortune $0 | Tax $0
Seat 1: Hero (button) folded before Flop (didn't bet)
Seat 2: 87bd6620 (small blind) folded before Flop
Seat 3: 3f010145 (big blind) folded before Flop
Seat 4: e75cdf96 folded before Flop (didn't bet)
Seat 5: 594f16dd folded before Flop (didn't bet)
Seat 6: 3b59ca4e collected ($0.12)


Poker Hand #RC2094801193: Hold'em No Limit ($0.02/$0.05) - 2023/12/27 22:05:31
Table 'RushAndCash3829697' 6-max Seat #1 is the button
Seat 1: 594f16dd ($5.13 in chips)
Seat 2: 854c4b13 ($12.54 in chips)
Seat 3: fecb23dd ($1.83 in chips)
Seat 4: 7d04edfb ($15.05 in chips)
Seat 5: Hero ($11.33 in chips)
Seat 6: d107e328 ($6.14 in chips)
854c4b13: posts small blind $0.02
fecb23dd: posts big blind $0.05
*** HOLE CARDS ***
Dealt to 594f16dd 
Dealt to 854c4b13 
Dealt to fecb23dd 
Dealt to 7d04edfb 
Dealt to Hero [Jd Jc]
Dealt to d107e328 
7d04edfb: folds
Hero: raises $0.05 to $0.1
d107e328: folds
594f16dd: raises $0.21 to $0.31
854c4b13: folds
fecb23dd: folds
Hero: calls $0.21
*** FLOP *** [Kd Qh 5h]
Hero: checks
594f16dd: bets $0.18
Hero: calls $0.18
*** TURN *** [Kd Qh 5h] [6s]
Hero: checks
594f16dd: checks
*** RIVER *** [Kd Qh 5h 6s] [Th]
Hero: checks
594f16dd: bets $0.27
Hero: folds
Uncalled bet ($0.27) returned to 594f16dd
*** SHOWDOWN ***
594f16dd collected $1 from pot
*** SUMMARY ***
Total pot $1.05 | Rake $0.05 | Jackpot $0 | Bingo $0 | Fortune $0 | Tax $0
Board [Kd Qh 5h 6s Th]
Seat 1: 594f16dd (button) won ($1)
Seat 2: 854c4b13 (small blind) folded before Flop
Seat 3: fecb23dd (big blind) folded before Flop
Seat 4: 7d04edfb folded before Flop (didn't bet)
Seat 5: Hero folded on the River
Seat 6: d107e328 folded before Flop (didn't bet)


Poker Hand #RC2094800806: Hold'em No Limit ($0.02/$0.05) - 2023/12/27 22:05:12
Table 'RushAndCash3829519' 6-max Seat #1 is the button
Seat 1: 3742af02 ($11.62 in chips)
Seat 2: Hero ($11.35 in chips)
Seat 3: 928be40e ($7.26 in chips)
Seat 4: fa247bbc ($6.84 in chips)
Seat 5: 3a2a7b05 ($6.39 in chips)
Seat 6: 606127e2 ($5.26 in chips)
Hero: posts small blind $0.02
928be40e: posts big blind $0.05
*** HOLE CARDS ***
Dealt to 3742af02 
Dealt to Hero [As 4c]
Dealt to 928be40e 
Dealt to fa247bbc 
Dealt to 3a2a7b05 
Dealt to 606127e2 
fa247bbc: folds
3a2a7b05: folds
606127e2: folds
3742af02: raises $0.05 to $0.1
Hero: folds
928be40e: calls $0.05
*** FLOP *** [Ks Jh Js]
928be40e: checks
3742af02: checks
*** TURN *** [Ks Jh Js] [5s]
928be40e: checks
3742af02: checks
*** RIVER *** [Ks Jh Js 5s] [Qc]
928be40e: checks
3742af02: checks
928be40e: shows [6c 6d] (Pair of Jacks and Pair of Sixes)
3742af02: shows [Ac 9c] (Pair of Jacks)
*** SHOWDOWN ***
928be40e collected $0.21 from pot
*** SUMMARY ***
Total pot $0.22 | Rake $0.01 | Jackpot $0 | Bingo $0 | Fortune $0 | Tax $0
Board [Ks Jh Js 5s Qc]
Seat 1: 3742af02 (button) showed [Ac 9c] and lost with Pair of Jacks
Seat 2: Hero (small blind) folded before Flop
Seat 3: 928be40e (big blind) showed [6c 6d] and won ($0.21) with Pair of Jacks and Pair of Sixes
Seat 4: fa247bbc folded before Flop (didn't bet)
Seat 5: 3a2a7b05 folded before Flop (didn't bet)
Seat 6: 606127e2 folded before Flop (didn't bet)


Poker Hand #RC2094800457: Hold'em No Limit ($0.02/$0.05) - 2023/12/27 22:04:55
Table 'RushAndCash3829363' 6-max Seat #1 is the button
Seat 1: b9fe9306 ($5.76 in chips)
Seat 2: Hero ($11.37 in chips)
Seat 3: d107e328 ($6.64 in chips)
Seat 4: 63ca922b ($5.29 in chips)
Seat 5: a0a7fed1 ($5 in chips)
Seat 6: 66001850 ($5 in chips)
Hero: posts small blind $0.02
d107e328: posts big blind $0.05
*** HOLE CARDS ***
Dealt to b9fe9306 
Dealt to Hero [9s 3s]
Dealt to d107e328 
Dealt to 63ca922b 
Dealt to a0a7fed1 
Dealt to 66001850 
63ca922b: folds
a0a7fed1: folds
66001850: folds
b9fe9306: raises $0.08 to $0.13
Hero: folds
d107e328: folds
Uncalled bet ($0.08) returned to b9fe9306
*** SHOWDOWN ***
b9fe9306 collected $0.12 from pot
*** SUMMARY ***
Total pot $0.12 | Rake $0 | Jackpot $0 | Bingo $0 | Fortune $0 | Tax $0
Seat 1: b9fe9306 (button) collected ($0.12)
Seat 2: Hero (small blind) folded before Flop
Seat 3: d107e328 (big blind) folded before Flop
Seat 4: 63ca922b folded before Flop (didn't bet)
Seat 5: a0a7fed1 folded before Flop (didn't bet)
Seat 6: 66001850 folded before Flop (didn't bet)


Poker Hand #RC2094800385: Hold'em No Limit ($0.02/$0.05) - 2023/12/27 22:04:51
Table 'RushAndCash3829331' 6-max Seat #1 is the button
Seat 1: 66001850 ($5 in chips)
Seat 2: b9fe9306 ($5.78 in chips)
Seat 3: Hero ($11.42 in chips)
Seat 4: 501194d ($5.05 in chips)
Seat 5: 4d2d4b93 ($5.25 in chips)
Seat 6: 475d8f40 ($5 in chips)
b9fe9306: posts small blind $0.02
Hero: posts big blind $0.05
*** HOLE CARDS ***
Dealt to 66001850 
Dealt to b9fe9306 
Dealt to Hero [9h 6h]
Dealt to 501194d 
Dealt to 4d2d4b93 
Dealt to 475d8f40 
501194d: raises $0.07 to $0.12
4d2d4b93: folds
475d8f40: folds
66001850: folds
b9fe9306: folds
Hero: folds
Uncalled bet ($0.07) returned to 501194d
*** SHOWDOWN ***
501194d collected $0.12 from pot
*** SUMMARY ***
Total pot $0.12 | Rake $0 | Jackpot $0 | Bingo $0 | Fortune $0 | Tax $0
Seat 1: 66001850 (button) folded before Flop (didn't bet)
Seat 2: b9fe9306 (small blind) folded before Flop
Seat 3: Hero (big blind) folded before Flop
Seat 4: 501194d collected ($0.12)
Seat 5: 4d2d4b93 folded before Flop (didn't bet)
Seat 6: 475d8f40 folded before Flop (didn't bet)


Poker Hand #RC2094800160: Hold'em No Limit ($0.02/$0.05) - 2023/12/27 22:04:39
Table 'RushAndCash3829229' 6-max Seat #1 is the button
Seat 1: a4ba7f22 ($8.86 in chips)
Seat 2: Hero ($11.37 in chips)
Seat 3: 28e012c6 ($4.78 in chips)
Seat 4: 7a53a537 ($9.92 in chips)
Seat 5: 7434f2f7 ($9.67 in chips)
Seat 6: e7b47e59 ($5.19 in chips)
Hero: posts small blind $0.02
28e012c6: posts big blind $0.05
*** HOLE CARDS ***
Dealt to a4ba7f22 
Dealt to Hero [2s 5s]
Dealt to 28e012c6 
Dealt to 7a53a537 
Dealt to 7434f2f7 
Dealt to e7b47e59 
7a53a537: folds
7434f2f7: folds
e7b47e59: folds
a4ba7f22: folds
Hero: raises $0.1 to $0.15
28e012c6: folds
Uncalled bet ($0.1) returned to Hero
*** SHOWDOWN ***
Hero collected $0.1 from pot
*** SUMMARY ***
Total pot $0.1 | Rake $0 | Jackpot $0 | Bingo $0 | Fortune $0 | Tax $0
Seat 1: a4ba7f22 (button) folded before Flop (didn't bet)
Seat 2: Hero (small blind) collected ($0.1)
Seat 3: 28e012c6 (big blind) folded before Flop
Seat 4: 7a53a537 folded before Flop (didn't bet)
Seat 5: 7434f2f7 folded before Flop (didn't bet)
Seat 6: e7b47e59 folded before Flop (didn't bet)


Poker Hand #RC2094800091: Hold'em No Limit ($0.02/$0.05) - 2023/12/27 22:04:36
Table 'RushAndCash3829196' 6-max Seat #1 is the button
Seat 1: Hero ($11.37 in chips)
Seat 2: 6e302acc ($8.21 in chips)
Seat 3: a3243cd1 ($18.14 in chips)
Seat 4: 5e87367f ($5.07 in chips)
Seat 5: f8648df3 ($4.76 in chips)
Seat 6: 301eab56 ($6.76 in chips)
6e302acc: posts small blind $0.02
a3243cd1: posts big blind $0.05
*** HOLE CARDS ***
Dealt to Hero [3s 8d]
Dealt to 6e302acc 
Dealt to a3243cd1 
Dealt to 5e87367f 
Dealt to f8648df3 
Dealt to 301eab56 
5e87367f: folds
f8648df3: folds
301eab56: folds
Hero: folds
6e302acc: raises $0.11 to $0.16
a3243cd1: calls $0.11
*** FLOP *** [Js 8h 9c]
6e302acc: bets $0.12
a3243cd1: raises $0.12 to $0.24
6e302acc: folds
Uncalled bet ($0.12) returned to a3243cd1
*** SHOWDOWN ***
a3243cd1 collected $0.54 from pot
*** SUMMARY ***
Total pot $0.56 | Rake $0.02 | Jackpot $0 | Bingo $0 | Fortune $0 | Tax $0
Board [Js 8h 9c]
Seat 1: Hero (button) folded before Flop (didn't bet)
Seat 2: 6e302acc (small blind) folded on the Flop
Seat 3: a3243cd1 (big blind) won ($0.54)
Seat 4: 5e87367f folded before Flop (didn't bet)
Seat 5: f8648df3 folded before Flop (didn't bet)
Seat 6: 301eab56 folded before Flop (didn't bet)


Poker Hand #RC2094800015: Hold'em No Limit ($0.02/$0.05) - 2023/12/27 22:04:32
Table 'RushAndCash3829159' 6-max Seat #1 is the button
Seat 1: 82961c60 ($5.12 in chips)
Seat 2: 57d6c279 ($5.14 in chips)
Seat 3: f8e9924c ($9.99 in chips)
Seat 4: Hero ($11.37 in chips)
Seat 5: a3617629 ($4.45 in chips)
Seat 6: 5801b1e0 ($5.21 in chips)
57d6c279: posts small blind $0.02
f8e9924c: posts big blind $0.05
*** HOLE CARDS ***
Dealt to 82961c60 
Dealt to 57d6c279 
Dealt to f8e9924c 
Dealt to Hero [Jd 7c]
Dealt to a3617629 
Dealt to 5801b1e0 
Hero: folds
a3617629: raises $0.06 to $0.11
5801b1e0: folds
82961c60: folds
57d6c279: folds
f8e9924c: calls $0.06
*** FLOP *** [Qh Ts Ks]
f8e9924c: checks
a3617629: bets $0.12
f8e9924c: raises $0.28 to $0.4
a3617629: folds
Uncalled bet ($0.28) returned to f8e9924c
*** SHOWDOWN ***
f8e9924c collected $0.46 from pot
*** SUMMARY ***
Total pot $0.48 | Rake $0.02 | Jackpot $0 | Bingo $0 | Fortune $0 | Tax $0
Board [Qh Ts Ks]
Seat 1: 82961c60 (button) folded before Flop (didn't bet)
Seat 2: 57d6c279 (small blind) folded before Flop
Seat 3: f8e9924c (big blind) won ($0.46)
Seat 4: Hero folded before Flop (didn't bet)
Seat 5: a3617629 folded on the Flop
Seat 6: 5801b1e0 folded before Flop (didn't bet)


Poker Hand #RC2094799651: Hold'em No Limit ($0.02/$0.05) - 2023/12/27 22:04:13
Table 'RushAndCash3828994' 6-max Seat #1 is the button
Seat 1: c4896743 ($1.97 in chips)
Seat 2: fd515659 ($0.88 in chips)
Seat 3: 8dcda2f3 ($5 in chips)
Seat 4: 42606853 ($14.76 in chips)
Seat 5: f8e9924c ($10.09 in chips)
Seat 6: Hero ($11.21 in chips)
fd515659: posts small blind $0.02
8dcda2f3: posts big blind $0.05
*** HOLE CARDS ***
Dealt to c4896743 
Dealt to fd515659 
Dealt to 8dcda2f3 
Dealt to 42606853 
Dealt to f8e9924c 
Dealt to Hero [Qh Qs]
42606853: folds
f8e9924c: raises $0.05 to $0.1
Hero: raises $0.27 to $0.37
c4896743: folds
fd515659: folds
8dcda2f3: folds
f8e9924c: folds
Uncalled bet ($0.27) returned to Hero
*** SHOWDOWN ***
Hero collected $0.26 from pot
*** SUMMARY ***
Total pot $0.27 | Rake $0.01 | Jackpot $0 | Bingo $0 | Fortune $0 | Tax $0
Seat 1: c4896743 (button) folded before Flop (didn't bet)
Seat 2: fd515659 (small blind) folded before Flop
Seat 3: 8dcda2f3 (big blind) folded before Flop
Seat 4: 42606853 folded before Flop (didn't bet)
Seat 5: f8e9924c folded before Flop
Seat 6: Hero collected ($0.26)


Poker Hand #RC2094799564: Hold'em No Limit ($0.02/$0.05) - 2023/12/27 22:04:10
Table 'RushAndCash3828953' 6-max Seat #1 is the button
Seat 1: a468def5 ($3.55 in chips)
Seat 2: 9815c904 ($12.86 in chips)
Seat 3: b7032b67 ($5 in chips)
Seat 4: e4bc673d ($6.39 in chips)
Seat 5: Hero ($11.21 in chips)
Seat 6: 9f83857b ($5.73 in chips)
9815c904: posts small blind $0.02
b7032b67: posts big blind $0.05
*** HOLE CARDS ***
Dealt to a468def5 
Dealt to 9815c904 
Dealt to b7032b67 
Dealt to e4bc673d 
Dealt to Hero [8d Tc]
Dealt to 9f83857b 
e4bc673d: folds
Hero: folds
9f83857b: folds
a468def5: folds
9815c904: folds
Uncalled bet ($0.03) returned to b7032b67
*** SHOWDOWN ***
b7032b67 collected $0.04 from pot
*** SUMMARY ***
Total pot $0.04 | Rake $0 | Jackpot $0 | Bingo $0 | Fortune $0 | Tax $0
Seat 1: a468def5 (button) folded before Flop (didn't bet)
Seat 2: 9815c904 (small blind) folded before Flop
Seat 3: b7032b67 (big blind) collected ($0.04)
Seat 4: e4bc673d folded before Flop (didn't bet)
Seat 5: Hero folded before Flop (didn't bet)
Seat 6: 9f83857b folded before Flop (didn't bet)


Poker Hand #RC2094799361: Hold'em No Limit ($0.02/$0.05) - 2023/12/27 22:04:00
Table 'RushAndCash3828863' 6-max Seat #1 is the button
Seat 1: a68b8417 ($5.16 in chips)
Seat 2: 853549e5 ($1.44 in chips)
Seat 3: Hero ($11.26 in chips)
Seat 4: 62f3707a ($6.75 in chips)
Seat 5: d0a9669b ($5.27 in chips)
Seat 6: 3c85d52b ($5.12 in chips)
853549e5: posts small blind $0.02
Hero: posts big blind $0.05
*** HOLE CARDS ***
Dealt to a68b8417 
Dealt to 853549e5 
Dealt to Hero [Th 4c]
Dealt to 62f3707a 
Dealt to d0a9669b 
Dealt to 3c85d52b 
62f3707a: raises $0.05 to $0.1
d0a9669b: folds
3c85d52b: folds
a68b8417: folds
853549e5: calls $0.08
Hero: folds
*** FLOP *** [3c 4d 6h]
853549e5: bets $0.13
62f3707a: calls $0.13
*** TURN *** [3c 4d 6h] [2d]
853549e5: bets $0.26
62f3707a: raises $6.26 to $6.52 and is all-in
853549e5: folds
Uncalled bet ($6.26) returned to 62f3707a
*** SHOWDOWN ***
62f3707a collected $0.98 from pot
*** SUMMARY ***
Total pot $1.03 | Rake $0.05 | Jackpot $0 | Bingo $0 | Fortune $0 | Tax $0
Board [3c 4d 6h 2d]
Seat 1: a68b8417 (button) folded before Flop (didn't bet)
Seat 2: 853549e5 (small blind) folded on the Turn
Seat 3: Hero (big blind) folded before Flop
Seat 4: 62f3707a won ($0.98)
Seat 5: d0a9669b folded before Flop (didn't bet)
Seat 6: 3c85d52b folded before Flop (didn't bet)


Poker Hand #RC2094799284: Hold'em No Limit ($0.02/$0.05) - 2023/12/27 22:03:56
Table 'RushAndCash3828828' 6-max Seat #1 is the button
Seat 1: f6fd5957 ($5 in chips)
Seat 2: Hero ($11.21 in chips)
Seat 3: fe238212 ($3.55 in chips)
Seat 4: 34d7c364 ($5.83 in chips)
Seat 5: a68b8417 ($5.16 in chips)
Seat 6: 594f16dd ($5.26 in chips)
Hero: posts small blind $0.02
fe238212: posts big blind $0.05
*** HOLE CARDS ***
Dealt to f6fd5957 
Dealt to Hero [Qd 6d]
Dealt to fe238212 
Dealt to 34d7c364 
Dealt to a68b8417 
Dealt to 594f16dd 
34d7c364: folds
a68b8417: folds
594f16dd: folds
f6fd5957: raises $0.05 to $0.1
Hero: folds
fe238212: calls $0.05
*** FLOP *** [Tc 5d 9s]
fe238212: checks
f6fd5957: checks
*** TURN *** [Tc 5d 9s] [3c]
fe238212: checks
f6fd5957: checks
*** RIVER *** [Tc 5d 9s 3c] [2d]
fe238212: checks
f6fd5957: checks
fe238212: shows [6c 6s] (Pair of Sixes)
f6fd5957: shows [5h 7h] (Pair of Fives)
*** SHOWDOWN ***
fe238212 collected $0.21 from pot
*** SUMMARY ***
Total pot $0.22 | Rake $0.01 | Jackpot $0 | Bingo $0 | Fortune $0 | Tax $0
Board [Tc 5d 9s 3c 2d]
Seat 1: f6fd5957 (button) showed [5h 7h] and lost with Pair of Fives
Seat 2: Hero (small blind) folded before Flop
Seat 3: fe238212 (big blind) showed [6c 6s] and won ($0.21) with Pair of Sixes
Seat 4: 34d7c364 folded before Flop (didn't bet)
Seat 5: a68b8417 folded before Flop (didn't bet)
Seat 6: 594f16dd folded before Flop (didn't bet)


Poker Hand #RC2094799167: Hold'em No Limit ($0.02/$0.05) - 2023/12/27 22:03:51
Table 'RushAndCash3828774' 6-max Seat #1 is the button
Seat 1: 3c85d52b ($5.12 in chips)
Seat 2: 5577c40d ($4.63 in chips)
Seat 3: 475d8f40 ($5.15 in chips)
Seat 4: 6db2b6b4 ($1.56 in chips)
Seat 5: Hero ($11.21 in chips)
Seat 6: 7d5bdf5e ($6.35 in chips)
5577c40d: posts small blind $0.02
475d8f40: posts big blind $0.05
*** HOLE CARDS ***
Dealt to 3c85d52b 
Dealt to 5577c40d 
Dealt to 475d8f40 
Dealt to 6db2b6b4 
Dealt to Hero [9c Kc]
Dealt to 7d5bdf5e 
6db2b6b4: raises $0.1 to $0.15
Hero: folds
7d5bdf5e: folds
3c85d52b: folds
5577c40d: folds
475d8f40: folds
Uncalled bet ($0.1) returned to 6db2b6b4
*** SHOWDOWN ***
6db2b6b4 collected $0.12 from pot
*** SUMMARY ***
Total pot $0.12 | Rake $0 | Jackpot $0 | Bingo $0 | Fortune $0 | Tax $0
Seat 1: 3c85d52b (button) folded before Flop (didn't bet)
Seat 2: 5577c40d (small blind) folded before Flop
Seat 3: 475d8f40 (big blind) folded before Flop
Seat 4: 6db2b6b4 collected ($0.12)
Seat 5: Hero folded before Flop (didn't bet)
Seat 6: 7d5bdf5e folded before Flop (didn't bet)


Poker Hand #RC2094799092: Hold'em No Limit ($0.02/$0.05) - 2023/12/27 22:03:46
Table 'RushAndCash3828739' 6-max Seat #1 is the button
Seat 1: b0830a8 ($7.83 in chips)
Seat 2: 23552681 ($4.99 in chips)
Seat 3: 3a2a7b05 ($6.61 in chips)
Seat 4: 819e0504 ($6.47 in chips)
Seat 5: f2b92eda ($4.02 in chips)
Seat 6: Hero ($11.21 in chips)
23552681: posts small blind $0.02
3a2a7b05: posts big blind $0.05
*** HOLE CARDS ***
Dealt to b0830a8 
Dealt to 23552681 
Dealt to 3a2a7b05 
Dealt to 819e0504 
Dealt to f2b92eda 
Dealt to Hero [9d Qh]
819e0504: folds
f2b92eda: folds
Hero: folds
b0830a8: raises $0.08 to $0.13
23552681: folds
3a2a7b05: calls $0.08
*** FLOP *** [9h Jd Kd]
3a2a7b05: checks
b0830a8: bets $0.14
3a2a7b05: folds
Uncalled bet ($0.14) returned to b0830a8
*** SHOWDOWN ***
b0830a8 collected $0.27 from pot
*** SUMMARY ***
Total pot $0.28 | Rake $0.01 | Jackpot $0 | Bingo $0 | Fortune $0 | Tax $0
Board [9h Jd Kd]
Seat 1: b0830a8 (button) won ($0.27)
Seat 2: 23552681 (small blind) folded before Flop
Seat 3: 3a2a7b05 (big blind) folded on the Flop
Seat 4: 819e0504 folded before Flop (didn't bet)
Seat 5: f2b92eda folded before Flop (didn't bet)
Seat 6: Hero folded before Flop (didn't bet)


Poker Hand #RC2094799016: Hold'em No Limit ($0.02/$0.05) - 2023/12/27 22:03:43
Table 'RushAndCash3828703' 6-max Seat #1 is the button
Seat 1: eda0d64f ($5.23 in chips)
Seat 2: 28e012c6 ($4.87 in chips)
Seat 3: Hero ($11.26 in chips)
Seat 4: d94cce2e ($5.25 in chips)
Seat 5: bba30b7a ($8.21 in chips)
Seat 6: 1f765dad ($5.99 in chips)
28e012c6: posts small blind $0.02
Hero: posts big blind $0.05
*** HOLE CARDS ***
Dealt to eda0d64f 
Dealt to 28e012c6 
Dealt to Hero [3c 2c]
Dealt to d94cce2e 
Dealt to bba30b7a 
Dealt to 1f765dad 
d94cce2e: folds
bba30b7a: folds
1f765dad: folds
eda0d64f: folds
28e012c6: folds
Uncalled bet ($0.03) returned to Hero
*** SHOWDOWN ***
Hero collected $0.04 from pot
*** SUMMARY ***
Total pot $0.04 | Rake $0 | Jackpot $0 | Bingo $0 | Fortune $0 | Tax $0
Seat 1: eda0d64f (button) folded before Flop (didn't bet)
Seat 2: 28e012c6 (small blind) folded before Flop
Seat 3: Hero (big blind) collected ($0.04)
Seat 4: d94cce2e folded before Flop (didn't bet)
Seat 5: bba30b7a folded before Flop (didn't bet)
Seat 6: 1f765dad folded before Flop (didn't bet)


Poker Hand #RC2094798883: Hold'em No Limit ($0.02/$0.05) - 2023/12/27 22:03:37
Table 'RushAndCash3828644' 6-max Seat #1 is the button
Seat 1: 5e46be01 ($4.92 in chips)
Seat 2: 66001850 ($5.48 in chips)
Seat 3: Hero ($11.24 in chips)
Seat 4: c34e5e03 ($9.81 in chips)
Seat 5: 1f765dad ($5.99 in chips)
Seat 6: 9f8c9c99 ($4.93 in chips)
66001850: posts small blind $0.02
Hero: posts big blind $0.05
*** HOLE CARDS ***
Dealt to 5e46be01 
Dealt to 66001850 
Dealt to Hero [3d 4h]
Dealt to c34e5e03 
Dealt to 1f765dad 
Dealt to 9f8c9c99 
c34e5e03: folds
1f765dad: folds
9f8c9c99: folds
5e46be01: folds
66001850: folds
Uncalled bet ($0.03) returned to Hero
*** SHOWDOWN ***
Hero collected $0.04 from pot
*** SUMMARY ***
Total pot $0.04 | Rake $0 | Jackpot $0 | Bingo $0 | Fortune $0 | Tax $0
Seat 1: 5e46be01 (button) folded before Flop (didn't bet)
Seat 2: 66001850 (small blind) folded before Flop
Seat 3: Hero (big blind) collected ($0.04)
Seat 4: c34e5e03 folded before Flop (didn't bet)
Seat 5: 1f765dad folded before Flop (didn't bet)
Seat 6: 9f8c9c99 folded before Flop (didn't bet)


Poker Hand #RC2094798220: Hold'em No Limit ($0.02/$0.05) - 2023/12/27 22:03:04
Table 'RushAndCash3828353' 6-max Seat #1 is the button
Seat 1: Hero ($11.52 in chips)
Seat 2: 1f765dad ($5.62 in chips)
Seat 3: 606127e2 ($5.44 in chips)
Seat 4: fbf37034 ($5.24 in chips)
Seat 5: f6bf05c1 ($9.24 in chips)
Seat 6: eb3b7a9 ($5 in chips)
1f765dad: posts small blind $0.02
606127e2: posts big blind $0.05
*** HOLE CARDS ***
Dealt to Hero [9c 9h]
Dealt to 1f765dad 
Dealt to 606127e2 
Dealt to fbf37034 
Dealt to f6bf05c1 
Dealt to eb3b7a9 
fbf37034: folds
f6bf05c1: folds
eb3b7a9: folds
Hero: raises $0.08 to $0.13
1f765dad: calls $0.11
606127e2: folds
*** FLOP *** [Kh Js Qd]
1f765dad: checks
Hero: bets $0.15
1f765dad: calls $0.15
*** TURN *** [Kh Js Qd] [4c]
1f765dad: checks
Hero: checks
*** RIVER *** [Kh Js Qd 4c] [Qc]
1f765dad: bets $0.34
Hero: folds
Uncalled bet ($0.34) returned to 1f765dad
*** SHOWDOWN ***
1f765dad collected $0.58 from pot
*** SUMMARY ***
Total pot $0.61 | Rake $0.03 | Jackpot $0 | Bingo $0 | Fortune $0 | Tax $0
Board [Kh Js Qd 4c Qc]
Seat 1: Hero (button) folded on the River
Seat 2: 1f765dad (small blind) won ($0.58)
Seat 3: 606127e2 (big blind) folded before Flop
Seat 4: fbf37034 folded before Flop (didn't bet)
Seat 5: f6bf05c1 folded before Flop (didn't bet)
Seat 6: eb3b7a9 folded before Flop (didn't bet)


Poker Hand #RC2094796624: Hold'em No Limit ($0.02/$0.05) - 2023/12/27 22:01:44
Table 'RushAndCash3827629' 6-max Seat #1 is the button
Seat 1: 511b4884 ($5 in chips)
Seat 2: 7e73be7f ($5.09 in chips)
Seat 3: abe1c1b1 ($5 in chips)
Seat 4: Hero ($11.62 in chips)
Seat 5: f6bf05c1 ($4.89 in chips)
Seat 6: 24862006 ($9.98 in chips)
7e73be7f: posts small blind $0.02
abe1c1b1: posts big blind $0.05
*** HOLE CARDS ***
Dealt to 511b4884 
Dealt to 7e73be7f 
Dealt to abe1c1b1 
Dealt to Hero [7c 7d]
Dealt to f6bf05c1 
Dealt to 24862006 
Hero: raises $0.05 to $0.1
f6bf05c1: calls $0.1
24862006: calls $0.1
511b4884: calls $0.1
7e73be7f: raises $0.9 to $1
abe1c1b1: folds
Hero: folds
f6bf05c1: calls $0.9
24862006: calls $0.9
511b4884: folds
*** FLOP *** [Td 3c 4s]
7e73be7f: bets $1.03
f6bf05c1: calls $1.03
24862006: folds
*** TURN *** [Td 3c 4s] [8h]
7e73be7f: bets $3.06 and is all-in
f6bf05c1: calls $2.86 and is all-in
Uncalled bet ($0.2) returned to 7e73be7f
7e73be7f: shows [Ac Ks] (Ace-High)
f6bf05c1: shows [Jh Jd] (Pair of Jacks)
*** RIVER *** [Td 3c 4s 8h] [Ad]
f6bf05c1: Receives Cashout ($9.24)
*** SHOWDOWN ***
7e73be7f collected $10.81 from pot
*** SUMMARY ***
Total pot $11.03 | Rake $0.15 | Jackpot $0.07 | Bingo $0 | Fortune $0 | Tax $0
Board [Td 3c 4s 8h Ad]
Seat 1: 511b4884 (button) folded before Flop
Seat 2: 7e73be7f (small blind) showed [Ac Ks] and won ($10.81) with Pair of Aces
Seat 3: abe1c1b1 (big blind) folded before Flop
Seat 4: Hero folded before Flop
Seat 5: f6bf05c1 showed [Jh Jd] and lost with Pair of Jacks, EV Cashout ($9.24)
Seat 6: 24862006 folded on the Flop


Poker Hand #RC2094796319: Hold'em No Limit ($0.02/$0.05) - 2023/12/27 22:01:30
Table 'RushAndCash3827491' 6-max Seat #1 is the button
Seat 1: Hero ($11.55 in chips)
Seat 2: 44366042 ($7.26 in chips)
Seat 3: 7dbc6773 ($4.22 in chips)
Seat 4: 6e1a1e6 ($4.82 in chips)
Seat 5: 3fb2f460 ($10.93 in chips)
Seat 6: 62f3707a ($6.38 in chips)
44366042: posts small blind $0.02
7dbc6773: posts big blind $0.05
*** HOLE CARDS ***
Dealt to Hero [As 7s]
Dealt to 44366042 
Dealt to 7dbc6773 
Dealt to 6e1a1e6 
Dealt to 3fb2f460 
Dealt to 62f3707a 
6e1a1e6: folds
3fb2f460: folds
62f3707a: folds
Hero: raises $0.08 to $0.13
44366042: folds
7dbc6773: folds
Uncalled bet ($0.08) returned to Hero
*** SHOWDOWN ***
Hero collected $0.12 from pot
*** SUMMARY ***
Total pot $0.12 | Rake $0 | Jackpot $0 | Bingo $0 | Fortune $0 | Tax $0
Seat 1: Hero (button) collected ($0.12)
Seat 2: 44366042 (small blind) folded before Flop
Seat 3: 7dbc6773 (big blind) folded before Flop
Seat 4: 6e1a1e6 folded before Flop (didn't bet)
Seat 5: 3fb2f460 folded before Flop (didn't bet)
Seat 6: 62f3707a folded before Flop (didn't bet)


Poker Hand #RC2094796242: Hold'em No Limit ($0.02/$0.05) - 2023/12/27 22:01:26
Table 'RushAndCash3827458' 6-max Seat #1 is the button
Seat 1: 7dbc6773 ($4.22 in chips)
Seat 2: f3d62317 ($5 in chips)
Seat 3: 589cc4e2 ($16.86 in chips)
Seat 4: f8648df3 ($4.89 in chips)
Seat 5: Hero ($11.55 in chips)
Seat 6: a02b33db ($4.18 in chips)
f3d62317: posts small blind $0.02
589cc4e2: posts big blind $0.05
*** HOLE CARDS ***
Dealt to 7dbc6773 
Dealt to f3d62317 
Dealt to 589cc4e2 
Dealt to f8648df3 
Dealt to Hero [Ks 6h]
Dealt to a02b33db 
f8648df3: folds
Hero: folds
a02b33db: folds
7dbc6773: folds
f3d62317: raises $0.05 to $0.1
589cc4e2: raises $0.4 to $0.5
f3d62317: folds
Uncalled bet ($0.4) returned to 589cc4e2
*** SHOWDOWN ***
589cc4e2 collected $0.19 from pot
*** SUMMARY ***
Total pot $0.2 | Rake $0.01 | Jackpot $0 | Bingo $0 | Fortune $0 | Tax $0
Seat 1: 7dbc6773 (button) folded before Flop (didn't bet)
Seat 2: f3d62317 (small blind) folded before Flop
Seat 3: 589cc4e2 (big blind) collected ($0.19)
Seat 4: f8648df3 folded before Flop (didn't bet)
Seat 5: Hero folded before Flop (didn't bet)
Seat 6: a02b33db folded before Flop (didn't bet)


Poker Hand #RC2094796079: Hold'em No Limit ($0.02/$0.05) - 2023/12/27 22:01:18
Table 'RushAndCash3827390' 6-max Seat #1 is the button
Seat 1: 730ad270 ($5.9 in chips)
Seat 2: Hero ($11.57 in chips)
Seat 3: bfec306f ($5 in chips)
Seat 4: 48dc9f88 ($5.66 in chips)
Seat 5: d9391ae3 ($6.64 in chips)
Seat 6: 3c18a029 ($6.15 in chips)
Hero: posts small blind $0.02
bfec306f: posts big blind $0.05
*** HOLE CARDS ***
Dealt to 730ad270 
Dealt to Hero [As 4c]
Dealt to bfec306f 
Dealt to 48dc9f88 
Dealt to d9391ae3 
Dealt to 3c18a029 
48dc9f88: folds
d9391ae3: folds
3c18a029: folds
730ad270: raises $0.08 to $0.13
Hero: folds
bfec306f: folds
Uncalled bet ($0.08) returned to 730ad270
*** SHOWDOWN ***
730ad270 collected $0.12 from pot
*** SUMMARY ***
Total pot $0.12 | Rake $0 | Jackpot $0 | Bingo $0 | Fortune $0 | Tax $0
Seat 1: 730ad270 (button) collected ($0.12)
Seat 2: Hero (small blind) folded before Flop
Seat 3: bfec306f (big blind) folded before Flop
Seat 4: 48dc9f88 folded before Flop (didn't bet)
Seat 5: d9391ae3 folded before Flop (didn't bet)
Seat 6: 3c18a029 folded before Flop (didn't bet)


Poker Hand #RC2094794977: Hold'em No Limit ($0.02/$0.05) - 2023/12/27 22:00:25
Table 'RushAndCash3826908' 6-max Seat #1 is the button
Seat 1: 3c18a029 ($7.66 in chips)
Seat 2: 257aef ($6.75 in chips)
Seat 3: cf1df9f4 ($5.06 in chips)
Seat 4: 19553e89 ($5 in chips)
Seat 5: Hero ($10.21 in chips)
Seat 6: fdc33ab9 ($5.8 in chips)
257aef: posts small blind $0.02
cf1df9f4: posts big blind $0.05
*** HOLE CARDS ***
Dealt to 3c18a029 
Dealt to 257aef 
Dealt to cf1df9f4 
Dealt to 19553e89 
Dealt to Hero [Js Jd]
Dealt to fdc33ab9 
19553e89: folds
Hero: raises $0.05 to $0.1
fdc33ab9: folds
3c18a029: raises $0.23 to $0.33
257aef: folds
cf1df9f4: folds
Hero: calls $0.23
*** FLOP *** [9s 4d Kc]
Hero: checks
3c18a029: bets $0.25
Hero: calls $0.25
*** TURN *** [9s 4d Kc] [8h]
Hero: checks
3c18a029: bets $0.93
Hero: calls $0.93
*** RIVER *** [9s 4d Kc 8h] [9c]
Hero: bets $1.02
3c18a029: folds
Uncalled bet ($1.02) returned to Hero
3c18a029: shows [Jc Qc] (Pair of Nines)
*** SHOWDOWN ***
Hero collected $2.87 from pot
*** SUMMARY ***
Total pot $3.09 | Rake $0.15 | Jackpot $0.07 | Bingo $0 | Fortune $0 | Tax $0
Board [9s 4d Kc 8h 9c]
Seat 1: 3c18a029 (button) folded on the River
Seat 2: 257aef (small blind) folded before Flop
Seat 3: cf1df9f4 (big blind) folded before Flop
Seat 4: 19553e89 folded before Flop (didn't bet)
Seat 5: Hero won ($2.87)
Seat 6: fdc33ab9 folded before Flop (didn't bet)


Poker Hand #RC2094784681: Hold'em No Limit ($0.02/$0.05) - 2023/12/27 22:00:10
Table 'RushAndCash3826774' 6-max Seat #1 is the button
Seat 1: 5e22d2c4 ($12.93 in chips)
Seat 2: Hero ($10.23 in chips)
Seat 3: 3b064713 ($3.85 in chips)
Seat 4: 4145b204 ($10.96 in chips)
Seat 5: bf0919e3 ($5.05 in chips)
Seat 6: 5d52972e ($12.51 in chips)
Hero: posts small blind $0.02
3b064713: posts big blind $0.05
*** HOLE CARDS ***
Dealt to 5e22d2c4 
Dealt to Hero [4h 2c]
Dealt to 3b064713 
Dealt to 4145b204 
Dealt to bf0919e3 
Dealt to 5d52972e 
4145b204: raises $0.05 to $0.1
bf0919e3: folds
5d52972e: raises $0.21 to $0.31
5e22d2c4: folds
Hero: folds
3b064713: folds
4145b204: folds
Uncalled bet ($0.21) returned to 5d52972e
*** SHOWDOWN ***
5d52972e collected $0.26 from pot
*** SUMMARY ***
Total pot $0.27 | Rake $0.01 | Jackpot $0 | Bingo $0 | Fortune $0 | Tax $0
Seat 1: 5e22d2c4 (button) folded before Flop (didn't bet)
Seat 2: Hero (small blind) folded before Flop
Seat 3: 3b064713 (big blind) folded before Flop
Seat 4: 4145b204 folded before Flop
Seat 5: bf0919e3 folded before Flop (didn't bet)
Seat 6: 5d52972e collected ($0.26)


Poker Hand #RC2094784604: Hold'em No Limit ($0.02/$0.05) - 2023/12/27 22:00:06
Table 'RushAndCash3826740' 6-max Seat #1 is the button
Seat 1: 4597fc13 ($10.18 in chips)
Seat 2: 5d03e211 ($10.38 in chips)
Seat 3: ed7db6c ($5.45 in chips)
Seat 4: Hero ($10.23 in chips)
Seat 5: 87bd6620 ($7.12 in chips)
Seat 6: beb5674c ($6.98 in chips)
5d03e211: posts small blind $0.02
ed7db6c: posts big blind $0.05
*** HOLE CARDS ***
Dealt to 4597fc13 
Dealt to 5d03e211 
Dealt to ed7db6c 
Dealt to Hero [4h Tc]
Dealt to 87bd6620 
Dealt to beb5674c 
Hero: folds
87bd6620: raises $0.06 to $0.11
beb5674c: folds
4597fc13: folds
5d03e211: folds
ed7db6c: folds
Uncalled bet ($0.06) returned to 87bd6620
*** SHOWDOWN ***
87bd6620 collected $0.12 from pot
*** SUMMARY ***
Total pot $0.12 | Rake $0 | Jackpot $0 | Bingo $0 | Fortune $0 | Tax $0
Seat 1: 4597fc13 (button) folded before Flop (didn't bet)
Seat 2: 5d03e211 (small blind) folded before Flop
Seat 3: ed7db6c (big blind) folded before Flop
Seat 4: Hero folded before Flop (didn't bet)
Seat 5: 87bd6620 collected ($0.12)
Seat 6: beb5674c folded before Flop (didn't bet)


Poker Hand #RC2094784529: Hold'em No Limit ($0.02/$0.05) - 2023/12/27 22:00:03
Table 'RushAndCash3826702' 6-max Seat #1 is the button
Seat 1: Hero ($10.23 in chips)
Seat 2: 3864461d ($13.5 in chips)
Seat 3: 70470d21 ($5.19 in chips)
Seat 4: 96788c24 ($5 in chips)
Seat 5: 9ede0bef ($5 in chips)
Seat 6: b7dc02f3 ($8.32 in chips)
3864461d: posts small blind $0.02
70470d21: posts big blind $0.05
*** HOLE CARDS ***
Dealt to Hero [Ks 5h]
Dealt to 3864461d 
Dealt to 70470d21 
Dealt to 96788c24 
Dealt to 9ede0bef 
Dealt to b7dc02f3 
96788c24: folds
9ede0bef: raises $0.05 to $0.1
b7dc02f3: folds
Hero: folds
3864461d: folds
70470d21: calls $0.05
*** FLOP *** [4c 8s 6s]
70470d21: checks
9ede0bef: checks
*** TURN *** [4c 8s 6s] [Jd]
70470d21: checks
9ede0bef: bets $0.15
70470d21: folds
Uncalled bet ($0.15) returned to 9ede0bef
*** SHOWDOWN ***
9ede0bef collected $0.21 from pot
*** SUMMARY ***
Total pot $0.22 | Rake $0.01 | Jackpot $0 | Bingo $0 | Fortune $0 | Tax $0
Board [4c 8s 6s Jd]
Seat 1: Hero (button) folded before Flop (didn't bet)
Seat 2: 3864461d (small blind) folded before Flop
Seat 3: 70470d21 (big blind) folded on the Turn
Seat 4: 96788c24 folded before Flop (didn't bet)
Seat 5: 9ede0bef won ($0.21)
Seat 6: b7dc02f3 folded before Flop (didn't bet)


Poker Hand #RC2094784368: Hold'em No Limit ($0.02/$0.05) - 2023/12/27 21:59:54
Table 'RushAndCash3826627' 6-max Seat #1 is the button
Seat 1: 6abc84cb ($5.72 in chips)
Seat 2: 92d3c0c5 ($5 in chips)
Seat 3: Hero ($10.28 in chips)
Seat 4: a62e60ac ($4.52 in chips)
Seat 5: f7d792af ($5.09 in chips)
Seat 6: 50203b74 ($9.84 in chips)
92d3c0c5: posts small blind $0.02
Hero: posts big blind $0.05
*** HOLE CARDS ***
Dealt to 6abc84cb 
Dealt to 92d3c0c5 
Dealt to Hero [Qs 2d]
Dealt to a62e60ac 
Dealt to f7d792af 
Dealt to 50203b74 
a62e60ac: folds
f7d792af: raises $0.08 to $0.13
50203b74: folds
6abc84cb: folds
92d3c0c5: folds
Hero: folds
Uncalled bet ($0.08) returned to f7d792af
*** SHOWDOWN ***
f7d792af collected $0.12 from pot
*** SUMMARY ***
Total pot $0.12 | Rake $0 | Jackpot $0 | Bingo $0 | Fortune $0 | Tax $0
Seat 1: 6abc84cb (button) folded before Flop (didn't bet)
Seat 2: 92d3c0c5 (small blind) folded before Flop
Seat 3: Hero (big blind) folded before Flop
Seat 4: a62e60ac folded before Flop (didn't bet)
Seat 5: f7d792af collected ($0.12)
Seat 6: 50203b74 folded before Flop (didn't bet)


Poker Hand #RC2094784288: Hold'em No Limit ($0.02/$0.05) - 2023/12/27 21:59:50
Table 'RushAndCash3826592' 6-max Seat #1 is the button
Seat 1: c9390073 ($0.11 in chips)
Seat 2: 704f8e60 ($3.35 in chips)
Seat 3: 18c65ff ($5 in chips)
Seat 4: 4ba3c380 ($5.2 in chips)
Seat 5: 2b0178d8 ($5.34 in chips)
Seat 6: Hero ($10.28 in chips)
704f8e60: posts small blind $0.02
18c65ff: posts big blind $0.05
*** HOLE CARDS ***
Dealt to c9390073 
Dealt to 704f8e60 
Dealt to 18c65ff 
Dealt to 4ba3c380 
Dealt to 2b0178d8 
Dealt to Hero [Th 9d]
4ba3c380: folds
2b0178d8: folds
Hero: folds
c9390073: folds
704f8e60: folds
Uncalled bet ($0.03) returned to 18c65ff
*** SHOWDOWN ***
18c65ff collected $0.04 from pot
*** SUMMARY ***
Total pot $0.04 | Rake $0 | Jackpot $0 | Bingo $0 | Fortune $0 | Tax $0
Seat 1: c9390073 (button) folded before Flop (didn't bet)
Seat 2: 704f8e60 (small blind) folded before Flop
Seat 3: 18c65ff (big blind) collected ($0.04)
Seat 4: 4ba3c380 folded before Flop (didn't bet)
Seat 5: 2b0178d8 folded before Flop (didn't bet)
Seat 6: Hero folded before Flop (didn't bet)


Poker Hand #RC2094784191: Hold'em No Limit ($0.02/$0.05) - 2023/12/27 21:59:45
Table 'RushAndCash3826551' 6-max Seat #1 is the button
Seat 1: 4145b204 ($10.77 in chips)
Seat 2: a101f823 ($2.03 in chips)
Seat 3: 30f0428f ($2 in chips)
Seat 4: ec8a1db7 ($5.62 in chips)
Seat 5: Hero ($10.28 in chips)
Seat 6: b6f6c90b ($16.37 in chips)
a101f823: posts small blind $0.02
30f0428f: posts big blind $0.05
*** HOLE CARDS ***
Dealt to 4145b204 
Dealt to a101f823 
Dealt to 30f0428f 
Dealt to ec8a1db7 
Dealt to Hero [6h 4d]
Dealt to b6f6c90b 
ec8a1db7: folds
Hero: folds
b6f6c90b: raises $0.08 to $0.13
4145b204: raises $0.25 to $0.38
a101f823: folds
30f0428f: folds
b6f6c90b: folds
Uncalled bet ($0.25) returned to 4145b204
*** SHOWDOWN ***
4145b204 collected $0.32 from pot
*** SUMMARY ***
Total pot $0.33 | Rake $0.01 | Jackpot $0 | Bingo $0 | Fortune $0 | Tax $0
Seat 1: 4145b204 (button) collected ($0.32)
Seat 2: a101f823 (small blind) folded before Flop
Seat 3: 30f0428f (big blind) folded before Flop
Seat 4: ec8a1db7 folded before Flop (didn't bet)
Seat 5: Hero folded before Flop (didn't bet)
Seat 6: b6f6c90b folded before Flop


Poker Hand #RC2094784101: Hold'em No Limit ($0.02/$0.05) - 2023/12/27 21:59:42
Table 'RushAndCash3826513' 6-max Seat #1 is the button
Seat 1: 708e061e ($4.36 in chips)
Seat 2: e8e85a69 ($6.01 in chips)
Seat 3: 92d3c0c5 ($5 in chips)
Seat 4: 30f0428f ($2 in chips)
Seat 5: Hero ($10.28 in chips)
Seat 6: 5fc0c0b6 ($5.35 in chips)
e8e85a69: posts small blind $0.02
92d3c0c5: posts big blind $0.05
*** HOLE CARDS ***
Dealt to 708e061e 
Dealt to e8e85a69 
Dealt to 92d3c0c5 
Dealt to 30f0428f 
Dealt to Hero [6d 5c]
Dealt to 5fc0c0b6 
30f0428f: folds
Hero: folds
5fc0c0b6: calls $0.05
708e061e: raises $0.13 to $0.18
e8e85a69: folds
92d3c0c5: folds
5fc0c0b6: calls $0.13
*** FLOP *** [Kh 6h Ac]
5fc0c0b6: bets $0.15
708e061e: raises $0.25 to $0.4
5fc0c0b6: folds
Uncalled bet ($0.25) returned to 708e061e
*** SHOWDOWN ***
708e061e collected $0.7 from pot
*** SUMMARY ***
Total pot $0.73 | Rake $0.03 | Jackpot $0 | Bingo $0 | Fortune $0 | Tax $0
Board [Kh 6h Ac]
Seat 1: 708e061e (button) won ($0.7)
Seat 2: e8e85a69 (small blind) folded before Flop
Seat 3: 92d3c0c5 (big blind) folded before Flop
Seat 4: 30f0428f folded before Flop (didn't bet)
Seat 5: Hero folded before Flop (didn't bet)
Seat 6: 5fc0c0b6 folded on the Flop


Poker Hand #RC2094783924: Hold'em No Limit ($0.02/$0.05) - 2023/12/27 21:59:33
Table 'RushAndCash3826438' 6-max Seat #1 is the button
Seat 1: Hero ($10.28 in chips)
Seat 2: 6c7fc561 ($6.9 in chips)
Seat 3: af05a87 ($4.64 in chips)
Seat 4: c72b837e ($10.27 in chips)
Seat 5: 9815c904 ($9.5 in chips)
Seat 6: 88fae8f8 ($21.99 in chips)
6c7fc561: posts small blind $0.02
af05a87: posts big blind $0.05
*** HOLE CARDS ***
Dealt to Hero [5d 6d]
Dealt to 6c7fc561 
Dealt to af05a87 
Dealt to c72b837e 
Dealt to 9815c904 
Dealt to 88fae8f8 
c72b837e: folds
9815c904: raises $0.07 to $0.12
88fae8f8: folds
Hero: folds
6c7fc561: folds
af05a87: calls $0.07
*** FLOP *** [2h 4s 7s]
af05a87: checks
9815c904: checks
*** TURN *** [2h 4s 7s] [9c]
af05a87: checks
9815c904: checks
*** RIVER *** [2h 4s 7s 9c] [5s]
af05a87: checks
9815c904: checks
af05a87: shows [Qh Tc] (Queen-High)
9815c904: shows [Ad 8h] (Ace-High)
*** SHOWDOWN ***
9815c904 collected $0.25 from pot
*** SUMMARY ***
Total pot $0.26 | Rake $0.01 | Jackpot $0 | Bingo $0 | Fortune $0 | Tax $0
Board [2h 4s 7s 9c 5s]
Seat 1: Hero (button) folded before Flop (didn't bet)
Seat 2: 6c7fc561 (small blind) folded before Flop
Seat 3: af05a87 (big blind) showed [Qh Tc] and lost with Queen-High
Seat 4: c72b837e folded before Flop (didn't bet)
Seat 5: 9815c904 showed [Ad 8h] and won ($0.25) with Ace-High
Seat 6: 88fae8f8 folded before Flop (didn't bet)


Poker Hand #RC2094783845: Hold'em No Limit ($0.02/$0.05) - 2023/12/27 21:59:29
Table 'RushAndCash3826406' 6-max Seat #1 is the button
Seat 1: 827ebdaf ($4.93 in chips)
Seat 2: 2f1ab13d ($12.76 in chips)
Seat 3: 94dfc246 ($5.07 in chips)
Seat 4: d4a7cec1 ($6.1 in chips)
Seat 5: Hero ($10.28 in chips)
Seat 6: 859737fd ($7.89 in chips)
2f1ab13d: posts small blind $0.02
94dfc246: posts big blind $0.05
*** HOLE CARDS ***
Dealt to 827ebdaf 
Dealt to 2f1ab13d 
Dealt to 94dfc246 
Dealt to d4a7cec1 
Dealt to Hero [5c Qd]
Dealt to 859737fd 
d4a7cec1: raises $0.1 to $0.15
Hero: folds
859737fd: folds
827ebdaf: calls $0.15
2f1ab13d: calls $0.13
94dfc246: calls $0.1
*** FLOP *** [Qc Js 9s]
2f1ab13d: checks
94dfc246: checks
d4a7cec1: checks
827ebdaf: checks
*** TURN *** [Qc Js 9s] [Td]
2f1ab13d: checks
94dfc246: checks
d4a7cec1: checks
827ebdaf: bets $0.2
2f1ab13d: calls $0.2
94dfc246: folds
d4a7cec1: folds
*** RIVER *** [Qc Js 9s Td] [7c]
2f1ab13d: bets $0.75
827ebdaf: folds
Uncalled bet ($0.75) returned to 2f1ab13d
*** SHOWDOWN ***
2f1ab13d collected $0.95 from pot
*** SUMMARY ***
Total pot $1 | Rake $0.05 | Jackpot $0 | Bingo $0 | Fortune $0 | Tax $0
Board [Qc Js 9s Td 7c]
Seat 1: 827ebdaf (button) folded on the River
Seat 2: 2f1ab13d (small blind) won ($0.95)
Seat 3: 94dfc246 (big blind) folded on the Turn
Seat 4: d4a7cec1 folded on the Turn
Seat 5: Hero folded before Flop (didn't bet)
Seat 6: 859737fd folded before Flop (didn't bet)


Poker Hand #RC2094783685: Hold'em No Limit ($0.02/$0.05) - 2023/12/27 21:59:21
Table 'RushAndCash3826337' 6-max Seat #1 is the button
Seat 1: 945a5eb8 ($5.14 in chips)
Seat 2: 5801b1e0 ($5.57 in chips)
Seat 3: Hero ($10.26 in chips)
Seat 4: 80cc9272 ($5 in chips)
Seat 5: 10498ffb ($5.96 in chips)
Seat 6: 4e413e32 ($10.5 in chips)
5801b1e0: posts small blind $0.02
Hero: posts big blind $0.05
*** HOLE CARDS ***
Dealt to 945a5eb8 
Dealt to 5801b1e0 
Dealt to Hero [8h 8c]
Dealt to 80cc9272 
Dealt to 10498ffb 
Dealt to 4e413e32 
80cc9272: folds
10498ffb: folds
4e413e32: folds
945a5eb8: folds
5801b1e0: folds
Uncalled bet ($0.03) returned to Hero
*** SHOWDOWN ***
Hero collected $0.04 from pot
*** SUMMARY ***
Total pot $0.04 | Rake $0 | Jackpot $0 | Bingo $0 | Fortune $0 | Tax $0
Seat 1: 945a5eb8 (button) folded before Flop (didn't bet)
Seat 2: 5801b1e0 (small blind) folded before Flop
Seat 3: Hero (big blind) collected ($0.04)
Seat 4: 80cc9272 folded before Flop (didn't bet)
Seat 5: 10498ffb folded before Flop (didn't bet)
Seat 6: 4e413e32 folded before Flop (didn't bet)


Poker Hand #RC2094783594: Hold'em No Limit ($0.02/$0.05) - 2023/12/27 21:59:17
Table 'RushAndCash3826299' 6-max Seat #1 is the button
Seat 1: Hero ($10.26 in chips)
Seat 2: 890d48d ($5.58 in chips)
Seat 3: 34d7c364 ($4.98 in chips)
Seat 4: 6c7fc561 ($6.83 in chips)
Seat 5: 781281cd ($5 in chips)
Seat 6: 32b6fcd6 ($6.74 in chips)
890d48d: posts small blind $0.02
34d7c364: posts big blind $0.05
*** HOLE CARDS ***
Dealt to Hero [6s 9h]
Dealt to 890d48d 
Dealt to 34d7c364 
Dealt to 6c7fc561 
Dealt to 781281cd 
Dealt to 32b6fcd6 
6c7fc561: raises $0.05 to $0.1
781281cd: folds
32b6fcd6: folds
Hero: folds
890d48d: folds
34d7c364: folds
Uncalled bet ($0.05) returned to 6c7fc561
*** SHOWDOWN ***
6c7fc561 collected $0.12 from pot
*** SUMMARY ***
Total pot $0.12 | Rake $0 | Jackpot $0 | Bingo $0 | Fortune $0 | Tax $0
Seat 1: Hero (button) folded before Flop (didn't bet)
Seat 2: 890d48d (small blind) folded before Flop
Seat 3: 34d7c364 (big blind) folded before Flop
Seat 4: 6c7fc561 collected ($0.12)
Seat 5: 781281cd folded before Flop (didn't bet)
Seat 6: 32b6fcd6 folded before Flop (didn't bet)


Poker Hand #RC2094783505: Hold'em No Limit ($0.02/$0.05) - 2023/12/27 21:59:12
Table 'RushAndCash3826262' 6-max Seat #1 is the button
Seat 1: e2e11081 ($1.44 in chips)
Seat 2: 180a21bc ($6.07 in chips)
Seat 3: 84de0a63 ($5.97 in chips)
Seat 4: 1f765dad ($5.2 in chips)
Seat 5: Hero ($10.26 in chips)
Seat 6: b324aa8c ($5.07 in chips)
180a21bc: posts small blind $0.02
84de0a63: posts big blind $0.05
*** HOLE CARDS ***
Dealt to e2e11081 
Dealt to 180a21bc 
Dealt to 84de0a63 
Dealt to 1f765dad 
Dealt to Hero [Js 3c]
Dealt to b324aa8c 
1f765dad: folds
Hero: folds
b324aa8c: folds
e2e11081: raises $0.06 to $0.11
180a21bc: raises $0.39 to $0.5
84de0a63: folds
e2e11081: folds
Uncalled bet ($0.39) returned to 180a21bc
*** SHOWDOWN ***
180a21bc collected $0.26 from pot
*** SUMMARY ***
Total pot $0.27 | Rake $0.01 | Jackpot $0 | Bingo $0 | Fortune $0 | Tax $0
Seat 1: e2e11081 (button) folded before Flop
Seat 2: 180a21bc (small blind) collected ($0.26)
Seat 3: 84de0a63 (big blind) folded before Flop
Seat 4: 1f765dad folded before Flop (didn't bet)
Seat 5: Hero folded before Flop (didn't bet)
Seat 6: b324aa8c folded before Flop (didn't bet)


Poker Hand #RC2094783351: Hold'em No Limit ($0.02/$0.05) - 2023/12/27 21:59:04
Table 'RushAndCash3826193' 6-max Seat #1 is the button
Seat 1: b74177f1 ($5.42 in chips)
Seat 2: Hero ($10.28 in chips)
Seat 3: bce2611d ($4.91 in chips)
Seat 4: fd558fee ($7.08 in chips)
Seat 5: a3243cd1 ($16.66 in chips)
Seat 6: 8ad83a64 ($5.92 in chips)
Hero: posts small blind $0.02
bce2611d: posts big blind $0.05
*** HOLE CARDS ***
Dealt to b74177f1 
Dealt to Hero [7c Jc]
Dealt to bce2611d 
Dealt to fd558fee 
Dealt to a3243cd1 
Dealt to 8ad83a64 
fd558fee: folds
a3243cd1: raises $0.05 to $0.1
8ad83a64: folds
b74177f1: folds
Hero: folds
bce2611d: folds
Uncalled bet ($0.05) returned to a3243cd1
*** SHOWDOWN ***
a3243cd1 collected $0.12 from pot
*** SUMMARY ***
Total pot $0.12 | Rake $0 | Jackpot $0 | Bingo $0 | Fortune $0 | Tax $0
Seat 1: b74177f1 (button) folded before Flop (didn't bet)
Seat 2: Hero (small blind) folded before Flop
Seat 3: bce2611d (big blind) folded before Flop
Seat 4: fd558fee folded before Flop (didn't bet)
Seat 5: a3243cd1 collected ($0.12)
Seat 6: 8ad83a64 folded before Flop (didn't bet)


Poker Hand #RC2094783048: Hold'em No Limit ($0.02/$0.05) - 2023/12/27 21:58:49
Table 'RushAndCash3826051' 6-max Seat #1 is the button
Seat 1: fbad1ce9 ($3.08 in chips)
Seat 2: fdae0788 ($4.33 in chips)
Seat 3: 934d578e ($1.96 in chips)
Seat 4: aa3f9bcd ($5 in chips)
Seat 5: 3528bf25 ($7.17 in chips)
Seat 6: Hero ($10.21 in chips)
fdae0788: posts small blind $0.02
934d578e: posts big blind $0.05
*** HOLE CARDS ***
Dealt to fbad1ce9 
Dealt to fdae0788 
Dealt to 934d578e 
Dealt to aa3f9bcd 
Dealt to 3528bf25 
Dealt to Hero [Ac 7c]
aa3f9bcd: folds
3528bf25: folds
Hero: raises $0.05 to $0.1
fbad1ce9: folds
fdae0788: folds
934d578e: folds
Uncalled bet ($0.05) returned to Hero
*** SHOWDOWN ***
Hero collected $0.12 from pot
*** SUMMARY ***
Total pot $0.12 | Rake $0 | Jackpot $0 | Bingo $0 | Fortune $0 | Tax $0
Seat 1: fbad1ce9 (button) folded before Flop (didn't bet)
Seat 2: fdae0788 (small blind) folded before Flop
Seat 3: 934d578e (big blind) folded before Flop
Seat 4: aa3f9bcd folded before Flop (didn't bet)
Seat 5: 3528bf25 folded before Flop (didn't bet)
Seat 6: Hero collected ($0.12)


Poker Hand #RC2094782937: Hold'em No Limit ($0.02/$0.05) - 2023/12/27 21:58:43
Table 'RushAndCash3826000' 6-max Seat #1 is the button
Seat 1: a53d5fed ($8.91 in chips)
Seat 2: d7545fc3 ($6.09 in chips)
Seat 3: 53d86a23 ($5.1 in chips)
Seat 4: Hero ($10.21 in chips)
Seat 5: cc15e090 ($7.62 in chips)
Seat 6: f2327973 ($5.05 in chips)
d7545fc3: posts small blind $0.02
53d86a23: posts big blind $0.05
*** HOLE CARDS ***
Dealt to a53d5fed 
Dealt to d7545fc3 
Dealt to 53d86a23 
Dealt to Hero [3s 8s]
Dealt to cc15e090 
Dealt to f2327973 
Hero: folds
cc15e090: folds
f2327973: folds
a53d5fed: folds
d7545fc3: folds
Uncalled bet ($0.03) returned to 53d86a23
*** SHOWDOWN ***
53d86a23 collected $0.04 from pot
*** SUMMARY ***
Total pot $0.04 | Rake $0 | Jackpot $0 | Bingo $0 | Fortune $0 | Tax $0
Seat 1: a53d5fed (button) folded before Flop (didn't bet)
Seat 2: d7545fc3 (small blind) folded before Flop
Seat 3: 53d86a23 (big blind) collected ($0.04)
Seat 4: Hero folded before Flop (didn't bet)
Seat 5: cc15e090 folded before Flop (didn't bet)
Seat 6: f2327973 folded before Flop (didn't bet)


Poker Hand #RC2094782743: Hold'em No Limit ($0.02/$0.05) - 2023/12/27 21:58:34
Table 'RushAndCash3825913' 6-max Seat #1 is the button
Seat 1: 31d20a36 ($15.54 in chips)
Seat 2: Hero ($10.23 in chips)
Seat 3: 9a47c457 ($5.35 in chips)
Seat 4: f24b7b85 ($7.72 in chips)
Seat 5: 5e22d2c4 ($9.66 in chips)
Seat 6: 73a02f29 ($5 in chips)
Hero: posts small blind $0.02
9a47c457: posts big blind $0.05
*** HOLE CARDS ***
Dealt to 31d20a36 
Dealt to Hero [4c 7h]
Dealt to 9a47c457 
Dealt to f24b7b85 
Dealt to 5e22d2c4 
Dealt to 73a02f29 
f24b7b85: folds
5e22d2c4: folds
73a02f29: folds
31d20a36: folds
Hero: folds
Uncalled bet ($0.03) returned to 9a47c457
*** SHOWDOWN ***
9a47c457 collected $0.04 from pot
*** SUMMARY ***
Total pot $0.04 | Rake $0 | Jackpot $0 | Bingo $0 | Fortune $0 | Tax $0
Seat 1: 31d20a36 (button) folded before Flop (didn't bet)
Seat 2: Hero (small blind) folded before Flop
Seat 3: 9a47c457 (big blind) collected ($0.04)
Seat 4: f24b7b85 folded before Flop (didn't bet)
Seat 5: 5e22d2c4 folded before Flop (didn't bet)
Seat 6: 73a02f29 folded before Flop (didn't bet)


Poker Hand #RC2094782459: Hold'em No Limit ($0.02/$0.05) - 2023/12/27 21:58:20
Table 'RushAndCash3825774' 6-max Seat #1 is the button
Seat 1: fe238212 ($3.81 in chips)
Seat 2: 10498ffb ($5.98 in chips)
Seat 3: Hero ($10.21 in chips)
Seat 4: 4e46285c ($15.55 in chips)
Seat 5: d7545fc3 ($6.14 in chips)
Seat 6: f05dee9b ($6.35 in chips)
10498ffb: posts small blind $0.02
Hero: posts big blind $0.05
*** HOLE CARDS ***
Dealt to fe238212 
Dealt to 10498ffb 
Dealt to Hero [8d 4h]
Dealt to 4e46285c 
Dealt to d7545fc3 
Dealt to f05dee9b 
4e46285c: folds
d7545fc3: folds
f05dee9b: folds
fe238212: folds
10498ffb: folds
Uncalled bet ($0.03) returned to Hero
*** SHOWDOWN ***
Hero collected $0.04 from pot
*** SUMMARY ***
Total pot $0.04 | Rake $0 | Jackpot $0 | Bingo $0 | Fortune $0 | Tax $0
Seat 1: fe238212 (button) folded before Flop (didn't bet)
Seat 2: 10498ffb (small blind) folded before Flop
Seat 3: Hero (big blind) collected ($0.04)
Seat 4: 4e46285c folded before Flop (didn't bet)
Seat 5: d7545fc3 folded before Flop (didn't bet)
Seat 6: f05dee9b folded before Flop (didn't bet)


Poker Hand #RC2094782381: Hold'em No Limit ($0.02/$0.05) - 2023/12/27 21:58:16
Table 'RushAndCash3825740' 6-max Seat #1 is the button
Seat 1: 26c09e5f ($5 in chips)
Seat 2: f7d792af ($5.11 in chips)
Seat 3: 2a2dfb36 ($5 in chips)
Seat 4: 9a47c457 ($5.35 in chips)
Seat 5: Hero ($10.21 in chips)
Seat 6: d7545fc3 ($6.14 in chips)
f7d792af: posts small blind $0.02
2a2dfb36: posts big blind $0.05
*** HOLE CARDS ***
Dealt to 26c09e5f 
Dealt to f7d792af 
Dealt to 2a2dfb36 
Dealt to 9a47c457 
Dealt to Hero [Qs 2s]
Dealt to d7545fc3 
9a47c457: folds
Hero: folds
d7545fc3: folds
26c09e5f: folds
f7d792af: folds
Uncalled bet ($0.03) returned to 2a2dfb36
*** SHOWDOWN ***
2a2dfb36 collected $0.04 from pot
*** SUMMARY ***
Total pot $0.04 | Rake $0 | Jackpot $0 | Bingo $0 | Fortune $0 | Tax $0
Seat 1: 26c09e5f (button) folded before Flop (didn't bet)
Seat 2: f7d792af (small blind) folded before Flop
Seat 3: 2a2dfb36 (big blind) collected ($0.04)
Seat 4: 9a47c457 folded before Flop (didn't bet)
Seat 5: Hero folded before Flop (didn't bet)
Seat 6: d7545fc3 folded before Flop (didn't bet)


Poker Hand #RC2094782265: Hold'em No Limit ($0.02/$0.05) - 2023/12/27 21:58:11
Table 'RushAndCash3825686' 6-max Seat #1 is the button
Seat 1: 9ede0bef ($5 in chips)
Seat 2: Hero ($10.23 in chips)
Seat 3: 181b99b4 ($5 in chips)
Seat 4: ce54c46a ($11.43 in chips)
Seat 5: 8ad83a64 ($5.94 in chips)
Seat 6: 53952f57 ($7.55 in chips)
Hero: posts small blind $0.02
181b99b4: posts big blind $0.05
*** HOLE CARDS ***
Dealt to 9ede0bef 
Dealt to Hero [Jh Kd]
Dealt to 181b99b4 
Dealt to ce54c46a 
Dealt to 8ad83a64 
Dealt to 53952f57 
ce54c46a: raises $0.05 to $0.1
8ad83a64: folds
53952f57: folds
9ede0bef: folds
Hero: folds
181b99b4: folds
Uncalled bet ($0.05) returned to ce54c46a
*** SHOWDOWN ***
ce54c46a collected $0.12 from pot
*** SUMMARY ***
Total pot $0.12 | Rake $0 | Jackpot $0 | Bingo $0 | Fortune $0 | Tax $0
Seat 1: 9ede0bef (button) folded before Flop (didn't bet)
Seat 2: Hero (small blind) folded before Flop
Seat 3: 181b99b4 (big blind) folded before Flop
Seat 4: ce54c46a collected ($0.12)
Seat 5: 8ad83a64 folded before Flop (didn't bet)
Seat 6: 53952f57 folded before Flop (didn't bet)


Poker Hand #RC2094781558: Hold'em No Limit ($0.02/$0.05) - 2023/12/27 21:57:35
Table 'RushAndCash3825351' 6-max Seat #1 is the button
Seat 1: 6a37d362 ($5.31 in chips)
Seat 2: 8fceda9f ($5.18 in chips)
Seat 3: Hero ($10.11 in chips)
Seat 4: a3ae3500 ($3.53 in chips)
Seat 5: cc992d9a ($4.45 in chips)
Seat 6: 4739e385 ($2.59 in chips)
8fceda9f: posts small blind $0.02
Hero: posts big blind $0.05
*** HOLE CARDS ***
Dealt to 6a37d362 
Dealt to 8fceda9f 
Dealt to Hero [7s As]
Dealt to a3ae3500 
Dealt to cc992d9a 
Dealt to 4739e385 
a3ae3500: raises $0.06 to $0.11
cc992d9a: folds
4739e385: folds
6a37d362: folds
8fceda9f: folds
Hero: calls $0.06
*** FLOP *** [Tc 5s 3s]
Hero: checks
a3ae3500: checks
*** TURN *** [Tc 5s 3s] [6s]
Hero: checks
a3ae3500: checks
*** RIVER *** [Tc 5s 3s 6s] [3h]
Hero: bets $0.1
a3ae3500: folds
Uncalled bet ($0.1) returned to Hero
*** SHOWDOWN ***
Hero collected $0.23 from pot
*** SUMMARY ***
Total pot $0.24 | Rake $0.01 | Jackpot $0 | Bingo $0 | Fortune $0 | Tax $0
Board [Tc 5s 3s 6s 3h]
Seat 1: 6a37d362 (button) folded before Flop (didn't bet)
Seat 2: 8fceda9f (small blind) folded before Flop
Seat 3: Hero (big blind) won ($0.23)
Seat 4: a3ae3500 folded on the River
Seat 5: cc992d9a folded before Flop (didn't bet)
Seat 6: 4739e385 folded before Flop (didn't bet)


Poker Hand #RC2094781479: Hold'em No Limit ($0.02/$0.05) - 2023/12/27 21:57:31
Table 'RushAndCash3825312' 6-max Seat #1 is the button
Seat 1: df9f25b ($4.59 in chips)
Seat 2: fa338ba2 ($3.64 in chips)
Seat 3: 1e710d8 ($6.73 in chips)
Seat 4: c2dfd0aa ($6.31 in chips)
Seat 5: 9a2b2bd3 ($6.16 in chips)
Seat 6: Hero ($10.11 in chips)
fa338ba2: posts small blind $0.02
1e710d8: posts big blind $0.05
*** HOLE CARDS ***
Dealt to df9f25b 
Dealt to fa338ba2 
Dealt to 1e710d8 
Dealt to c2dfd0aa 
Dealt to 9a2b2bd3 
Dealt to Hero [4c 8s]
c2dfd0aa: folds
9a2b2bd3: folds
Hero: folds
df9f25b: folds
fa338ba2: raises $0.06 to $0.11
1e710d8: folds
Uncalled bet ($0.06) returned to fa338ba2
*** SHOWDOWN ***
fa338ba2 collected $0.1 from pot
*** SUMMARY ***
Total pot $0.1 | Rake $0 | Jackpot $0 | Bingo $0 | Fortune $0 | Tax $0
Seat 1: df9f25b (button) folded before Flop (didn't bet)
Seat 2: fa338ba2 (small blind) collected ($0.1)
Seat 3: 1e710d8 (big blind) folded before Flop
Seat 4: c2dfd0aa folded before Flop (didn't bet)
Seat 5: 9a2b2bd3 folded before Flop (didn't bet)
Seat 6: Hero folded before Flop (didn't bet)


Poker Hand #RC2094781350: Hold'em No Limit ($0.02/$0.05) - 2023/12/27 21:57:25
Table 'RushAndCash3825246' 6-max Seat #1 is the button
Seat 1: Hero ($10.11 in chips)
Seat 2: b2082962 ($5 in chips)
Seat 3: 583bb1f8 ($5.04 in chips)
Seat 4: 5e87367f ($5.41 in chips)
Seat 5: 3ea707b7 ($5.16 in chips)
Seat 6: 61737da3 ($6.9 in chips)
b2082962: posts small blind $0.02
583bb1f8: posts big blind $0.05
*** HOLE CARDS ***
Dealt to Hero [Th 5d]
Dealt to b2082962 
Dealt to 583bb1f8 
Dealt to 5e87367f 
Dealt to 3ea707b7 
Dealt to 61737da3 
5e87367f: raises $0.05 to $0.1
3ea707b7: folds
61737da3: folds
Hero: folds
b2082962: folds
583bb1f8: calls $0.05
*** FLOP *** [7h 5s 9h]
583bb1f8: bets $0.22
5e87367f: folds
Uncalled bet ($0.22) returned to 583bb1f8
*** SHOWDOWN ***
583bb1f8 collected $0.21 from pot
*** SUMMARY ***
Total pot $0.22 | Rake $0.01 | Jackpot $0 | Bingo $0 | Fortune $0 | Tax $0
Board [7h 5s 9h]
Seat 1: Hero (button) folded before Flop (didn't bet)
Seat 2: b2082962 (small blind) folded before Flop
Seat 3: 583bb1f8 (big blind) won ($0.21)
Seat 4: 5e87367f folded on the Flop
Seat 5: 3ea707b7 folded before Flop (didn't bet)
Seat 6: 61737da3 folded before Flop (didn't bet)


Poker Hand #RC2094781185: Hold'em No Limit ($0.02/$0.05) - 2023/12/27 21:57:18
Table 'RushAndCash3825168' 6-max Seat #1 is the button
Seat 1: 40e2ea8e ($7.72 in chips)
Seat 2: Hero ($10.13 in chips)
Seat 3: 961b7a42 ($7.94 in chips)
Seat 4: 53952f57 ($7.39 in chips)
Seat 5: e72137e2 ($32.68 in chips)
Seat 6: 2259dd2a ($5.87 in chips)
Hero: posts small blind $0.02
961b7a42: posts big blind $0.05
*** HOLE CARDS ***
Dealt to 40e2ea8e 
Dealt to Hero [Jd 9s]
Dealt to 961b7a42 
Dealt to 53952f57 
Dealt to e72137e2 
Dealt to 2259dd2a 
53952f57: folds
e72137e2: folds
2259dd2a: folds
40e2ea8e: folds
Hero: folds
Uncalled bet ($0.03) returned to 961b7a42
*** SHOWDOWN ***
961b7a42 collected $0.04 from pot
*** SUMMARY ***
Total pot $0.04 | Rake $0 | Jackpot $0 | Bingo $0 | Fortune $0 | Tax $0
Seat 1: 40e2ea8e (button) folded before Flop (didn't bet)
Seat 2: Hero (small blind) folded before Flop
Seat 3: 961b7a42 (big blind) collected ($0.04)
Seat 4: 53952f57 folded before Flop (didn't bet)
Seat 5: e72137e2 folded before Flop (didn't bet)
Seat 6: 2259dd2a folded before Flop (didn't bet)


Poker Hand #RC2094780604: Hold'em No Limit ($0.02/$0.05) - 2023/12/27 21:56:50
Table 'RushAndCash3824898' 6-max Seat #1 is the button
Seat 1: 7a63b7cf ($5 in chips)
Seat 2: 981c98f0 ($1.15 in chips)
Seat 3: 9c855748 ($10.17 in chips)
Seat 4: 97de8ad6 ($5.19 in chips)
Seat 5: 53952f57 ($7.5 in chips)
Seat 6: Hero ($9.96 in chips)
981c98f0: posts small blind $0.02
9c855748: posts big blind $0.05
*** HOLE CARDS ***
Dealt to 7a63b7cf 
Dealt to 981c98f0 
Dealt to 9c855748 
Dealt to 97de8ad6 
Dealt to 53952f57 
Dealt to Hero [Ah Ac]
97de8ad6: folds
53952f57: raises $0.06 to $0.11
Hero: raises $0.29 to $0.4
7a63b7cf: folds
981c98f0: folds
9c855748: folds
53952f57: folds
Uncalled bet ($0.29) returned to Hero
*** SHOWDOWN ***
Hero collected $0.28 from pot
*** SUMMARY ***
Total pot $0.29 | Rake $0.01 | Jackpot $0 | Bingo $0 | Fortune $0 | Tax $0
Seat 1: 7a63b7cf (button) folded before Flop (didn't bet)
Seat 2: 981c98f0 (small blind) folded before Flop
Seat 3: 9c855748 (big blind) folded before Flop
Seat 4: 97de8ad6 folded before Flop (didn't bet)
Seat 5: 53952f57 folded before Flop
Seat 6: Hero collected ($0.28)


Poker Hand #RC2094780152: Hold'em No Limit ($0.02/$0.05) - 2023/12/27 21:56:28
Table 'RushAndCash3824695' 6-max Seat #1 is the button
Seat 1: 53952f57 ($7.13 in chips)
Seat 2: 3fee3a29 ($3.07 in chips)
Seat 3: affbdae1 ($5.95 in chips)
Seat 4: Hero ($10.29 in chips)
Seat 5: 1cabf370 ($11.92 in chips)
Seat 6: 49de23b9 ($5 in chips)
3fee3a29: posts small blind $0.02
affbdae1: posts big blind $0.05
*** HOLE CARDS ***
Dealt to 53952f57 
Dealt to 3fee3a29 
Dealt to affbdae1 
Dealt to Hero [Ks Qh]
Dealt to 1cabf370 
Dealt to 49de23b9 
Hero: raises $0.05 to $0.1
1cabf370: folds
49de23b9: folds
53952f57: raises $0.23 to $0.33
3fee3a29: folds
affbdae1: folds
Hero: calls $0.23
*** FLOP *** [Jd 7c 5d]
Hero: checks
53952f57: bets $0.25
Hero: folds
Uncalled bet ($0.25) returned to 53952f57
*** SHOWDOWN ***
53952f57 collected $0.7 from pot
*** SUMMARY ***
Total pot $0.73 | Rake $0.03 | Jackpot $0 | Bingo $0 | Fortune $0 | Tax $0
Board [Jd 7c 5d]
Seat 1: 53952f57 (button) won ($0.7)
Seat 2: 3fee3a29 (small blind) folded before Flop
Seat 3: affbdae1 (big blind) folded before Flop
Seat 4: Hero folded on the Flop
Seat 5: 1cabf370 folded before Flop (didn't bet)
Seat 6: 49de23b9 folded before Flop (didn't bet)


Poker Hand #RC2094780081: Hold'em No Limit ($0.02/$0.05) - 2023/12/27 21:56:24
Table 'RushAndCash3824662' 6-max Seat #1 is the button
Seat 1: f8a29f2e ($5.43 in chips)
Seat 2: c8fcf0e7 ($5.32 in chips)
Seat 3: ec8a1db7 ($5.76 in chips)
Seat 4: Hero ($10.29 in chips)
Seat 5: 33c413e5 ($9.02 in chips)
Seat 6: 97aed9d4 ($21.32 in chips)
c8fcf0e7: posts small blind $0.02
ec8a1db7: posts big blind $0.05
*** HOLE CARDS ***
Dealt to f8a29f2e 
Dealt to c8fcf0e7 
Dealt to ec8a1db7 
Dealt to Hero [6c Th]
Dealt to 33c413e5 
Dealt to 97aed9d4 
Hero: folds
33c413e5: folds
97aed9d4: folds
f8a29f2e: folds
c8fcf0e7: folds
Uncalled bet ($0.03) returned to ec8a1db7
*** SHOWDOWN ***
ec8a1db7 collected $0.04 from pot
*** SUMMARY ***
Total pot $0.04 | Rake $0 | Jackpot $0 | Bingo $0 | Fortune $0 | Tax $0
Seat 1: f8a29f2e (button) folded before Flop (didn't bet)
Seat 2: c8fcf0e7 (small blind) folded before Flop
Seat 3: ec8a1db7 (big blind) collected ($0.04)
Seat 4: Hero folded before Flop (didn't bet)
Seat 5: 33c413e5 folded before Flop (didn't bet)
Seat 6: 97aed9d4 folded before Flop (didn't bet)


Poker Hand #RC2094779999: Hold'em No Limit ($0.02/$0.05) - 2023/12/27 21:56:20
Table 'RushAndCash3824623' 6-max Seat #1 is the button
Seat 1: 251d3082 ($5.39 in chips)
Seat 2: 9a86c0e4 ($4 in chips)
Seat 3: 1b28deb0 ($5.81 in chips)
Seat 4: f829c887 ($5.9 in chips)
Seat 5: Hero ($10.29 in chips)
Seat 6: 6265c52d ($5.63 in chips)
9a86c0e4: posts small blind $0.02
1b28deb0: posts big blind $0.05
*** HOLE CARDS ***
Dealt to 251d3082 
Dealt to 9a86c0e4 
Dealt to 1b28deb0 
Dealt to f829c887 
Dealt to Hero [Qh 7c]
Dealt to 6265c52d 
f829c887: folds
Hero: folds
6265c52d: folds
251d3082: folds
9a86c0e4: folds
Uncalled bet ($0.03) returned to 1b28deb0
*** SHOWDOWN ***
1b28deb0 collected $0.04 from pot
*** SUMMARY ***
Total pot $0.04 | Rake $0 | Jackpot $0 | Bingo $0 | Fortune $0 | Tax $0
Seat 1: 251d3082 (button) folded before Flop (didn't bet)
Seat 2: 9a86c0e4 (small blind) folded before Flop
Seat 3: 1b28deb0 (big blind) collected ($0.04)
Seat 4: f829c887 folded before Flop (didn't bet)
Seat 5: Hero folded before Flop (didn't bet)
Seat 6: 6265c52d folded before Flop (didn't bet)


Poker Hand #RC2094779926: Hold'em No Limit ($0.02/$0.05) - 2023/12/27 21:56:17
Table 'RushAndCash3824588' 6-max Seat #1 is the button
Seat 1: Hero ($10.29 in chips)
Seat 2: 97aed9d4 ($21.34 in chips)
Seat 3: bcf443b6 ($8.57 in chips)
Seat 4: e75cdf96 ($8.98 in chips)
Seat 5: 160e801a ($5 in chips)
Seat 6: 30d7a069 ($5.91 in chips)
97aed9d4: posts small blind $0.02
bcf443b6: posts big blind $0.05
*** HOLE CARDS ***
Dealt to Hero [4s 9d]
Dealt to 97aed9d4 
Dealt to bcf443b6 
Dealt to e75cdf96 
Dealt to 160e801a 
Dealt to 30d7a069 
e75cdf96: raises $0.07 to $0.12
160e801a: calls $0.12
30d7a069: folds
Hero: folds
97aed9d4: folds
bcf443b6: folds
*** FLOP *** [Td 4d Kh]
e75cdf96: bets $0.12
160e801a: folds
Uncalled bet ($0.12) returned to e75cdf96
*** SHOWDOWN ***
e75cdf96 collected $0.3 from pot
*** SUMMARY ***
Total pot $0.31 | Rake $0.01 | Jackpot $0 | Bingo $0 | Fortune $0 | Tax $0
Board [Td 4d Kh]
Seat 1: Hero (button) folded before Flop (didn't bet)
Seat 2: 97aed9d4 (small blind) folded before Flop
Seat 3: bcf443b6 (big blind) folded before Flop
Seat 4: e75cdf96 won ($0.3)
Seat 5: 160e801a folded on the Flop
Seat 6: 30d7a069 folded before Flop (didn't bet)


Poker Hand #RC2094779854: Hold'em No Limit ($0.02/$0.05) - 2023/12/27 21:56:13
Table 'RushAndCash3824555' 6-max Seat #1 is the button
Seat 1: Hero ($10.29 in chips)
Seat 2: 51e25143 ($5 in chips)
Seat 3: af05a87 ($5.32 in chips)
Seat 4: 257aef ($7.21 in chips)
Seat 5: 23d3ca5e ($19.26 in chips)
Seat 6: a163dcf0 ($1.91 in chips)
51e25143: posts small blind $0.02
af05a87: posts big blind $0.05
*** HOLE CARDS ***
Dealt to Hero [Jd 6h]
Dealt to 51e25143 
Dealt to af05a87 
Dealt to 257aef 
Dealt to 23d3ca5e 
Dealt to a163dcf0 
257aef: folds
23d3ca5e: folds
a163dcf0: raises $0.05 to $0.1
Hero: folds
51e25143: folds
af05a87: calls $0.05
*** FLOP *** [Ac Th 9d]
af05a87: checks
a163dcf0: bets $0.11
af05a87: raises $0.33 to $0.44
a163dcf0: folds
Uncalled bet ($0.33) returned to af05a87
*** SHOWDOWN ***
af05a87 collected $0.42 from pot
*** SUMMARY ***
Total pot $0.44 | Rake $0.02 | Jackpot $0 | Bingo $0 | Fortune $0 | Tax $0
Board [Ac Th 9d]
Seat 1: Hero (button) folded before Flop (didn't bet)
Seat 2: 51e25143 (small blind) folded before Flop
Seat 3: af05a87 (big blind) won ($0.42)
Seat 4: 257aef folded before Flop (didn't bet)
Seat 5: 23d3ca5e folded before Flop (didn't bet)
Seat 6: a163dcf0 folded on the Flop


Poker Hand #RC2094779778: Hold'em No Limit ($0.02/$0.05) - 2023/12/27 21:56:09
Table 'RushAndCash3824517' 6-max Seat #1 is the button
Seat 1: d91f2ab0 ($5 in chips)
Seat 2: a0c39214 ($5.02 in chips)
Seat 3: 8dc4f307 ($7.11 in chips)
Seat 4: 1e710d8 ($6.64 in chips)
Seat 5: Hero ($10.29 in chips)
Seat 6: fe238212 ($4.34 in chips)
a0c39214: posts small blind $0.02
8dc4f307: posts big blind $0.05
*** HOLE CARDS ***
Dealt to d91f2ab0 
Dealt to a0c39214 
Dealt to 8dc4f307 
Dealt to 1e710d8 
Dealt to Hero [6d Ah]
Dealt to fe238212 
1e710d8: raises $0.07 to $0.12
Hero: folds
fe238212: folds
d91f2ab0: folds
a0c39214: folds
8dc4f307: calls $0.07
*** FLOP *** [As 9h 2h]
8dc4f307: checks
1e710d8: checks
*** TURN *** [As 9h 2h] [9s]
8dc4f307: checks
1e710d8: checks
*** RIVER *** [As 9h 2h 9s] [Kd]
8dc4f307: bets $0.09
1e710d8: raises $6.43 to $6.52 and is all-in
8dc4f307: folds
Uncalled bet ($6.43) returned to 1e710d8
*** SHOWDOWN ***
1e710d8 collected $0.42 from pot
*** SUMMARY ***
Total pot $0.44 | Rake $0.02 | Jackpot $0 | Bingo $0 | Fortune $0 | Tax $0
Board [As 9h 2h 9s Kd]
Seat 1: d91f2ab0 (button) folded before Flop (didn't bet)
Seat 2: a0c39214 (small blind) folded before Flop
Seat 3: 8dc4f307 (big blind) folded on the River
Seat 4: 1e710d8 won ($0.42)
Seat 5: Hero folded before Flop (didn't bet)
Seat 6: fe238212 folded before Flop (didn't bet)


Poker Hand #RC2094779705: Hold'em No Limit ($0.02/$0.05) - 2023/12/27 21:56:06
Table 'RushAndCash3824484' 6-max Seat #1 is the button
Seat 1: c28bae97 ($5.18 in chips)
Seat 2: 85217622 ($23.35 in chips)
Seat 3: Hero ($10.34 in chips)
Seat 4: 1e710d8 ($6.64 in chips)
Seat 5: 6431e365 ($12.66 in chips)
Seat 6: 8dc4f307 ($7.11 in chips)
85217622: posts small blind $0.02
Hero: posts big blind $0.05
*** HOLE CARDS ***
Dealt to c28bae97 
Dealt to 85217622 
Dealt to Hero [6s Td]
Dealt to 1e710d8 
Dealt to 6431e365 
Dealt to 8dc4f307 
1e710d8: folds
6431e365: folds
8dc4f307: folds
c28bae97: raises $0.05 to $0.1
85217622: folds
Hero: folds
Uncalled bet ($0.05) returned to c28bae97
*** SHOWDOWN ***
c28bae97 collected $0.12 from pot
*** SUMMARY ***
Total pot $0.12 | Rake $0 | Jackpot $0 | Bingo $0 | Fortune $0 | Tax $0
Seat 1: c28bae97 (button) collected ($0.12)
Seat 2: 85217622 (small blind) folded before Flop
Seat 3: Hero (big blind) folded before Flop
Seat 4: 1e710d8 folded before Flop (didn't bet)
Seat 5: 6431e365 folded before Flop (didn't bet)
Seat 6: 8dc4f307 folded before Flop (didn't bet)


Poker Hand #RC2094779624: Hold'em No Limit ($0.02/$0.05) - 2023/12/27 21:56:02
Table 'RushAndCash3824448' 6-max Seat #1 is the button
Seat 1: 4c63ecae ($5.04 in chips)
Seat 2: aa3f9bcd ($5 in chips)
Seat 3: 7434f2f7 ($10.53 in chips)
Seat 4: b9485e14 ($4.37 in chips)
Seat 5: 9815c904 ($7.94 in chips)
Seat 6: Hero ($10.34 in chips)
aa3f9bcd: posts small blind $0.02
7434f2f7: posts big blind $0.05
*** HOLE CARDS ***
Dealt to 4c63ecae 
Dealt to aa3f9bcd 
Dealt to 7434f2f7 
Dealt to b9485e14 
Dealt to 9815c904 
Dealt to Hero [7c 4s]
b9485e14: folds
9815c904: folds
Hero: folds
4c63ecae: raises $0.06 to $0.11
aa3f9bcd: folds
7434f2f7: folds
Uncalled bet ($0.06) returned to 4c63ecae
*** SHOWDOWN ***
4c63ecae collected $0.12 from pot
*** SUMMARY ***
Total pot $0.12 | Rake $0 | Jackpot $0 | Bingo $0 | Fortune $0 | Tax $0
Seat 1: 4c63ecae (button) collected ($0.12)
Seat 2: aa3f9bcd (small blind) folded before Flop
Seat 3: 7434f2f7 (big blind) folded before Flop
Seat 4: b9485e14 folded before Flop (didn't bet)
Seat 5: 9815c904 folded before Flop (didn't bet)
Seat 6: Hero folded before Flop (didn't bet)


Poker Hand #RC2094779545: Hold'em No Limit ($0.02/$0.05) - 2023/12/27 21:55:57
Table 'RushAndCash3824411' 6-max Seat #1 is the button
Seat 1: af05a87 ($5.25 in chips)
Seat 2: 74c2f2d2 ($5.07 in chips)
Seat 3: 2e1c2eb ($6.71 in chips)
Seat 4: a26d8d82 ($9.2 in chips)
Seat 5: b9485e14 ($4.37 in chips)
Seat 6: Hero ($10.34 in chips)
74c2f2d2: posts small blind $0.02
2e1c2eb: posts big blind $0.05
*** HOLE CARDS ***
Dealt to af05a87 
Dealt to 74c2f2d2 
Dealt to 2e1c2eb 
Dealt to a26d8d82 
Dealt to b9485e14 
Dealt to Hero [Ac 7h]
a26d8d82: folds
b9485e14: folds
Hero: folds
af05a87: raises $0.08 to $0.13
74c2f2d2: folds
2e1c2eb: folds
Uncalled bet ($0.08) returned to af05a87
*** SHOWDOWN ***
af05a87 collected $0.12 from pot
*** SUMMARY ***
Total pot $0.12 | Rake $0 | Jackpot $0 | Bingo $0 | Fortune $0 | Tax $0
Seat 1: af05a87 (button) collected ($0.12)
Seat 2: 74c2f2d2 (small blind) folded before Flop
Seat 3: 2e1c2eb (big blind) folded before Flop
Seat 4: a26d8d82 folded before Flop (didn't bet)
Seat 5: b9485e14 folded before Flop (didn't bet)
Seat 6: Hero folded before Flop (didn't bet)


Poker Hand #RC2094779479: Hold'em No Limit ($0.02/$0.05) - 2023/12/27 21:55:54
Table 'RushAndCash3824374' 6-max Seat #1 is the button
Seat 1: 3f587bf6 ($13.93 in chips)
Seat 2: 48dc9f88 ($5.87 in chips)
Seat 3: 9a86c0e4 ($3.89 in chips)
Seat 4: 1853e4f7 ($14.33 in chips)
Seat 5: Hero ($10.34 in chips)
Seat 6: 80bc4dbd ($7.11 in chips)
48dc9f88: posts small blind $0.02
9a86c0e4: posts big blind $0.05
*** HOLE CARDS ***
Dealt to 3f587bf6 
Dealt to 48dc9f88 
Dealt to 9a86c0e4 
Dealt to 1853e4f7 
Dealt to Hero [6h 2c]
Dealt to 80bc4dbd 
1853e4f7: raises $0.05 to $0.1
Hero: folds
80bc4dbd: folds
3f587bf6: folds
48dc9f88: folds
9a86c0e4: raises $0.22 to $0.32
1853e4f7: folds
Uncalled bet ($0.22) returned to 9a86c0e4
*** SHOWDOWN ***
9a86c0e4 collected $0.21 from pot
*** SUMMARY ***
Total pot $0.22 | Rake $0.01 | Jackpot $0 | Bingo $0 | Fortune $0 | Tax $0
Seat 1: 3f587bf6 (button) folded before Flop (didn't bet)
Seat 2: 48dc9f88 (small blind) folded before Flop
Seat 3: 9a86c0e4 (big blind) collected ($0.21)
Seat 4: 1853e4f7 folded before Flop
Seat 5: Hero folded before Flop (didn't bet)
Seat 6: 80bc4dbd folded before Flop (didn't bet)


Poker Hand #RC2094779296: Hold'em No Limit ($0.02/$0.05) - 2023/12/27 21:55:46
Table 'RushAndCash3824280' 6-max Seat #1 is the button
Seat 1: d1e7c1a6 ($4.68 in chips)
Seat 2: b324aa8c ($5.4 in chips)
Seat 3: Hero ($10.32 in chips)
Seat 4: 25fa88af ($4.73 in chips)
Seat 5: 77c5f254 ($5 in chips)
Seat 6: 2dccf225 ($5 in chips)
b324aa8c: posts small blind $0.02
Hero: posts big blind $0.05
*** HOLE CARDS ***
Dealt to d1e7c1a6 
Dealt to b324aa8c 
Dealt to Hero [9c Qs]
Dealt to 25fa88af 
Dealt to 77c5f254 
Dealt to 2dccf225 
25fa88af: folds
77c5f254: folds
2dccf225: folds
d1e7c1a6: folds
b324aa8c: folds
Uncalled bet ($0.03) returned to Hero
*** SHOWDOWN ***
Hero collected $0.04 from pot
*** SUMMARY ***
Total pot $0.04 | Rake $0 | Jackpot $0 | Bingo $0 | Fortune $0 | Tax $0
Seat 1: d1e7c1a6 (button) folded before Flop (didn't bet)
Seat 2: b324aa8c (small blind) folded before Flop
Seat 3: Hero (big blind) collected ($0.04)
Seat 4: 25fa88af folded before Flop (didn't bet)
Seat 5: 77c5f254 folded before Flop (didn't bet)
Seat 6: 2dccf225 folded before Flop (didn't bet)


Poker Hand #RC2094779183: Hold'em No Limit ($0.02/$0.05) - 2023/12/27 21:55:39
Table 'RushAndCash3824225' 6-max Seat #1 is the button
Seat 1: Hero ($10.32 in chips)
Seat 2: f7d792af ($5.43 in chips)
Seat 3: 6e63b45 ($7.19 in chips)
Seat 4: e2e11081 ($3.26 in chips)
Seat 5: 2290d615 ($10.5 in chips)
Seat 6: 8aa066ea ($5 in chips)
f7d792af: posts small blind $0.02
6e63b45: posts big blind $0.05
*** HOLE CARDS ***
Dealt to Hero [3d 6h]
Dealt to f7d792af 
Dealt to 6e63b45 
Dealt to e2e11081 
Dealt to 2290d615 
Dealt to 8aa066ea 
e2e11081: raises $0.06 to $0.11
2290d615: folds
8aa066ea: folds
Hero: folds
f7d792af: folds
6e63b45: folds
Uncalled bet ($0.06) returned to e2e11081
*** SHOWDOWN ***
e2e11081 collected $0.12 from pot
*** SUMMARY ***
Total pot $0.12 | Rake $0 | Jackpot $0 | Bingo $0 | Fortune $0 | Tax $0
Seat 1: Hero (button) folded before Flop (didn't bet)
Seat 2: f7d792af (small blind) folded before Flop
Seat 3: 6e63b45 (big blind) folded before Flop
Seat 4: e2e11081 collected ($0.12)
Seat 5: 2290d615 folded before Flop (didn't bet)
Seat 6: 8aa066ea folded before Flop (didn't bet)


Poker Hand #RC2094778963: Hold'em No Limit ($0.02/$0.05) - 2023/12/27 21:55:29
Table 'RushAndCash3824118' 6-max Seat #1 is the button
Seat 1: 859737fd ($7.48 in chips)
Seat 2: Hero ($10.34 in chips)
Seat 3: fb843558 ($5 in chips)
Seat 4: 4106b0ea ($5.9 in chips)
Seat 5: 5ba355dd ($2.92 in chips)
Seat 6: 6a37d362 ($5.6 in chips)
Hero: posts small blind $0.02
fb843558: posts big blind $0.05
*** HOLE CARDS ***
Dealt to 859737fd 
Dealt to Hero [5d 7h]
Dealt to fb843558 
Dealt to 4106b0ea 
Dealt to 5ba355dd 
Dealt to 6a37d362 
4106b0ea: folds
5ba355dd: folds
6a37d362: raises $0.08 to $0.13
859737fd: folds
Hero: folds
fb843558: folds
Uncalled bet ($0.08) returned to 6a37d362
*** SHOWDOWN ***
6a37d362 collected $0.12 from pot
*** SUMMARY ***
Total pot $0.12 | Rake $0 | Jackpot $0 | Bingo $0 | Fortune $0 | Tax $0
Seat 1: 859737fd (button) folded before Flop (didn't bet)
Seat 2: Hero (small blind) folded before Flop
Seat 3: fb843558 (big blind) folded before Flop
Seat 4: 4106b0ea folded before Flop (didn't bet)
Seat 5: 5ba355dd folded before Flop (didn't bet)
Seat 6: 6a37d362 collected ($0.12)


Poker Hand #RC2094778744: Hold'em No Limit ($0.02/$0.05) - 2023/12/27 21:55:19
Table 'RushAndCash3824012' 6-max Seat #1 is the button
Seat 1: 1cabf370 ($12 in chips)
Seat 2: Hero ($10.36 in chips)
Seat 3: a53d5fed ($8.92 in chips)
Seat 4: 781281cd ($5.05 in chips)
Seat 5: 4597fc13 ($7.88 in chips)
Seat 6: 57ba2dfd ($8.21 in chips)
Hero: posts small blind $0.02
a53d5fed: posts big blind $0.05
*** HOLE CARDS ***
Dealt to 1cabf370 
Dealt to Hero [2h Tc]
Dealt to a53d5fed 
Dealt to 781281cd 
Dealt to 4597fc13 
Dealt to 57ba2dfd 
781281cd: raises $0.05 to $0.1
4597fc13: folds
57ba2dfd: folds
1cabf370: folds
Hero: folds
a53d5fed: folds
Uncalled bet ($0.05) returned to 781281cd
*** SHOWDOWN ***
781281cd collected $0.12 from pot
*** SUMMARY ***
Total pot $0.12 | Rake $0 | Jackpot $0 | Bingo $0 | Fortune $0 | Tax $0
Seat 1: 1cabf370 (button) folded before Flop (didn't bet)
Seat 2: Hero (small blind) folded before Flop
Seat 3: a53d5fed (big blind) folded before Flop
Seat 4: 781281cd collected ($0.12)
Seat 5: 4597fc13 folded before Flop (didn't bet)
Seat 6: 57ba2dfd folded before Flop (didn't bet)


Poker Hand #RC2094778013: Hold'em No Limit ($0.02/$0.05) - 2023/12/27 21:54:45
Table 'RushAndCash3823661' 6-max Seat #1 is the button
Seat 1: e2e11081 ($2.93 in chips)
Seat 2: 74254aff ($5.26 in chips)
Seat 3: Hero ($10.48 in chips)
Seat 4: b881f476 ($5.09 in chips)
Seat 5: a64665aa ($5 in chips)
Seat 6: 1ea807d1 ($4.98 in chips)
74254aff: posts small blind $0.02
Hero: posts big blind $0.05
*** HOLE CARDS ***
Dealt to e2e11081 
Dealt to 74254aff 
Dealt to Hero [5h 7h]
Dealt to b881f476 
Dealt to a64665aa 
Dealt to 1ea807d1 
b881f476: folds
a64665aa: folds
1ea807d1: raises $0.07 to $0.12
e2e11081: folds
74254aff: folds
Hero: calls $0.07
*** FLOP *** [Jc 4c Ks]
Hero: checks
1ea807d1: bets $0.21
Hero: folds
Uncalled bet ($0.21) returned to 1ea807d1
*** SHOWDOWN ***
1ea807d1 collected $0.25 from pot
*** SUMMARY ***
Total pot $0.26 | Rake $0.01 | Jackpot $0 | Bingo $0 | Fortune $0 | Tax $0
Board [Jc 4c Ks]
Seat 1: e2e11081 (button) folded before Flop (didn't bet)
Seat 2: 74254aff (small blind) folded before Flop
Seat 3: Hero (big blind) folded on the Flop
Seat 4: b881f476 folded before Flop (didn't bet)
Seat 5: a64665aa folded before Flop (didn't bet)
Seat 6: 1ea807d1 won ($0.25)


Poker Hand #RC2094777620: Hold'em No Limit ($0.02/$0.05) - 2023/12/27 21:54:26
Table 'RushAndCash3823483' 6-max Seat #1 is the button
Seat 1: 5507970f ($5.4 in chips)
Seat 2: 23b29eac ($5.02 in chips)
Seat 3: abe1c1b1 ($6.26 in chips)
Seat 4: 82961c60 ($5 in chips)
Seat 5: Hero ($10.41 in chips)
Seat 6: 6ff240fb ($5.84 in chips)
23b29eac: posts small blind $0.02
abe1c1b1: posts big blind $0.05
*** HOLE CARDS ***
Dealt to 5507970f 
Dealt to 23b29eac 
Dealt to abe1c1b1 
Dealt to 82961c60 
Dealt to Hero [Ac Jd]
Dealt to 6ff240fb 
82961c60: folds
Hero: raises $0.05 to $0.1
6ff240fb: folds
5507970f: folds
23b29eac: folds
abe1c1b1: folds
Uncalled bet ($0.05) returned to Hero
*** SHOWDOWN ***
Hero collected $0.12 from pot
*** SUMMARY ***
Total pot $0.12 | Rake $0 | Jackpot $0 | Bingo $0 | Fortune $0 | Tax $0
Seat 1: 5507970f (button) folded before Flop (didn't bet)
Seat 2: 23b29eac (small blind) folded before Flop
Seat 3: abe1c1b1 (big blind) folded before Flop
Seat 4: 82961c60 folded before Flop (didn't bet)
Seat 5: Hero collected ($0.12)
Seat 6: 6ff240fb folded before Flop (didn't bet)


Poker Hand #RC2094777548: Hold'em No Limit ($0.02/$0.05) - 2023/12/27 21:54:22
Table 'RushAndCash3823448' 6-max Seat #1 is the button
Seat 1: 359efefa ($9.21 in chips)
Seat 2: d648759 ($15.67 in chips)
Seat 3: a1e959ec ($6.55 in chips)
Seat 4: cca43bec ($5.52 in chips)
Seat 5: 8a52bf78 ($4.5 in chips)
Seat 6: Hero ($10.41 in chips)
d648759: posts small blind $0.02
a1e959ec: posts big blind $0.05
*** HOLE CARDS ***
Dealt to 359efefa 
Dealt to d648759 
Dealt to a1e959ec 
Dealt to cca43bec 
Dealt to 8a52bf78 
Dealt to Hero [5c 8d]
cca43bec: folds
8a52bf78: folds
Hero: folds
359efefa: folds
d648759: raises $0.1 to $0.15
a1e959ec: folds
Uncalled bet ($0.1) returned to d648759
*** SHOWDOWN ***
d648759 collected $0.1 from pot
*** SUMMARY ***
Total pot $0.1 | Rake $0 | Jackpot $0 | Bingo $0 | Fortune $0 | Tax $0
Seat 1: 359efefa (button) folded before Flop (didn't bet)
Seat 2: d648759 (small blind) collected ($0.1)
Seat 3: a1e959ec (big blind) folded before Flop
Seat 4: cca43bec folded before Flop (didn't bet)
Seat 5: 8a52bf78 folded before Flop (didn't bet)
Seat 6: Hero folded before Flop (didn't bet)


Poker Hand #RC2094777471: Hold'em No Limit ($0.02/$0.05) - 2023/12/27 21:54:19
Table 'RushAndCash3823412' 6-max Seat #1 is the button
Seat 1: 19d9f383 ($4.95 in chips)
Seat 2: 49de23b9 ($5 in chips)
Seat 3: 50203b74 ($8.76 in chips)
Seat 4: ba5c773b ($5.73 in chips)
Seat 5: Hero ($10.41 in chips)
Seat 6: 686d5d70 ($6.03 in chips)
49de23b9: posts small blind $0.02
50203b74: posts big blind $0.05
*** HOLE CARDS ***
Dealt to 19d9f383 
Dealt to 49de23b9 
Dealt to 50203b74 
Dealt to ba5c773b 
Dealt to Hero [Ac 5h]
Dealt to 686d5d70 
ba5c773b: folds
Hero: folds
686d5d70: raises $0.07 to $0.12
19d9f383: folds
49de23b9: folds
50203b74: calls $0.07
*** FLOP *** [Ts Tc As]
50203b74: checks
686d5d70: checks
*** TURN *** [Ts Tc As] [7d]
50203b74: checks
686d5d70: bets $0.13
50203b74: calls $0.13
*** RIVER *** [Ts Tc As 7d] [2h]
50203b74: checks
686d5d70: checks
50203b74: shows [8d 8h] (Pair of Tens and Pair of Eights)
686d5d70: shows [Qs 7s] (Pair of Tens and Pair of Sevens)
*** SHOWDOWN ***
50203b74 collected $0.5 from pot
*** SUMMARY ***
Total pot $0.52 | Rake $0.02 | Jackpot $0 | Bingo $0 | Fortune $0 | Tax $0
Board [Ts Tc As 7d 2h]
Seat 1: 19d9f383 (button) folded before Flop (didn't bet)
Seat 2: 49de23b9 (small blind) folded before Flop
Seat 3: 50203b74 (big blind) showed [8d 8h] and won ($0.5) with Pair of Tens and Pair of Eights
Seat 4: ba5c773b folded before Flop (didn't bet)
Seat 5: Hero folded before Flop (didn't bet)
Seat 6: 686d5d70 showed [Qs 7s] and lost with Pair of Tens and Pair of Sevens


Poker Hand #RC2094777396: Hold'em No Limit ($0.02/$0.05) - 2023/12/27 21:54:15
Table 'RushAndCash3823379' 6-max Seat #1 is the button
Seat 1: 39cd590d ($8.73 in chips)
Seat 2: babbcf16 ($5 in chips)
Seat 3: 143f7b2f ($5.86 in chips)
Seat 4: Hero ($10.41 in chips)
Seat 5: f92a2ace ($6.52 in chips)
Seat 6: f33e82d8 ($6.51 in chips)
babbcf16: posts small blind $0.02
143f7b2f: posts big blind $0.05
*** HOLE CARDS ***
Dealt to 39cd590d 
Dealt to babbcf16 
Dealt to 143f7b2f 
Dealt to Hero [Ac 6s]
Dealt to f92a2ace 
Dealt to f33e82d8 
Hero: folds
f92a2ace: folds
f33e82d8: folds
39cd590d: folds
babbcf16: raises $0.05 to $0.1
143f7b2f: calls $0.05
*** FLOP *** [3c 7c 3d]
babbcf16: checks
143f7b2f: checks
*** TURN *** [3c 7c 3d] [4c]
babbcf16: checks
143f7b2f: checks
*** RIVER *** [3c 7c 3d 4c] [Qd]
babbcf16: checks
143f7b2f: bets $0.2
babbcf16: folds
Uncalled bet ($0.2) returned to 143f7b2f
*** SHOWDOWN ***
143f7b2f collected $0.19 from pot
*** SUMMARY ***
Total pot $0.2 | Rake $0.01 | Jackpot $0 | Bingo $0 | Fortune $0 | Tax $0
Board [3c 7c 3d 4c Qd]
Seat 1: 39cd590d (button) folded before Flop (didn't bet)
Seat 2: babbcf16 (small blind) folded on the River
Seat 3: 143f7b2f (big blind) won ($0.19)
Seat 4: Hero folded before Flop (didn't bet)
Seat 5: f92a2ace folded before Flop (didn't bet)
Seat 6: f33e82d8 folded before Flop (didn't bet)


Poker Hand #RC2094777299: Hold'em No Limit ($0.02/$0.05) - 2023/12/27 21:54:11
Table 'RushAndCash3823333' 6-max Seat #1 is the button
Seat 1: 5e254867 ($15.83 in chips)
Seat 2: 76079863 ($6.35 in chips)
Seat 3: d244a6e ($5.71 in chips)
Seat 4: Hero ($10.41 in chips)
Seat 5: 6e63b45 ($6.89 in chips)
Seat 6: 303ed313 ($5.35 in chips)
76079863: posts small blind $0.02
d244a6e: posts big blind $0.05
*** HOLE CARDS ***
Dealt to 5e254867 
Dealt to 76079863 
Dealt to d244a6e 
Dealt to Hero [As 5c]
Dealt to 6e63b45 
Dealt to 303ed313 
Hero: folds
6e63b45: folds
303ed313: folds
5e254867: raises $0.08 to $0.13
76079863: folds
d244a6e: calls $0.08
*** FLOP *** [2h Kh Ac]
d244a6e: checks
5e254867: bets $0.1
d244a6e: calls $0.1
*** TURN *** [2h Kh Ac] [Qd]
d244a6e: checks
5e254867: checks
*** RIVER *** [2h Kh Ac Qd] [7d]
d244a6e: bets $0.36
5e254867: calls $0.36
d244a6e: shows [6d Kd] (Pair of Kings)
5e254867: shows [6s Ah] (Pair of Aces)
*** SHOWDOWN ***
5e254867 collected $1.14 from pot
*** SUMMARY ***
Total pot $1.2 | Rake $0.06 | Jackpot $0 | Bingo $0 | Fortune $0 | Tax $0
Board [2h Kh Ac Qd 7d]
Seat 1: 5e254867 (button) showed [6s Ah] and won ($1.14) with Pair of Aces
Seat 2: 76079863 (small blind) folded before Flop
Seat 3: d244a6e (big blind) showed [6d Kd] and lost with Pair of Kings
Seat 4: Hero folded before Flop (didn't bet)
Seat 5: 6e63b45 folded before Flop (didn't bet)
Seat 6: 303ed313 folded before Flop (didn't bet)


Poker Hand #RC2094777158: Hold'em No Limit ($0.02/$0.05) - 2023/12/27 21:54:04
Table 'RushAndCash3823271' 6-max Seat #1 is the button
Seat 1: Hero ($10.41 in chips)
Seat 2: a1e959ec ($6.57 in chips)
Seat 3: 1b33f895 ($5 in chips)
Seat 4: 6bcfb94d ($5.86 in chips)
Seat 5: 303949b0 ($9.18 in chips)
Seat 6: 2e81a1b9 ($13.98 in chips)
a1e959ec: posts small blind $0.02
1b33f895: posts big blind $0.05
*** HOLE CARDS ***
Dealt to Hero [2s Ah]
Dealt to a1e959ec 
Dealt to 1b33f895 
Dealt to 6bcfb94d 
Dealt to 303949b0 
Dealt to 2e81a1b9 
6bcfb94d: folds
303949b0: raises $0.08 to $0.13
2e81a1b9: folds
Hero: folds
a1e959ec: folds
1b33f895: calls $0.08
*** FLOP *** [9s 9d 4d]
1b33f895: checks
303949b0: bets $0.1
1b33f895: calls $0.1
*** TURN *** [9s 9d 4d] [Ad]
1b33f895: checks
303949b0: checks
*** RIVER *** [9s 9d 4d Ad] [As]
1b33f895: checks
303949b0: bets $0.36
1b33f895: folds
Uncalled bet ($0.36) returned to 303949b0
*** SHOWDOWN ***
303949b0 collected $0.46 from pot
*** SUMMARY ***
Total pot $0.48 | Rake $0.02 | Jackpot $0 | Bingo $0 | Fortune $0 | Tax $0
Board [9s 9d 4d Ad As]
Seat 1: Hero (button) folded before Flop (didn't bet)
Seat 2: a1e959ec (small blind) folded before Flop
Seat 3: 1b33f895 (big blind) folded on the River
Seat 4: 6bcfb94d folded before Flop (didn't bet)
Seat 5: 303949b0 won ($0.46)
Seat 6: 2e81a1b9 folded before Flop (didn't bet)


Poker Hand #RC2094777028: Hold'em No Limit ($0.02/$0.05) - 2023/12/27 21:53:57
Table 'RushAndCash3823215' 6-max Seat #1 is the button
Seat 1: 7d5bdf5e ($5.05 in chips)
Seat 2: 7be8413b ($7.36 in chips)
Seat 3: 115c94a ($4.3 in chips)
Seat 4: fa247bbc ($5.4 in chips)
Seat 5: Hero ($10.41 in chips)
Seat 6: d244a6e ($5.71 in chips)
7be8413b: posts small blind $0.02
115c94a: posts big blind $0.05
*** HOLE CARDS ***
Dealt to 7d5bdf5e 
Dealt to 7be8413b 
Dealt to 115c94a 
Dealt to fa247bbc 
Dealt to Hero [5c 7c]
Dealt to d244a6e 
fa247bbc: folds
Hero: folds
d244a6e: folds
7d5bdf5e: folds
7be8413b: folds
Uncalled bet ($0.03) returned to 115c94a
*** SHOWDOWN ***
115c94a collected $0.04 from pot
*** SUMMARY ***
Total pot $0.04 | Rake $0 | Jackpot $0 | Bingo $0 | Fortune $0 | Tax $0
Seat 1: 7d5bdf5e (button) folded before Flop (didn't bet)
Seat 2: 7be8413b (small blind) folded before Flop
Seat 3: 115c94a (big blind) collected ($0.04)
Seat 4: fa247bbc folded before Flop (didn't bet)
Seat 5: Hero folded before Flop (didn't bet)
Seat 6: d244a6e folded before Flop (didn't bet)


Poker Hand #RC2094776808: Hold'em No Limit ($0.02/$0.05) - 2023/12/27 21:53:47
Table 'RushAndCash3823112' 6-max Seat #1 is the button
Seat 1: 4f7c05d4 ($13.92 in chips)
Seat 2: 802b86d ($5.07 in chips)
Seat 3: Hero ($10.46 in chips)
Seat 4: e00693d4 ($6.01 in chips)
Seat 5: 8e1e4bb4 ($5.28 in chips)
Seat 6: a40df83 ($5.81 in chips)
802b86d: posts small blind $0.02
Hero: posts big blind $0.05
*** HOLE CARDS ***
Dealt to 4f7c05d4 
Dealt to 802b86d 
Dealt to Hero [8h 5h]
Dealt to e00693d4 
Dealt to 8e1e4bb4 
Dealt to a40df83 
e00693d4: folds
8e1e4bb4: folds
a40df83: folds
4f7c05d4: raises $0.08 to $0.13
802b86d: folds
Hero: folds
Uncalled bet ($0.08) returned to 4f7c05d4
*** SHOWDOWN ***
4f7c05d4 collected $0.12 from pot
*** SUMMARY ***
Total pot $0.12 | Rake $0 | Jackpot $0 | Bingo $0 | Fortune $0 | Tax $0
Seat 1: 4f7c05d4 (button) collected ($0.12)
Seat 2: 802b86d (small blind) folded before Flop
Seat 3: Hero (big blind) folded before Flop
Seat 4: e00693d4 folded before Flop (didn't bet)
Seat 5: 8e1e4bb4 folded before Flop (didn't bet)
Seat 6: a40df83 folded before Flop (didn't bet)


Poker Hand #RC2094776334: Hold'em No Limit ($0.02/$0.05) - 2023/12/27 21:53:24
Table 'RushAndCash3822889' 6-max Seat #1 is the button
Seat 1: Hero ($10.39 in chips)
Seat 2: 63c3c3df ($5.65 in chips)
Seat 3: 2c2b1b ($5.07 in chips)
Seat 4: d557ab62 ($16.64 in chips)
Seat 5: b881f476 ($5.02 in chips)
Seat 6: f62f437 ($4.98 in chips)
63c3c3df: posts small blind $0.02
2c2b1b: posts big blind $0.05
*** HOLE CARDS ***
Dealt to Hero [Js Td]
Dealt to 63c3c3df 
Dealt to 2c2b1b 
Dealt to d557ab62 
Dealt to b881f476 
Dealt to f62f437 
d557ab62: folds
b881f476: folds
f62f437: folds
Hero: raises $0.08 to $0.13
63c3c3df: folds
2c2b1b: folds
Uncalled bet ($0.08) returned to Hero
*** SHOWDOWN ***
Hero collected $0.12 from pot
*** SUMMARY ***
Total pot $0.12 | Rake $0 | Jackpot $0 | Bingo $0 | Fortune $0 | Tax $0
Seat 1: Hero (button) collected ($0.12)
Seat 2: 63c3c3df (small blind) folded before Flop
Seat 3: 2c2b1b (big blind) folded before Flop
Seat 4: d557ab62 folded before Flop (didn't bet)
Seat 5: b881f476 folded before Flop (didn't bet)
Seat 6: f62f437 folded before Flop (didn't bet)


Poker Hand #RC2094776265: Hold'em No Limit ($0.02/$0.05) - 2023/12/27 21:53:20
Table 'RushAndCash3822858' 6-max Seat #1 is the button
Seat 1: 268acd45 ($5.07 in chips)
Seat 2: Hero ($10.41 in chips)
Seat 3: e11b6f8f ($13.53 in chips)
Seat 4: 321a4999 ($5.24 in chips)
Seat 5: 115c94a ($4.23 in chips)
Seat 6: a5cefc8 ($2.4 in chips)
Hero: posts small blind $0.02
e11b6f8f: posts big blind $0.05
*** HOLE CARDS ***
Dealt to 268acd45 
Dealt to Hero [9d Ts]
Dealt to e11b6f8f 
Dealt to 321a4999 
Dealt to 115c94a 
Dealt to a5cefc8 
321a4999: folds
115c94a: folds
a5cefc8: raises $0.05 to $0.1
268acd45: raises $0.23 to $0.33
Hero: folds
e11b6f8f: calls $0.28
a5cefc8: calls $0.23
*** FLOP *** [6s Td 4c]
e11b6f8f: checks
a5cefc8: checks
268acd45: checks
*** TURN *** [6s Td 4c] [Kd]
e11b6f8f: checks
a5cefc8: checks
268acd45: bets $0.61
e11b6f8f: folds
a5cefc8: folds
Uncalled bet ($0.61) returned to 268acd45
*** SHOWDOWN ***
268acd45 collected $0.95 from pot
*** SUMMARY ***
Total pot $1.01 | Rake $0.06 | Jackpot $0 | Bingo $0 | Fortune $0 | Tax $0
Board [6s Td 4c Kd]
Seat 1: 268acd45 (button) won ($0.95)
Seat 2: Hero (small blind) folded before Flop
Seat 3: e11b6f8f (big blind) folded on the Turn
Seat 4: 321a4999 folded before Flop (didn't bet)
Seat 5: 115c94a folded before Flop (didn't bet)
Seat 6: a5cefc8 folded on the Turn


Poker Hand #RC2094776100: Hold'em No Limit ($0.02/$0.05) - 2023/12/27 21:53:12
Table 'RushAndCash3822786' 6-max Seat #1 is the button
Seat 1: Hero ($10.34 in chips)
Seat 2: 1f91e580 ($6.3 in chips)
Seat 3: 6440ee1f ($4.64 in chips)
Seat 4: 4d756f58 ($13.79 in chips)
Seat 5: c0464767 ($6.01 in chips)
Seat 6: 3bdf9969 ($5.7 in chips)
1f91e580: posts small blind $0.02
6440ee1f: posts big blind $0.05
*** HOLE CARDS ***
Dealt to Hero [8d Jd]
Dealt to 1f91e580 
Dealt to 6440ee1f 
Dealt to 4d756f58 
Dealt to c0464767 
Dealt to 3bdf9969 
4d756f58: folds
c0464767: folds
3bdf9969: folds
Hero: raises $0.08 to $0.13
1f91e580: folds
6440ee1f: folds
Uncalled bet ($0.08) returned to Hero
*** SHOWDOWN ***
Hero collected $0.12 from pot
*** SUMMARY ***
Total pot $0.12 | Rake $0 | Jackpot $0 | Bingo $0 | Fortune $0 | Tax $0
Seat 1: Hero (button) collected ($0.12)
Seat 2: 1f91e580 (small blind) folded before Flop
Seat 3: 6440ee1f (big blind) folded before Flop
Seat 4: 4d756f58 folded before Flop (didn't bet)
Seat 5: c0464767 folded before Flop (didn't bet)
Seat 6: 3bdf9969 folded before Flop (didn't bet)


Poker Hand #RC2094775979: Hold'em No Limit ($0.02/$0.05) - 2023/12/27 21:53:06
Table 'RushAndCash3822731' 6-max Seat #1 is the button
Seat 1: 64ae07c6 ($5.14 in chips)
Seat 2: Hero ($10.36 in chips)
Seat 3: eb42d0a ($2.96 in chips)
Seat 4: e2b62da8 ($5.07 in chips)
Seat 5: 9a2b2bd3 ($6.44 in chips)
Seat 6: eaa97e93 ($5.07 in chips)
Hero: posts small blind $0.02
eb42d0a: posts big blind $0.05
*** HOLE CARDS ***
Dealt to 64ae07c6 
Dealt to Hero [6s 9c]
Dealt to eb42d0a 
Dealt to e2b62da8 
Dealt to 9a2b2bd3 
Dealt to eaa97e93 
e2b62da8: folds
9a2b2bd3: folds
eaa97e93: folds
64ae07c6: folds
Hero: folds
Uncalled bet ($0.03) returned to eb42d0a
*** SHOWDOWN ***
eb42d0a collected $0.04 from pot
*** SUMMARY ***
Total pot $0.04 | Rake $0 | Jackpot $0 | Bingo $0 | Fortune $0 | Tax $0
Seat 1: 64ae07c6 (button) folded before Flop (didn't bet)
Seat 2: Hero (small blind) folded before Flop
Seat 3: eb42d0a (big blind) collected ($0.04)
Seat 4: e2b62da8 folded before Flop (didn't bet)
Seat 5: 9a2b2bd3 folded before Flop (didn't bet)
Seat 6: eaa97e93 folded before Flop (didn't bet)


Poker Hand #RC2094775894: Hold'em No Limit ($0.02/$0.05) - 2023/12/27 21:53:02
Table 'RushAndCash3822691' 6-max Seat #1 is the button
Seat 1: 6bd38906 ($3.31 in chips)
Seat 2: 7e9d57a6 ($2.65 in chips)
Seat 3: fdbb6637 ($3.19 in chips)
Seat 4: b3ca4355 ($2.66 in chips)
Seat 5: Hero ($10.36 in chips)
Seat 6: b324aa8c ($5 in chips)
7e9d57a6: posts small blind $0.02
fdbb6637: posts big blind $0.05
*** HOLE CARDS ***
Dealt to 6bd38906 
Dealt to 7e9d57a6 
Dealt to fdbb6637 
Dealt to b3ca4355 
Dealt to Hero [2d 3h]
Dealt to b324aa8c 
b3ca4355: raises $0.08 to $0.13
Hero: folds
b324aa8c: folds
6bd38906: folds
7e9d57a6: folds
fdbb6637: calls $0.08
*** FLOP *** [5h Qs 9h]
fdbb6637: checks
b3ca4355: checks
*** TURN *** [5h Qs 9h] [7d]
fdbb6637: checks
b3ca4355: bets $0.11
fdbb6637: folds
Uncalled bet ($0.11) returned to b3ca4355
*** SHOWDOWN ***
b3ca4355 collected $0.27 from pot
*** SUMMARY ***
Total pot $0.28 | Rake $0.01 | Jackpot $0 | Bingo $0 | Fortune $0 | Tax $0
Board [5h Qs 9h 7d]
Seat 1: 6bd38906 (button) folded before Flop (didn't bet)
Seat 2: 7e9d57a6 (small blind) folded before Flop
Seat 3: fdbb6637 (big blind) folded on the Turn
Seat 4: b3ca4355 won ($0.27)
Seat 5: Hero folded before Flop (didn't bet)
Seat 6: b324aa8c folded before Flop (didn't bet)


Poker Hand #RC2094775679: Hold'em No Limit ($0.02/$0.05) - 2023/12/27 21:52:52
Table 'RushAndCash3822592' 6-max Seat #1 is the button
Seat 1: 1ea3c784 ($16.12 in chips)
Seat 2: 594f16dd ($5 in chips)
Seat 3: Hero ($10.41 in chips)
Seat 4: 5fdcf0fd ($4.51 in chips)
Seat 5: 5e02aa81 ($6.18 in chips)
Seat 6: 4635182e ($5.17 in chips)
594f16dd: posts small blind $0.02
Hero: posts big blind $0.05
*** HOLE CARDS ***
Dealt to 1ea3c784 
Dealt to 594f16dd 
Dealt to Hero [Qc Td]
Dealt to 5fdcf0fd 
Dealt to 5e02aa81 
Dealt to 4635182e 
5fdcf0fd: raises $0.1 to $0.15
5e02aa81: folds
4635182e: folds
1ea3c784: folds
594f16dd: folds
Hero: folds
Uncalled bet ($0.1) returned to 5fdcf0fd
*** SHOWDOWN ***
5fdcf0fd collected $0.12 from pot
*** SUMMARY ***
Total pot $0.12 | Rake $0 | Jackpot $0 | Bingo $0 | Fortune $0 | Tax $0
Seat 1: 1ea3c784 (button) folded before Flop (didn't bet)
Seat 2: 594f16dd (small blind) folded before Flop
Seat 3: Hero (big blind) folded before Flop
Seat 4: 5fdcf0fd collected ($0.12)
Seat 5: 5e02aa81 folded before Flop (didn't bet)
Seat 6: 4635182e folded before Flop (didn't bet)


Poker Hand #RC2094775572: Hold'em No Limit ($0.02/$0.05) - 2023/12/27 21:52:47
Table 'RushAndCash3822539' 6-max Seat #1 is the button
Seat 1: 301b50 ($5.14 in chips)
Seat 2: 94aecf3c ($5.38 in chips)
Seat 3: fddf0af2 ($6.6 in chips)
Seat 4: 31dcc161 ($5.28 in chips)
Seat 5: 4739e385 ($2.9 in chips)
Seat 6: Hero ($10.41 in chips)
94aecf3c: posts small blind $0.02
fddf0af2: posts big blind $0.05
*** HOLE CARDS ***
Dealt to 301b50 
Dealt to 94aecf3c 
Dealt to fddf0af2 
Dealt to 31dcc161 
Dealt to 4739e385 
Dealt to Hero [Ts 4h]
31dcc161: folds
4739e385: folds
Hero: folds
301b50: folds
94aecf3c: folds
Uncalled bet ($0.03) returned to fddf0af2
*** SHOWDOWN ***
fddf0af2 collected $0.04 from pot
*** SUMMARY ***
Total pot $0.04 | Rake $0 | Jackpot $0 | Bingo $0 | Fortune $0 | Tax $0
Seat 1: 301b50 (button) folded before Flop (didn't bet)
Seat 2: 94aecf3c (small blind) folded before Flop
Seat 3: fddf0af2 (big blind) collected ($0.04)
Seat 4: 31dcc161 folded before Flop (didn't bet)
Seat 5: 4739e385 folded before Flop (didn't bet)
Seat 6: Hero folded before Flop (didn't bet)


Poker Hand #RC2094775487: Hold'em No Limit ($0.02/$0.05) - 2023/12/27 21:52:43
Table 'RushAndCash3822501' 6-max Seat #1 is the button
Seat 1: d9cd8b67 ($5.35 in chips)
Seat 2: bc79e3f1 ($15.5 in chips)
Seat 3: 6e302acc ($5.44 in chips)
Seat 4: Hero ($10.41 in chips)
Seat 5: 74c2f2d2 ($5 in chips)
Seat 6: a8803c53 ($5.57 in chips)
bc79e3f1: posts small blind $0.02
6e302acc: posts big blind $0.05
*** HOLE CARDS ***
Dealt to d9cd8b67 
Dealt to bc79e3f1 
Dealt to 6e302acc 
Dealt to Hero [Qc 7c]
Dealt to 74c2f2d2 
Dealt to a8803c53 
Hero: folds
74c2f2d2: folds
a8803c53: folds
d9cd8b67: raises $0.08 to $0.13
bc79e3f1: raises $0.33 to $0.46
6e302acc: folds
d9cd8b67: folds
Uncalled bet ($0.33) returned to bc79e3f1
*** SHOWDOWN ***
bc79e3f1 collected $0.3 from pot
*** SUMMARY ***
Total pot $0.31 | Rake $0.01 | Jackpot $0 | Bingo $0 | Fortune $0 | Tax $0
Seat 1: d9cd8b67 (button) folded before Flop
Seat 2: bc79e3f1 (small blind) collected ($0.3)
Seat 3: 6e302acc (big blind) folded before Flop
Seat 4: Hero folded before Flop (didn't bet)
Seat 5: 74c2f2d2 folded before Flop (didn't bet)
Seat 6: a8803c53 folded before Flop (didn't bet)


Poker Hand #RC2094775411: Hold'em No Limit ($0.02/$0.05) - 2023/12/27 21:52:39
Table 'RushAndCash3822468' 6-max Seat #1 is the button
Seat 1: cad13b99 ($5 in chips)
Seat 2: 4a71fbf ($4.95 in chips)
Seat 3: 74254aff ($5.17 in chips)
Seat 4: Hero ($10.41 in chips)
Seat 5: 44366042 ($5 in chips)
Seat 6: 7ac4c2d5 ($5 in chips)
4a71fbf: posts small blind $0.02
74254aff: posts big blind $0.05
*** HOLE CARDS ***
Dealt to cad13b99 
Dealt to 4a71fbf 
Dealt to 74254aff 
Dealt to Hero [5c Ad]
Dealt to 44366042 
Dealt to 7ac4c2d5 
Hero: folds
44366042: folds
7ac4c2d5: folds
cad13b99: raises $0.06 to $0.11
4a71fbf: calls $0.09
74254aff: folds
*** FLOP *** [4s Td 7d]
4a71fbf: checks
cad13b99: checks
*** TURN *** [4s Td 7d] [3c]
4a71fbf: checks
cad13b99: checks
*** RIVER *** [4s Td 7d 3c] [Kh]
4a71fbf: bets $0.09
cad13b99: raises $0.09 to $0.18
4a71fbf: calls $0.09
cad13b99: shows [9s Kd] (Pair of Kings)
4a71fbf: shows [Qd Ks] (Pair of Kings)
*** SHOWDOWN ***
4a71fbf collected $0.6 from pot
*** SUMMARY ***
Total pot $0.63 | Rake $0.03 | Jackpot $0 | Bingo $0 | Fortune $0 | Tax $0
Board [4s Td 7d 3c Kh]
Seat 1: cad13b99 (button) showed [9s Kd] and lost with Pair of Kings
Seat 2: 4a71fbf (small blind) showed [Qd Ks] and won ($0.6) with Pair of Kings
Seat 3: 74254aff (big blind) folded before Flop
Seat 4: Hero folded before Flop (didn't bet)
Seat 5: 44366042 folded before Flop (didn't bet)
Seat 6: 7ac4c2d5 folded before Flop (didn't bet)


Poker Hand #RC2094775326: Hold'em No Limit ($0.02/$0.05) - 2023/12/27 21:52:35
Table 'RushAndCash3822429' 6-max Seat #1 is the button
Seat 1: 97ba59eb ($22.65 in chips)
Seat 2: Hero ($10.43 in chips)
Seat 3: e16e04ba ($7.54 in chips)
Seat 4: 143f7b2f ($5.94 in chips)
Seat 5: 2c708c8a ($3.82 in chips)
Seat 6: 2e81a1b9 ($14.84 in chips)
Hero: posts small blind $0.02
e16e04ba: posts big blind $0.05
*** HOLE CARDS ***
Dealt to 97ba59eb 
Dealt to Hero [3s 5s]
Dealt to e16e04ba 
Dealt to 143f7b2f 
Dealt to 2c708c8a 
Dealt to 2e81a1b9 
143f7b2f: raises $0.05 to $0.1
2c708c8a: folds
2e81a1b9: folds
97ba59eb: folds
Hero: folds
e16e04ba: folds
Uncalled bet ($0.05) returned to 143f7b2f
*** SHOWDOWN ***
143f7b2f collected $0.12 from pot
*** SUMMARY ***
Total pot $0.12 | Rake $0 | Jackpot $0 | Bingo $0 | Fortune $0 | Tax $0
Seat 1: 97ba59eb (button) folded before Flop (didn't bet)
Seat 2: Hero (small blind) folded before Flop
Seat 3: e16e04ba (big blind) folded before Flop
Seat 4: 143f7b2f collected ($0.12)
Seat 5: 2c708c8a folded before Flop (didn't bet)
Seat 6: 2e81a1b9 folded before Flop (didn't bet)


Poker Hand #RC2094764699: Hold'em No Limit ($0.02/$0.05) - 2023/12/27 21:52:06
Table 'RushAndCash3822152' 6-max Seat #1 is the button
Seat 1: 2c708c8a ($3.92 in chips)
Seat 2: c07b5111 ($13.08 in chips)
Seat 3: Hero ($10.53 in chips)
Seat 4: 143f7b2f ($5.73 in chips)
Seat 5: e16e04ba ($7.56 in chips)
Seat 6: 4635182e ($5 in chips)
c07b5111: posts small blind $0.02
Hero: posts big blind $0.05
*** HOLE CARDS ***
Dealt to 2c708c8a 
Dealt to c07b5111 
Dealt to Hero [Ts 2s]
Dealt to 143f7b2f 
Dealt to e16e04ba 
Dealt to 4635182e 
143f7b2f: raises $0.05 to $0.1
e16e04ba: folds
4635182e: folds
2c708c8a: calls $0.1
c07b5111: folds
Hero: calls $0.05
*** FLOP *** [3s 7d Qd]
Hero: checks
143f7b2f: checks
2c708c8a: checks
*** TURN *** [3s 7d Qd] [8d]
Hero: checks
143f7b2f: bets $0.16
2c708c8a: folds
Hero: folds
Uncalled bet ($0.16) returned to 143f7b2f
*** SHOWDOWN ***
143f7b2f collected $0.31 from pot
*** SUMMARY ***
Total pot $0.32 | Rake $0.01 | Jackpot $0 | Bingo $0 | Fortune $0 | Tax $0
Board [3s 7d Qd 8d]
Seat 1: 2c708c8a (button) folded on the Turn
Seat 2: c07b5111 (small blind) folded before Flop
Seat 3: Hero (big blind) folded on the Turn
Seat 4: 143f7b2f won ($0.31)
Seat 5: e16e04ba folded before Flop (didn't bet)
Seat 6: 4635182e folded before Flop (didn't bet)


Poker Hand #RC2094764481: Hold'em No Limit ($0.02/$0.05) - 2023/12/27 21:51:55
Table 'RushAndCash3822055' 6-max Seat #1 is the button
Seat 1: c03393aa ($7.3 in chips)
Seat 2: Hero ($10.55 in chips)
Seat 3: 6e2c1a87 ($3.92 in chips)
Seat 4: f90b803e ($6.94 in chips)
Seat 5: cc15e090 ($6.57 in chips)
Seat 6: 3679dcf2 ($5.87 in chips)
Hero: posts small blind $0.02
6e2c1a87: posts big blind $0.05
*** HOLE CARDS ***
Dealt to c03393aa 
Dealt to Hero [As 7h]
Dealt to 6e2c1a87 
Dealt to f90b803e 
Dealt to cc15e090 
Dealt to 3679dcf2 
f90b803e: folds
cc15e090: folds
3679dcf2: raises $0.08 to $0.13
c03393aa: raises $0.22 to $0.35
Hero: folds
6e2c1a87: folds
3679dcf2: folds
Uncalled bet ($0.22) returned to c03393aa
*** SHOWDOWN ***
c03393aa collected $0.32 from pot
*** SUMMARY ***
Total pot $0.33 | Rake $0.01 | Jackpot $0 | Bingo $0 | Fortune $0 | Tax $0
Seat 1: c03393aa (button) collected ($0.32)
Seat 2: Hero (small blind) folded before Flop
Seat 3: 6e2c1a87 (big blind) folded before Flop
Seat 4: f90b803e folded before Flop (didn't bet)
Seat 5: cc15e090 folded before Flop (didn't bet)
Seat 6: 3679dcf2 folded before Flop


Poker Hand #RC2094764401: Hold'em No Limit ($0.02/$0.05) - 2023/12/27 21:51:52
Table 'RushAndCash3822017' 6-max Seat #1 is the button
Seat 1: 6d52943a ($5.55 in chips)
Seat 2: 66647495 ($5 in chips)
Seat 3: 6c7fc561 ($6.45 in chips)
Seat 4: cf7fdd27 ($5 in chips)
Seat 5: b3ca4355 ($2.52 in chips)
Seat 6: Hero ($10.55 in chips)
66647495: posts small blind $0.02
6c7fc561: posts big blind $0.05
*** HOLE CARDS ***
Dealt to 6d52943a 
Dealt to 66647495 
Dealt to 6c7fc561 
Dealt to cf7fdd27 
Dealt to b3ca4355 
Dealt to Hero [Jh 5s]
cf7fdd27: folds
b3ca4355: folds
Hero: folds
6d52943a: folds
66647495: raises $0.1 to $0.15
6c7fc561: raises $0.35 to $0.5
66647495: folds
Uncalled bet ($0.35) returned to 6c7fc561
*** SHOWDOWN ***
6c7fc561 collected $0.29 from pot
*** SUMMARY ***
Total pot $0.3 | Rake $0.01 | Jackpot $0 | Bingo $0 | Fortune $0 | Tax $0
Seat 1: 6d52943a (button) folded before Flop (didn't bet)
Seat 2: 66647495 (small blind) folded before Flop
Seat 3: 6c7fc561 (big blind) collected ($0.29)
Seat 4: cf7fdd27 folded before Flop (didn't bet)
Seat 5: b3ca4355 folded before Flop (didn't bet)
Seat 6: Hero folded before Flop (didn't bet)


Poker Hand #RC2094764315: Hold'em No Limit ($0.02/$0.05) - 2023/12/27 21:51:48
Table 'RushAndCash3821975' 6-max Seat #1 is the button
Seat 1: 77c5f254 ($5.29 in chips)
Seat 2: 63bb9f51 ($5.91 in chips)
Seat 3: 181b99b4 ($5.16 in chips)
Seat 4: Hero ($10.55 in chips)
Seat 5: 6440ee1f ($4.76 in chips)
Seat 6: 6d52943a ($5.55 in chips)
63bb9f51: posts small blind $0.02
181b99b4: posts big blind $0.05
*** HOLE CARDS ***
Dealt to 77c5f254 
Dealt to 63bb9f51 
Dealt to 181b99b4 
Dealt to Hero [6h 9c]
Dealt to 6440ee1f 
Dealt to 6d52943a 
Hero: folds
6440ee1f: folds
6d52943a: folds
77c5f254: raises $0.1 to $0.15
63bb9f51: folds
181b99b4: folds
Uncalled bet ($0.1) returned to 77c5f254
*** SHOWDOWN ***
77c5f254 collected $0.12 from pot
*** SUMMARY ***
Total pot $0.12 | Rake $0 | Jackpot $0 | Bingo $0 | Fortune $0 | Tax $0
Seat 1: 77c5f254 (button) collected ($0.12)
Seat 2: 63bb9f51 (small blind) folded before Flop
Seat 3: 181b99b4 (big blind) folded before Flop
Seat 4: Hero folded before Flop (didn't bet)
Seat 5: 6440ee1f folded before Flop (didn't bet)
Seat 6: 6d52943a folded before Flop (didn't bet)


Poker Hand #RC2094763955: Hold'em No Limit ($0.02/$0.05) - 2023/12/27 21:51:32
Table 'RushAndCash3821801' 6-max Seat #1 is the button
Seat 1: Hero ($10.39 in chips)
Seat 2: 821ad16a ($3.13 in chips)
Seat 3: c27eeda6 ($0.82 in chips)
Seat 4: 5d31ed85 ($7.92 in chips)
Seat 5: 6d52943a ($5.65 in chips)
Seat 6: f35b3ca8 ($6.36 in chips)
821ad16a: posts small blind $0.02
c27eeda6: posts big blind $0.05
*** HOLE CARDS ***
Dealt to Hero [Ac Qd]
Dealt to 821ad16a 
Dealt to c27eeda6 
Dealt to 5d31ed85 
Dealt to 6d52943a 
Dealt to f35b3ca8 
5d31ed85: folds
6d52943a: raises $0.05 to $0.1
f35b3ca8: folds
Hero: raises $0.27 to $0.37
821ad16a: folds
c27eeda6: folds
6d52943a: folds
Uncalled bet ($0.27) returned to Hero
*** SHOWDOWN ***
Hero collected $0.26 from pot
*** SUMMARY ***
Total pot $0.27 | Rake $0.01 | Jackpot $0 | Bingo $0 | Fortune $0 | Tax $0
Seat 1: Hero (button) collected ($0.26)
Seat 2: 821ad16a (small blind) folded before Flop
Seat 3: c27eeda6 (big blind) folded before Flop
Seat 4: 5d31ed85 folded before Flop (didn't bet)
Seat 5: 6d52943a folded before Flop
Seat 6: f35b3ca8 folded before Flop (didn't bet)


Poker Hand #RC2094763401: Hold'em No Limit ($0.02/$0.05) - 2023/12/27 21:51:07
Table 'RushAndCash3821549' 6-max Seat #1 is the button
Seat 1: 1679c576 ($7.13 in chips)
Seat 2: 988a2da7 ($5 in chips)
Seat 3: 821ad16a ($3.23 in chips)
Seat 4: 19879f5e ($8.01 in chips)
Seat 5: 2a55aa6 ($7.87 in chips)
Seat 6: Hero ($10.28 in chips)
988a2da7: posts small blind $0.02
821ad16a: posts big blind $0.05
*** HOLE CARDS ***
Dealt to 1679c576 
Dealt to 988a2da7 
Dealt to 821ad16a 
Dealt to 19879f5e 
Dealt to 2a55aa6 
Dealt to Hero [Ac Qc]
19879f5e: folds
2a55aa6: folds
Hero: raises $0.05 to $0.1
1679c576: folds
988a2da7: folds
821ad16a: calls $0.05
*** FLOP *** [8c Th Qs]
821ad16a: checks
Hero: bets $0.1
821ad16a: folds
Uncalled bet ($0.1) returned to Hero
*** SHOWDOWN ***
Hero collected $0.21 from pot
*** SUMMARY ***
Total pot $0.22 | Rake $0.01 | Jackpot $0 | Bingo $0 | Fortune $0 | Tax $0
Board [8c Th Qs]
Seat 1: 1679c576 (button) folded before Flop (didn't bet)
Seat 2: 988a2da7 (small blind) folded before Flop
Seat 3: 821ad16a (big blind) folded on the Flop
Seat 4: 19879f5e folded before Flop (didn't bet)
Seat 5: 2a55aa6 folded before Flop (didn't bet)
Seat 6: Hero won ($0.21)


Poker Hand #RC2094763307: Hold'em No Limit ($0.02/$0.05) - 2023/12/27 21:51:03
Table 'RushAndCash3821506' 6-max Seat #1 is the button
Seat 1: f1591abc ($8.61 in chips)
Seat 2: c0af341d ($4.4 in chips)
Seat 3: 2a55aa6 ($7.92 in chips)
Seat 4: 467744b8 ($7.36 in chips)
Seat 5: abb57e5 ($5 in chips)
Seat 6: Hero ($10.28 in chips)
c0af341d: posts small blind $0.02
2a55aa6: posts big blind $0.05
*** HOLE CARDS ***
Dealt to f1591abc 
Dealt to c0af341d 
Dealt to 2a55aa6 
Dealt to 467744b8 
Dealt to abb57e5 
Dealt to Hero [Qd 2c]
467744b8: folds
abb57e5: folds
Hero: folds
f1591abc: folds
c0af341d: folds
Uncalled bet ($0.03) returned to 2a55aa6
*** SHOWDOWN ***
2a55aa6 collected $0.04 from pot
*** SUMMARY ***
Total pot $0.04 | Rake $0 | Jackpot $0 | Bingo $0 | Fortune $0 | Tax $0
Seat 1: f1591abc (button) folded before Flop (didn't bet)
Seat 2: c0af341d (small blind) folded before Flop
Seat 3: 2a55aa6 (big blind) collected ($0.04)
Seat 4: 467744b8 folded before Flop (didn't bet)
Seat 5: abb57e5 folded before Flop (didn't bet)
Seat 6: Hero folded before Flop (didn't bet)


Poker Hand #RC2094763230: Hold'em No Limit ($0.02/$0.05) - 2023/12/27 21:50:59
Table 'RushAndCash3821474' 6-max Seat #1 is the button
Seat 1: Hero ($10.28 in chips)
Seat 2: 99def2c7 ($5.75 in chips)
Seat 3: 8c6ba401 ($5 in chips)
Seat 4: a4c3f119 ($6.94 in chips)
Seat 5: 6954bf21 ($5.5 in chips)
Seat 6: 64a75632 ($4.93 in chips)
99def2c7: posts small blind $0.02
8c6ba401: posts big blind $0.05
*** HOLE CARDS ***
Dealt to Hero [3s 8h]
Dealt to 99def2c7 
Dealt to 8c6ba401 
Dealt to a4c3f119 
Dealt to 6954bf21 
Dealt to 64a75632 
a4c3f119: folds
6954bf21: raises $0.05 to $0.1
64a75632: folds
Hero: folds
99def2c7: raises $0.38 to $0.48
8c6ba401: folds
6954bf21: folds
Uncalled bet ($0.38) returned to 99def2c7
*** SHOWDOWN ***
99def2c7 collected $0.24 from pot
*** SUMMARY ***
Total pot $0.25 | Rake $0.01 | Jackpot $0 | Bingo $0 | Fortune $0 | Tax $0
Seat 1: Hero (button) folded before Flop (didn't bet)
Seat 2: 99def2c7 (small blind) collected ($0.24)
Seat 3: 8c6ba401 (big blind) folded before Flop
Seat 4: a4c3f119 folded before Flop (didn't bet)
Seat 5: 6954bf21 folded before Flop
Seat 6: 64a75632 folded before Flop (didn't bet)


Poker Hand #RC2094762517: Hold'em No Limit ($0.02/$0.05) - 2023/12/27 21:50:25
Table 'RushAndCash3821155' 6-max Seat #1 is the button
Seat 1: 99def2c7 ($5.09 in chips)
Seat 2: 7e73be7f ($5 in chips)
Seat 3: 55790f5a ($4.05 in chips)
Seat 4: Hero ($10.94 in chips)
Seat 5: 99afffbd ($4.38 in chips)
Seat 6: 319f4f42 ($6.49 in chips)
7e73be7f: posts small blind $0.02
55790f5a: posts big blind $0.05
*** HOLE CARDS ***
Dealt to 99def2c7 
Dealt to 7e73be7f 
Dealt to 55790f5a 
Dealt to Hero [Ah Qh]
Dealt to 99afffbd 
Dealt to 319f4f42 
Hero: raises $0.05 to $0.1
99afffbd: folds
319f4f42: folds
99def2c7: raises $0.21 to $0.31
7e73be7f: folds
55790f5a: folds
Hero: calls $0.21
*** FLOP *** [Th 3s 6h]
Hero: checks
99def2c7: bets $0.35
Hero: calls $0.35
*** TURN *** [Th 3s 6h] [8c]
Hero: checks
99def2c7: checks
*** RIVER *** [Th 3s 6h 8c] [Kc]
Hero: checks
99def2c7: bets $1.05
Hero: folds
Uncalled bet ($1.05) returned to 99def2c7
*** SHOWDOWN ***
99def2c7 collected $1.32 from pot
*** SUMMARY ***
Total pot $1.39 | Rake $0.07 | Jackpot $0 | Bingo $0 | Fortune $0 | Tax $0
Board [Th 3s 6h 8c Kc]
Seat 1: 99def2c7 (button) won ($1.32)
Seat 2: 7e73be7f (small blind) folded before Flop
Seat 3: 55790f5a (big blind) folded before Flop
Seat 4: Hero folded on the River
Seat 5: 99afffbd folded before Flop (didn't bet)
Seat 6: 319f4f42 folded before Flop (didn't bet)


Poker Hand #RC2094761806: Hold'em No Limit ($0.02/$0.05) - 2023/12/27 21:49:52
Table 'RushAndCash3820841' 6-max Seat #1 is the button
Seat 1: 34a9d7fc ($6.67 in chips)
Seat 2: 50203b74 ($9.45 in chips)
Seat 3: Hero ($10.99 in chips)
Seat 4: 59488c7e ($5 in chips)
Seat 5: 7db53687 ($3.22 in chips)
Seat 6: cbc9fff5 ($9.11 in chips)
50203b74: posts small blind $0.02
Hero: posts big blind $0.05
*** HOLE CARDS ***
Dealt to 34a9d7fc 
Dealt to 50203b74 
Dealt to Hero [8c Jc]
Dealt to 59488c7e 
Dealt to 7db53687 
Dealt to cbc9fff5 
59488c7e: folds
7db53687: calls $0.05
cbc9fff5: folds
34a9d7fc: calls $0.05
50203b74: calls $0.03
Hero: checks
*** FLOP *** [2c 5s 7c]
50203b74: checks
Hero: checks
7db53687: bets $0.1
34a9d7fc: calls $0.1
50203b74: folds
Hero: folds
*** TURN *** [2c 5s 7c] [3s]
7db53687: bets $0.2
34a9d7fc: calls $0.2
*** RIVER *** [2c 5s 7c 3s] [2s]
7db53687: bets $0.4
34a9d7fc: folds
Uncalled bet ($0.4) returned to 7db53687
7db53687: shows [7d] (Pair of Sevens and Pair of Twos)
*** SHOWDOWN ***
7db53687 collected $0.76 from pot
*** SUMMARY ***
Total pot $0.8 | Rake $0.04 | Jackpot $0 | Bingo $0 | Fortune $0 | Tax $0
Board [2c 5s 7c 3s 2s]
Seat 1: 34a9d7fc (button) folded on the River
Seat 2: 50203b74 (small blind) folded on the Flop
Seat 3: Hero (big blind) folded on the Flop
Seat 4: 59488c7e folded before Flop (didn't bet)
Seat 5: 7db53687 showed [7d] and won ($0.76)
Seat 6: cbc9fff5 folded before Flop (didn't bet)


Poker Hand #RC2094761174: Hold'em No Limit ($0.02/$0.05) - 2023/12/27 21:49:24
Table 'RushAndCash3820566' 6-max Seat #1 is the button
Seat 1: 5edbcb03 ($12.91 in chips)
Seat 2: e132f9c6 ($1.77 in chips)
Seat 3: 34a9d7fc ($6.66 in chips)
Seat 4: 6c7fc561 ($6.64 in chips)
Seat 5: a6ae07 ($5 in chips)
Seat 6: Hero ($10.98 in chips)
e132f9c6: posts small blind $0.02
34a9d7fc: posts big blind $0.05
*** HOLE CARDS ***
Dealt to 5edbcb03 
Dealt to e132f9c6 
Dealt to 34a9d7fc 
Dealt to 6c7fc561 
Dealt to a6ae07 
Dealt to Hero [3d Ad]
6c7fc561: folds
a6ae07: folds
Hero: raises $0.05 to $0.1
5edbcb03: folds
e132f9c6: folds
34a9d7fc: calls $0.05
*** FLOP *** [5s 2c 2h]
34a9d7fc: checks
Hero: checks
*** TURN *** [5s 2c 2h] [5h]
34a9d7fc: checks
Hero: checks
*** RIVER *** [5s 2c 2h 5h] [5d]
34a9d7fc: checks
Hero: checks
34a9d7fc: shows [Ah 9d] (Fives Full over Twos)
Hero: shows [3d Ad] (Fives Full over Twos)
*** SHOWDOWN ***
34a9d7fc collected $0.11 from pot
Hero collected $0.11 from pot
*** SUMMARY ***
Total pot $0.22 | Rake $0 | Jackpot $0 | Bingo $0 | Fortune $0 | Tax $0
Board [5s 2c 2h 5h 5d]
Seat 1: 5edbcb03 (button) folded before Flop (didn't bet)
Seat 2: e132f9c6 (small blind) folded before Flop
Seat 3: 34a9d7fc (big blind) showed [Ah 9d] and won ($0.11) with Fives Full over Twos
Seat 4: 6c7fc561 folded before Flop (didn't bet)
Seat 5: a6ae07 folded before Flop (didn't bet)
Seat 6: Hero showed [3d Ad] and won ($0.11) with Fives Full over Twos


Poker Hand #RC2094761056: Hold'em No Limit ($0.02/$0.05) - 2023/12/27 21:49:19
Table 'RushAndCash3820517' 6-max Seat #1 is the button
Seat 1: d648759 ($15.55 in chips)
Seat 2: f2b7e58d ($4.95 in chips)
Seat 3: 44161807 ($6.25 in chips)
Seat 4: Hero ($10.98 in chips)
Seat 5: 46a86d2c ($8.12 in chips)
Seat 6: 77c268f7 ($5.85 in chips)
f2b7e58d: posts small blind $0.02
44161807: posts big blind $0.05
*** HOLE CARDS ***
Dealt to d648759 
Dealt to f2b7e58d 
Dealt to 44161807 
Dealt to Hero [4h 2s]
Dealt to 46a86d2c 
Dealt to 77c268f7 
Hero: folds
46a86d2c: folds
77c268f7: raises $0.05 to $0.1
d648759: folds
f2b7e58d: calls $0.08
44161807: folds
*** FLOP *** [5d 2d 5h]
f2b7e58d: checks
77c268f7: checks
*** TURN *** [5d 2d 5h] [3h]
f2b7e58d: bets $0.09
77c268f7: raises $0.26 to $0.35
f2b7e58d: calls $0.26
*** RIVER *** [5d 2d 5h 3h] [Kh]
f2b7e58d: checks
77c268f7: checks
f2b7e58d: shows [Ad Th] (Pair of Fives)
77c268f7: shows [As Ah] (Pair of Aces and Pair of Fives)
*** SHOWDOWN ***
77c268f7 collected $0.91 from pot
*** SUMMARY ***
Total pot $0.95 | Rake $0.04 | Jackpot $0 | Bingo $0 | Fortune $0 | Tax $0
Board [5d 2d 5h 3h Kh]
Seat 1: d648759 (button) folded before Flop (didn't bet)
Seat 2: f2b7e58d (small blind) showed [Ad Th] and lost with Pair of Fives
Seat 3: 44161807 (big blind) folded before Flop
Seat 4: Hero folded before Flop (didn't bet)
Seat 5: 46a86d2c folded before Flop (didn't bet)
Seat 6: 77c268f7 showed [As Ah] and won ($0.91) with Pair of Aces and Pair of Fives


Poker Hand #RC2094760827: Hold'em No Limit ($0.02/$0.05) - 2023/12/27 21:49:08
Table 'RushAndCash3820424' 6-max Seat #1 is the button
Seat 1: 9a47c457 ($9.67 in chips)
Seat 2: 23d3ca5e ($20.18 in chips)
Seat 3: Hero ($11.03 in chips)
Seat 4: 18d5b7d0 ($7.39 in chips)
Seat 5: 87a8079f ($5.83 in chips)
Seat 6: 1031d375 ($5 in chips)
23d3ca5e: posts small blind $0.02
Hero: posts big blind $0.05
*** HOLE CARDS ***
Dealt to 9a47c457 
Dealt to 23d3ca5e 
Dealt to Hero [6s 7h]
Dealt to 18d5b7d0 
Dealt to 87a8079f 
Dealt to 1031d375 
18d5b7d0: folds
87a8079f: folds
1031d375: folds
9a47c457: folds
23d3ca5e: raises $0.05 to $0.1
Hero: folds
Uncalled bet ($0.05) returned to 23d3ca5e
*** SHOWDOWN ***
23d3ca5e collected $0.1 from pot
*** SUMMARY ***
Total pot $0.1 | Rake $0 | Jackpot $0 | Bingo $0 | Fortune $0 | Tax $0
Seat 1: 9a47c457 (button) folded before Flop (didn't bet)
Seat 2: 23d3ca5e (small blind) collected ($0.1)
Seat 3: Hero (big blind) folded before Flop
Seat 4: 18d5b7d0 folded before Flop (didn't bet)
Seat 5: 87a8079f folded before Flop (didn't bet)
Seat 6: 1031d375 folded before Flop (didn't bet)


Poker Hand #RC2094760647: Hold'em No Limit ($0.02/$0.05) - 2023/12/27 21:49:00
Table 'RushAndCash3820345' 6-max Seat #1 is the button
Seat 1: ed487780 ($6.08 in chips)
Seat 2: Hero ($11.05 in chips)
Seat 3: d7b73e59 ($8.51 in chips)
Seat 4: bc79e3f1 ($15.98 in chips)
Seat 5: 1853e4f7 ($10.68 in chips)
Seat 6: 3f202778 ($3.11 in chips)
Hero: posts small blind $0.02
d7b73e59: posts big blind $0.05
*** HOLE CARDS ***
Dealt to ed487780 
Dealt to Hero [5s Qd]
Dealt to d7b73e59 
Dealt to bc79e3f1 
Dealt to 1853e4f7 
Dealt to 3f202778 
bc79e3f1: folds
1853e4f7: folds
3f202778: folds
ed487780: folds
Hero: folds
Uncalled bet ($0.03) returned to d7b73e59
*** SHOWDOWN ***
d7b73e59 collected $0.04 from pot
*** SUMMARY ***
Total pot $0.04 | Rake $0 | Jackpot $0 | Bingo $0 | Fortune $0 | Tax $0
Seat 1: ed487780 (button) folded before Flop (didn't bet)
Seat 2: Hero (small blind) folded before Flop
Seat 3: d7b73e59 (big blind) collected ($0.04)
Seat 4: bc79e3f1 folded before Flop (didn't bet)
Seat 5: 1853e4f7 folded before Flop (didn't bet)
Seat 6: 3f202778 folded before Flop (didn't bet)


Poker Hand #RC2094760571: Hold'em No Limit ($0.02/$0.05) - 2023/12/27 21:48:56
Table 'RushAndCash3820309' 6-max Seat #1 is the button
Seat 1: 7abc9e5b ($12.54 in chips)
Seat 2: fb14c819 ($5.9 in chips)
Seat 3: 94aecf3c ($5 in chips)
Seat 4: Hero ($11.05 in chips)
Seat 5: 97aed9d4 ($22.44 in chips)
Seat 6: 16744d35 ($6.22 in chips)
fb14c819: posts small blind $0.02
94aecf3c: posts big blind $0.05
*** HOLE CARDS ***
Dealt to 7abc9e5b 
Dealt to fb14c819 
Dealt to 94aecf3c 
Dealt to Hero [5c 9h]
Dealt to 97aed9d4 
Dealt to 16744d35 
Hero: folds
97aed9d4: raises $0.1 to $0.15
16744d35: folds
7abc9e5b: folds
fb14c819: folds
94aecf3c: calls $0.1
*** FLOP *** [8d Qh Js]
94aecf3c: checks
97aed9d4: bets $0.22
94aecf3c: folds
Uncalled bet ($0.22) returned to 97aed9d4
*** SHOWDOWN ***
97aed9d4 collected $0.31 from pot
*** SUMMARY ***
Total pot $0.32 | Rake $0.01 | Jackpot $0 | Bingo $0 | Fortune $0 | Tax $0
Board [8d Qh Js]
Seat 1: 7abc9e5b (button) folded before Flop (didn't bet)
Seat 2: fb14c819 (small blind) folded before Flop
Seat 3: 94aecf3c (big blind) folded on the Flop
Seat 4: Hero folded before Flop (didn't bet)
Seat 5: 97aed9d4 won ($0.31)
Seat 6: 16744d35 folded before Flop (didn't bet)


Poker Hand #RC2094760479: Hold'em No Limit ($0.02/$0.05) - 2023/12/27 21:48:52
Table 'RushAndCash3820271' 6-max Seat #1 is the button
Seat 1: 732ce223 ($5.26 in chips)
Seat 2: d107e328 ($8.96 in chips)
Seat 3: 2e3df286 ($6.78 in chips)
Seat 4: abe1c1b1 ($5.67 in chips)
Seat 5: 82f3a210 ($8.43 in chips)
Seat 6: Hero ($11.05 in chips)
d107e328: posts small blind $0.02
2e3df286: posts big blind $0.05
*** HOLE CARDS ***
Dealt to 732ce223 
Dealt to d107e328 
Dealt to 2e3df286 
Dealt to abe1c1b1 
Dealt to 82f3a210 
Dealt to Hero [As 3s]
abe1c1b1: raises $0.08 to $0.13
82f3a210: folds
Hero: folds
732ce223: folds
d107e328: folds
2e3df286: folds
Uncalled bet ($0.08) returned to abe1c1b1
*** SHOWDOWN ***
abe1c1b1 collected $0.12 from pot
*** SUMMARY ***
Total pot $0.12 | Rake $0 | Jackpot $0 | Bingo $0 | Fortune $0 | Tax $0
Seat 1: 732ce223 (button) folded before Flop (didn't bet)
Seat 2: d107e328 (small blind) folded before Flop
Seat 3: 2e3df286 (big blind) folded before Flop
Seat 4: abe1c1b1 collected ($0.12)
Seat 5: 82f3a210 folded before Flop (didn't bet)
Seat 6: Hero folded before Flop (didn't bet)


Poker Hand #RC2094760400: Hold'em No Limit ($0.02/$0.05) - 2023/12/27 21:48:48
Table 'RushAndCash3820238' 6-max Seat #1 is the button
Seat 1: 40e2ea8e ($8.02 in chips)
Seat 2: aed68bba ($6.18 in chips)
Seat 3: e8630dc0 ($1.49 in chips)
Seat 4: Hero ($11.05 in chips)
Seat 5: fbf37034 ($7.19 in chips)
Seat 6: 6e2c1a87 ($3.84 in chips)
aed68bba: posts small blind $0.02
e8630dc0: posts big blind $0.05
*** HOLE CARDS ***
Dealt to 40e2ea8e 
Dealt to aed68bba 
Dealt to e8630dc0 
Dealt to Hero [7d 8d]
Dealt to fbf37034 
Dealt to 6e2c1a87 
Hero: folds
fbf37034: folds
6e2c1a87: folds
40e2ea8e: folds
aed68bba: folds
Uncalled bet ($0.03) returned to e8630dc0
*** SHOWDOWN ***
e8630dc0 collected $0.04 from pot
*** SUMMARY ***
Total pot $0.04 | Rake $0 | Jackpot $0 | Bingo $0 | Fortune $0 | Tax $0
Seat 1: 40e2ea8e (button) folded before Flop (didn't bet)
Seat 2: aed68bba (small blind) folded before Flop
Seat 3: e8630dc0 (big blind) collected ($0.04)
Seat 4: Hero folded before Flop (didn't bet)
Seat 5: fbf37034 folded before Flop (didn't bet)
Seat 6: 6e2c1a87 folded before Flop (didn't bet)


Poker Hand #RC2094760225: Hold'em No Limit ($0.02/$0.05) - 2023/12/27 21:48:40
Table 'RushAndCash3820163' 6-max Seat #1 is the button
Seat 1: ad4e6f9f ($2.6 in chips)
Seat 2: Hero ($11.07 in chips)
Seat 3: 981e0951 ($5.76 in chips)
Seat 4: 992c2b55 ($7.23 in chips)
Seat 5: 7d04edfb ($14.07 in chips)
Seat 6: 45d47230 ($6.01 in chips)
Hero: posts small blind $0.02
981e0951: posts big blind $0.05
*** HOLE CARDS ***
Dealt to ad4e6f9f 
Dealt to Hero [4s 4h]
Dealt to 981e0951 
Dealt to 992c2b55 
Dealt to 7d04edfb 
Dealt to 45d47230 
992c2b55: raises $0.1 to $0.15
7d04edfb: folds
45d47230: raises $0.17 to $0.32
ad4e6f9f: folds
Hero: folds
981e0951: folds
992c2b55: calls $0.17
*** FLOP *** [Qc Jd 3c]
992c2b55: checks
45d47230: bets $0.51
992c2b55: folds
Uncalled bet ($0.51) returned to 45d47230
*** SHOWDOWN ***
45d47230 collected $0.68 from pot
*** SUMMARY ***
Total pot $0.71 | Rake $0.03 | Jackpot $0 | Bingo $0 | Fortune $0 | Tax $0
Board [Qc Jd 3c]
Seat 1: ad4e6f9f (button) folded before Flop (didn't bet)
Seat 2: Hero (small blind) folded before Flop
Seat 3: 981e0951 (big blind) folded before Flop
Seat 4: 992c2b55 folded on the Flop
Seat 5: 7d04edfb folded before Flop (didn't bet)
Seat 6: 45d47230 won ($0.68)


Poker Hand #RC2094760141: Hold'em No Limit ($0.02/$0.05) - 2023/12/27 21:48:36
Table 'RushAndCash3820125' 6-max Seat #1 is the button
Seat 1: 180ef80b ($5.14 in chips)
Seat 2: 1d87709e ($5.61 in chips)
Seat 3: 4ba3c380 ($5.27 in chips)
Seat 4: cc15e090 ($6.63 in chips)
Seat 5: Hero ($11 in chips)
Seat 6: ab20611 ($1 in chips)
1d87709e: posts small blind $0.02
4ba3c380: posts big blind $0.05
*** HOLE CARDS ***
Dealt to 180ef80b 
Dealt to 1d87709e 
Dealt to 4ba3c380 
Dealt to cc15e090 
Dealt to Hero [Th 5h]
Dealt to ab20611 
cc15e090: raises $0.1 to $0.15
Hero: folds
ab20611: folds
180ef80b: folds
1d87709e: folds
4ba3c380: calls $0.1
*** FLOP *** [5c 7h As]
4ba3c380: checks
cc15e090: bets $0.16
4ba3c380: folds
Uncalled bet ($0.16) returned to cc15e090
*** SHOWDOWN ***
cc15e090 collected $0.31 from pot
*** SUMMARY ***
Total pot $0.32 | Rake $0.01 | Jackpot $0 | Bingo $0 | Fortune $0 | Tax $0
Board [5c 7h As]
Seat 1: 180ef80b (button) folded before Flop (didn't bet)
Seat 2: 1d87709e (small blind) folded before Flop
Seat 3: 4ba3c380 (big blind) folded on the Flop
Seat 4: cc15e090 won ($0.31)
Seat 5: Hero folded before Flop (didn't bet)
Seat 6: ab20611 folded before Flop (didn't bet)


Poker Hand #RC2094760061: Hold'em No Limit ($0.02/$0.05) - 2023/12/27 21:48:33
Table 'RushAndCash3820089' 6-max Seat #1 is the button
Seat 1: a1e959ec ($5.77 in chips)
Seat 2: 94497711 ($5 in chips)
Seat 3: Hero ($11.05 in chips)
Seat 4: 1a38999d ($8.29 in chips)
Seat 5: 7abc9e5b ($12.47 in chips)
Seat 6: 6bd38906 ($4.25 in chips)
94497711: posts small blind $0.02
Hero: posts big blind $0.05
*** HOLE CARDS ***
Dealt to a1e959ec 
Dealt to 94497711 
Dealt to Hero [3h 5s]
Dealt to 1a38999d 
Dealt to 7abc9e5b 
Dealt to 6bd38906 
1a38999d: folds
7abc9e5b: folds
6bd38906: folds
a1e959ec: folds
94497711: folds
Uncalled bet ($0.03) returned to Hero
*** SHOWDOWN ***
Hero collected $0.04 from pot
*** SUMMARY ***
Total pot $0.04 | Rake $0 | Jackpot $0 | Bingo $0 | Fortune $0 | Tax $0
Seat 1: a1e959ec (button) folded before Flop (didn't bet)
Seat 2: 94497711 (small blind) folded before Flop
Seat 3: Hero (big blind) collected ($0.04)
Seat 4: 1a38999d folded before Flop (didn't bet)
Seat 5: 7abc9e5b folded before Flop (didn't bet)
Seat 6: 6bd38906 folded before Flop (didn't bet)


Poker Hand #RC2094759967: Hold'em No Limit ($0.02/$0.05) - 2023/12/27 21:48:29
Table 'RushAndCash3820046' 6-max Seat #1 is the button
Seat 1: 82f3a210 ($8.43 in chips)
Seat 2: e8630dc0 ($1.44 in chips)
Seat 3: 3d4025bf ($10.41 in chips)
Seat 4: 3c5c244 ($7.25 in chips)
Seat 5: Hero ($11.05 in chips)
Seat 6: 42fa380a ($7.74 in chips)
e8630dc0: posts small blind $0.02
3d4025bf: posts big blind $0.05
*** HOLE CARDS ***
Dealt to 82f3a210 
Dealt to e8630dc0 
Dealt to 3d4025bf 
Dealt to 3c5c244 
Dealt to Hero [5d Ah]
Dealt to 42fa380a 
3c5c244: folds
Hero: folds
42fa380a: raises $0.07 to $0.12
82f3a210: folds
e8630dc0: folds
3d4025bf: calls $0.07
*** FLOP *** [Qd 3h 4h]
3d4025bf: checks
42fa380a: bets $0.18
3d4025bf: calls $0.18
*** TURN *** [Qd 3h 4h] [4d]
3d4025bf: checks
42fa380a: bets $0.41
3d4025bf: calls $0.41
*** RIVER *** [Qd 3h 4h 4d] [3s]
3d4025bf: checks
42fa380a: checks
3d4025bf: shows [Qh 8d] (Pair of Queens and Pair of Fours)
42fa380a: shows [Kd 2d] (Pair of Fours and Pair of Treys)
*** SHOWDOWN ***
3d4025bf collected $1.37 from pot
*** SUMMARY ***
Total pot $1.44 | Rake $0.07 | Jackpot $0 | Bingo $0 | Fortune $0 | Tax $0
Board [Qd 3h 4h 4d 3s]
Seat 1: 82f3a210 (button) folded before Flop (didn't bet)
Seat 2: e8630dc0 (small blind) folded before Flop
Seat 3: 3d4025bf (big blind) showed [Qh 8d] and won ($1.37) with Pair of Queens and Pair of Fours
Seat 4: 3c5c244 folded before Flop (didn't bet)
Seat 5: Hero folded before Flop (didn't bet)
Seat 6: 42fa380a showed [Kd 2d] and lost with Pair of Fours and Pair of Treys


Poker Hand #RC2094759866: Hold'em No Limit ($0.02/$0.05) - 2023/12/27 21:48:25
Table 'RushAndCash3819999' 6-max Seat #1 is the button
Seat 1: Hero ($11.05 in chips)
Seat 2: 861b60d2 ($5.22 in chips)
Seat 3: e8630dc0 ($1.49 in chips)
Seat 4: 3d4025bf ($10.41 in chips)
Seat 5: 3c5c244 ($7.25 in chips)
Seat 6: 82f3a210 ($8.43 in chips)
861b60d2: posts small blind $0.02
e8630dc0: posts big blind $0.05
*** HOLE CARDS ***
Dealt to Hero [5s 9h]
Dealt to 861b60d2 
Dealt to e8630dc0 
Dealt to 3d4025bf 
Dealt to 3c5c244 
Dealt to 82f3a210 
3d4025bf: folds
3c5c244: folds
82f3a210: folds
Hero: folds
861b60d2: folds
Uncalled bet ($0.03) returned to e8630dc0
*** SHOWDOWN ***
e8630dc0 collected $0.04 from pot
*** SUMMARY ***
Total pot $0.04 | Rake $0 | Jackpot $0 | Bingo $0 | Fortune $0 | Tax $0
Seat 1: Hero (button) folded before Flop (didn't bet)
Seat 2: 861b60d2 (small blind) folded before Flop
Seat 3: e8630dc0 (big blind) collected ($0.04)
Seat 4: 3d4025bf folded before Flop (didn't bet)
Seat 5: 3c5c244 folded before Flop (didn't bet)
Seat 6: 82f3a210 folded before Flop (didn't bet)


Poker Hand #RC2094759775: Hold'em No Limit ($0.02/$0.05) - 2023/12/27 21:48:21
Table 'RushAndCash3819961' 6-max Seat #1 is the button
Seat 1: 63c4597c ($10.61 in chips)
Seat 2: 282919f9 ($5.02 in chips)
Seat 3: 85217622 ($22.43 in chips)
Seat 4: 6d629bd ($12.39 in chips)
Seat 5: 8db5fe7d ($9.66 in chips)
Seat 6: Hero ($11.05 in chips)
282919f9: posts small blind $0.02
85217622: posts big blind $0.05
*** HOLE CARDS ***
Dealt to 63c4597c 
Dealt to 282919f9 
Dealt to 85217622 
Dealt to 6d629bd 
Dealt to 8db5fe7d 
Dealt to Hero [9h Jd]
6d629bd: folds
8db5fe7d: raises $0.05 to $0.1
Hero: folds
63c4597c: folds
282919f9: folds
85217622: folds
Uncalled bet ($0.05) returned to 8db5fe7d
*** SHOWDOWN ***
8db5fe7d collected $0.12 from pot
*** SUMMARY ***
Total pot $0.12 | Rake $0 | Jackpot $0 | Bingo $0 | Fortune $0 | Tax $0
Seat 1: 63c4597c (button) folded before Flop (didn't bet)
Seat 2: 282919f9 (small blind) folded before Flop
Seat 3: 85217622 (big blind) folded before Flop
Seat 4: 6d629bd folded before Flop (didn't bet)
Seat 5: 8db5fe7d collected ($0.12)
Seat 6: Hero folded before Flop (didn't bet)


Poker Hand #RC2094759686: Hold'em No Limit ($0.02/$0.05) - 2023/12/27 21:48:17
Table 'RushAndCash3819920' 6-max Seat #1 is the button
Seat 1: a53d5fed ($8.02 in chips)
Seat 2: 8b066018 ($5.49 in chips)
Seat 3: 80cc9272 ($6 in chips)
Seat 4: 90fe0bbb ($4.67 in chips)
Seat 5: 8271a44d ($5 in chips)
Seat 6: Hero ($11.05 in chips)
8b066018: posts small blind $0.02
80cc9272: posts big blind $0.05
*** HOLE CARDS ***
Dealt to a53d5fed 
Dealt to 8b066018 
Dealt to 80cc9272 
Dealt to 90fe0bbb 
Dealt to 8271a44d 
Dealt to Hero [Ts 4d]
90fe0bbb: folds
8271a44d: raises $0.05 to $0.1
Hero: folds
a53d5fed: folds
8b066018: raises $0.13 to $0.23
80cc9272: folds
8271a44d: folds
Uncalled bet ($0.13) returned to 8b066018
*** SHOWDOWN ***
8b066018 collected $0.24 from pot
*** SUMMARY ***
Total pot $0.25 | Rake $0.01 | Jackpot $0 | Bingo $0 | Fortune $0 | Tax $0
Seat 1: a53d5fed (button) folded before Flop (didn't bet)
Seat 2: 8b066018 (small blind) collected ($0.24)
Seat 3: 80cc9272 (big blind) folded before Flop
Seat 4: 90fe0bbb folded before Flop (didn't bet)
Seat 5: 8271a44d folded before Flop
Seat 6: Hero folded before Flop (didn't bet)


Poker Hand #RC2094759601: Hold'em No Limit ($0.02/$0.05) - 2023/12/27 21:48:13
Table 'RushAndCash3819885' 6-max Seat #1 is the button
Seat 1: 6e2c1a87 ($3.96 in chips)
Seat 2: b324aa8c ($5.2 in chips)
Seat 3: 7d92d461 ($5.23 in chips)
Seat 4: Hero ($11.05 in chips)
Seat 5: 50203b74 ($9.34 in chips)
Seat 6: 854c4b13 ($14.79 in chips)
b324aa8c: posts small blind $0.02
7d92d461: posts big blind $0.05
*** HOLE CARDS ***
Dealt to 6e2c1a87 
Dealt to b324aa8c 
Dealt to 7d92d461 
Dealt to Hero [Qs 2c]
Dealt to 50203b74 
Dealt to 854c4b13 
Hero: folds
50203b74: folds
854c4b13: folds
6e2c1a87: folds
b324aa8c: raises $0.1 to $0.15
7d92d461: folds
Uncalled bet ($0.1) returned to b324aa8c
*** SHOWDOWN ***
b324aa8c collected $0.1 from pot
*** SUMMARY ***
Total pot $0.1 | Rake $0 | Jackpot $0 | Bingo $0 | Fortune $0 | Tax $0
Seat 1: 6e2c1a87 (button) folded before Flop (didn't bet)
Seat 2: b324aa8c (small blind) collected ($0.1)
Seat 3: 7d92d461 (big blind) folded before Flop
Seat 4: Hero folded before Flop (didn't bet)
Seat 5: 50203b74 folded before Flop (didn't bet)
Seat 6: 854c4b13 folded before Flop (didn't bet)


Poker Hand #RC2094759514: Hold'em No Limit ($0.02/$0.05) - 2023/12/27 21:48:09
Table 'RushAndCash3819847' 6-max Seat #1 is the button
Seat 1: Hero ($11.05 in chips)
Seat 2: e20ff958 ($7.86 in chips)
Seat 3: ec8a1db7 ($5.72 in chips)
Seat 4: ad525fd4 ($5 in chips)
Seat 5: f100600f ($6.06 in chips)
Seat 6: 6e2c1a87 ($3.96 in chips)
e20ff958: posts small blind $0.02
ec8a1db7: posts big blind $0.05
*** HOLE CARDS ***
Dealt to Hero [8d 5s]
Dealt to e20ff958 
Dealt to ec8a1db7 
Dealt to ad525fd4 
Dealt to f100600f 
Dealt to 6e2c1a87 
ad525fd4: folds
f100600f: folds
6e2c1a87: folds
Hero: folds
e20ff958: folds
Uncalled bet ($0.03) returned to ec8a1db7
*** SHOWDOWN ***
ec8a1db7 collected $0.04 from pot
*** SUMMARY ***
Total pot $0.04 | Rake $0 | Jackpot $0 | Bingo $0 | Fortune $0 | Tax $0
Seat 1: Hero (button) folded before Flop (didn't bet)
Seat 2: e20ff958 (small blind) folded before Flop
Seat 3: ec8a1db7 (big blind) collected ($0.04)
Seat 4: ad525fd4 folded before Flop (didn't bet)
Seat 5: f100600f folded before Flop (didn't bet)
Seat 6: 6e2c1a87 folded before Flop (didn't bet)


Poker Hand #RC2094759400: Hold'em No Limit ($0.02/$0.05) - 2023/12/27 21:48:03
Table 'RushAndCash3819796' 6-max Seat #1 is the button
Seat 1: ea25b399 ($5 in chips)
Seat 2: 1d548f31 ($4.9 in chips)
Seat 3: Hero ($11.1 in chips)
Seat 4: 55790f5a ($4.76 in chips)
Seat 5: daac7685 ($7.56 in chips)
Seat 6: 18fc2199 ($5.3 in chips)
1d548f31: posts small blind $0.02
Hero: posts big blind $0.05
*** HOLE CARDS ***
Dealt to ea25b399 
Dealt to 1d548f31 
Dealt to Hero [9h 6d]
Dealt to 55790f5a 
Dealt to daac7685 
Dealt to 18fc2199 
55790f5a: raises $0.06 to $0.11
daac7685: folds
18fc2199: folds
ea25b399: folds
1d548f31: folds
Hero: folds
Uncalled bet ($0.06) returned to 55790f5a
*** SHOWDOWN ***
55790f5a collected $0.12 from pot
*** SUMMARY ***
Total pot $0.12 | Rake $0 | Jackpot $0 | Bingo $0 | Fortune $0 | Tax $0
Seat 1: ea25b399 (button) folded before Flop (didn't bet)
Seat 2: 1d548f31 (small blind) folded before Flop
Seat 3: Hero (big blind) folded before Flop
Seat 4: 55790f5a collected ($0.12)
Seat 5: daac7685 folded before Flop (didn't bet)
Seat 6: 18fc2199 folded before Flop (didn't bet)


Poker Hand #RC2094759234: Hold'em No Limit ($0.02/$0.05) - 2023/12/27 21:47:55
Table 'RushAndCash3819718' 6-max Seat #1 is the button
Seat 1: ef0ec9d9 ($5.07 in chips)
Seat 2: Hero ($11.12 in chips)
Seat 3: 8b7e3c96 ($7.24 in chips)
Seat 4: 2e698cbb ($5.25 in chips)
Seat 5: 5fdcf0fd ($4.66 in chips)
Seat 6: 12776d2c ($3.93 in chips)
Hero: posts small blind $0.02
8b7e3c96: posts big blind $0.05
*** HOLE CARDS ***
Dealt to ef0ec9d9 
Dealt to Hero [Jh 5h]
Dealt to 8b7e3c96 
Dealt to 2e698cbb 
Dealt to 5fdcf0fd 
Dealt to 12776d2c 
2e698cbb: raises $0.05 to $0.1
5fdcf0fd: folds
12776d2c: folds
ef0ec9d9: folds
Hero: folds
8b7e3c96: folds
Uncalled bet ($0.05) returned to 2e698cbb
*** SHOWDOWN ***
2e698cbb collected $0.12 from pot
*** SUMMARY ***
Total pot $0.12 | Rake $0 | Jackpot $0 | Bingo $0 | Fortune $0 | Tax $0
Seat 1: ef0ec9d9 (button) folded before Flop (didn't bet)
Seat 2: Hero (small blind) folded before Flop
Seat 3: 8b7e3c96 (big blind) folded before Flop
Seat 4: 2e698cbb collected ($0.12)
Seat 5: 5fdcf0fd folded before Flop (didn't bet)
Seat 6: 12776d2c folded before Flop (didn't bet)


Poker Hand #RC2094759148: Hold'em No Limit ($0.02/$0.05) - 2023/12/27 21:47:52
Table 'RushAndCash3819677' 6-max Seat #1 is the button
Seat 1: Hero ($11.12 in chips)
Seat 2: 4f7c05d4 ($7.45 in chips)
Seat 3: aa286bd3 ($10.51 in chips)
Seat 4: 8882b476 ($3.61 in chips)
Seat 5: cf37a064 ($29.59 in chips)
Seat 6: f7d792af ($4.93 in chips)
4f7c05d4: posts small blind $0.02
aa286bd3: posts big blind $0.05
*** HOLE CARDS ***
Dealt to Hero [7c 2h]
Dealt to 4f7c05d4 
Dealt to aa286bd3 
Dealt to 8882b476 
Dealt to cf37a064 
Dealt to f7d792af 
8882b476: raises $0.1 to $0.15
cf37a064: folds
f7d792af: folds
Hero: folds
4f7c05d4: calls $0.13
aa286bd3: folds
*** FLOP *** [Jh 4s 8s]
4f7c05d4: checks
8882b476: bets $0.1
4f7c05d4: folds
Uncalled bet ($0.1) returned to 8882b476
*** SHOWDOWN ***
8882b476 collected $0.34 from pot
*** SUMMARY ***
Total pot $0.35 | Rake $0.01 | Jackpot $0 | Bingo $0 | Fortune $0 | Tax $0
Board [Jh 4s 8s]
Seat 1: Hero (button) folded before Flop (didn't bet)
Seat 2: 4f7c05d4 (small blind) folded on the Flop
Seat 3: aa286bd3 (big blind) folded before Flop
Seat 4: 8882b476 won ($0.34)
Seat 5: cf37a064 folded before Flop (didn't bet)
Seat 6: f7d792af folded before Flop (didn't bet)


Poker Hand #RC2094758508: Hold'em No Limit ($0.02/$0.05) - 2023/12/27 21:47:23
Table 'RushAndCash3819400' 6-max Seat #1 is the button
Seat 1: 24862006 ($6.97 in chips)
Seat 2: cf37a064 ($29.69 in chips)
Seat 3: 8431310f ($5.31 in chips)
Seat 4: Hero ($10.88 in chips)
Seat 5: 4e46285c ($17 in chips)
Seat 6: 32f4a040 ($5.1 in chips)
cf37a064: posts small blind $0.02
8431310f: posts big blind $0.05
*** HOLE CARDS ***
Dealt to 24862006 
Dealt to cf37a064 
Dealt to 8431310f 
Dealt to Hero [Qc Ah]
Dealt to 4e46285c 
Dealt to 32f4a040 
Hero: raises $0.05 to $0.1
4e46285c: folds
32f4a040: folds
24862006: calls $0.1
cf37a064: calls $0.08
8431310f: folds
*** FLOP *** [2c Kc 5c]
cf37a064: checks
Hero: bets $0.18
24862006: folds
cf37a064: folds
Uncalled bet ($0.18) returned to Hero
*** SHOWDOWN ***
Hero collected $0.34 from pot
*** SUMMARY ***
Total pot $0.35 | Rake $0.01 | Jackpot $0 | Bingo $0 | Fortune $0 | Tax $0
Board [2c Kc 5c]
Seat 1: 24862006 (button) folded on the Flop
Seat 2: cf37a064 (small blind) folded on the Flop
Seat 3: 8431310f (big blind) folded before Flop
Seat 4: Hero won ($0.34)
Seat 5: 4e46285c folded before Flop (didn't bet)
Seat 6: 32f4a040 folded before Flop (didn't bet)


Poker Hand #RC2094758431: Hold'em No Limit ($0.02/$0.05) - 2023/12/27 21:47:19
Table 'RushAndCash3819364' 6-max Seat #1 is the button
Seat 1: 4da0542c ($5 in chips)
Seat 2: 16744d35 ($6.44 in chips)
Seat 3: 6f0b593c ($9.64 in chips)
Seat 4: 40459f94 ($5.63 in chips)
Seat 5: f7afce21 ($8.11 in chips)
Seat 6: Hero ($10.88 in chips)
16744d35: posts small blind $0.02
6f0b593c: posts big blind $0.05
*** HOLE CARDS ***
Dealt to 4da0542c 
Dealt to 16744d35 
Dealt to 6f0b593c 
Dealt to 40459f94 
Dealt to f7afce21 
Dealt to Hero [2d 5h]
40459f94: raises $0.05 to $0.1
f7afce21: raises $0.27 to $0.37
Hero: folds
4da0542c: folds
16744d35: folds
6f0b593c: folds
40459f94: raises $0.62 to $0.99
f7afce21: folds
Uncalled bet ($0.62) returned to 40459f94
*** SHOWDOWN ***
40459f94 collected $0.77 from pot
*** SUMMARY ***
Total pot $0.81 | Rake $0.04 | Jackpot $0 | Bingo $0 | Fortune $0 | Tax $0
Seat 1: 4da0542c (button) folded before Flop (didn't bet)
Seat 2: 16744d35 (small blind) folded before Flop
Seat 3: 6f0b593c (big blind) folded before Flop
Seat 4: 40459f94 collected ($0.77)
Seat 5: f7afce21 folded before Flop
Seat 6: Hero folded before Flop (didn't bet)


Poker Hand #RC2094758352: Hold'em No Limit ($0.02/$0.05) - 2023/12/27 21:47:16
Table 'RushAndCash3819327' 6-max Seat #1 is the button
Seat 1: 8f1669a8 ($7.43 in chips)
Seat 2: 2e698cbb ($5.29 in chips)
Seat 3: 2dedd418 ($9.11 in chips)
Seat 4: 1b78f5f7 ($5.74 in chips)
Seat 5: Hero ($10.88 in chips)
Seat 6: 7db53687 ($3.47 in chips)
2e698cbb: posts small blind $0.02
2dedd418: posts big blind $0.05
*** HOLE CARDS ***
Dealt to 8f1669a8 
Dealt to 2e698cbb 
Dealt to 2dedd418 
Dealt to 1b78f5f7 
Dealt to Hero [2c 6c]
Dealt to 7db53687 
1b78f5f7: folds
Hero: folds
7db53687: calls $0.05
8f1669a8: folds
2e698cbb: folds
2dedd418: checks
*** FLOP *** [8h 4c Ks]
2dedd418: checks
7db53687: bets $0.09
2dedd418: calls $0.09
*** TURN *** [8h 4c Ks] [7d]
2dedd418: checks
7db53687: checks
*** RIVER *** [8h 4c Ks 7d] [9h]
2dedd418: checks
7db53687: checks
2dedd418: shows [Jc 8c] (Pair of Eights)
7db53687: shows [Jd Qs] (King-High)
*** SHOWDOWN ***
2dedd418 collected $0.29 from pot
*** SUMMARY ***
Total pot $0.3 | Rake $0.01 | Jackpot $0 | Bingo $0 | Fortune $0 | Tax $0
Board [8h 4c Ks 7d 9h]
Seat 1: 8f1669a8 (button) folded before Flop (didn't bet)
Seat 2: 2e698cbb (small blind) folded before Flop
Seat 3: 2dedd418 (big blind) showed [Jc 8c] and won ($0.29) with Pair of Eights
Seat 4: 1b78f5f7 folded before Flop (didn't bet)
Seat 5: Hero folded before Flop (didn't bet)
Seat 6: 7db53687 showed [Jd Qs] and lost with King-High


Poker Hand #RC2094758267: Hold'em No Limit ($0.02/$0.05) - 2023/12/27 21:47:12
Table 'RushAndCash3819291' 6-max Seat #1 is the button
Seat 1: 9f1c61d8 ($6.62 in chips)
Seat 2: f290076b ($6.75 in chips)
Seat 3: 27538157 ($6.82 in chips)
Seat 4: 186e4d79 ($9.63 in chips)
Seat 5: 8c9da424 ($5.05 in chips)
Seat 6: Hero ($10.88 in chips)
f290076b: posts small blind $0.02
27538157: posts big blind $0.05
*** HOLE CARDS ***
Dealt to 9f1c61d8 
Dealt to f290076b 
Dealt to 27538157 
Dealt to 186e4d79 
Dealt to 8c9da424 
Dealt to Hero [9s Qd]
186e4d79: folds
8c9da424: folds
Hero: folds
9f1c61d8: folds
f290076b: raises $0.1 to $0.15
27538157: folds
Uncalled bet ($0.1) returned to f290076b
*** SHOWDOWN ***
f290076b collected $0.1 from pot
*** SUMMARY ***
Total pot $0.1 | Rake $0 | Jackpot $0 | Bingo $0 | Fortune $0 | Tax $0
Seat 1: 9f1c61d8 (button) folded before Flop (didn't bet)
Seat 2: f290076b (small blind) collected ($0.1)
Seat 3: 27538157 (big blind) folded before Flop
Seat 4: 186e4d79 folded before Flop (didn't bet)
Seat 5: 8c9da424 folded before Flop (didn't bet)
Seat 6: Hero folded before Flop (didn't bet)


Poker Hand #RC2094758017: Hold'em No Limit ($0.02/$0.05) - 2023/12/27 21:47:01
Table 'RushAndCash3819184' 6-max Seat #1 is the button
Seat 1: 7c133075 ($4.85 in chips)
Seat 2: Hero ($10.9 in chips)
Seat 3: f7bb7d2b ($6.71 in chips)
Seat 4: bbfdeb6a ($5.13 in chips)
Seat 5: abfdf1fa ($4.93 in chips)
Seat 6: 2e1c2eb ($6.11 in chips)
Hero: posts small blind $0.02
f7bb7d2b: posts big blind $0.05
*** HOLE CARDS ***
Dealt to 7c133075 
Dealt to Hero [Kc 7h]
Dealt to f7bb7d2b 
Dealt to bbfdeb6a 
Dealt to abfdf1fa 
Dealt to 2e1c2eb 
bbfdeb6a: raises $0.05 to $0.1
abfdf1fa: raises $0.27 to $0.37
2e1c2eb: folds
7c133075: raises $0.31 to $0.68
Hero: folds
f7bb7d2b: folds
bbfdeb6a: folds
abfdf1fa: calls $0.31
*** FLOP *** [Qc 5h 8h]
abfdf1fa: checks
7c133075: checks
*** TURN *** [Qc 5h 8h] [4h]
abfdf1fa: bets $0.51
7c133075: calls $0.51
*** RIVER *** [Qc 5h 8h 4h] [Kh]
abfdf1fa: checks
7c133075: bets $3.66 and is all-in
abfdf1fa: folds
Uncalled bet ($3.66) returned to 7c133075
7c133075: shows [Ad Ah] (Ace High Flush)
*** SHOWDOWN ***
7c133075 collected $2.36 from pot
*** SUMMARY ***
Total pot $2.55 | Rake $0.12 | Jackpot $0.07 | Bingo $0 | Fortune $0 | Tax $0
Board [Qc 5h 8h 4h Kh]
Seat 1: 7c133075 (button) showed [Ad Ah] and won ($2.36)
Seat 2: Hero (small blind) folded before Flop
Seat 3: f7bb7d2b (big blind) folded before Flop
Seat 4: bbfdeb6a folded before Flop
Seat 5: abfdf1fa folded on the River
Seat 6: 2e1c2eb folded before Flop (didn't bet)


Poker Hand #RC2094757011: Hold'em No Limit ($0.02/$0.05) - 2023/12/27 21:46:16
Table 'RushAndCash3818720' 6-max Seat #1 is the button
Seat 1: Hero ($11.01 in chips)
Seat 2: 7c133075 ($4.54 in chips)
Seat 3: 9340dfcd ($4.15 in chips)
Seat 4: 5cef3b34 ($10.31 in chips)
Seat 5: 2e81a1b9 ($15.24 in chips)
Seat 6: d2511a5c ($6.31 in chips)
7c133075: posts small blind $0.02
9340dfcd: posts big blind $0.05
*** HOLE CARDS ***
Dealt to Hero [3d 3s]
Dealt to 7c133075 
Dealt to 9340dfcd 
Dealt to 5cef3b34 
Dealt to 2e81a1b9 
Dealt to d2511a5c 
5cef3b34: folds
2e81a1b9: folds
d2511a5c: raises $0.06 to $0.11
Hero: calls $0.11
7c133075: calls $0.09
9340dfcd: calls $0.06
*** FLOP *** [As Qh 8d]
7c133075: checks
9340dfcd: checks
d2511a5c: checks
Hero: checks
*** TURN *** [As Qh 8d] [8c]
7c133075: bets $0.15
9340dfcd: folds
d2511a5c: folds
Hero: folds
Uncalled bet ($0.15) returned to 7c133075
*** SHOWDOWN ***
7c133075 collected $0.42 from pot
*** SUMMARY ***
Total pot $0.44 | Rake $0.02 | Jackpot $0 | Bingo $0 | Fortune $0 | Tax $0
Board [As Qh 8d 8c]
Seat 1: Hero (button) folded on the Turn
Seat 2: 7c133075 (small blind) won ($0.42)
Seat 3: 9340dfcd (big blind) folded on the Turn
Seat 4: 5cef3b34 folded before Flop (didn't bet)
Seat 5: 2e81a1b9 folded before Flop (didn't bet)
Seat 6: d2511a5c folded on the Turn


Poker Hand #RC2094756849: Hold'em No Limit ($0.02/$0.05) - 2023/12/27 21:46:08
Table 'RushAndCash3818647' 6-max Seat #1 is the button
Seat 1: adbd64b8 ($13.01 in chips)
Seat 2: 64ae07c6 ($5 in chips)
Seat 3: Hero ($10.99 in chips)
Seat 4: ad525fd4 ($5 in chips)
Seat 5: 1b9f4dda ($5.45 in chips)
Seat 6: 3fe9a08a ($4.93 in chips)
64ae07c6: posts small blind $0.02
Hero: posts big blind $0.05
*** HOLE CARDS ***
Dealt to adbd64b8 
Dealt to 64ae07c6 
Dealt to Hero [5c 3s]
Dealt to ad525fd4 
Dealt to 1b9f4dda 
Dealt to 3fe9a08a 
ad525fd4: folds
1b9f4dda: folds
3fe9a08a: folds
adbd64b8: folds
64ae07c6: folds
Uncalled bet ($0.03) returned to Hero
*** SHOWDOWN ***
Hero collected $0.04 from pot
*** SUMMARY ***
Total pot $0.04 | Rake $0 | Jackpot $0 | Bingo $0 | Fortune $0 | Tax $0
Seat 1: adbd64b8 (button) folded before Flop (didn't bet)
Seat 2: 64ae07c6 (small blind) folded before Flop
Seat 3: Hero (big blind) collected ($0.04)
Seat 4: ad525fd4 folded before Flop (didn't bet)
Seat 5: 1b9f4dda folded before Flop (didn't bet)
Seat 6: 3fe9a08a folded before Flop (didn't bet)


Poker Hand #RC2094756768: Hold'em No Limit ($0.02/$0.05) - 2023/12/27 21:46:05
Table 'RushAndCash3818613' 6-max Seat #1 is the button
Seat 1: 5507970f ($5 in chips)
Seat 2: 18d5b7d0 ($7.59 in chips)
Seat 3: 64ae07c6 ($5 in chips)
Seat 4: Hero ($10.99 in chips)
Seat 5: ea25b399 ($5.07 in chips)
Seat 6: 575a0f73 ($6.48 in chips)
18d5b7d0: posts small blind $0.02
64ae07c6: posts big blind $0.05
*** HOLE CARDS ***
Dealt to 5507970f 
Dealt to 18d5b7d0 
Dealt to 64ae07c6 
Dealt to Hero [3c 8c]
Dealt to ea25b399 
Dealt to 575a0f73 
Hero: folds
ea25b399: folds
575a0f73: folds
5507970f: raises $0.06 to $0.11
18d5b7d0: folds
64ae07c6: folds
Uncalled bet ($0.06) returned to 5507970f
*** SHOWDOWN ***
5507970f collected $0.12 from pot
*** SUMMARY ***
Total pot $0.12 | Rake $0 | Jackpot $0 | Bingo $0 | Fortune $0 | Tax $0
Seat 1: 5507970f (button) collected ($0.12)
Seat 2: 18d5b7d0 (small blind) folded before Flop
Seat 3: 64ae07c6 (big blind) folded before Flop
Seat 4: Hero folded before Flop (didn't bet)
Seat 5: ea25b399 folded before Flop (didn't bet)
Seat 6: 575a0f73 folded before Flop (didn't bet)


Poker Hand #RC2094755998: Hold'em No Limit ($0.02/$0.05) - 2023/12/27 21:45:30
Table 'RushAndCash3818275' 6-max Seat #1 is the button
Seat 1: 9b8d2d21 ($12.61 in chips)
Seat 2: caff888b ($8.06 in chips)
Seat 3: 4e413e32 ($5.53 in chips)
Seat 4: 575a0f73 ($6.24 in chips)
Seat 5: 8c6ba401 ($5.44 in chips)
Seat 6: Hero ($11.09 in chips)
caff888b: posts small blind $0.02
4e413e32: posts big blind $0.05
*** HOLE CARDS ***
Dealt to 9b8d2d21 
Dealt to caff888b 
Dealt to 4e413e32 
Dealt to 575a0f73 
Dealt to 8c6ba401 
Dealt to Hero [Ah Jd]
575a0f73: raises $0.05 to $0.1
8c6ba401: folds
Hero: calls $0.1
9b8d2d21: folds
caff888b: calls $0.08
4e413e32: folds
*** FLOP *** [Ks 7s 8s]
caff888b: checks
575a0f73: bets $0.35
Hero: folds
caff888b: folds
Uncalled bet ($0.35) returned to 575a0f73
*** SHOWDOWN ***
575a0f73 collected $0.34 from pot
*** SUMMARY ***
Total pot $0.35 | Rake $0.01 | Jackpot $0 | Bingo $0 | Fortune $0 | Tax $0
Board [Ks 7s 8s]
Seat 1: 9b8d2d21 (button) folded before Flop (didn't bet)
Seat 2: caff888b (small blind) folded on the Flop
Seat 3: 4e413e32 (big blind) folded before Flop
Seat 4: 575a0f73 won ($0.34)
Seat 5: 8c6ba401 folded before Flop (didn't bet)
Seat 6: Hero folded on the Flop


Poker Hand #RC2094755139: Hold'em No Limit ($0.02/$0.05) - 2023/12/27 21:44:51
Table 'RushAndCash3817894' 6-max Seat #1 is the button
Seat 1: 575a0f73 ($5.25 in chips)
Seat 2: b945d657 ($23.2 in chips)
Seat 3: 8c13f88f ($5.76 in chips)
Seat 4: aec6acc ($5.19 in chips)
Seat 5: 8431310f ($5.41 in chips)
Seat 6: Hero ($12.19 in chips)
b945d657: posts small blind $0.02
8c13f88f: posts big blind $0.05
*** HOLE CARDS ***
Dealt to 575a0f73 
Dealt to b945d657 
Dealt to 8c13f88f 
Dealt to aec6acc 
Dealt to 8431310f 
Dealt to Hero [7s 7d]
aec6acc: folds
8431310f: folds
Hero: raises $0.05 to $0.1
575a0f73: raises $0.35 to $0.45
b945d657: folds
8c13f88f: folds
Hero: calls $0.35
*** FLOP *** [5s 5c 2s]
Hero: checks
575a0f73: bets $0.65
Hero: calls $0.65
*** TURN *** [5s 5c 2s] [Kd]
Hero: checks
575a0f73: bets $1.5
Hero: folds
Uncalled bet ($1.5) returned to 575a0f73
*** SHOWDOWN ***
575a0f73 collected $2.09 from pot
*** SUMMARY ***
Total pot $2.27 | Rake $0.11 | Jackpot $0.07 | Bingo $0 | Fortune $0 | Tax $0
Board [5s 5c 2s Kd]
Seat 1: 575a0f73 (button) won ($2.09)
Seat 2: b945d657 (small blind) folded before Flop
Seat 3: 8c13f88f (big blind) folded before Flop
Seat 4: aec6acc folded before Flop (didn't bet)
Seat 5: 8431310f folded before Flop (didn't bet)
Seat 6: Hero folded on the Turn


Poker Hand #RC2094755070: Hold'em No Limit ($0.02/$0.05) - 2023/12/27 21:44:47
Table 'RushAndCash3817865' 6-max Seat #1 is the button
Seat 1: Hero ($12.19 in chips)
Seat 2: ab59cb2 ($5.35 in chips)
Seat 3: cbc9fff5 ($10.3 in chips)
Seat 4: 96c710c2 ($4.68 in chips)
Seat 5: daac7685 ($5.6 in chips)
Seat 6: 2e75303d ($5.61 in chips)
ab59cb2: posts small blind $0.02
cbc9fff5: posts big blind $0.05
*** HOLE CARDS ***
Dealt to Hero [6d Ts]
Dealt to ab59cb2 
Dealt to cbc9fff5 
Dealt to 96c710c2 
Dealt to daac7685 
Dealt to 2e75303d 
96c710c2: folds
daac7685: folds
2e75303d: folds
Hero: folds
ab59cb2: raises $0.07 to $0.12
cbc9fff5: folds
Uncalled bet ($0.07) returned to ab59cb2
*** SHOWDOWN ***
ab59cb2 collected $0.1 from pot
*** SUMMARY ***
Total pot $0.1 | Rake $0 | Jackpot $0 | Bingo $0 | Fortune $0 | Tax $0
Seat 1: Hero (button) folded before Flop (didn't bet)
Seat 2: ab59cb2 (small blind) collected ($0.1)
Seat 3: cbc9fff5 (big blind) folded before Flop
Seat 4: 96c710c2 folded before Flop (didn't bet)
Seat 5: daac7685 folded before Flop (didn't bet)
Seat 6: 2e75303d folded before Flop (didn't bet)


Poker Hand #RC2094734567: Hold'em No Limit ($0.02/$0.05) - 2023/12/27 21:44:25
Table 'RushAndCash3817645' 6-max Seat #1 is the button
Seat 1: 151aa935 ($5 in chips)
Seat 2: 4473a677 ($4.92 in chips)
Seat 3: Hero ($12.31 in chips)
Seat 4: 3679dcf2 ($5.57 in chips)
Seat 5: 9d22830f ($5.15 in chips)
Seat 6: ab59cb2 ($5.22 in chips)
4473a677: posts small blind $0.02
Hero: posts big blind $0.05
*** HOLE CARDS ***
Dealt to 151aa935 
Dealt to 4473a677 
Dealt to Hero [9c 8c]
Dealt to 3679dcf2 
Dealt to 9d22830f 
Dealt to ab59cb2 
3679dcf2: folds
9d22830f: folds
ab59cb2: raises $0.07 to $0.12
151aa935: folds
4473a677: folds
Hero: calls $0.07
*** FLOP *** [5s Qh Jc]
Hero: checks
ab59cb2: bets $0.09
Hero: folds
Uncalled bet ($0.09) returned to ab59cb2
*** SHOWDOWN ***
ab59cb2 collected $0.25 from pot
*** SUMMARY ***
Total pot $0.26 | Rake $0.01 | Jackpot $0 | Bingo $0 | Fortune $0 | Tax $0
Board [5s Qh Jc]
Seat 1: 151aa935 (button) folded before Flop (didn't bet)
Seat 2: 4473a677 (small blind) folded before Flop
Seat 3: Hero (big blind) folded on the Flop
Seat 4: 3679dcf2 folded before Flop (didn't bet)
Seat 5: 9d22830f folded before Flop (didn't bet)
Seat 6: ab59cb2 won ($0.25)


Poker Hand #RC2094734439: Hold'em No Limit ($0.02/$0.05) - 2023/12/27 21:44:19
Table 'RushAndCash3817587' 6-max Seat #1 is the button
Seat 1: 8e1e4bb4 ($5 in chips)
Seat 2: Hero ($12.33 in chips)
Seat 3: 4b857f1e ($5.08 in chips)
Seat 4: 4d9b8681 ($9.74 in chips)
Seat 5: 921d5159 ($5 in chips)
Seat 6: 2c0902b1 ($6.64 in chips)
Hero: posts small blind $0.02
4b857f1e: posts big blind $0.05
*** HOLE CARDS ***
Dealt to 8e1e4bb4 
Dealt to Hero [Qs 6s]
Dealt to 4b857f1e 
Dealt to 4d9b8681 
Dealt to 921d5159 
Dealt to 2c0902b1 
4d9b8681: raises $0.07 to $0.12
921d5159: folds
2c0902b1: raises $0.28 to $0.4
8e1e4bb4: folds
Hero: folds
4b857f1e: folds
4d9b8681: folds
Uncalled bet ($0.28) returned to 2c0902b1
*** SHOWDOWN ***
2c0902b1 collected $0.3 from pot
*** SUMMARY ***
Total pot $0.31 | Rake $0.01 | Jackpot $0 | Bingo $0 | Fortune $0 | Tax $0
Seat 1: 8e1e4bb4 (button) folded before Flop (didn't bet)
Seat 2: Hero (small blind) folded before Flop
Seat 3: 4b857f1e (big blind) folded before Flop
Seat 4: 4d9b8681 folded before Flop
Seat 5: 921d5159 folded before Flop (didn't bet)
Seat 6: 2c0902b1 collected ($0.3)


Poker Hand #RC2094733449: Hold'em No Limit ($0.02/$0.05) - 2023/12/27 21:43:33
Table 'RushAndCash3817162' 6-max Seat #1 is the button
Seat 1: 80cc9272 ($6.08 in chips)
Seat 2: 7b3ca8fa ($4.4 in chips)
Seat 3: Hero ($11.98 in chips)
Seat 4: 8271a44d ($5 in chips)
Seat 5: 65705dba ($5.7 in chips)
Seat 6: 1ffd0a04 ($4.79 in chips)
7b3ca8fa: posts small blind $0.02
Hero: posts big blind $0.05
*** HOLE CARDS ***
Dealt to 80cc9272 
Dealt to 7b3ca8fa 
Dealt to Hero [7s 7c]
Dealt to 8271a44d 
Dealt to 65705dba 
Dealt to 1ffd0a04 
8271a44d: folds
65705dba: folds
1ffd0a04: raises $0.08 to $0.13
80cc9272: folds
7b3ca8fa: folds
Hero: calls $0.08
*** FLOP *** [7d Ad Qh]
Hero: checks
1ffd0a04: checks
*** TURN *** [7d Ad Qh] [As]
Hero: checks
1ffd0a04: bets $0.09
Hero: raises $0.14 to $0.23
1ffd0a04: calls $0.14
*** RIVER *** [7d Ad Qh As] [6h]
Hero: bets $0.79
1ffd0a04: folds
Uncalled bet ($0.79) returned to Hero
*** SHOWDOWN ***
Hero collected $0.71 from pot
*** SUMMARY ***
Total pot $0.74 | Rake $0.03 | Jackpot $0 | Bingo $0 | Fortune $0 | Tax $0
Board [7d Ad Qh As 6h]
Seat 1: 80cc9272 (button) folded before Flop (didn't bet)
Seat 2: 7b3ca8fa (small blind) folded before Flop
Seat 3: Hero (big blind) won ($0.71)
Seat 4: 8271a44d folded before Flop (didn't bet)
Seat 5: 65705dba folded before Flop (didn't bet)
Seat 6: 1ffd0a04 folded on the River


Poker Hand #RC2094733151: Hold'em No Limit ($0.02/$0.05) - 2023/12/27 21:43:19
Table 'RushAndCash3817035' 6-max Seat #1 is the button
Seat 1: 129d5d42 ($6.12 in chips)
Seat 2: Hero ($12 in chips)
Seat 3: fdc33ab9 ($5 in chips)
Seat 4: 86c6d8e7 ($11.17 in chips)
Seat 5: 7b3ca8fa ($4.45 in chips)
Seat 6: 92b8b5e2 ($4.78 in chips)
Hero: posts small blind $0.02
fdc33ab9: posts big blind $0.05
*** HOLE CARDS ***
Dealt to 129d5d42 
Dealt to Hero [6h 7c]
Dealt to fdc33ab9 
Dealt to 86c6d8e7 
Dealt to 7b3ca8fa 
Dealt to 92b8b5e2 
86c6d8e7: folds
7b3ca8fa: folds
92b8b5e2: folds
129d5d42: folds
Hero: folds
Uncalled bet ($0.03) returned to fdc33ab9
*** SHOWDOWN ***
fdc33ab9 collected $0.04 from pot
*** SUMMARY ***
Total pot $0.04 | Rake $0 | Jackpot $0 | Bingo $0 | Fortune $0 | Tax $0
Seat 1: 129d5d42 (button) folded before Flop (didn't bet)
Seat 2: Hero (small blind) folded before Flop
Seat 3: fdc33ab9 (big blind) collected ($0.04)
Seat 4: 86c6d8e7 folded before Flop (didn't bet)
Seat 5: 7b3ca8fa folded before Flop (didn't bet)
Seat 6: 92b8b5e2 folded before Flop (didn't bet)


Poker Hand #RC2094732920: Hold'em No Limit ($0.02/$0.05) - 2023/12/27 21:43:09
Table 'RushAndCash3816930' 6-max Seat #1 is the button
Seat 1: b4e485a2 ($13.37 in chips)
Seat 2: 4fe738c0 ($4.01 in chips)
Seat 3: 85217622 ($21.37 in chips)
Seat 4: Hero ($11.93 in chips)
Seat 5: 61737da3 ($6.49 in chips)
Seat 6: 7d04edfb ($13.52 in chips)
4fe738c0: posts small blind $0.02
85217622: posts big blind $0.05
*** HOLE CARDS ***
Dealt to b4e485a2 
Dealt to 4fe738c0 
Dealt to 85217622 
Dealt to Hero [Qd Qc]
Dealt to 61737da3 
Dealt to 7d04edfb 
Hero: raises $0.05 to $0.1
61737da3: folds
7d04edfb: folds
b4e485a2: folds
4fe738c0: folds
85217622: folds
Uncalled bet ($0.05) returned to Hero
*** SHOWDOWN ***
Hero collected $0.12 from pot
*** SUMMARY ***
Total pot $0.12 | Rake $0 | Jackpot $0 | Bingo $0 | Fortune $0 | Tax $0
Seat 1: b4e485a2 (button) folded before Flop (didn't bet)
Seat 2: 4fe738c0 (small blind) folded before Flop
Seat 3: 85217622 (big blind) folded before Flop
Seat 4: Hero collected ($0.12)
Seat 5: 61737da3 folded before Flop (didn't bet)
Seat 6: 7d04edfb folded before Flop (didn't bet)


Poker Hand #RC2094732840: Hold'em No Limit ($0.02/$0.05) - 2023/12/27 21:43:05
Table 'RushAndCash3816894' 6-max Seat #1 is the button
Seat 1: 2e3df286 ($7.15 in chips)
Seat 2: 42fa380a ($5 in chips)
Seat 3: 19879f5e ($8.39 in chips)
Seat 4: Hero ($11.93 in chips)
Seat 5: 63bb9f51 ($5 in chips)
Seat 6: df1a79c7 ($5.63 in chips)
42fa380a: posts small blind $0.02
19879f5e: posts big blind $0.05
*** HOLE CARDS ***
Dealt to 2e3df286 
Dealt to 42fa380a 
Dealt to 19879f5e 
Dealt to Hero [4h 2s]
Dealt to 63bb9f51 
Dealt to df1a79c7 
Hero: folds
63bb9f51: folds
df1a79c7: folds
2e3df286: folds
42fa380a: folds
Uncalled bet ($0.03) returned to 19879f5e
*** SHOWDOWN ***
19879f5e collected $0.04 from pot
*** SUMMARY ***
Total pot $0.04 | Rake $0 | Jackpot $0 | Bingo $0 | Fortune $0 | Tax $0
Seat 1: 2e3df286 (button) folded before Flop (didn't bet)
Seat 2: 42fa380a (small blind) folded before Flop
Seat 3: 19879f5e (big blind) collected ($0.04)
Seat 4: Hero folded before Flop (didn't bet)
Seat 5: 63bb9f51 folded before Flop (didn't bet)
Seat 6: df1a79c7 folded before Flop (didn't bet)


Poker Hand #RC2094732765: Hold'em No Limit ($0.02/$0.05) - 2023/12/27 21:43:02
Table 'RushAndCash3816861' 6-max Seat #1 is the button
Seat 1: ad4e6f9f ($2.93 in chips)
Seat 2: cf37a064 ($25.41 in chips)
Seat 3: 6022a9c1 ($5 in chips)
Seat 4: 7b3ca8fa ($4.52 in chips)
Seat 5: 7be8413b ($5.3 in chips)
Seat 6: Hero ($11.93 in chips)
cf37a064: posts small blind $0.02
6022a9c1: posts big blind $0.05
*** HOLE CARDS ***
Dealt to ad4e6f9f 
Dealt to cf37a064 
Dealt to 6022a9c1 
Dealt to 7b3ca8fa 
Dealt to 7be8413b 
Dealt to Hero [Th 3h]
7b3ca8fa: folds
7be8413b: folds
Hero: folds
ad4e6f9f: folds
cf37a064: folds
Uncalled bet ($0.03) returned to 6022a9c1
*** SHOWDOWN ***
6022a9c1 collected $0.04 from pot
*** SUMMARY ***
Total pot $0.04 | Rake $0 | Jackpot $0 | Bingo $0 | Fortune $0 | Tax $0
Seat 1: ad4e6f9f (button) folded before Flop (didn't bet)
Seat 2: cf37a064 (small blind) folded before Flop
Seat 3: 6022a9c1 (big blind) collected ($0.04)
Seat 4: 7b3ca8fa folded before Flop (didn't bet)
Seat 5: 7be8413b folded before Flop (didn't bet)
Seat 6: Hero folded before Flop (didn't bet)


Poker Hand #RC2094732422: Hold'em No Limit ($0.02/$0.05) - 2023/12/27 21:42:47
Table 'RushAndCash3816707' 6-max Seat #1 is the button
Seat 1: 283529b2 ($4.21 in chips)
Seat 2: 42606853 ($15.97 in chips)
Seat 3: Hero ($11.98 in chips)
Seat 4: fe47eed7 ($5 in chips)
Seat 5: 24862006 ($4.43 in chips)
Seat 6: 710e30bf ($5.11 in chips)
42606853: posts small blind $0.02
Hero: posts big blind $0.05
*** HOLE CARDS ***
Dealt to 283529b2 
Dealt to 42606853 
Dealt to Hero [9h 9c]
Dealt to fe47eed7 
Dealt to 24862006 
Dealt to 710e30bf 
fe47eed7: folds
24862006: raises $0.05 to $0.1
710e30bf: raises $0.25 to $0.35
283529b2: folds
42606853: folds
Hero: folds
24862006: calls $0.25
*** FLOP *** [Js 3d 4d]
24862006: checks
710e30bf: bets $0.39
24862006: calls $0.39
*** TURN *** [Js 3d 4d] [Kd]
24862006: checks
710e30bf: bets $0.78
24862006: raises $1.22 to $2
710e30bf: calls $1.22
*** RIVER *** [Js 3d 4d Kd] [2h]
24862006: bets $1.69 and is all-in
710e30bf: folds
Uncalled bet ($1.69) returned to 24862006
*** SHOWDOWN ***
24862006 collected $5.33 from pot
*** SUMMARY ***
Total pot $5.55 | Rake $0.15 | Jackpot $0.07 | Bingo $0 | Fortune $0 | Tax $0
Board [Js 3d 4d Kd 2h]
Seat 1: 283529b2 (button) folded before Flop (didn't bet)
Seat 2: 42606853 (small blind) folded before Flop
Seat 3: Hero (big blind) folded before Flop
Seat 4: fe47eed7 folded before Flop (didn't bet)
Seat 5: 24862006 won ($5.33)
Seat 6: 710e30bf folded on the River


Poker Hand #RC2094732214: Hold'em No Limit ($0.02/$0.05) - 2023/12/27 21:42:37
Table 'RushAndCash3816607' 6-max Seat #1 is the button
Seat 1: 27dfc090 ($9.94 in chips)
Seat 2: c67b85a9 ($15.08 in chips)
Seat 3: 2e1c2eb ($5.17 in chips)
Seat 4: 959f22e1 ($12.25 in chips)
Seat 5: Hero ($11.91 in chips)
Seat 6: 7b3ca8fa ($4.59 in chips)
c67b85a9: posts small blind $0.02
2e1c2eb: posts big blind $0.05
*** HOLE CARDS ***
Dealt to 27dfc090 
Dealt to c67b85a9 
Dealt to 2e1c2eb 
Dealt to 959f22e1 
Dealt to Hero [Ad 2d]
Dealt to 7b3ca8fa 
959f22e1: folds
Hero: raises $0.05 to $0.1
7b3ca8fa: folds
27dfc090: folds
c67b85a9: folds
2e1c2eb: folds
Uncalled bet ($0.05) returned to Hero
*** SHOWDOWN ***
Hero collected $0.12 from pot
*** SUMMARY ***
Total pot $0.12 | Rake $0 | Jackpot $0 | Bingo $0 | Fortune $0 | Tax $0
Seat 1: 27dfc090 (button) folded before Flop (didn't bet)
Seat 2: c67b85a9 (small blind) folded before Flop
Seat 3: 2e1c2eb (big blind) folded before Flop
Seat 4: 959f22e1 folded before Flop (didn't bet)
Seat 5: Hero collected ($0.12)
Seat 6: 7b3ca8fa folded before Flop (didn't bet)


Poker Hand #RC2094732130: Hold'em No Limit ($0.02/$0.05) - 2023/12/27 21:42:34
Table 'RushAndCash3816570' 6-max Seat #1 is the button
Seat 1: Hero ($11.91 in chips)
Seat 2: bf02d9b6 ($18.06 in chips)
Seat 3: c4d14388 ($5.38 in chips)
Seat 4: d72c034d ($5.82 in chips)
Seat 5: e6015102 ($4.92 in chips)
Seat 6: 2e1c2eb ($5.17 in chips)
bf02d9b6: posts small blind $0.02
c4d14388: posts big blind $0.05
*** HOLE CARDS ***
Dealt to Hero [4d 3h]
Dealt to bf02d9b6 
Dealt to c4d14388 
Dealt to d72c034d 
Dealt to e6015102 
Dealt to 2e1c2eb 
d72c034d: folds
e6015102: folds
2e1c2eb: folds
Hero: folds
bf02d9b6: folds
Uncalled bet ($0.03) returned to c4d14388
*** SHOWDOWN ***
c4d14388 collected $0.04 from pot
*** SUMMARY ***
Total pot $0.04 | Rake $0 | Jackpot $0 | Bingo $0 | Fortune $0 | Tax $0
Seat 1: Hero (button) folded before Flop (didn't bet)
Seat 2: bf02d9b6 (small blind) folded before Flop
Seat 3: c4d14388 (big blind) collected ($0.04)
Seat 4: d72c034d folded before Flop (didn't bet)
Seat 5: e6015102 folded before Flop (didn't bet)
Seat 6: 2e1c2eb folded before Flop (didn't bet)


Poker Hand #RC2094731569: Hold'em No Limit ($0.02/$0.05) - 2023/12/27 21:42:08
Table 'RushAndCash3816322' 6-max Seat #1 is the button
Seat 1: 3105a0e3 ($5.6 in chips)
Seat 2: bbfdeb6a ($5.69 in chips)
Seat 3: a564255e ($5 in chips)
Seat 4: Hero ($11.75 in chips)
Seat 5: 1fa3ea14 ($5 in chips)
Seat 6: d72c034d ($5.92 in chips)
bbfdeb6a: posts small blind $0.02
a564255e: posts big blind $0.05
*** HOLE CARDS ***
Dealt to 3105a0e3 
Dealt to bbfdeb6a 
Dealt to a564255e 
Dealt to Hero [Ac Ah]
Dealt to 1fa3ea14 
Dealt to d72c034d 
Hero: raises $0.05 to $0.1
1fa3ea14: folds
d72c034d: calls $0.1
3105a0e3: folds
bbfdeb6a: folds
a564255e: folds
*** FLOP *** [Qh 2d 4s]
Hero: bets $0.14
d72c034d: folds
Uncalled bet ($0.14) returned to Hero
*** SHOWDOWN ***
Hero collected $0.26 from pot
*** SUMMARY ***
Total pot $0.27 | Rake $0.01 | Jackpot $0 | Bingo $0 | Fortune $0 | Tax $0
Board [Qh 2d 4s]
Seat 1: 3105a0e3 (button) folded before Flop (didn't bet)
Seat 2: bbfdeb6a (small blind) folded before Flop
Seat 3: a564255e (big blind) folded before Flop
Seat 4: Hero won ($0.26)
Seat 5: 1fa3ea14 folded before Flop (didn't bet)
Seat 6: d72c034d folded on the Flop


Poker Hand #RC2094731486: Hold'em No Limit ($0.02/$0.05) - 2023/12/27 21:42:05
Table 'RushAndCash3816282' 6-max Seat #1 is the button
Seat 1: 5507970f ($4.83 in chips)
Seat 2: 3bdf9969 ($7.85 in chips)
Seat 3: bb12d006 ($2 in chips)
Seat 4: d9947d19 ($5.2 in chips)
Seat 5: Hero ($11.75 in chips)
Seat 6: 859e6609 ($5.8 in chips)
3bdf9969: posts small blind $0.02
bb12d006: posts big blind $0.05
*** HOLE CARDS ***
Dealt to 5507970f 
Dealt to 3bdf9969 
Dealt to bb12d006 
Dealt to d9947d19 
Dealt to Hero [Qs 3h]
Dealt to 859e6609 
d9947d19: folds
Hero: folds
859e6609: folds
5507970f: folds
3bdf9969: folds
Uncalled bet ($0.03) returned to bb12d006
*** SHOWDOWN ***
bb12d006 collected $0.04 from pot
*** SUMMARY ***
Total pot $0.04 | Rake $0 | Jackpot $0 | Bingo $0 | Fortune $0 | Tax $0
Seat 1: 5507970f (button) folded before Flop (didn't bet)
Seat 2: 3bdf9969 (small blind) folded before Flop
Seat 3: bb12d006 (big blind) collected ($0.04)
Seat 4: d9947d19 folded before Flop (didn't bet)
Seat 5: Hero folded before Flop (didn't bet)
Seat 6: 859e6609 folded before Flop (didn't bet)


Poker Hand #RC2094731355: Hold'em No Limit ($0.02/$0.05) - 2023/12/27 21:41:59
Table 'RushAndCash3816227' 6-max Seat #1 is the button
Seat 1: Hero ($11.75 in chips)
Seat 2: 2e1c2eb ($5.12 in chips)
Seat 3: 48480486 ($16.62 in chips)
Seat 4: 4e1f52ef ($5.05 in chips)
Seat 5: 115f0c0d ($2.05 in chips)
Seat 6: 96c710c2 ($4.85 in chips)
2e1c2eb: posts small blind $0.02
48480486: posts big blind $0.05
*** HOLE CARDS ***
Dealt to Hero [7d Th]
Dealt to 2e1c2eb 
Dealt to 48480486 
Dealt to 4e1f52ef 
Dealt to 115f0c0d 
Dealt to 96c710c2 
4e1f52ef: folds
115f0c0d: folds
96c710c2: folds
Hero: folds
2e1c2eb: raises $0.08 to $0.13
48480486: folds
Uncalled bet ($0.08) returned to 2e1c2eb
*** SHOWDOWN ***
2e1c2eb collected $0.1 from pot
*** SUMMARY ***
Total pot $0.1 | Rake $0 | Jackpot $0 | Bingo $0 | Fortune $0 | Tax $0
Seat 1: Hero (button) folded before Flop (didn't bet)
Seat 2: 2e1c2eb (small blind) collected ($0.1)
Seat 3: 48480486 (big blind) folded before Flop
Seat 4: 4e1f52ef folded before Flop (didn't bet)
Seat 5: 115f0c0d folded before Flop (didn't bet)
Seat 6: 96c710c2 folded before Flop (didn't bet)


Poker Hand #RC2094731093: Hold'em No Limit ($0.02/$0.05) - 2023/12/27 21:41:47
Table 'RushAndCash3816110' 6-max Seat #1 is the button
Seat 1: 23defde5 ($6.69 in chips)
Seat 2: Hero ($11.77 in chips)
Seat 3: 13cd5b95 ($2.64 in chips)
Seat 4: f8e9924c ($3.25 in chips)
Seat 5: 1a38999d ($8.88 in chips)
Seat 6: 99def2c7 ($5.27 in chips)
Hero: posts small blind $0.02
13cd5b95: posts big blind $0.05
*** HOLE CARDS ***
Dealt to 23defde5 
Dealt to Hero [5s 3s]
Dealt to 13cd5b95 
Dealt to f8e9924c 
Dealt to 1a38999d 
Dealt to 99def2c7 
f8e9924c: raises $0.05 to $0.1
1a38999d: folds
99def2c7: folds
23defde5: folds
Hero: folds
13cd5b95: folds
Uncalled bet ($0.05) returned to f8e9924c
*** SHOWDOWN ***
f8e9924c collected $0.12 from pot
*** SUMMARY ***
Total pot $0.12 | Rake $0 | Jackpot $0 | Bingo $0 | Fortune $0 | Tax $0
Seat 1: 23defde5 (button) folded before Flop (didn't bet)
Seat 2: Hero (small blind) folded before Flop
Seat 3: 13cd5b95 (big blind) folded before Flop
Seat 4: f8e9924c collected ($0.12)
Seat 5: 1a38999d folded before Flop (didn't bet)
Seat 6: 99def2c7 folded before Flop (didn't bet)


Poker Hand #RC2094730147: Hold'em No Limit ($0.02/$0.05) - 2023/12/27 21:41:02
Table 'RushAndCash3815692' 6-max Seat #1 is the button
Seat 1: 1cd4b990 ($4.31 in chips)
Seat 2: 25122960 ($3.19 in chips)
Seat 3: 9d9f8e48 ($5.08 in chips)
Seat 4: 23defde5 ($7.02 in chips)
Seat 5: Hero ($11.4 in chips)
Seat 6: cbc9fff5 ($10.33 in chips)
25122960: posts small blind $0.02
9d9f8e48: posts big blind $0.05
*** HOLE CARDS ***
Dealt to 1cd4b990 
Dealt to 25122960 
Dealt to 9d9f8e48 
Dealt to 23defde5 
Dealt to Hero [As 5s]
Dealt to cbc9fff5 
23defde5: calls $0.05
Hero: raises $0.05 to $0.1
cbc9fff5: folds
1cd4b990: folds
25122960: folds
9d9f8e48: folds
23defde5: calls $0.05
*** FLOP *** [4s 9s Js]
23defde5: bets $0.09
Hero: raises $0.14 to $0.23
23defde5: calls $0.14
*** TURN *** [4s 9s Js] [5c]
23defde5: checks
Hero: bets $0.55
23defde5: folds
Uncalled bet ($0.55) returned to Hero
*** SHOWDOWN ***
Hero collected $0.7 from pot
*** SUMMARY ***
Total pot $0.73 | Rake $0.03 | Jackpot $0 | Bingo $0 | Fortune $0 | Tax $0
Board [4s 9s Js 5c]
Seat 1: 1cd4b990 (button) folded before Flop (didn't bet)
Seat 2: 25122960 (small blind) folded before Flop
Seat 3: 9d9f8e48 (big blind) folded before Flop
Seat 4: 23defde5 folded on the Turn
Seat 5: Hero won ($0.7)
Seat 6: cbc9fff5 folded before Flop (didn't bet)


Poker Hand #RC2094729233: Hold'em No Limit ($0.02/$0.05) - 2023/12/27 21:40:19
Table 'RushAndCash3815266' 6-max Seat #1 is the button
Seat 1: 4dd9da17 ($7.09 in chips)
Seat 2: 87a8079f ($6.21 in chips)
Seat 3: 25122960 ($2.12 in chips)
Seat 4: Hero ($11.8 in chips)
Seat 5: 1cd4b990 ($5.12 in chips)
Seat 6: 18d5b7d0 ($6.68 in chips)
87a8079f: posts small blind $0.02
25122960: posts big blind $0.05
*** HOLE CARDS ***
Dealt to 4dd9da17 
Dealt to 87a8079f 
Dealt to 25122960 
Dealt to Hero [Ac Kc]
Dealt to 1cd4b990 
Dealt to 18d5b7d0 
Hero: raises $0.05 to $0.1
1cd4b990: raises $0.3 to $0.4
18d5b7d0: folds
4dd9da17: folds
87a8079f: folds
25122960: calls $0.35
Hero: calls $0.3
*** FLOP *** [Qc 7s 2d]
25122960: checks
Hero: checks
1cd4b990: bets $0.41
25122960: raises $1.31 to $1.72 and is all-in
Hero: folds
1cd4b990: folds
Uncalled bet ($1.31) returned to 25122960
*** SHOWDOWN ***
25122960 collected $1.88 from pot
*** SUMMARY ***
Total pot $2.04 | Rake $0.09 | Jackpot $0.07 | Bingo $0 | Fortune $0 | Tax $0
Board [Qc 7s 2d]
Seat 1: 4dd9da17 (button) folded before Flop (didn't bet)
Seat 2: 87a8079f (small blind) folded before Flop
Seat 3: 25122960 (big blind) won ($1.88)
Seat 4: Hero folded on the Flop
Seat 5: 1cd4b990 folded on the Flop
Seat 6: 18d5b7d0 folded before Flop (didn't bet)


Poker Hand #RC2094729104: Hold'em No Limit ($0.02/$0.05) - 2023/12/27 21:40:14
Table 'RushAndCash3815206' 6-max Seat #1 is the button
Seat 1: Hero ($11.8 in chips)
Seat 2: 6d629bd ($12.43 in chips)
Seat 3: d96cb66b ($4.7 in chips)
Seat 4: df1a79c7 ($4.86 in chips)
Seat 5: bba30b7a ($12.26 in chips)
Seat 6: 35bf540a ($4.98 in chips)
6d629bd: posts small blind $0.02
d96cb66b: posts big blind $0.05
*** HOLE CARDS ***
Dealt to Hero [5s 6d]
Dealt to 6d629bd 
Dealt to d96cb66b 
Dealt to df1a79c7 
Dealt to bba30b7a 
Dealt to 35bf540a 
df1a79c7: folds
bba30b7a: folds
35bf540a: folds
Hero: folds
6d629bd: folds
Uncalled bet ($0.03) returned to d96cb66b
*** SHOWDOWN ***
d96cb66b collected $0.04 from pot
*** SUMMARY ***
Total pot $0.04 | Rake $0 | Jackpot $0 | Bingo $0 | Fortune $0 | Tax $0
Seat 1: Hero (button) folded before Flop (didn't bet)
Seat 2: 6d629bd (small blind) folded before Flop
Seat 3: d96cb66b (big blind) collected ($0.04)
Seat 4: df1a79c7 folded before Flop (didn't bet)
Seat 5: bba30b7a folded before Flop (didn't bet)
Seat 6: 35bf540a folded before Flop (didn't bet)


Poker Hand #RC2094728945: Hold'em No Limit ($0.02/$0.05) - 2023/12/27 21:40:06
Table 'RushAndCash3815128' 6-max Seat #1 is the button
Seat 1: 77c268f7 ($5.23 in chips)
Seat 2: ac62ec71 ($6.24 in chips)
Seat 3: Hero ($11.78 in chips)
Seat 4: f0a666fd ($6.44 in chips)
Seat 5: 80cc9272 ($5.56 in chips)
Seat 6: 50421fa7 ($6.33 in chips)
ac62ec71: posts small blind $0.02
Hero: posts big blind $0.05
*** HOLE CARDS ***
Dealt to 77c268f7 
Dealt to ac62ec71 
Dealt to Hero [Ks Qs]
Dealt to f0a666fd 
Dealt to 80cc9272 
Dealt to 50421fa7 
f0a666fd: folds
80cc9272: folds
50421fa7: folds
77c268f7: folds
ac62ec71: folds
Uncalled bet ($0.03) returned to Hero
*** SHOWDOWN ***
Hero collected $0.04 from pot
*** SUMMARY ***
Total pot $0.04 | Rake $0 | Jackpot $0 | Bingo $0 | Fortune $0 | Tax $0
Seat 1: 77c268f7 (button) folded before Flop (didn't bet)
Seat 2: ac62ec71 (small blind) folded before Flop
Seat 3: Hero (big blind) collected ($0.04)
Seat 4: f0a666fd folded before Flop (didn't bet)
Seat 5: 80cc9272 folded before Flop (didn't bet)
Seat 6: 50421fa7 folded before Flop (didn't bet)


Poker Hand #RC2094728812: Hold'em No Limit ($0.02/$0.05) - 2023/12/27 21:40:00
Table 'RushAndCash3815064' 6-max Seat #1 is the button
Seat 1: a40df83 ($5.58 in chips)
Seat 2: Hero ($11.8 in chips)
Seat 3: a500499b ($5.62 in chips)
Seat 4: 705aefdf ($4.25 in chips)
Seat 5: 32f33ae3 ($5.07 in chips)
Seat 6: 97362b19 ($5.79 in chips)
Hero: posts small blind $0.02
a500499b: posts big blind $0.05
*** HOLE CARDS ***
Dealt to a40df83 
Dealt to Hero [6h 9c]
Dealt to a500499b 
Dealt to 705aefdf 
Dealt to 32f33ae3 
Dealt to 97362b19 
705aefdf: folds
32f33ae3: raises $0.08 to $0.13
97362b19: folds
a40df83: folds
Hero: folds
a500499b: folds
Uncalled bet ($0.08) returned to 32f33ae3
*** SHOWDOWN ***
32f33ae3 collected $0.12 from pot
*** SUMMARY ***
Total pot $0.12 | Rake $0 | Jackpot $0 | Bingo $0 | Fortune $0 | Tax $0
Seat 1: a40df83 (button) folded before Flop (didn't bet)
Seat 2: Hero (small blind) folded before Flop
Seat 3: a500499b (big blind) folded before Flop
Seat 4: 705aefdf folded before Flop (didn't bet)
Seat 5: 32f33ae3 collected ($0.12)
Seat 6: 97362b19 folded before Flop (didn't bet)


Poker Hand #RC2094728177: Hold'em No Limit ($0.02/$0.05) - 2023/12/27 21:39:31
Table 'RushAndCash3814767' 6-max Seat #1 is the button
Seat 1: 46a86d2c ($7.57 in chips)
Seat 2: Hero ($11.9 in chips)
Seat 3: ae934d8f ($7.32 in chips)
Seat 4: 708e061e ($4.17 in chips)
Seat 5: 12f62865 ($5.7 in chips)
Seat 6: 1d555d84 ($12.24 in chips)
Hero: posts small blind $0.02
ae934d8f: posts big blind $0.05
*** HOLE CARDS ***
Dealt to 46a86d2c 
Dealt to Hero [6h 7h]
Dealt to ae934d8f 
Dealt to 708e061e 
Dealt to 12f62865 
Dealt to 1d555d84 
708e061e: folds
12f62865: folds
1d555d84: folds
46a86d2c: raises $0.05 to $0.1
Hero: calls $0.08
ae934d8f: calls $0.05
*** FLOP *** [2d Qd 2c]
Hero: checks
ae934d8f: checks
46a86d2c: checks
*** TURN *** [2d Qd 2c] [Kd]
Hero: checks
ae934d8f: bets $0.16
46a86d2c: calls $0.16
Hero: folds
*** RIVER *** [2d Qd 2c Kd] [Ah]
ae934d8f: bets $0.47
46a86d2c: calls $0.47
ae934d8f: shows [As 2h] (Twos Full over Aces)
46a86d2c: shows [Ks Td] (Pair of Kings and Pair of Twos)
*** SHOWDOWN ***
ae934d8f collected $1.42 from pot
*** SUMMARY ***
Total pot $1.56 | Rake $0.07 | Jackpot $0.07 | Bingo $0 | Fortune $0 | Tax $0
Board [2d Qd 2c Kd Ah]
Seat 1: 46a86d2c (button) showed [Ks Td] and lost with Pair of Kings and Pair of Twos
Seat 2: Hero (small blind) folded on the Turn
Seat 3: ae934d8f (big blind) showed [As 2h] and won ($1.42) with Twos Full over Aces
Seat 4: 708e061e folded before Flop (didn't bet)
Seat 5: 12f62865 folded before Flop (didn't bet)
Seat 6: 1d555d84 folded before Flop (didn't bet)


Poker Hand #RC2094726556: Hold'em No Limit ($0.02/$0.05) - 2023/12/27 21:38:14
Table 'RushAndCash3814038' 6-max Seat #1 is the button
Seat 1: 3d24497a ($5.23 in chips)
Seat 2: 42b8649c ($5.02 in chips)
Seat 3: 16a47d43 ($2 in chips)
Seat 4: ed2c1b45 ($5.11 in chips)
Seat 5: Hero ($11.38 in chips)
Seat 6: 8940de41 ($5.02 in chips)
42b8649c: posts small blind $0.02
16a47d43: posts big blind $0.05
*** HOLE CARDS ***
Dealt to 3d24497a 
Dealt to 42b8649c 
Dealt to 16a47d43 
Dealt to ed2c1b45 
Dealt to Hero [6s 6d]
Dealt to 8940de41 
ed2c1b45: raises $0.05 to $0.1
Hero: calls $0.1
8940de41: folds
3d24497a: raises $0.29 to $0.39
42b8649c: folds
16a47d43: folds
ed2c1b45: folds
Hero: calls $0.29
*** FLOP *** [4s Ts Td]
Hero: checks
3d24497a: checks
*** TURN *** [4s Ts Td] [2d]
Hero: checks
3d24497a: checks
*** RIVER *** [4s Ts Td 2d] [9d]
Hero: checks
3d24497a: checks
Hero: shows [6s 6d] (Pair of Tens and Pair of Sixes)
3d24497a: shows [Ac Kh] (Pair of Tens)
*** SHOWDOWN ***
Hero collected $0.91 from pot
*** SUMMARY ***
Total pot $0.95 | Rake $0.04 | Jackpot $0 | Bingo $0 | Fortune $0 | Tax $0
Board [4s Ts Td 2d 9d]
Seat 1: 3d24497a (button) showed [Ac Kh] and lost with Pair of Tens
Seat 2: 42b8649c (small blind) folded before Flop
Seat 3: 16a47d43 (big blind) folded before Flop
Seat 4: ed2c1b45 folded before Flop
Seat 5: Hero showed [6s 6d] and won ($0.91) with Pair of Tens and Pair of Sixes
Seat 6: 8940de41 folded before Flop (didn't bet)


Poker Hand #RC2094726477: Hold'em No Limit ($0.02/$0.05) - 2023/12/27 21:38:11
Table 'RushAndCash3813999' 6-max Seat #1 is the button
Seat 1: 70470d21 ($6.47 in chips)
Seat 2: 2db2e6bd ($5.73 in chips)
Seat 3: f37b44ed ($5.21 in chips)
Seat 4: Hero ($11.31 in chips)
Seat 5: 1f84843f ($7.22 in chips)
Seat 6: 7434f2f7 ($7.84 in chips)
2db2e6bd: posts small blind $0.02
f37b44ed: posts big blind $0.05
*** HOLE CARDS ***
Dealt to 70470d21 
Dealt to 2db2e6bd 
Dealt to f37b44ed 
Dealt to Hero [Jd 9h]
Dealt to 1f84843f 
Dealt to 7434f2f7 
Hero: folds
1f84843f: folds
7434f2f7: folds
70470d21: folds
2db2e6bd: raises $0.1 to $0.15
f37b44ed: folds
Uncalled bet ($0.1) returned to 2db2e6bd
*** SHOWDOWN ***
2db2e6bd collected $0.1 from pot
*** SUMMARY ***
Total pot $0.1 | Rake $0 | Jackpot $0 | Bingo $0 | Fortune $0 | Tax $0
Seat 1: 70470d21 (button) folded before Flop (didn't bet)
Seat 2: 2db2e6bd (small blind) collected ($0.1)
Seat 3: f37b44ed (big blind) folded before Flop
Seat 4: Hero folded before Flop (didn't bet)
Seat 5: 1f84843f folded before Flop (didn't bet)
Seat 6: 7434f2f7 folded before Flop (didn't bet)


Poker Hand #RC2094726314: Hold'em No Limit ($0.02/$0.05) - 2023/12/27 21:38:03
Table 'RushAndCash3813926' 6-max Seat #1 is the button
Seat 1: a3243cd1 ($13.53 in chips)
Seat 2: 24921fc1 ($4.95 in chips)
Seat 3: Hero ($11.36 in chips)
Seat 4: ec57a582 ($5.81 in chips)
Seat 5: 19879f5e ($8.44 in chips)
Seat 6: 78123e35 ($15.69 in chips)
24921fc1: posts small blind $0.02
Hero: posts big blind $0.05
*** HOLE CARDS ***
Dealt to a3243cd1 
Dealt to 24921fc1 
Dealt to Hero [9c Ks]
Dealt to ec57a582 
Dealt to 19879f5e 
Dealt to 78123e35 
ec57a582: folds
19879f5e: folds
78123e35: folds
a3243cd1: folds
24921fc1: folds
Uncalled bet ($0.03) returned to Hero
*** SHOWDOWN ***
Hero collected $0.04 from pot
*** SUMMARY ***
Total pot $0.04 | Rake $0 | Jackpot $0 | Bingo $0 | Fortune $0 | Tax $0
Seat 1: a3243cd1 (button) folded before Flop (didn't bet)
Seat 2: 24921fc1 (small blind) folded before Flop
Seat 3: Hero (big blind) collected ($0.04)
Seat 4: ec57a582 folded before Flop (didn't bet)
Seat 5: 19879f5e folded before Flop (didn't bet)
Seat 6: 78123e35 folded before Flop (didn't bet)


Poker Hand #RC2094725725: Hold'em No Limit ($0.02/$0.05) - 2023/12/27 21:37:35
Table 'RushAndCash3813673' 6-max Seat #1 is the button
Seat 1: Hero ($11.1 in chips)
Seat 2: 589cc4e2 ($15.8 in chips)
Seat 3: 854c4b13 ($14.49 in chips)
Seat 4: a3243cd1 ($13.63 in chips)
Seat 5: ec57a582 ($5.91 in chips)
Seat 6: 39cd590d ($3.19 in chips)
589cc4e2: posts small blind $0.02
854c4b13: posts big blind $0.05
*** HOLE CARDS ***
Dealt to Hero [Tc Td]
Dealt to 589cc4e2 
Dealt to 854c4b13 
Dealt to a3243cd1 
Dealt to ec57a582 
Dealt to 39cd590d 
a3243cd1: raises $0.05 to $0.1
ec57a582: calls $0.1
39cd590d: folds
Hero: raises $0.42 to $0.52
589cc4e2: folds
854c4b13: folds
a3243cd1: folds
ec57a582: folds
Uncalled bet ($0.42) returned to Hero
*** SHOWDOWN ***
Hero collected $0.36 from pot
*** SUMMARY ***
Total pot $0.37 | Rake $0.01 | Jackpot $0 | Bingo $0 | Fortune $0 | Tax $0
Seat 1: Hero (button) collected ($0.36)
Seat 2: 589cc4e2 (small blind) folded before Flop
Seat 3: 854c4b13 (big blind) folded before Flop
Seat 4: a3243cd1 folded before Flop
Seat 5: ec57a582 folded before Flop
Seat 6: 39cd590d folded before Flop (didn't bet)


Poker Hand #RC2094725641: Hold'em No Limit ($0.02/$0.05) - 2023/12/27 21:37:31
Table 'RushAndCash3813633' 6-max Seat #1 is the button
Seat 1: ea2d30d8 ($8.09 in chips)
Seat 2: 3876bd01 ($5.34 in chips)
Seat 3: f18ae513 ($4.64 in chips)
Seat 4: ff1a6043 ($5.28 in chips)
Seat 5: c9c1cb01 ($16.08 in chips)
Seat 6: Hero ($11.1 in chips)
3876bd01: posts small blind $0.02
f18ae513: posts big blind $0.05
*** HOLE CARDS ***
Dealt to ea2d30d8 
Dealt to 3876bd01 
Dealt to f18ae513 
Dealt to ff1a6043 
Dealt to c9c1cb01 
Dealt to Hero [5d Js]
ff1a6043: folds
c9c1cb01: folds
Hero: folds
ea2d30d8: folds
3876bd01: folds
Uncalled bet ($0.03) returned to f18ae513
*** SHOWDOWN ***
f18ae513 collected $0.04 from pot
*** SUMMARY ***
Total pot $0.04 | Rake $0 | Jackpot $0 | Bingo $0 | Fortune $0 | Tax $0
Seat 1: ea2d30d8 (button) folded before Flop (didn't bet)
Seat 2: 3876bd01 (small blind) folded before Flop
Seat 3: f18ae513 (big blind) collected ($0.04)
Seat 4: ff1a6043 folded before Flop (didn't bet)
Seat 5: c9c1cb01 folded before Flop (didn't bet)
Seat 6: Hero folded before Flop (didn't bet)


Poker Hand #RC2094725563: Hold'em No Limit ($0.02/$0.05) - 2023/12/27 21:37:27
Table 'RushAndCash3813599' 6-max Seat #1 is the button
Seat 1: 283529b2 ($4.96 in chips)
Seat 2: cf682d39 ($5.61 in chips)
Seat 3: 9d9f8e48 ($5 in chips)
Seat 4: 59488c7e ($5.66 in chips)
Seat 5: 1c22b9b5 ($7.7 in chips)
Seat 6: Hero ($11.1 in chips)
cf682d39: posts small blind $0.02
9d9f8e48: posts big blind $0.05
*** HOLE CARDS ***
Dealt to 283529b2 
Dealt to cf682d39 
Dealt to 9d9f8e48 
Dealt to 59488c7e 
Dealt to 1c22b9b5 
Dealt to Hero [Qd 3s]
59488c7e: folds
1c22b9b5: folds
Hero: folds
283529b2: raises $0.05 to $0.1
cf682d39: folds
9d9f8e48: folds
Uncalled bet ($0.05) returned to 283529b2
*** SHOWDOWN ***
283529b2 collected $0.12 from pot
*** SUMMARY ***
Total pot $0.12 | Rake $0 | Jackpot $0 | Bingo $0 | Fortune $0 | Tax $0
Seat 1: 283529b2 (button) collected ($0.12)
Seat 2: cf682d39 (small blind) folded before Flop
Seat 3: 9d9f8e48 (big blind) folded before Flop
Seat 4: 59488c7e folded before Flop (didn't bet)
Seat 5: 1c22b9b5 folded before Flop (didn't bet)
Seat 6: Hero folded before Flop (didn't bet)


Poker Hand #RC2094725305: Hold'em No Limit ($0.02/$0.05) - 2023/12/27 21:37:16
Table 'RushAndCash3813480' 6-max Seat #1 is the button
Seat 1: 474b1213 ($13.43 in chips)
Seat 2: Hero ($11.05 in chips)
Seat 3: 33c413e5 ($4.85 in chips)
Seat 4: 4e46285c ($17.28 in chips)
Seat 5: b0596725 ($5.34 in chips)
Seat 6: 180a21bc ($5.05 in chips)
Hero: posts small blind $0.02
33c413e5: posts big blind $0.05
*** HOLE CARDS ***
Dealt to 474b1213 
Dealt to Hero [Th 2h]
Dealt to 33c413e5 
Dealt to 4e46285c 
Dealt to b0596725 
Dealt to 180a21bc 
4e46285c: folds
b0596725: folds
180a21bc: folds
474b1213: folds
Hero: raises $0.1 to $0.15
33c413e5: folds
Uncalled bet ($0.1) returned to Hero
*** SHOWDOWN ***
Hero collected $0.1 from pot
*** SUMMARY ***
Total pot $0.1 | Rake $0 | Jackpot $0 | Bingo $0 | Fortune $0 | Tax $0
Seat 1: 474b1213 (button) folded before Flop (didn't bet)
Seat 2: Hero (small blind) collected ($0.1)
Seat 3: 33c413e5 (big blind) folded before Flop
Seat 4: 4e46285c folded before Flop (didn't bet)
Seat 5: b0596725 folded before Flop (didn't bet)
Seat 6: 180a21bc folded before Flop (didn't bet)


Poker Hand #RC2094725227: Hold'em No Limit ($0.02/$0.05) - 2023/12/27 21:37:12
Table 'RushAndCash3813444' 6-max Seat #1 is the button
Seat 1: 583bb1f8 ($1.24 in chips)
Seat 2: 7d04edfb ($7.62 in chips)
Seat 3: 6265c52d ($5 in chips)
Seat 4: Hero ($11.05 in chips)
Seat 5: ac62ec71 ($5.55 in chips)
Seat 6: 319f4f42 ($5 in chips)
7d04edfb: posts small blind $0.02
6265c52d: posts big blind $0.05
*** HOLE CARDS ***
Dealt to 583bb1f8 
Dealt to 7d04edfb 
Dealt to 6265c52d 
Dealt to Hero [9c 7s]
Dealt to ac62ec71 
Dealt to 319f4f42 
Hero: folds
ac62ec71: folds
319f4f42: raises $0.06 to $0.11
583bb1f8: folds
7d04edfb: raises $0.35 to $0.46
6265c52d: folds
319f4f42: calls $0.35
*** FLOP *** [8c Qs 4s]
7d04edfb: bets $0.3
319f4f42: calls $0.3
*** TURN *** [8c Qs 4s] [6c]
7d04edfb: bets $0.85
319f4f42: folds
Uncalled bet ($0.85) returned to 7d04edfb
*** SHOWDOWN ***
7d04edfb collected $1.43 from pot
*** SUMMARY ***
Total pot $1.57 | Rake $0.07 | Jackpot $0.07 | Bingo $0 | Fortune $0 | Tax $0
Board [8c Qs 4s 6c]
Seat 1: 583bb1f8 (button) folded before Flop (didn't bet)
Seat 2: 7d04edfb (small blind) won ($1.43)
Seat 3: 6265c52d (big blind) folded before Flop
Seat 4: Hero folded before Flop (didn't bet)
Seat 5: ac62ec71 folded before Flop (didn't bet)
Seat 6: 319f4f42 folded on the Turn


Poker Hand #RC2094725147: Hold'em No Limit ($0.02/$0.05) - 2023/12/27 21:37:09
Table 'RushAndCash3813409' 6-max Seat #1 is the button
Seat 1: c07b5111 ($13.65 in chips)
Seat 2: 680931b5 ($7.46 in chips)
Seat 3: 80bc4dbd ($7.21 in chips)
Seat 4: d7b73e59 ($11.15 in chips)
Seat 5: 78dd4e29 ($8.48 in chips)
Seat 6: Hero ($11.05 in chips)
680931b5: posts small blind $0.02
80bc4dbd: posts big blind $0.05
*** HOLE CARDS ***
Dealt to c07b5111 
Dealt to 680931b5 
Dealt to 80bc4dbd 
Dealt to d7b73e59 
Dealt to 78dd4e29 
Dealt to Hero [3h 6d]
d7b73e59: folds
78dd4e29: folds
Hero: folds
c07b5111: raises $0.07 to $0.12
680931b5: calls $0.1
80bc4dbd: folds
*** FLOP *** [2c Ts 9d]
680931b5: checks
c07b5111: bets $0.22
680931b5: folds
Uncalled bet ($0.22) returned to c07b5111
*** SHOWDOWN ***
c07b5111 collected $0.28 from pot
*** SUMMARY ***
Total pot $0.29 | Rake $0.01 | Jackpot $0 | Bingo $0 | Fortune $0 | Tax $0
Board [2c Ts 9d]
Seat 1: c07b5111 (button) won ($0.28)
Seat 2: 680931b5 (small blind) folded on the Flop
Seat 3: 80bc4dbd (big blind) folded before Flop
Seat 4: d7b73e59 folded before Flop (didn't bet)
Seat 5: 78dd4e29 folded before Flop (didn't bet)
Seat 6: Hero folded before Flop (didn't bet)


Poker Hand #RC2094725065: Hold'em No Limit ($0.02/$0.05) - 2023/12/27 21:37:05
Table 'RushAndCash3813371' 6-max Seat #1 is the button
Seat 1: d1e05b05 ($4.53 in chips)
Seat 2: 9815c904 ($4.54 in chips)
Seat 3: a4c223ac ($4.04 in chips)
Seat 4: Hero ($11.05 in chips)
Seat 5: a4c3f119 ($8.46 in chips)
Seat 6: aec6acc ($5.15 in chips)
9815c904: posts small blind $0.02
a4c223ac: posts big blind $0.05
*** HOLE CARDS ***
Dealt to d1e05b05 
Dealt to 9815c904 
Dealt to a4c223ac 
Dealt to Hero [2h Td]
Dealt to a4c3f119 
Dealt to aec6acc 
Hero: folds
a4c3f119: folds
aec6acc: folds
d1e05b05: folds
9815c904: folds
Uncalled bet ($0.03) returned to a4c223ac
*** SHOWDOWN ***
a4c223ac collected $0.04 from pot
*** SUMMARY ***
Total pot $0.04 | Rake $0 | Jackpot $0 | Bingo $0 | Fortune $0 | Tax $0
Seat 1: d1e05b05 (button) folded before Flop (didn't bet)
Seat 2: 9815c904 (small blind) folded before Flop
Seat 3: a4c223ac (big blind) collected ($0.04)
Seat 4: Hero folded before Flop (didn't bet)
Seat 5: a4c3f119 folded before Flop (didn't bet)
Seat 6: aec6acc folded before Flop (didn't bet)


Poker Hand #RC2094724968: Hold'em No Limit ($0.02/$0.05) - 2023/12/27 21:37:01
Table 'RushAndCash3813324' 6-max Seat #1 is the button
Seat 1: Hero ($11.05 in chips)
Seat 2: ff503359 ($5.96 in chips)
Seat 3: d72c034d ($5 in chips)
Seat 4: 3b59ca4e ($4.72 in chips)
Seat 5: cca43bec ($5.42 in chips)
Seat 6: 66b6d542 ($5 in chips)
ff503359: posts small blind $0.02
d72c034d: posts big blind $0.05
*** HOLE CARDS ***
Dealt to Hero [3h As]
Dealt to ff503359 
Dealt to d72c034d 
Dealt to 3b59ca4e 
Dealt to cca43bec 
Dealt to 66b6d542 
3b59ca4e: folds
cca43bec: folds
66b6d542: folds
Hero: folds
ff503359: raises $0.1 to $0.15
d72c034d: calls $0.1
*** FLOP *** [Qc 3d 6c]
ff503359: checks
d72c034d: checks
*** TURN *** [Qc 3d 6c] [Ts]
ff503359: checks
d72c034d: bets $0.16
ff503359: calls $0.16
*** RIVER *** [Qc 3d 6c Ts] [Js]
ff503359: checks
d72c034d: bets $0.52
ff503359: folds
Uncalled bet ($0.52) returned to d72c034d
*** SHOWDOWN ***
d72c034d collected $0.59 from pot
*** SUMMARY ***
Total pot $0.62 | Rake $0.03 | Jackpot $0 | Bingo $0 | Fortune $0 | Tax $0
Board [Qc 3d 6c Ts Js]
Seat 1: Hero (button) folded before Flop (didn't bet)
Seat 2: ff503359 (small blind) folded on the River
Seat 3: d72c034d (big blind) won ($0.59)
Seat 4: 3b59ca4e folded before Flop (didn't bet)
Seat 5: cca43bec folded before Flop (didn't bet)
Seat 6: 66b6d542 folded before Flop (didn't bet)


Poker Hand #RC2094724751: Hold'em No Limit ($0.02/$0.05) - 2023/12/27 21:36:50
Table 'RushAndCash3813225' 6-max Seat #1 is the button
Seat 1: 6a53bfa7 ($5 in chips)
Seat 2: b19b0d12 ($9.59 in chips)
Seat 3: Hero ($11.03 in chips)
Seat 4: dc8f15a1 ($6.1 in chips)
Seat 5: 8a3d13e8 ($6.26 in chips)
Seat 6: 3d951ecb ($12.71 in chips)
b19b0d12: posts small blind $0.02
Hero: posts big blind $0.05
*** HOLE CARDS ***
Dealt to 6a53bfa7 
Dealt to b19b0d12 
Dealt to Hero [Ac 7s]
Dealt to dc8f15a1 
Dealt to 8a3d13e8 
Dealt to 3d951ecb 
dc8f15a1: folds
8a3d13e8: folds
3d951ecb: folds
6a53bfa7: folds
b19b0d12: folds
Uncalled bet ($0.03) returned to Hero
*** SHOWDOWN ***
Hero collected $0.04 from pot
*** SUMMARY ***
Total pot $0.04 | Rake $0 | Jackpot $0 | Bingo $0 | Fortune $0 | Tax $0
Seat 1: 6a53bfa7 (button) folded before Flop (didn't bet)
Seat 2: b19b0d12 (small blind) folded before Flop
Seat 3: Hero (big blind) collected ($0.04)
Seat 4: dc8f15a1 folded before Flop (didn't bet)
Seat 5: 8a3d13e8 folded before Flop (didn't bet)
Seat 6: 3d951ecb folded before Flop (didn't bet)


Poker Hand #RC2094713952: Hold'em No Limit ($0.02/$0.05) - 2023/12/27 21:36:12
Table 'RushAndCash3812859' 6-max Seat #1 is the button
Seat 1: f90b803e ($5.07 in chips)
Seat 2: 934d578e ($2.19 in chips)
Seat 3: 869cd4a ($5 in chips)
Seat 4: b7d18ab0 ($8.22 in chips)
Seat 5: 3d951ecb ($12.25 in chips)
Seat 6: Hero ($11.46 in chips)
934d578e: posts small blind $0.02
869cd4a: posts big blind $0.05
*** HOLE CARDS ***
Dealt to f90b803e 
Dealt to 934d578e 
Dealt to 869cd4a 
Dealt to b7d18ab0 
Dealt to 3d951ecb 
Dealt to Hero [9d 8d]
b7d18ab0: folds
3d951ecb: raises $0.1 to $0.15
Hero: calls $0.15
f90b803e: folds
934d578e: folds
869cd4a: folds
*** FLOP *** [Js 3d 6h]
3d951ecb: checks
Hero: checks
*** TURN *** [Js 3d 6h] [9s]
3d951ecb: bets $0.28
Hero: calls $0.28
*** RIVER *** [Js 3d 6h 9s] [Kh]
3d951ecb: bets $0.47
Hero: folds
Uncalled bet ($0.47) returned to 3d951ecb
*** SHOWDOWN ***
3d951ecb collected $0.89 from pot
*** SUMMARY ***
Total pot $0.93 | Rake $0.04 | Jackpot $0 | Bingo $0 | Fortune $0 | Tax $0
Board [Js 3d 6h 9s Kh]
Seat 1: f90b803e (button) folded before Flop (didn't bet)
Seat 2: 934d578e (small blind) folded before Flop
Seat 3: 869cd4a (big blind) folded before Flop
Seat 4: b7d18ab0 folded before Flop (didn't bet)
Seat 5: 3d951ecb won ($0.89)
Seat 6: Hero folded on the River


Poker Hand #RC2094713878: Hold'em No Limit ($0.02/$0.05) - 2023/12/27 21:36:09
Table 'RushAndCash3812827' 6-max Seat #1 is the button
Seat 1: 51c7aec9 ($5.62 in chips)
Seat 2: Hero ($11.48 in chips)
Seat 3: 7ac4c2d5 ($5 in chips)
Seat 4: f9527640 ($6.53 in chips)
Seat 5: 7be8413b ($5.07 in chips)
Seat 6: 34e95ed ($14.86 in chips)
Hero: posts small blind $0.02
7ac4c2d5: posts big blind $0.05
*** HOLE CARDS ***
Dealt to 51c7aec9 
Dealt to Hero [6c 2c]
Dealt to 7ac4c2d5 
Dealt to f9527640 
Dealt to 7be8413b 
Dealt to 34e95ed 
f9527640: folds
7be8413b: raises $0.05 to $0.1
34e95ed: raises $0.27 to $0.37
51c7aec9: folds
Hero: folds
7ac4c2d5: folds
7be8413b: calls $0.27
*** FLOP *** [2s Ad 8h]
7be8413b: checks
34e95ed: bets $0.43
7be8413b: folds
Uncalled bet ($0.43) returned to 34e95ed
*** SHOWDOWN ***
34e95ed collected $0.77 from pot
*** SUMMARY ***
Total pot $0.81 | Rake $0.04 | Jackpot $0 | Bingo $0 | Fortune $0 | Tax $0
Board [2s Ad 8h]
Seat 1: 51c7aec9 (button) folded before Flop (didn't bet)
Seat 2: Hero (small blind) folded before Flop
Seat 3: 7ac4c2d5 (big blind) folded before Flop
Seat 4: f9527640 folded before Flop (didn't bet)
Seat 5: 7be8413b folded on the Flop
Seat 6: 34e95ed won ($0.77)


Poker Hand #RC2094713796: Hold'em No Limit ($0.02/$0.05) - 2023/12/27 21:36:05
Table 'RushAndCash3812792' 6-max Seat #1 is the button
Seat 1: b19b0d12 ($9.72 in chips)
Seat 2: 7d92d461 ($5.53 in chips)
Seat 3: 6e63b45 ($5.13 in chips)
Seat 4: 1ea3c784 ($10.87 in chips)
Seat 5: f9527640 ($6.53 in chips)
Seat 6: Hero ($11.48 in chips)
7d92d461: posts small blind $0.02
6e63b45: posts big blind $0.05
*** HOLE CARDS ***
Dealt to b19b0d12 
Dealt to 7d92d461 
Dealt to 6e63b45 
Dealt to 1ea3c784 
Dealt to f9527640 
Dealt to Hero [Ts 7h]
1ea3c784: raises $0.06 to $0.11
f9527640: folds
Hero: folds
b19b0d12: folds
7d92d461: folds
6e63b45: folds
Uncalled bet ($0.06) returned to 1ea3c784
*** SHOWDOWN ***
1ea3c784 collected $0.12 from pot
*** SUMMARY ***
Total pot $0.12 | Rake $0 | Jackpot $0 | Bingo $0 | Fortune $0 | Tax $0
Seat 1: b19b0d12 (button) folded before Flop (didn't bet)
Seat 2: 7d92d461 (small blind) folded before Flop
Seat 3: 6e63b45 (big blind) folded before Flop
Seat 4: 1ea3c784 collected ($0.12)
Seat 5: f9527640 folded before Flop (didn't bet)
Seat 6: Hero folded before Flop (didn't bet)


Poker Hand #RC2094713700: Hold'em No Limit ($0.02/$0.05) - 2023/12/27 21:36:01
Table 'RushAndCash3812752' 6-max Seat #1 is the button
Seat 1: Hero ($11.48 in chips)
Seat 2: 7b62c427 ($5.29 in chips)
Seat 3: b83090f2 ($9.5 in chips)
Seat 4: 79a53f37 ($11.66 in chips)
Seat 5: b8919ecb ($14.23 in chips)
Seat 6: ab59cb2 ($5.66 in chips)
7b62c427: posts small blind $0.02
b83090f2: posts big blind $0.05
*** HOLE CARDS ***
Dealt to Hero [7d Ts]
Dealt to 7b62c427 
Dealt to b83090f2 
Dealt to 79a53f37 
Dealt to b8919ecb 
Dealt to ab59cb2 
79a53f37: folds
b8919ecb: folds
ab59cb2: folds
Hero: folds
7b62c427: raises $0.1 to $0.15
b83090f2: calls $0.1
*** FLOP *** [4c Jh 4d]
7b62c427: bets $0.15
b83090f2: folds
Uncalled bet ($0.15) returned to 7b62c427
*** SHOWDOWN ***
7b62c427 collected $0.29 from pot
*** SUMMARY ***
Total pot $0.3 | Rake $0.01 | Jackpot $0 | Bingo $0 | Fortune $0 | Tax $0
Board [4c Jh 4d]
Seat 1: Hero (button) folded before Flop (didn't bet)
Seat 2: 7b62c427 (small blind) won ($0.29)
Seat 3: b83090f2 (big blind) folded on the Flop
Seat 4: 79a53f37 folded before Flop (didn't bet)
Seat 5: b8919ecb folded before Flop (didn't bet)
Seat 6: ab59cb2 folded before Flop (didn't bet)


Poker Hand #RC2094712762: Hold'em No Limit ($0.02/$0.05) - 2023/12/27 21:35:16
Table 'RushAndCash3812336' 6-max Seat #1 is the button
Seat 1: fb14c819 ($5 in chips)
Seat 2: 53085a55 ($5 in chips)
Seat 3: 358d5b9e ($12.26 in chips)
Seat 4: 85ea6071 ($5 in chips)
Seat 5: Hero ($11.77 in chips)
Seat 6: 79a53f37 ($11.33 in chips)
53085a55: posts small blind $0.02
358d5b9e: posts big blind $0.05
*** HOLE CARDS ***
Dealt to fb14c819 
Dealt to 53085a55 
Dealt to 358d5b9e 
Dealt to 85ea6071 
Dealt to Hero [5d 4d]
Dealt to 79a53f37 
85ea6071: folds
Hero: raises $0.05 to $0.1
79a53f37: raises $0.19 to $0.29
fb14c819: folds
53085a55: folds
358d5b9e: folds
Hero: calls $0.19
*** FLOP *** [Ac 2c 6s]
Hero: checks
79a53f37: bets $0.3
Hero: folds
Uncalled bet ($0.3) returned to 79a53f37
*** SHOWDOWN ***
79a53f37 collected $0.62 from pot
*** SUMMARY ***
Total pot $0.65 | Rake $0.03 | Jackpot $0 | Bingo $0 | Fortune $0 | Tax $0
Board [Ac 2c 6s]
Seat 1: fb14c819 (button) folded before Flop (didn't bet)
Seat 2: 53085a55 (small blind) folded before Flop
Seat 3: 358d5b9e (big blind) folded before Flop
Seat 4: 85ea6071 folded before Flop (didn't bet)
Seat 5: Hero folded on the Flop
Seat 6: 79a53f37 won ($0.62)


Poker Hand #RC2094712363: Hold'em No Limit ($0.02/$0.05) - 2023/12/27 21:34:57
Table 'RushAndCash3812169' 6-max Seat #1 is the button
Seat 1: 99def2c7 ($5 in chips)
Seat 2: Hero ($11.79 in chips)
Seat 3: 4c5efad8 ($6.83 in chips)
Seat 4: 43d76951 ($2.66 in chips)
Seat 5: 1f6a6de6 ($5.66 in chips)
Seat 6: c27eeda6 ($2.3 in chips)
Hero: posts small blind $0.02
4c5efad8: posts big blind $0.05
*** HOLE CARDS ***
Dealt to 99def2c7 
Dealt to Hero [Jh 8h]
Dealt to 4c5efad8 
Dealt to 43d76951 
Dealt to 1f6a6de6 
Dealt to c27eeda6 
43d76951: calls $0.05
1f6a6de6: folds
c27eeda6: calls $0.05
99def2c7: folds
Hero: folds
4c5efad8: checks
*** FLOP *** [3d 6d Qh]
4c5efad8: checks
43d76951: checks
c27eeda6: bets $0.17
4c5efad8: folds
43d76951: calls $0.17
*** TURN *** [3d 6d Qh] [Ks]
43d76951: checks
c27eeda6: checks
*** RIVER *** [3d 6d Qh Ks] [Qd]
43d76951: checks
c27eeda6: bets $2.08 and is all-in
43d76951: folds
Uncalled bet ($2.08) returned to c27eeda6
*** SHOWDOWN ***
c27eeda6 collected $0.49 from pot
*** SUMMARY ***
Total pot $0.51 | Rake $0.02 | Jackpot $0 | Bingo $0 | Fortune $0 | Tax $0
Board [3d 6d Qh Ks Qd]
Seat 1: 99def2c7 (button) folded before Flop (didn't bet)
Seat 2: Hero (small blind) folded before Flop
Seat 3: 4c5efad8 (big blind) folded on the Flop
Seat 4: 43d76951 folded on the River
Seat 5: 1f6a6de6 folded before Flop (didn't bet)
Seat 6: c27eeda6 won ($0.49)


Poker Hand #RC2094712161: Hold'em No Limit ($0.02/$0.05) - 2023/12/27 21:34:48
Table 'RushAndCash3812081' 6-max Seat #1 is the button
Seat 1: caff888b ($3.72 in chips)
Seat 2: bb25585d ($13.61 in chips)
Seat 3: Hero ($11.77 in chips)
Seat 4: 207a873 ($5 in chips)
Seat 5: 490aca78 ($3.53 in chips)
Seat 6: 5d52972e ($5.07 in chips)
bb25585d: posts small blind $0.02
Hero: posts big blind $0.05
*** HOLE CARDS ***
Dealt to caff888b 
Dealt to bb25585d 
Dealt to Hero [3s Td]
Dealt to 207a873 
Dealt to 490aca78 
Dealt to 5d52972e 
207a873: raises $0.05 to $0.1
490aca78: folds
5d52972e: folds
caff888b: folds
bb25585d: folds
Hero: folds
Uncalled bet ($0.05) returned to 207a873
*** SHOWDOWN ***
207a873 collected $0.12 from pot
*** SUMMARY ***
Total pot $0.12 | Rake $0 | Jackpot $0 | Bingo $0 | Fortune $0 | Tax $0
Seat 1: caff888b (button) folded before Flop (didn't bet)
Seat 2: bb25585d (small blind) folded before Flop
Seat 3: Hero (big blind) folded before Flop
Seat 4: 207a873 collected ($0.12)
Seat 5: 490aca78 folded before Flop (didn't bet)
Seat 6: 5d52972e folded before Flop (didn't bet)


Poker Hand #RC2094712086: Hold'em No Limit ($0.02/$0.05) - 2023/12/27 21:34:44
Table 'RushAndCash3812049' 6-max Seat #1 is the button
Seat 1: 38fc381d ($4.81 in chips)
Seat 2: 8ba492cd ($6.18 in chips)
Seat 3: Hero ($11.82 in chips)
Seat 4: 94497711 ($5 in chips)
Seat 5: 53085a55 ($5.03 in chips)
Seat 6: d3c4c18f ($7.8 in chips)
8ba492cd: posts small blind $0.02
Hero: posts big blind $0.05
*** HOLE CARDS ***
Dealt to 38fc381d 
Dealt to 8ba492cd 
Dealt to Hero [Qc Jh]
Dealt to 94497711 
Dealt to 53085a55 
Dealt to d3c4c18f 
94497711: folds
53085a55: folds
d3c4c18f: folds
38fc381d: folds
8ba492cd: folds
Uncalled bet ($0.03) returned to Hero
*** SHOWDOWN ***
Hero collected $0.04 from pot
*** SUMMARY ***
Total pot $0.04 | Rake $0 | Jackpot $0 | Bingo $0 | Fortune $0 | Tax $0
Seat 1: 38fc381d (button) folded before Flop (didn't bet)
Seat 2: 8ba492cd (small blind) folded before Flop
Seat 3: Hero (big blind) collected ($0.04)
Seat 4: 94497711 folded before Flop (didn't bet)
Seat 5: 53085a55 folded before Flop (didn't bet)
Seat 6: d3c4c18f folded before Flop (didn't bet)


Poker Hand #RC2094712008: Hold'em No Limit ($0.02/$0.05) - 2023/12/27 21:34:40
Table 'RushAndCash3812018' 6-max Seat #1 is the button
Seat 1: 705aefdf ($4.65 in chips)
Seat 2: 4a471529 ($8.37 in chips)
Seat 3: d29a0c0f ($8.19 in chips)
Seat 4: 7865c4a1 ($4.52 in chips)
Seat 5: Hero ($11.82 in chips)
Seat 6: 4b0ffa02 ($5 in chips)
4a471529: posts small blind $0.02
d29a0c0f: posts big blind $0.05
*** HOLE CARDS ***
Dealt to 705aefdf 
Dealt to 4a471529 
Dealt to d29a0c0f 
Dealt to 7865c4a1 
Dealt to Hero [3c 8s]
Dealt to 4b0ffa02 
7865c4a1: raises $0.1 to $0.15
Hero: folds
4b0ffa02: folds
705aefdf: folds
4a471529: folds
d29a0c0f: folds
Uncalled bet ($0.1) returned to 7865c4a1
*** SHOWDOWN ***
7865c4a1 collected $0.12 from pot
*** SUMMARY ***
Total pot $0.12 | Rake $0 | Jackpot $0 | Bingo $0 | Fortune $0 | Tax $0
Seat 1: 705aefdf (button) folded before Flop (didn't bet)
Seat 2: 4a471529 (small blind) folded before Flop
Seat 3: d29a0c0f (big blind) folded before Flop
Seat 4: 7865c4a1 collected ($0.12)
Seat 5: Hero folded before Flop (didn't bet)
Seat 6: 4b0ffa02 folded before Flop (didn't bet)


Poker Hand #RC2094711930: Hold'em No Limit ($0.02/$0.05) - 2023/12/27 21:34:36
Table 'RushAndCash3811984' 6-max Seat #1 is the button
Seat 1: 9d9e913 ($4.66 in chips)
Seat 2: 7b06a8e2 ($3.44 in chips)
Seat 3: 57a8d6e1 ($5.05 in chips)
Seat 4: 4a471529 ($8.37 in chips)
Seat 5: 186e4d79 ($10 in chips)
Seat 6: Hero ($11.82 in chips)
7b06a8e2: posts small blind $0.02
57a8d6e1: posts big blind $0.05
*** HOLE CARDS ***
Dealt to 9d9e913 
Dealt to 7b06a8e2 
Dealt to 57a8d6e1 
Dealt to 4a471529 
Dealt to 186e4d79 
Dealt to Hero [6c 3s]
4a471529: folds
186e4d79: raises $0.05 to $0.1
Hero: folds
9d9e913: raises $0.14 to $0.24
7b06a8e2: raises $0.21 to $0.45
57a8d6e1: folds
186e4d79: calls $0.35
9d9e913: calls $0.21
*** FLOP *** [9d Ts 4d]
7b06a8e2: bets $2.99 and is all-in
186e4d79: folds
9d9e913: calls $2.99
7b06a8e2: shows [Tc Kc] (Pair of Tens)
9d9e913: shows [Ac 9c] (Pair of Nines)
*** TURN *** [9d Ts 4d] [6d]
*** RIVER *** [9d Ts 4d 6d] [2d]
*** SHOWDOWN ***
7b06a8e2 collected $7.16 from pot
*** SUMMARY ***
Total pot $7.38 | Rake $0.15 | Jackpot $0.07 | Bingo $0 | Fortune $0 | Tax $0
Board [9d Ts 4d 6d 2d]
Seat 1: 9d9e913 (button) showed [Ac 9c] and lost with Pair of Nines
Seat 2: 7b06a8e2 (small blind) showed [Tc Kc] and won ($7.16) with Pair of Tens
Seat 3: 57a8d6e1 (big blind) folded before Flop
Seat 4: 4a471529 folded before Flop (didn't bet)
Seat 5: 186e4d79 folded on the Flop
Seat 6: Hero folded before Flop (didn't bet)


Poker Hand #RC2094711857: Hold'em No Limit ($0.02/$0.05) - 2023/12/27 21:34:33
Table 'RushAndCash3811951' 6-max Seat #1 is the button
Seat 1: 981110b3 ($15.61 in chips)
Seat 2: 2c57e2a1 ($5.1 in chips)
Seat 3: 80c5c386 ($2.07 in chips)
Seat 4: 3f069be6 ($5.34 in chips)
Seat 5: Hero ($11.82 in chips)
Seat 6: 96f5939b ($4.37 in chips)
2c57e2a1: posts small blind $0.02
80c5c386: posts big blind $0.05
*** HOLE CARDS ***
Dealt to 981110b3 
Dealt to 2c57e2a1 
Dealt to 80c5c386 
Dealt to 3f069be6 
Dealt to Hero [8h 5c]
Dealt to 96f5939b 
3f069be6: folds
Hero: folds
96f5939b: folds
981110b3: folds
2c57e2a1: calls $0.03
80c5c386: raises $0.07 to $0.12
2c57e2a1: calls $0.07
*** FLOP *** [4h Ac 4s]
2c57e2a1: checks
80c5c386: bets $0.08
2c57e2a1: folds
Uncalled bet ($0.08) returned to 80c5c386
*** SHOWDOWN ***
80c5c386 collected $0.23 from pot
*** SUMMARY ***
Total pot $0.24 | Rake $0.01 | Jackpot $0 | Bingo $0 | Fortune $0 | Tax $0
Board [4h Ac 4s]
Seat 1: 981110b3 (button) folded before Flop (didn't bet)
Seat 2: 2c57e2a1 (small blind) folded on the Flop
Seat 3: 80c5c386 (big blind) won ($0.23)
Seat 4: 3f069be6 folded before Flop (didn't bet)
Seat 5: Hero folded before Flop (didn't bet)
Seat 6: 96f5939b folded before Flop (didn't bet)


Poker Hand #RC2094711776: Hold'em No Limit ($0.02/$0.05) - 2023/12/27 21:34:29
Table 'RushAndCash3811914' 6-max Seat #1 is the button
Seat 1: Hero ($11.82 in chips)
Seat 2: 151aa935 ($5 in chips)
Seat 3: f37b44ed ($5.18 in chips)
Seat 4: 3f069be6 ($5.34 in chips)
Seat 5: 5e254867 ($8.29 in chips)
Seat 6: 24d191e2 ($3.24 in chips)
151aa935: posts small blind $0.02
f37b44ed: posts big blind $0.05
*** HOLE CARDS ***
Dealt to Hero [3s Jd]
Dealt to 151aa935 
Dealt to f37b44ed 
Dealt to 3f069be6 
Dealt to 5e254867 
Dealt to 24d191e2 
3f069be6: folds
5e254867: raises $0.08 to $0.13
24d191e2: folds
Hero: folds
151aa935: folds
f37b44ed: calls $0.08
*** FLOP *** [Ah 3d Qd]
f37b44ed: checks
5e254867: bets $0.1
f37b44ed: calls $0.1
*** TURN *** [Ah 3d Qd] [Tc]
f37b44ed: checks
5e254867: bets $0.32
f37b44ed: folds
Uncalled bet ($0.32) returned to 5e254867
*** SHOWDOWN ***
5e254867 collected $0.46 from pot
*** SUMMARY ***
Total pot $0.48 | Rake $0.02 | Jackpot $0 | Bingo $0 | Fortune $0 | Tax $0
Board [Ah 3d Qd Tc]
Seat 1: Hero (button) folded before Flop (didn't bet)
Seat 2: 151aa935 (small blind) folded before Flop
Seat 3: f37b44ed (big blind) folded on the Turn
Seat 4: 3f069be6 folded before Flop (didn't bet)
Seat 5: 5e254867 won ($0.46)
Seat 6: 24d191e2 folded before Flop (didn't bet)


Poker Hand #RC2094711704: Hold'em No Limit ($0.02/$0.05) - 2023/12/27 21:34:25
Table 'RushAndCash3811881' 6-max Seat #1 is the button
Seat 1: 956ca50b ($3.44 in chips)
Seat 2: aab4cc64 ($2.38 in chips)
Seat 3: 3528bf25 ($11 in chips)
Seat 4: 4e46285c ($17.47 in chips)
Seat 5: Hero ($11.82 in chips)
Seat 6: 32f33ae3 ($7.89 in chips)
aab4cc64: posts small blind $0.02
3528bf25: posts big blind $0.05
*** HOLE CARDS ***
Dealt to 956ca50b 
Dealt to aab4cc64 
Dealt to 3528bf25 
Dealt to 4e46285c 
Dealt to Hero [Td 8c]
Dealt to 32f33ae3 
4e46285c: folds
Hero: folds
32f33ae3: folds
956ca50b: folds
aab4cc64: folds
Uncalled bet ($0.03) returned to 3528bf25
*** SHOWDOWN ***
3528bf25 collected $0.04 from pot
*** SUMMARY ***
Total pot $0.04 | Rake $0 | Jackpot $0 | Bingo $0 | Fortune $0 | Tax $0
Seat 1: 956ca50b (button) folded before Flop (didn't bet)
Seat 2: aab4cc64 (small blind) folded before Flop
Seat 3: 3528bf25 (big blind) collected ($0.04)
Seat 4: 4e46285c folded before Flop (didn't bet)
Seat 5: Hero folded before Flop (didn't bet)
Seat 6: 32f33ae3 folded before Flop (didn't bet)


Poker Hand #RC2094711463: Hold'em No Limit ($0.02/$0.05) - 2023/12/27 21:34:15
Table 'RushAndCash3811772' 6-max Seat #1 is the button
Seat 1: b6c5c6d ($5 in chips)
Seat 2: 24d191e2 ($3.31 in chips)
Seat 3: Hero ($11.8 in chips)
Seat 4: 3f069be6 ($5.34 in chips)
Seat 5: c28bae97 ($5.26 in chips)
Seat 6: f454dc62 ($5.26 in chips)
24d191e2: posts small blind $0.02
Hero: posts big blind $0.05
*** HOLE CARDS ***
Dealt to b6c5c6d 
Dealt to 24d191e2 
Dealt to Hero [Kc 8s]
Dealt to 3f069be6 
Dealt to c28bae97 
Dealt to f454dc62 
3f069be6: folds
c28bae97: folds
f454dc62: folds
b6c5c6d: folds
24d191e2: folds
Uncalled bet ($0.03) returned to Hero
*** SHOWDOWN ***
Hero collected $0.04 from pot
*** SUMMARY ***
Total pot $0.04 | Rake $0 | Jackpot $0 | Bingo $0 | Fortune $0 | Tax $0
Seat 1: b6c5c6d (button) folded before Flop (didn't bet)
Seat 2: 24d191e2 (small blind) folded before Flop
Seat 3: Hero (big blind) collected ($0.04)
Seat 4: 3f069be6 folded before Flop (didn't bet)
Seat 5: c28bae97 folded before Flop (didn't bet)
Seat 6: f454dc62 folded before Flop (didn't bet)


Poker Hand #RC2094711081: Hold'em No Limit ($0.02/$0.05) - 2023/12/27 21:33:56
Table 'RushAndCash3811605' 6-max Seat #1 is the button
Seat 1: e80fe244 ($9.55 in chips)
Seat 2: c67b85a9 ($15.05 in chips)
Seat 3: 1a55a4ac ($11.13 in chips)
Seat 4: Hero ($11.9 in chips)
Seat 5: 27dfc090 ($12.63 in chips)
Seat 6: 8d8864c6 ($3.66 in chips)
c67b85a9: posts small blind $0.02
1a55a4ac: posts big blind $0.05
*** HOLE CARDS ***
Dealt to e80fe244 
Dealt to c67b85a9 
Dealt to 1a55a4ac 
Dealt to Hero [6c Ac]
Dealt to 27dfc090 
Dealt to 8d8864c6 
Hero: raises $0.05 to $0.1
27dfc090: folds
8d8864c6: folds
e80fe244: folds
c67b85a9: raises $0.46 to $0.56
1a55a4ac: folds
Hero: folds
Uncalled bet ($0.46) returned to c67b85a9
*** SHOWDOWN ***
c67b85a9 collected $0.24 from pot
*** SUMMARY ***
Total pot $0.25 | Rake $0.01 | Jackpot $0 | Bingo $0 | Fortune $0 | Tax $0
Seat 1: e80fe244 (button) folded before Flop (didn't bet)
Seat 2: c67b85a9 (small blind) collected ($0.24)
Seat 3: 1a55a4ac (big blind) folded before Flop
Seat 4: Hero folded before Flop
Seat 5: 27dfc090 folded before Flop (didn't bet)
Seat 6: 8d8864c6 folded before Flop (didn't bet)


Poker Hand #RC2094710762: Hold'em No Limit ($0.02/$0.05) - 2023/12/27 21:33:41
Table 'RushAndCash3811460' 6-max Seat #1 is the button
Seat 1: 52dc12c9 ($5 in chips)
Seat 2: 6b9956d1 ($6.6 in chips)
Seat 3: 151aa935 ($5.11 in chips)
Seat 4: c67b85a9 ($15.15 in chips)
Seat 5: Hero ($11.74 in chips)
Seat 6: b83090f2 ($9.37 in chips)
6b9956d1: posts small blind $0.02
151aa935: posts big blind $0.05
*** HOLE CARDS ***
Dealt to 52dc12c9 
Dealt to 6b9956d1 
Dealt to 151aa935 
Dealt to c67b85a9 
Dealt to Hero [Kd Ks]
Dealt to b83090f2 
c67b85a9: raises $0.05 to $0.1
Hero: raises $0.32 to $0.42
b83090f2: folds
52dc12c9: folds
6b9956d1: folds
151aa935: folds
c67b85a9: folds
Uncalled bet ($0.32) returned to Hero
*** SHOWDOWN ***
Hero collected $0.26 from pot
*** SUMMARY ***
Total pot $0.27 | Rake $0.01 | Jackpot $0 | Bingo $0 | Fortune $0 | Tax $0
Seat 1: 52dc12c9 (button) folded before Flop (didn't bet)
Seat 2: 6b9956d1 (small blind) folded before Flop
Seat 3: 151aa935 (big blind) folded before Flop
Seat 4: c67b85a9 folded before Flop
Seat 5: Hero collected ($0.26)
Seat 6: b83090f2 folded before Flop (didn't bet)


Poker Hand #RC2094710385: Hold'em No Limit ($0.02/$0.05) - 2023/12/27 21:33:22
Table 'RushAndCash3811289' 6-max Seat #1 is the button
Seat 1: 4a0851c ($8.64 in chips)
Seat 2: Hero ($11.76 in chips)
Seat 3: 7865c4a1 ($4.66 in chips)
Seat 4: 88d150e8 ($8.09 in chips)
Seat 5: 9b509514 ($6.19 in chips)
Seat 6: a619e8f7 ($9.54 in chips)
Hero: posts small blind $0.02
7865c4a1: posts big blind $0.05
*** HOLE CARDS ***
Dealt to 4a0851c 
Dealt to Hero [6c 7h]
Dealt to 7865c4a1 
Dealt to 88d150e8 
Dealt to 9b509514 
Dealt to a619e8f7 
88d150e8: folds
9b509514: raises $0.05 to $0.1
a619e8f7: raises $0.25 to $0.35
4a0851c: folds
Hero: folds
7865c4a1: folds
9b509514: raises $0.59 to $0.94
a619e8f7: folds
Uncalled bet ($0.59) returned to 9b509514
*** SHOWDOWN ***
9b509514 collected $0.74 from pot
*** SUMMARY ***
Total pot $0.77 | Rake $0.03 | Jackpot $0 | Bingo $0 | Fortune $0 | Tax $0
Seat 1: 4a0851c (button) folded before Flop (didn't bet)
Seat 2: Hero (small blind) folded before Flop
Seat 3: 7865c4a1 (big blind) folded before Flop
Seat 4: 88d150e8 folded before Flop (didn't bet)
Seat 5: 9b509514 collected ($0.74)
Seat 6: a619e8f7 folded before Flop


Poker Hand #RC2094710255: Hold'em No Limit ($0.02/$0.05) - 2023/12/27 21:33:15
Table 'RushAndCash3811224' 6-max Seat #1 is the button
Seat 1: af6e2ca2 ($1.75 in chips)
Seat 2: 1ea3c784 ($6.55 in chips)
Seat 3: 6715ca7 ($4.74 in chips)
Seat 4: 5fdcf0fd ($4.85 in chips)
Seat 5: Hero ($11.76 in chips)
Seat 6: 3e37faf6 ($5 in chips)
1ea3c784: posts small blind $0.02
6715ca7: posts big blind $0.05
*** HOLE CARDS ***
Dealt to af6e2ca2 
Dealt to 1ea3c784 
Dealt to 6715ca7 
Dealt to 5fdcf0fd 
Dealt to Hero [9c As]
Dealt to 3e37faf6 
5fdcf0fd: folds
Hero: folds
3e37faf6: folds
af6e2ca2: raises $0.1 to $0.15
1ea3c784: folds
6715ca7: folds
Uncalled bet ($0.1) returned to af6e2ca2
*** SHOWDOWN ***
af6e2ca2 collected $0.12 from pot
*** SUMMARY ***
Total pot $0.12 | Rake $0 | Jackpot $0 | Bingo $0 | Fortune $0 | Tax $0
Seat 1: af6e2ca2 (button) collected ($0.12)
Seat 2: 1ea3c784 (small blind) folded before Flop
Seat 3: 6715ca7 (big blind) folded before Flop
Seat 4: 5fdcf0fd folded before Flop (didn't bet)
Seat 5: Hero folded before Flop (didn't bet)
Seat 6: 3e37faf6 folded before Flop (didn't bet)


Poker Hand #RC2094710153: Hold'em No Limit ($0.02/$0.05) - 2023/12/27 21:33:10
Table 'RushAndCash3811172' 6-max Seat #1 is the button
Seat 1: f0a666fd ($5.98 in chips)
Seat 2: 186e4d79 ($10.11 in chips)
Seat 3: 85217622 ($22.54 in chips)
Seat 4: d94cce2e ($5.52 in chips)
Seat 5: 6d462730 ($5 in chips)
Seat 6: Hero ($11.76 in chips)
186e4d79: posts small blind $0.02
85217622: posts big blind $0.05
*** HOLE CARDS ***
Dealt to f0a666fd 
Dealt to 186e4d79 
Dealt to 85217622 
Dealt to d94cce2e 
Dealt to 6d462730 
Dealt to Hero [Ks Jh]
d94cce2e: raises $0.05 to $0.1
6d462730: folds
Hero: folds
f0a666fd: folds
186e4d79: folds
85217622: calls $0.05
*** FLOP *** [Ts Jc 9c]
85217622: checks
d94cce2e: bets $0.17
85217622: calls $0.17
*** TURN *** [Ts Jc 9c] [8d]
85217622: bets $0.75
d94cce2e: calls $0.75
*** RIVER *** [Ts Jc 9c 8d] [7c]
85217622: checks
d94cce2e: checks
85217622: shows [Qh Js] (Queens-High Straight)
d94cce2e: shows [9d 9h] (Jacks-High Straight)
*** SHOWDOWN ***
85217622 collected $1.89 from pot
*** SUMMARY ***
Total pot $2.06 | Rake $0.1 | Jackpot $0.07 | Bingo $0 | Fortune $0 | Tax $0
Board [Ts Jc 9c 8d 7c]
Seat 1: f0a666fd (button) folded before Flop (didn't bet)
Seat 2: 186e4d79 (small blind) folded before Flop
Seat 3: 85217622 (big blind) showed [Qh Js] and won ($1.89) with Queens-High Straight
Seat 4: d94cce2e showed [9d 9h] and lost with Jacks-High Straight
Seat 5: 6d462730 folded before Flop (didn't bet)
Seat 6: Hero folded before Flop (didn't bet)


Poker Hand #RC2094710043: Hold'em No Limit ($0.02/$0.05) - 2023/12/27 21:33:05
Table 'RushAndCash3811119' 6-max Seat #1 is the button
Seat 1: d107e328 ($5.13 in chips)
Seat 2: 5de3c09f ($3.8 in chips)
Seat 3: 659eb463 ($5 in chips)
Seat 4: 845c0c3e ($5.18 in chips)
Seat 5: Hero ($11.76 in chips)
Seat 6: 26c09e5f ($4.28 in chips)
5de3c09f: posts small blind $0.02
659eb463: posts big blind $0.05
*** HOLE CARDS ***
Dealt to d107e328 
Dealt to 5de3c09f 
Dealt to 659eb463 
Dealt to 845c0c3e 
Dealt to Hero [9d 2c]
Dealt to 26c09e5f 
845c0c3e: folds
Hero: folds
26c09e5f: folds
d107e328: folds
5de3c09f: folds
Uncalled bet ($0.03) returned to 659eb463
*** SHOWDOWN ***
659eb463 collected $0.04 from pot
*** SUMMARY ***
Total pot $0.04 | Rake $0 | Jackpot $0 | Bingo $0 | Fortune $0 | Tax $0
Seat 1: d107e328 (button) folded before Flop (didn't bet)
Seat 2: 5de3c09f (small blind) folded before Flop
Seat 3: 659eb463 (big blind) collected ($0.04)
Seat 4: 845c0c3e folded before Flop (didn't bet)
Seat 5: Hero folded before Flop (didn't bet)
Seat 6: 26c09e5f folded before Flop (didn't bet)


Poker Hand #RC2094709778: Hold'em No Limit ($0.02/$0.05) - 2023/12/27 21:32:52
Table 'RushAndCash3810993' 6-max Seat #1 is the button
Seat 1: Hero ($11.76 in chips)
Seat 2: dc0818fe ($5 in chips)
Seat 3: 3bdf9969 ($9.41 in chips)
Seat 4: c9cc4342 ($4.97 in chips)
Seat 5: 9ede0bef ($5 in chips)
Seat 6: 5ecba1be ($3.96 in chips)
dc0818fe: posts small blind $0.02
3bdf9969: posts big blind $0.05
*** HOLE CARDS ***
Dealt to Hero [4s Th]
Dealt to dc0818fe 
Dealt to 3bdf9969 
Dealt to c9cc4342 
Dealt to 9ede0bef 
Dealt to 5ecba1be 
c9cc4342: folds
9ede0bef: folds
5ecba1be: folds
Hero: folds
dc0818fe: folds
Uncalled bet ($0.03) returned to 3bdf9969
*** SHOWDOWN ***
3bdf9969 collected $0.04 from pot
*** SUMMARY ***
Total pot $0.04 | Rake $0 | Jackpot $0 | Bingo $0 | Fortune $0 | Tax $0
Seat 1: Hero (button) folded before Flop (didn't bet)
Seat 2: dc0818fe (small blind) folded before Flop
Seat 3: 3bdf9969 (big blind) collected ($0.04)
Seat 4: c9cc4342 folded before Flop (didn't bet)
Seat 5: 9ede0bef folded before Flop (didn't bet)
Seat 6: 5ecba1be folded before Flop (didn't bet)


Poker Hand #RC2094709444: Hold'em No Limit ($0.02/$0.05) - 2023/12/27 21:32:35
Table 'RushAndCash3810828' 6-max Seat #1 is the button
Seat 1: 2db2e6bd ($5 in chips)
Seat 2: Hero ($11.71 in chips)
Seat 3: 151aa935 ($5 in chips)
Seat 4: f8e9924c ($4.71 in chips)
Seat 5: 97ba59eb ($15.75 in chips)
Seat 6: e5065184 ($4.85 in chips)
Hero: posts small blind $0.02
151aa935: posts big blind $0.05
*** HOLE CARDS ***
Dealt to 2db2e6bd 
Dealt to Hero [Kd Jh]
Dealt to 151aa935 
Dealt to f8e9924c 
Dealt to 97ba59eb 
Dealt to e5065184 
f8e9924c: folds
97ba59eb: folds
e5065184: folds
2db2e6bd: folds
Hero: raises $0.1 to $0.15
151aa935: folds
Uncalled bet ($0.1) returned to Hero
*** SHOWDOWN ***
Hero collected $0.1 from pot
*** SUMMARY ***
Total pot $0.1 | Rake $0 | Jackpot $0 | Bingo $0 | Fortune $0 | Tax $0
Seat 1: 2db2e6bd (button) folded before Flop (didn't bet)
Seat 2: Hero (small blind) collected ($0.1)
Seat 3: 151aa935 (big blind) folded before Flop
Seat 4: f8e9924c folded before Flop (didn't bet)
Seat 5: 97ba59eb folded before Flop (didn't bet)
Seat 6: e5065184 folded before Flop (didn't bet)


Poker Hand #RC2094709346: Hold'em No Limit ($0.02/$0.05) - 2023/12/27 21:32:31
Table 'RushAndCash3810783' 6-max Seat #1 is the button
Seat 1: Hero ($11.71 in chips)
Seat 2: caff888b ($5.82 in chips)
Seat 3: 44161807 ($7.71 in chips)
Seat 4: 68669d25 ($5.49 in chips)
Seat 5: 358d5b9e ($11.59 in chips)
Seat 6: 8aeab93d ($5.83 in chips)
caff888b: posts small blind $0.02
44161807: posts big blind $0.05
*** HOLE CARDS ***
Dealt to Hero [2d 8d]
Dealt to caff888b 
Dealt to 44161807 
Dealt to 68669d25 
Dealt to 358d5b9e 
Dealt to 8aeab93d 
68669d25: folds
358d5b9e: folds
8aeab93d: folds
Hero: folds
caff888b: raises $0.08 to $0.13
44161807: calls $0.08
*** FLOP *** [Kc Td 8h]
caff888b: checks
44161807: bets $0.09
caff888b: folds
Uncalled bet ($0.09) returned to 44161807
*** SHOWDOWN ***
44161807 collected $0.25 from pot
*** SUMMARY ***
Total pot $0.26 | Rake $0.01 | Jackpot $0 | Bingo $0 | Fortune $0 | Tax $0
Board [Kc Td 8h]
Seat 1: Hero (button) folded before Flop (didn't bet)
Seat 2: caff888b (small blind) folded on the Flop
Seat 3: 44161807 (big blind) won ($0.25)
Seat 4: 68669d25 folded before Flop (didn't bet)
Seat 5: 358d5b9e folded before Flop (didn't bet)
Seat 6: 8aeab93d folded before Flop (didn't bet)


Poker Hand #RC2094709169: Hold'em No Limit ($0.02/$0.05) - 2023/12/27 21:32:22
Table 'RushAndCash3810697' 6-max Seat #1 is the button
Seat 1: 301b50 ($5.07 in chips)
Seat 2: 61bf7d9e ($6.07 in chips)
Seat 3: Hero ($11.69 in chips)
Seat 4: 61d0d10e ($5.11 in chips)
Seat 5: 74f57a89 ($19.17 in chips)
Seat 6: 1ffd0a04 ($3.32 in chips)
61bf7d9e: posts small blind $0.02
Hero: posts big blind $0.05
*** HOLE CARDS ***
Dealt to 301b50 
Dealt to 61bf7d9e 
Dealt to Hero [7s Kc]
Dealt to 61d0d10e 
Dealt to 74f57a89 
Dealt to 1ffd0a04 
61d0d10e: folds
74f57a89: folds
1ffd0a04: folds
301b50: folds
61bf7d9e: folds
Uncalled bet ($0.03) returned to Hero
*** SHOWDOWN ***
Hero collected $0.04 from pot
*** SUMMARY ***
Total pot $0.04 | Rake $0 | Jackpot $0 | Bingo $0 | Fortune $0 | Tax $0
Seat 1: 301b50 (button) folded before Flop (didn't bet)
Seat 2: 61bf7d9e (small blind) folded before Flop
Seat 3: Hero (big blind) collected ($0.04)
Seat 4: 61d0d10e folded before Flop (didn't bet)
Seat 5: 74f57a89 folded before Flop (didn't bet)
Seat 6: 1ffd0a04 folded before Flop (didn't bet)


Poker Hand #RC2094708697: Hold'em No Limit ($0.02/$0.05) - 2023/12/27 21:31:59
Table 'RushAndCash3810468' 6-max Seat #1 is the button
Seat 1: 52dc12c9 ($5 in chips)
Seat 2: eeb4ff60 ($7.89 in chips)
Seat 3: Hero ($11.79 in chips)
Seat 4: 61d0d10e ($5 in chips)
Seat 5: e87f3d8b ($1.08 in chips)
Seat 6: f35b3ca8 ($5 in chips)
eeb4ff60: posts small blind $0.02
Hero: posts big blind $0.05
*** HOLE CARDS ***
Dealt to 52dc12c9 
Dealt to eeb4ff60 
Dealt to Hero [Ks Jd]
Dealt to 61d0d10e 
Dealt to e87f3d8b 
Dealt to f35b3ca8 
61d0d10e: raises $0.05 to $0.1
e87f3d8b: folds
f35b3ca8: folds
52dc12c9: folds
eeb4ff60: folds
Hero: calls $0.05
*** FLOP *** [7s 3s 6h]
Hero: checks
61d0d10e: bets $0.08
Hero: folds
Uncalled bet ($0.08) returned to 61d0d10e
*** SHOWDOWN ***
61d0d10e collected $0.21 from pot
*** SUMMARY ***
Total pot $0.22 | Rake $0.01 | Jackpot $0 | Bingo $0 | Fortune $0 | Tax $0
Board [7s 3s 6h]
Seat 1: 52dc12c9 (button) folded before Flop (didn't bet)
Seat 2: eeb4ff60 (small blind) folded before Flop
Seat 3: Hero (big blind) folded on the Flop
Seat 4: 61d0d10e won ($0.21)
Seat 5: e87f3d8b folded before Flop (didn't bet)
Seat 6: f35b3ca8 folded before Flop (didn't bet)


Poker Hand #RC2094708260: Hold'em No Limit ($0.02/$0.05) - 2023/12/27 21:31:38
Table 'RushAndCash3810270' 6-max Seat #1 is the button
Seat 1: d2e84261 ($6.32 in chips)
Seat 2: 6e2c1a87 ($4.88 in chips)
Seat 3: 22f4bad0 ($8.62 in chips)
Seat 4: eeb4ff60 ($7.65 in chips)
Seat 5: 4ffb088b ($5.54 in chips)
Seat 6: Hero ($11.98 in chips)
6e2c1a87: posts small blind $0.02
22f4bad0: posts big blind $0.05
*** HOLE CARDS ***
Dealt to d2e84261 
Dealt to 6e2c1a87 
Dealt to 22f4bad0 
Dealt to eeb4ff60 
Dealt to 4ffb088b 
Dealt to Hero [2h 2c]
eeb4ff60: raises $0.05 to $0.1
4ffb088b: folds
Hero: calls $0.1
d2e84261: folds
6e2c1a87: folds
22f4bad0: folds
*** FLOP *** [Ad 7h Ks]
eeb4ff60: bets $0.09
Hero: calls $0.09
*** TURN *** [Ad 7h Ks] [5h]
eeb4ff60: bets $0.3
Hero: folds
Uncalled bet ($0.3) returned to eeb4ff60
*** SHOWDOWN ***
eeb4ff60 collected $0.43 from pot
*** SUMMARY ***
Total pot $0.45 | Rake $0.02 | Jackpot $0 | Bingo $0 | Fortune $0 | Tax $0
Board [Ad 7h Ks 5h]
Seat 1: d2e84261 (button) folded before Flop (didn't bet)
Seat 2: 6e2c1a87 (small blind) folded before Flop
Seat 3: 22f4bad0 (big blind) folded before Flop
Seat 4: eeb4ff60 won ($0.43)
Seat 5: 4ffb088b folded before Flop (didn't bet)
Seat 6: Hero folded on the Turn


Poker Hand #RC2094707354: Hold'em No Limit ($0.02/$0.05) - 2023/12/27 21:30:51
Table 'RushAndCash3809852' 6-max Seat #1 is the button
Seat 1: 2af2d2a2 ($6.62 in chips)
Seat 2: Hero ($11.26 in chips)
Seat 3: 356bbdcb ($5 in chips)
Seat 4: b0830a8 ($9.63 in chips)
Seat 5: ac97af40 ($10.5 in chips)
Seat 6: 49819dd1 ($8.07 in chips)
Hero: posts small blind $0.02
356bbdcb: posts big blind $0.05
*** HOLE CARDS ***
Dealt to 2af2d2a2 
Dealt to Hero [Td 7d]
Dealt to 356bbdcb 
Dealt to b0830a8 
Dealt to ac97af40 
Dealt to 49819dd1 
b0830a8: raises $0.08 to $0.13
ac97af40: folds
49819dd1: folds
2af2d2a2: folds
Hero: calls $0.11
356bbdcb: calls $0.08
*** FLOP *** [6h 3h 8h]
Hero: bets $0.2
356bbdcb: folds
b0830a8: calls $0.2
*** TURN *** [6h 3h 8h] [As]
Hero: checks
b0830a8: checks
*** RIVER *** [6h 3h 8h As] [9c]
Hero: bets $0.4
b0830a8: calls $0.4
Hero: shows [Td 7d] (Tens-High Straight)
b0830a8: shows [Qh Ac] (Pair of Aces)
*** SHOWDOWN ***
Hero collected $1.45 from pot
*** SUMMARY ***
Total pot $1.59 | Rake $0.07 | Jackpot $0.07 | Bingo $0 | Fortune $0 | Tax $0
Board [6h 3h 8h As 9c]
Seat 1: 2af2d2a2 (button) folded before Flop (didn't bet)
Seat 2: Hero (small blind) showed [Td 7d] and won ($1.45) with Tens-High Straight
Seat 3: 356bbdcb (big blind) folded on the Flop
Seat 4: b0830a8 showed [Qh Ac] and lost with Pair of Aces
Seat 5: ac97af40 folded before Flop (didn't bet)
Seat 6: 49819dd1 folded before Flop (didn't bet)


Poker Hand #RC2094707287: Hold'em No Limit ($0.02/$0.05) - 2023/12/27 21:30:47
Table 'RushAndCash3809822' 6-max Seat #1 is the button
Seat 1: Hero ($11.26 in chips)
Seat 2: f100600f ($5.02 in chips)
Seat 3: 8b7e3c96 ($5.99 in chips)
Seat 4: 80d82178 ($8.38 in chips)
Seat 5: b19b0d12 ($10.65 in chips)
Seat 6: 961c5f19 ($25.15 in chips)
f100600f: posts small blind $0.02
8b7e3c96: posts big blind $0.05
*** HOLE CARDS ***
Dealt to Hero [6s 8h]
Dealt to f100600f 
Dealt to 8b7e3c96 
Dealt to 80d82178 
Dealt to b19b0d12 
Dealt to 961c5f19 
80d82178: folds
b19b0d12: folds
961c5f19: folds
Hero: folds
f100600f: folds
Uncalled bet ($0.03) returned to 8b7e3c96
*** SHOWDOWN ***
8b7e3c96 collected $0.04 from pot
*** SUMMARY ***
Total pot $0.04 | Rake $0 | Jackpot $0 | Bingo $0 | Fortune $0 | Tax $0
Seat 1: Hero (button) folded before Flop (didn't bet)
Seat 2: f100600f (small blind) folded before Flop
Seat 3: 8b7e3c96 (big blind) collected ($0.04)
Seat 4: 80d82178 folded before Flop (didn't bet)
Seat 5: b19b0d12 folded before Flop (didn't bet)
Seat 6: 961c5f19 folded before Flop (didn't bet)


Poker Hand #RC2094707214: Hold'em No Limit ($0.02/$0.05) - 2023/12/27 21:30:43
Table 'RushAndCash3809787' 6-max Seat #1 is the button
Seat 1: b5f1c98d ($1.54 in chips)
Seat 2: bce2611d ($6.64 in chips)
Seat 3: 50421fa7 ($6.26 in chips)
Seat 4: Hero ($11.26 in chips)
Seat 5: d93e8040 ($5.48 in chips)
Seat 6: 961c5f19 ($25.15 in chips)
bce2611d: posts small blind $0.02
50421fa7: posts big blind $0.05
*** HOLE CARDS ***
Dealt to b5f1c98d 
Dealt to bce2611d 
Dealt to 50421fa7 
Dealt to Hero [Ts 4d]
Dealt to d93e8040 
Dealt to 961c5f19 
Hero: folds
d93e8040: folds
961c5f19: folds
b5f1c98d: folds
bce2611d: raises $0.07 to $0.12
50421fa7: folds
Uncalled bet ($0.07) returned to bce2611d
*** SHOWDOWN ***
bce2611d collected $0.1 from pot
*** SUMMARY ***
Total pot $0.1 | Rake $0 | Jackpot $0 | Bingo $0 | Fortune $0 | Tax $0
Seat 1: b5f1c98d (button) folded before Flop (didn't bet)
Seat 2: bce2611d (small blind) collected ($0.1)
Seat 3: 50421fa7 (big blind) folded before Flop
Seat 4: Hero folded before Flop (didn't bet)
Seat 5: d93e8040 folded before Flop (didn't bet)
Seat 6: 961c5f19 folded before Flop (didn't bet)


Poker Hand #RC2094706992: Hold'em No Limit ($0.02/$0.05) - 2023/12/27 21:30:32
Table 'RushAndCash3809678' 6-max Seat #1 is the button
Seat 1: a7bfee05 ($5 in chips)
Seat 2: f8e9924c ($4.8 in chips)
Seat 3: 52dc12c9 ($5.47 in chips)
Seat 4: d96cb66b ($5.26 in chips)
Seat 5: 28777524 ($4.42 in chips)
Seat 6: Hero ($11.19 in chips)
f8e9924c: posts small blind $0.02
52dc12c9: posts big blind $0.05
*** HOLE CARDS ***
Dealt to a7bfee05 
Dealt to f8e9924c 
Dealt to 52dc12c9 
Dealt to d96cb66b 
Dealt to 28777524 
Dealt to Hero [Ad Kc]
d96cb66b: folds
28777524: folds
Hero: raises $0.05 to $0.1
a7bfee05: folds
f8e9924c: folds
52dc12c9: folds
Uncalled bet ($0.05) returned to Hero
*** SHOWDOWN ***
Hero collected $0.12 from pot
*** SUMMARY ***
Total pot $0.12 | Rake $0 | Jackpot $0 | Bingo $0 | Fortune $0 | Tax $0
Seat 1: a7bfee05 (button) folded before Flop (didn't bet)
Seat 2: f8e9924c (small blind) folded before Flop
Seat 3: 52dc12c9 (big blind) folded before Flop
Seat 4: d96cb66b folded before Flop (didn't bet)
Seat 5: 28777524 folded before Flop (didn't bet)
Seat 6: Hero collected ($0.12)


Poker Hand #RC2094706916: Hold'em No Limit ($0.02/$0.05) - 2023/12/27 21:30:29
Table 'RushAndCash3809642' 6-max Seat #1 is the button
Seat 1: 99c31039 ($3.9 in chips)
Seat 2: 3876bd01 ($5 in chips)
Seat 3: b9aa90d9 ($12.76 in chips)
Seat 4: 12f62865 ($8.61 in chips)
Seat 5: abe1c1b1 ($5.16 in chips)
Seat 6: Hero ($11.19 in chips)
3876bd01: posts small blind $0.02
b9aa90d9: posts big blind $0.05
*** HOLE CARDS ***
Dealt to 99c31039 
Dealt to 3876bd01 
Dealt to b9aa90d9 
Dealt to 12f62865 
Dealt to abe1c1b1 
Dealt to Hero [2c 3s]
12f62865: folds
abe1c1b1: raises $0.08 to $0.13
Hero: folds
99c31039: folds
3876bd01: folds
b9aa90d9: folds
Uncalled bet ($0.08) returned to abe1c1b1
*** SHOWDOWN ***
abe1c1b1 collected $0.12 from pot
*** SUMMARY ***
Total pot $0.12 | Rake $0 | Jackpot $0 | Bingo $0 | Fortune $0 | Tax $0
Seat 1: 99c31039 (button) folded before Flop (didn't bet)
Seat 2: 3876bd01 (small blind) folded before Flop
Seat 3: b9aa90d9 (big blind) folded before Flop
Seat 4: 12f62865 folded before Flop (didn't bet)
Seat 5: abe1c1b1 collected ($0.12)
Seat 6: Hero folded before Flop (didn't bet)


Poker Hand #RC2094705970: Hold'em No Limit ($0.02/$0.05) - 2023/12/27 21:29:41
Table 'RushAndCash3809190' 6-max Seat #1 is the button
Seat 1: 14c369ea ($1.03 in chips)
Seat 2: Hero ($10.38 in chips)
Seat 3: 99c31039 ($4.73 in chips)
Seat 4: b61e68c4 ($2.58 in chips)
Seat 5: abe1c1b1 ($5.29 in chips)
Seat 6: 40758d6c ($5 in chips)
Hero: posts small blind $0.02
99c31039: posts big blind $0.05
*** HOLE CARDS ***
Dealt to 14c369ea 
Dealt to Hero [Jd Td]
Dealt to 99c31039 
Dealt to b61e68c4 
Dealt to abe1c1b1 
Dealt to 40758d6c 
b61e68c4: folds
abe1c1b1: raises $0.08 to $0.13
40758d6c: folds
14c369ea: folds
Hero: calls $0.11
99c31039: calls $0.08
*** FLOP *** [Jc 7h 3c]
Hero: checks
99c31039: checks
abe1c1b1: checks
*** TURN *** [Jc 7h 3c] [8s]
Hero: checks
99c31039: bets $0.25
abe1c1b1: folds
Hero: calls $0.25
*** RIVER *** [Jc 7h 3c 8s] [Ks]
Hero: checks
99c31039: bets $0.45
Hero: calls $0.45
99c31039: shows [4c 5c] (King-High)
Hero: shows [Jd Td] (Pair of Jacks)
*** SHOWDOWN ***
Hero collected $1.64 from pot
*** SUMMARY ***
Total pot $1.79 | Rake $0.08 | Jackpot $0.07 | Bingo $0 | Fortune $0 | Tax $0
Board [Jc 7h 3c 8s Ks]
Seat 1: 14c369ea (button) folded before Flop (didn't bet)
Seat 2: Hero (small blind) showed [Jd Td] and won ($1.64) with Pair of Jacks
Seat 3: 99c31039 (big blind) showed [4c 5c] and lost with King-High
Seat 4: b61e68c4 folded before Flop (didn't bet)
Seat 5: abe1c1b1 folded on the Turn
Seat 6: 40758d6c folded before Flop (didn't bet)


Poker Hand #RC2094705204: Hold'em No Limit ($0.02/$0.05) - 2023/12/27 21:29:03
Table 'RushAndCash3808839' 6-max Seat #1 is the button
Seat 1: c94b4e1d ($12.64 in chips)
Seat 2: 572253fd ($5.24 in chips)
Seat 3: fc10e886 ($9.46 in chips)
Seat 4: 635c277c ($10.48 in chips)
Seat 5: 81fdf362 ($7.37 in chips)
Seat 6: Hero ($10.27 in chips)
572253fd: posts small blind $0.02
fc10e886: posts big blind $0.05
*** HOLE CARDS ***
Dealt to c94b4e1d 
Dealt to 572253fd 
Dealt to fc10e886 
Dealt to 635c277c 
Dealt to 81fdf362 
Dealt to Hero [Ah Td]
635c277c: folds
81fdf362: folds
Hero: raises $0.05 to $0.1
c94b4e1d: folds
572253fd: folds
fc10e886: calls $0.05
*** FLOP *** [9c 7c 2c]
fc10e886: checks
Hero: checks
*** TURN *** [9c 7c 2c] [9h]
fc10e886: checks
Hero: checks
*** RIVER *** [9c 7c 2c 9h] [4s]
fc10e886: checks
Hero: checks
fc10e886: shows [Kd Th] (Pair of Nines)
Hero: shows [Ah Td] (Pair of Nines)
*** SHOWDOWN ***
Hero collected $0.21 from pot
*** SUMMARY ***
Total pot $0.22 | Rake $0.01 | Jackpot $0 | Bingo $0 | Fortune $0 | Tax $0
Board [9c 7c 2c 9h 4s]
Seat 1: c94b4e1d (button) folded before Flop (didn't bet)
Seat 2: 572253fd (small blind) folded before Flop
Seat 3: fc10e886 (big blind) showed [Kd Th] and lost with Pair of Nines
Seat 4: 635c277c folded before Flop (didn't bet)
Seat 5: 81fdf362 folded before Flop (didn't bet)
Seat 6: Hero showed [Ah Td] and won ($0.21) with Pair of Nines


Poker Hand #RC2094705135: Hold'em No Limit ($0.02/$0.05) - 2023/12/27 21:28:59
Table 'RushAndCash3808805' 6-max Seat #1 is the button
Seat 1: a64665aa ($7.49 in chips)
Seat 2: edb16e47 ($4.93 in chips)
Seat 3: Hero ($10.32 in chips)
Seat 4: 635c277c ($10.48 in chips)
Seat 5: 8d8864c6 ($3.6 in chips)
Seat 6: e5e1e9a9 ($5 in chips)
edb16e47: posts small blind $0.02
Hero: posts big blind $0.05
*** HOLE CARDS ***
Dealt to a64665aa 
Dealt to edb16e47 
Dealt to Hero [6s 8c]
Dealt to 635c277c 
Dealt to 8d8864c6 
Dealt to e5e1e9a9 
635c277c: folds
8d8864c6: folds
e5e1e9a9: raises $0.05 to $0.1
a64665aa: folds
edb16e47: raises $0.14 to $0.24
Hero: folds
e5e1e9a9: calls $0.14
*** FLOP *** [7d Jh 6c]
edb16e47: bets $0.4
e5e1e9a9: calls $0.4
*** TURN *** [7d Jh 6c] [8d]
edb16e47: bets $0.05
e5e1e9a9: raises $0.95 to $1
edb16e47: folds
Uncalled bet ($0.95) returned to e5e1e9a9
*** SHOWDOWN ***
e5e1e9a9 collected $1.36 from pot
*** SUMMARY ***
Total pot $1.43 | Rake $0.07 | Jackpot $0 | Bingo $0 | Fortune $0 | Tax $0
Board [7d Jh 6c 8d]
Seat 1: a64665aa (button) folded before Flop (didn't bet)
Seat 2: edb16e47 (small blind) folded on the Turn
Seat 3: Hero (big blind) folded before Flop
Seat 4: 635c277c folded before Flop (didn't bet)
Seat 5: 8d8864c6 folded before Flop (didn't bet)
Seat 6: e5e1e9a9 won ($1.36)


Poker Hand #RC2094705050: Hold'em No Limit ($0.02/$0.05) - 2023/12/27 21:28:55
Table 'RushAndCash3808764' 6-max Seat #1 is the button
Seat 1: 58ee8a8c ($5.07 in chips)
Seat 2: 50203b74 ($4.93 in chips)
Seat 3: d67a4d8c ($5.86 in chips)
Seat 4: 3742af02 ($5.07 in chips)
Seat 5: Hero ($10.32 in chips)
Seat 6: b881f476 ($5.15 in chips)
50203b74: posts small blind $0.02
d67a4d8c: posts big blind $0.05
*** HOLE CARDS ***
Dealt to 58ee8a8c 
Dealt to 50203b74 
Dealt to d67a4d8c 
Dealt to 3742af02 
Dealt to Hero [9c 7s]
Dealt to b881f476 
3742af02: folds
Hero: folds
b881f476: folds
58ee8a8c: raises $0.06 to $0.11
50203b74: folds
d67a4d8c: calls $0.06
*** FLOP *** [Ac 3d 6d]
d67a4d8c: checks
58ee8a8c: bets $0.12
d67a4d8c: folds
Uncalled bet ($0.12) returned to 58ee8a8c
*** SHOWDOWN ***
58ee8a8c collected $0.23 from pot
*** SUMMARY ***
Total pot $0.24 | Rake $0.01 | Jackpot $0 | Bingo $0 | Fortune $0 | Tax $0
Board [Ac 3d 6d]
Seat 1: 58ee8a8c (button) won ($0.23)
Seat 2: 50203b74 (small blind) folded before Flop
Seat 3: d67a4d8c (big blind) folded on the Flop
Seat 4: 3742af02 folded before Flop (didn't bet)
Seat 5: Hero folded before Flop (didn't bet)
Seat 6: b881f476 folded before Flop (didn't bet)


Poker Hand #RC2094704982: Hold'em No Limit ($0.02/$0.05) - 2023/12/27 21:28:52
Table 'RushAndCash3808730' 6-max Seat #1 is the button
Seat 1: Hero ($10.32 in chips)
Seat 2: 770cf96b ($11.1 in chips)
Seat 3: 3ed5343b ($9.92 in chips)
Seat 4: eb42d0a ($3.94 in chips)
Seat 5: fb5182e1 ($18.26 in chips)
Seat 6: 971781e9 ($6.77 in chips)
770cf96b: posts small blind $0.02
3ed5343b: posts big blind $0.05
*** HOLE CARDS ***
Dealt to Hero [Tc 6d]
Dealt to 770cf96b 
Dealt to 3ed5343b 
Dealt to eb42d0a 
Dealt to fb5182e1 
Dealt to 971781e9 
eb42d0a: folds
fb5182e1: folds
971781e9: folds
Hero: folds
770cf96b: raises $0.05 to $0.1
3ed5343b: folds
Uncalled bet ($0.05) returned to 770cf96b
*** SHOWDOWN ***
770cf96b collected $0.1 from pot
*** SUMMARY ***
Total pot $0.1 | Rake $0 | Jackpot $0 | Bingo $0 | Fortune $0 | Tax $0
Seat 1: Hero (button) folded before Flop (didn't bet)
Seat 2: 770cf96b (small blind) collected ($0.1)
Seat 3: 3ed5343b (big blind) folded before Flop
Seat 4: eb42d0a folded before Flop (didn't bet)
Seat 5: fb5182e1 folded before Flop (didn't bet)
Seat 6: 971781e9 folded before Flop (didn't bet)


Poker Hand #RC2094704795: Hold'em No Limit ($0.02/$0.05) - 2023/12/27 21:28:43
Table 'RushAndCash3808638' 6-max Seat #1 is the button
Seat 1: 4da0542c ($5 in chips)
Seat 2: Hero ($10.34 in chips)
Seat 3: 79055c43 ($6.52 in chips)
Seat 4: 46d53aa0 ($11.05 in chips)
Seat 5: 2c2f32e2 ($3.76 in chips)
Seat 6: d93e8040 ($5.02 in chips)
Hero: posts small blind $0.02
79055c43: posts big blind $0.05
*** HOLE CARDS ***
Dealt to 4da0542c 
Dealt to Hero [5s 2d]
Dealt to 79055c43 
Dealt to 46d53aa0 
Dealt to 2c2f32e2 
Dealt to d93e8040 
46d53aa0: raises $0.05 to $0.1
2c2f32e2: folds
d93e8040: folds
4da0542c: calls $0.1
Hero: folds
79055c43: raises $0.32 to $0.42
46d53aa0: folds
4da0542c: calls $0.32
*** FLOP *** [5h Qs 7c]
79055c43: checks
4da0542c: checks
*** TURN *** [5h Qs 7c] [Ts]
79055c43: checks
4da0542c: bets $0.32
79055c43: calls $0.32
*** RIVER *** [5h Qs 7c Ts] [4d]
79055c43: checks
4da0542c: bets $0.8
79055c43: folds
Uncalled bet ($0.8) returned to 4da0542c
*** SHOWDOWN ***
4da0542c collected $1.46 from pot
*** SUMMARY ***
Total pot $1.6 | Rake $0.07 | Jackpot $0.07 | Bingo $0 | Fortune $0 | Tax $0
Board [5h Qs 7c Ts 4d]
Seat 1: 4da0542c (button) won ($1.46)
Seat 2: Hero (small blind) folded before Flop
Seat 3: 79055c43 (big blind) folded on the River
Seat 4: 46d53aa0 folded before Flop
Seat 5: 2c2f32e2 folded before Flop (didn't bet)
Seat 6: d93e8040 folded before Flop (didn't bet)


Poker Hand #RC2094684274: Hold'em No Limit ($0.02/$0.05) - 2023/12/27 21:28:17
Table 'RushAndCash3808394' 6-max Seat #1 is the button
Seat 1: 3f202778 ($2.73 in chips)
Seat 2: 74882d05 ($5.21 in chips)
Seat 3: cf37a064 ($25.69 in chips)
Seat 4: 46d53aa0 ($11.24 in chips)
Seat 5: Hero ($10.1 in chips)
Seat 6: f48efef4 ($4.62 in chips)
74882d05: posts small blind $0.02
cf37a064: posts big blind $0.05
*** HOLE CARDS ***
Dealt to 3f202778 
Dealt to 74882d05 
Dealt to cf37a064 
Dealt to 46d53aa0 
Dealt to Hero [Td Ad]
Dealt to f48efef4 
46d53aa0: raises $0.05 to $0.1
Hero: calls $0.1
f48efef4: folds
3f202778: folds
74882d05: folds
cf37a064: folds
*** FLOP *** [Ah 4c Ts]
46d53aa0: bets $0.09
Hero: raises $0.19 to $0.28
46d53aa0: folds
Uncalled bet ($0.19) returned to Hero
*** SHOWDOWN ***
Hero collected $0.43 from pot
*** SUMMARY ***
Total pot $0.45 | Rake $0.02 | Jackpot $0 | Bingo $0 | Fortune $0 | Tax $0
Board [Ah 4c Ts]
Seat 1: 3f202778 (button) folded before Flop (didn't bet)
Seat 2: 74882d05 (small blind) folded before Flop
Seat 3: cf37a064 (big blind) folded before Flop
Seat 4: 46d53aa0 folded on the Flop
Seat 5: Hero won ($0.43)
Seat 6: f48efef4 folded before Flop (didn't bet)


Poker Hand #RC2094684200: Hold'em No Limit ($0.02/$0.05) - 2023/12/27 21:28:13
Table 'RushAndCash3808358' 6-max Seat #1 is the button
Seat 1: d4026ab ($5.05 in chips)
Seat 2: b8ee58e6 ($5.94 in chips)
Seat 3: 24c1fb5f ($5 in chips)
Seat 4: 4f7c05d4 ($8.36 in chips)
Seat 5: Hero ($10.1 in chips)
Seat 6: 319f4f42 ($5.07 in chips)
b8ee58e6: posts small blind $0.02
24c1fb5f: posts big blind $0.05
*** HOLE CARDS ***
Dealt to d4026ab 
Dealt to b8ee58e6 
Dealt to 24c1fb5f 
Dealt to 4f7c05d4 
Dealt to Hero [8s 3h]
Dealt to 319f4f42 
4f7c05d4: folds
Hero: folds
319f4f42: folds
d4026ab: folds
b8ee58e6: folds
Uncalled bet ($0.03) returned to 24c1fb5f
*** SHOWDOWN ***
24c1fb5f collected $0.04 from pot
*** SUMMARY ***
Total pot $0.04 | Rake $0 | Jackpot $0 | Bingo $0 | Fortune $0 | Tax $0
Seat 1: d4026ab (button) folded before Flop (didn't bet)
Seat 2: b8ee58e6 (small blind) folded before Flop
Seat 3: 24c1fb5f (big blind) collected ($0.04)
Seat 4: 4f7c05d4 folded before Flop (didn't bet)
Seat 5: Hero folded before Flop (didn't bet)
Seat 6: 319f4f42 folded before Flop (didn't bet)


Poker Hand #RC2094683864: Hold'em No Limit ($0.02/$0.05) - 2023/12/27 21:27:56
Table 'RushAndCash3808193' 6-max Seat #1 is the button
Seat 1: e16e04ba ($7.04 in chips)
Seat 2: f277bf46 ($1.52 in chips)
Seat 3: Hero ($10.15 in chips)
Seat 4: 18e28073 ($10.91 in chips)
Seat 5: 3742af02 ($5 in chips)
Seat 6: c7d29ab9 ($5.07 in chips)
f277bf46: posts small blind $0.02
Hero: posts big blind $0.05
*** HOLE CARDS ***
Dealt to e16e04ba 
Dealt to f277bf46 
Dealt to Hero [2h Ah]
Dealt to 18e28073 
Dealt to 3742af02 
Dealt to c7d29ab9 
18e28073: folds
3742af02: folds
c7d29ab9: folds
e16e04ba: raises $0.08 to $0.13
f277bf46: raises $0.21 to $0.34
Hero: folds
e16e04ba: calls $0.21
*** FLOP *** [9d 9s Ad]
f277bf46: checks
e16e04ba: checks
*** TURN *** [9d 9s Ad] [2d]
f277bf46: checks
e16e04ba: checks
*** RIVER *** [9d 9s Ad 2d] [3h]
f277bf46: checks
e16e04ba: bets $0.92
f277bf46: raises $0.26 to $1.18 and is all-in
e16e04ba: calls $0.26
f277bf46: shows [Qh Qs] (Pair of Queens and Pair of Nines)
e16e04ba: shows [Jd 3d] (Ace High Flush)
*** SHOWDOWN ***
e16e04ba collected $2.87 from pot
*** SUMMARY ***
Total pot $3.09 | Rake $0.15 | Jackpot $0.07 | Bingo $0 | Fortune $0 | Tax $0
Board [9d 9s Ad 2d 3h]
Seat 1: e16e04ba (button) showed [Jd 3d] and won ($2.87) with Ace High Flush
Seat 2: f277bf46 (small blind) showed [Qh Qs] and lost with Pair of Queens and Pair of Nines
Seat 3: Hero (big blind) folded before Flop
Seat 4: 18e28073 folded before Flop (didn't bet)
Seat 5: 3742af02 folded before Flop (didn't bet)
Seat 6: c7d29ab9 folded before Flop (didn't bet)


Poker Hand #RC2094683763: Hold'em No Limit ($0.02/$0.05) - 2023/12/27 21:27:51
Table 'RushAndCash3808142' 6-max Seat #1 is the button
Seat 1: e0c80248 ($7.2 in chips)
Seat 2: b7dc02f3 ($8 in chips)
Seat 3: 1a55a4ac ($5 in chips)
Seat 4: cca43bec ($5.61 in chips)
Seat 5: 23defde5 ($12.47 in chips)
Seat 6: Hero ($10.15 in chips)
b7dc02f3: posts small blind $0.02
1a55a4ac: posts big blind $0.05
*** HOLE CARDS ***
Dealt to e0c80248 
Dealt to b7dc02f3 
Dealt to 1a55a4ac 
Dealt to cca43bec 
Dealt to 23defde5 
Dealt to Hero [7d 2c]
cca43bec: folds
23defde5: calls $0.05
Hero: folds
e0c80248: folds
b7dc02f3: raises $0.1 to $0.15
1a55a4ac: folds
23defde5: calls $0.1
*** FLOP *** [Th Ad Qc]
b7dc02f3: bets $0.27
23defde5: calls $0.27
*** TURN *** [Th Ad Qc] [Ah]
b7dc02f3: checks
23defde5: bets $0.3
b7dc02f3: calls $0.3
*** RIVER *** [Th Ad Qc Ah] [9d]
b7dc02f3: checks
23defde5: bets $0.5
b7dc02f3: calls $0.5
23defde5: shows [5s As] (Three Aces)
b7dc02f3: shows [Ks Kc] (Pair of Aces and Pair of Kings)
*** SHOWDOWN ***
23defde5 collected $2.3 from pot
*** SUMMARY ***
Total pot $2.49 | Rake $0.12 | Jackpot $0.07 | Bingo $0 | Fortune $0 | Tax $0
Board [Th Ad Qc Ah 9d]
Seat 1: e0c80248 (button) folded before Flop (didn't bet)
Seat 2: b7dc02f3 (small blind) showed [Ks Kc] and lost with Pair of Aces and Pair of Kings
Seat 3: 1a55a4ac (big blind) folded before Flop
Seat 4: cca43bec folded before Flop (didn't bet)
Seat 5: 23defde5 showed [5s As] and won ($2.3) with Three Aces
Seat 6: Hero folded before Flop (didn't bet)


Poker Hand #RC2094683660: Hold'em No Limit ($0.02/$0.05) - 2023/12/27 21:27:45
Table 'RushAndCash3808092' 6-max Seat #1 is the button
Seat 1: 6d629bd ($8.72 in chips)
Seat 2: aa286bd3 ($5.16 in chips)
Seat 3: 64b521e3 ($6.65 in chips)
Seat 4: Hero ($10.15 in chips)
Seat 5: a64665aa ($7.62 in chips)
Seat 6: d557ab62 ($10.85 in chips)
aa286bd3: posts small blind $0.02
64b521e3: posts big blind $0.05
*** HOLE CARDS ***
Dealt to 6d629bd 
Dealt to aa286bd3 
Dealt to 64b521e3 
Dealt to Hero [9c 4h]
Dealt to a64665aa 
Dealt to d557ab62 
Hero: folds
a64665aa: raises $0.06 to $0.11
d557ab62: calls $0.11
6d629bd: folds
aa286bd3: folds
64b521e3: calls $0.06
*** FLOP *** [8c 3s 5c]
64b521e3: checks
a64665aa: checks
d557ab62: bets $0.28
64b521e3: folds
a64665aa: folds
Uncalled bet ($0.28) returned to d557ab62
*** SHOWDOWN ***
d557ab62 collected $0.34 from pot
*** SUMMARY ***
Total pot $0.35 | Rake $0.01 | Jackpot $0 | Bingo $0 | Fortune $0 | Tax $0
Board [8c 3s 5c]
Seat 1: 6d629bd (button) folded before Flop (didn't bet)
Seat 2: aa286bd3 (small blind) folded before Flop
Seat 3: 64b521e3 (big blind) folded on the Flop
Seat 4: Hero folded before Flop (didn't bet)
Seat 5: a64665aa folded on the Flop
Seat 6: d557ab62 won ($0.34)


Poker Hand #RC2094683551: Hold'em No Limit ($0.02/$0.05) - 2023/12/27 21:27:40
Table 'RushAndCash3808039' 6-max Seat #1 is the button
Seat 1: Hero ($10.15 in chips)
Seat 2: 49d204ad ($7.28 in chips)
Seat 3: fc10e886 ($9.53 in chips)
Seat 4: 50421fa7 ($6.62 in chips)
Seat 5: e6718ecd ($5.31 in chips)
Seat 6: 8ba492cd ($4.83 in chips)
49d204ad: posts small blind $0.02
fc10e886: posts big blind $0.05
*** HOLE CARDS ***
Dealt to Hero [Js 4h]
Dealt to 49d204ad 
Dealt to fc10e886 
Dealt to 50421fa7 
Dealt to e6718ecd 
Dealt to 8ba492cd 
50421fa7: folds
e6718ecd: raises $0.07 to $0.12
8ba492cd: folds
Hero: folds
49d204ad: folds
fc10e886: calls $0.07
*** FLOP *** [Ah 5h 8h]
fc10e886: checks
e6718ecd: checks
*** TURN *** [Ah 5h 8h] [Td]
fc10e886: checks
e6718ecd: bets $0.1
fc10e886: folds
Uncalled bet ($0.1) returned to e6718ecd
*** SHOWDOWN ***
e6718ecd collected $0.25 from pot
*** SUMMARY ***
Total pot $0.26 | Rake $0.01 | Jackpot $0 | Bingo $0 | Fortune $0 | Tax $0
Board [Ah 5h 8h Td]
Seat 1: Hero (button) folded before Flop (didn't bet)
Seat 2: 49d204ad (small blind) folded before Flop
Seat 3: fc10e886 (big blind) folded on the Turn
Seat 4: 50421fa7 folded before Flop (didn't bet)
Seat 5: e6718ecd won ($0.25)
Seat 6: 8ba492cd folded before Flop (didn't bet)


Poker Hand #RC2094683340: Hold'em No Limit ($0.02/$0.05) - 2023/12/27 21:27:29
Table 'RushAndCash3807942' 6-max Seat #1 is the button
Seat 1: ebfbe9e5 ($8.38 in chips)
Seat 2: Hero ($10.17 in chips)
Seat 3: 14c369ea ($1.34 in chips)
Seat 4: 451cabba ($6.97 in chips)
Seat 5: 4c5efad8 ($5.32 in chips)
Seat 6: 44366042 ($5.05 in chips)
Hero: posts small blind $0.02
14c369ea: posts big blind $0.05
*** HOLE CARDS ***
Dealt to ebfbe9e5 
Dealt to Hero [Qd 7s]
Dealt to 14c369ea 
Dealt to 451cabba 
Dealt to 4c5efad8 
Dealt to 44366042 
451cabba: folds
4c5efad8: folds
44366042: raises $0.06 to $0.11
ebfbe9e5: folds
Hero: folds
14c369ea: calls $0.06
*** FLOP *** [5d 4c 9c]
14c369ea: checks
44366042: bets $0.2
14c369ea: calls $0.2
*** TURN *** [5d 4c 9c] [Qs]
14c369ea: checks
44366042: bets $0.8
14c369ea: folds
Uncalled bet ($0.8) returned to 44366042
*** SHOWDOWN ***
44366042 collected $0.61 from pot
*** SUMMARY ***
Total pot $0.64 | Rake $0.03 | Jackpot $0 | Bingo $0 | Fortune $0 | Tax $0
Board [5d 4c 9c Qs]
Seat 1: ebfbe9e5 (button) folded before Flop (didn't bet)
Seat 2: Hero (small blind) folded before Flop
Seat 3: 14c369ea (big blind) folded on the Turn
Seat 4: 451cabba folded before Flop (didn't bet)
Seat 5: 4c5efad8 folded before Flop (didn't bet)
Seat 6: 44366042 won ($0.61)


Poker Hand #RC2094683268: Hold'em No Limit ($0.02/$0.05) - 2023/12/27 21:27:26
Table 'RushAndCash3807909' 6-max Seat #1 is the button
Seat 1: d80d70f1 ($7.7 in chips)
Seat 2: 9f63a7f5 ($4.04 in chips)
Seat 3: 6f42c5ff ($5 in chips)
Seat 4: Hero ($10.17 in chips)
Seat 5: bcc21958 ($5.56 in chips)
Seat 6: 5d0bed9d ($20.26 in chips)
9f63a7f5: posts small blind $0.02
6f42c5ff: posts big blind $0.05
*** HOLE CARDS ***
Dealt to d80d70f1 
Dealt to 9f63a7f5 
Dealt to 6f42c5ff 
Dealt to Hero [2d Ah]
Dealt to bcc21958 
Dealt to 5d0bed9d 
Hero: folds
bcc21958: folds
5d0bed9d: raises $0.05 to $0.1
d80d70f1: folds
9f63a7f5: folds
6f42c5ff: folds
Uncalled bet ($0.05) returned to 5d0bed9d
*** SHOWDOWN ***
5d0bed9d collected $0.12 from pot
*** SUMMARY ***
Total pot $0.12 | Rake $0 | Jackpot $0 | Bingo $0 | Fortune $0 | Tax $0
Seat 1: d80d70f1 (button) folded before Flop (didn't bet)
Seat 2: 9f63a7f5 (small blind) folded before Flop
Seat 3: 6f42c5ff (big blind) folded before Flop
Seat 4: Hero folded before Flop (didn't bet)
Seat 5: bcc21958 folded before Flop (didn't bet)
Seat 6: 5d0bed9d collected ($0.12)


Poker Hand #RC2094683191: Hold'em No Limit ($0.02/$0.05) - 2023/12/27 21:27:22
Table 'RushAndCash3807873' 6-max Seat #1 is the button
Seat 1: b5d8e03c ($15.72 in chips)
Seat 2: f87a2c19 ($9.29 in chips)
Seat 3: 3ff590c1 ($5 in chips)
Seat 4: Hero ($10.17 in chips)
Seat 5: e26b959d ($5.05 in chips)
Seat 6: 633ada18 ($5.57 in chips)
f87a2c19: posts small blind $0.02
3ff590c1: posts big blind $0.05
*** HOLE CARDS ***
Dealt to b5d8e03c 
Dealt to f87a2c19 
Dealt to 3ff590c1 
Dealt to Hero [Tc 5c]
Dealt to e26b959d 
Dealt to 633ada18 
Hero: folds
e26b959d: folds
633ada18: folds
b5d8e03c: raises $0.08 to $0.13
f87a2c19: folds
3ff590c1: calls $0.08
*** FLOP *** [Js Kd Ks]
3ff590c1: checks
b5d8e03c: checks
*** TURN *** [Js Kd Ks] [Qs]
3ff590c1: checks
b5d8e03c: bets $0.14
3ff590c1: calls $0.14
*** RIVER *** [Js Kd Ks Qs] [Qc]
3ff590c1: checks
b5d8e03c: bets $0.56
3ff590c1: calls $0.56
b5d8e03c: shows [5h As] (Pair of Kings and Pair of Queens)
3ff590c1: shows [Ac Qh] (Queens Full over Kings)
*** SHOWDOWN ***
3ff590c1 collected $1.53 from pot
*** SUMMARY ***
Total pot $1.68 | Rake $0.08 | Jackpot $0.07 | Bingo $0 | Fortune $0 | Tax $0
Board [Js Kd Ks Qs Qc]
Seat 1: b5d8e03c (button) showed [5h As] and lost with Pair of Kings and Pair of Queens
Seat 2: f87a2c19 (small blind) folded before Flop
Seat 3: 3ff590c1 (big blind) showed [Ac Qh] and won ($1.53) with Queens Full over Kings
Seat 4: Hero folded before Flop (didn't bet)
Seat 5: e26b959d folded before Flop (didn't bet)
Seat 6: 633ada18 folded before Flop (didn't bet)


Poker Hand #RC2094682960: Hold'em No Limit ($0.02/$0.05) - 2023/12/27 21:27:10
Table 'RushAndCash3807764' 6-max Seat #1 is the button
Seat 1: b0830a8 ($9.42 in chips)
Seat 2: 14c369ea ($1.36 in chips)
Seat 3: Hero ($10.22 in chips)
Seat 4: 1ea3c784 ($12.02 in chips)
Seat 5: 303949b0 ($5 in chips)
Seat 6: 28cffda ($7.41 in chips)
14c369ea: posts small blind $0.02
Hero: posts big blind $0.05
*** HOLE CARDS ***
Dealt to b0830a8 
Dealt to 14c369ea 
Dealt to Hero [Td 4c]
Dealt to 1ea3c784 
Dealt to 303949b0 
Dealt to 28cffda 
1ea3c784: raises $0.06 to $0.11
303949b0: raises $0.22 to $0.33
28cffda: folds
b0830a8: folds
14c369ea: folds
Hero: folds
1ea3c784: raises $0.82 to $1.15
303949b0: calls $0.82
*** FLOP *** [2s 7s 4d]
1ea3c784: bets $0.79
303949b0: calls $0.79
*** TURN *** [2s 7s 4d] [2d]
1ea3c784: bets $2.18
303949b0: raises $0.88 to $3.06 and is all-in
1ea3c784: calls $0.88
303949b0: shows [9h 9s] (Pair of Nines and Pair of Twos)
1ea3c784: shows [Ad Kd] (Pair of Twos)
*** RIVER *** [2s 7s 4d 2d] [7h]
*** SHOWDOWN ***
303949b0 collected $9.85 from pot
*** SUMMARY ***
Total pot $10.07 | Rake $0.15 | Jackpot $0.07 | Bingo $0 | Fortune $0 | Tax $0
Board [2s 7s 4d 2d 7h]
Seat 1: b0830a8 (button) folded before Flop (didn't bet)
Seat 2: 14c369ea (small blind) folded before Flop
Seat 3: Hero (big blind) folded before Flop
Seat 4: 1ea3c784 showed [Ad Kd] and lost with Pair of Sevens and Pair of Twos
Seat 5: 303949b0 showed [9h 9s] and won ($9.85) with Pair of Nines and Pair of Sevens
Seat 6: 28cffda folded before Flop (didn't bet)


Poker Hand #RC2094682879: Hold'em No Limit ($0.02/$0.05) - 2023/12/27 21:27:07
Table 'RushAndCash3807728' 6-max Seat #1 is the button
Seat 1: Hero ($10.22 in chips)
Seat 2: bc902f73 ($0.64 in chips)
Seat 3: 7561f1c ($7.92 in chips)
Seat 4: 48b5c4f6 ($11.24 in chips)
Seat 5: 88ac0764 ($7.66 in chips)
Seat 6: 2748a772 ($5.07 in chips)
bc902f73: posts small blind $0.02
7561f1c: posts big blind $0.05
*** HOLE CARDS ***
Dealt to Hero [As 3h]
Dealt to bc902f73 
Dealt to 7561f1c 
Dealt to 48b5c4f6 
Dealt to 88ac0764 
Dealt to 2748a772 
48b5c4f6: folds
88ac0764: folds
2748a772: folds
Hero: folds
bc902f73: folds
Uncalled bet ($0.03) returned to 7561f1c
*** SHOWDOWN ***
7561f1c collected $0.04 from pot
*** SUMMARY ***
Total pot $0.04 | Rake $0 | Jackpot $0 | Bingo $0 | Fortune $0 | Tax $0
Seat 1: Hero (button) folded before Flop (didn't bet)
Seat 2: bc902f73 (small blind) folded before Flop
Seat 3: 7561f1c (big blind) collected ($0.04)
Seat 4: 48b5c4f6 folded before Flop (didn't bet)
Seat 5: 88ac0764 folded before Flop (didn't bet)
Seat 6: 2748a772 folded before Flop (didn't bet)


Poker Hand #RC2094682062: Hold'em No Limit ($0.02/$0.05) - 2023/12/27 21:26:24
Table 'RushAndCash3807318' 6-max Seat #1 is the button
Seat 1: 7659f4be ($5 in chips)
Seat 2: e6a3a3d7 ($2.17 in chips)
Seat 3: 451cabba ($7.11 in chips)
Seat 4: Hero ($10.32 in chips)
Seat 5: e00693d4 ($9.43 in chips)
Seat 6: 9cae1f ($2.48 in chips)
e6a3a3d7: posts small blind $0.02
451cabba: posts big blind $0.05
*** HOLE CARDS ***
Dealt to 7659f4be 
Dealt to e6a3a3d7 
Dealt to 451cabba 
Dealt to Hero [Jc Ks]
Dealt to e00693d4 
Dealt to 9cae1f 
Hero: raises $0.05 to $0.1
e00693d4: calls $0.1
9cae1f: calls $0.1
7659f4be: raises $0.45 to $0.55
e6a3a3d7: folds
451cabba: folds
Hero: folds
e00693d4: folds
9cae1f: calls $0.45
*** FLOP *** [2s Qd 3h]
9cae1f: checks
7659f4be: bets $2.1
9cae1f: calls $1.93 and is all-in
Uncalled bet ($0.17) returned to 7659f4be
7659f4be: shows [4h 5h] (Queen-High)
9cae1f: shows [9h Qh] (Pair of Queens)
*** TURN *** [2s Qd 3h] [Ac]
*** RIVER *** [2s Qd 3h Ac] [Qs]
*** SHOWDOWN ***
7659f4be collected $5.01 from pot
*** SUMMARY ***
Total pot $5.23 | Rake $0.15 | Jackpot $0.07 | Bingo $0 | Fortune $0 | Tax $0
Board [2s Qd 3h Ac Qs]
Seat 1: 7659f4be (button) showed [4h 5h] and won ($5.01) with Fives-High Straight
Seat 2: e6a3a3d7 (small blind) folded before Flop
Seat 3: 451cabba (big blind) folded before Flop
Seat 4: Hero folded before Flop
Seat 5: e00693d4 folded before Flop
Seat 6: 9cae1f showed [9h Qh] and lost with Three Queens


Poker Hand #RC2094681059: Hold'em No Limit ($0.02/$0.05) - 2023/12/27 21:25:35
Table 'RushAndCash3806844' 6-max Seat #1 is the button
Seat 1: 55f38a46 ($5.32 in chips)
Seat 2: eeb4ff60 ($7.64 in chips)
Seat 3: Hero ($10.53 in chips)
Seat 4: 16db37a3 ($11.61 in chips)
Seat 5: 3418c0f ($4.2 in chips)
Seat 6: e6a3a3d7 ($1.96 in chips)
eeb4ff60: posts small blind $0.02
Hero: posts big blind $0.05
*** HOLE CARDS ***
Dealt to 55f38a46 
Dealt to eeb4ff60 
Dealt to Hero [5s 5d]
Dealt to 16db37a3 
Dealt to 3418c0f 
Dealt to e6a3a3d7 
16db37a3: folds
3418c0f: folds
e6a3a3d7: raises $0.07 to $0.12
55f38a46: folds
eeb4ff60: folds
Hero: calls $0.07
*** FLOP *** [Ah Jd Qd]
Hero: checks
e6a3a3d7: checks
*** TURN *** [Ah Jd Qd] [Ad]
Hero: checks
e6a3a3d7: bets $0.09
Hero: calls $0.09
*** RIVER *** [Ah Jd Qd Ad] [9h]
Hero: checks
e6a3a3d7: checks
Hero: shows [5s 5d] (Pair of Aces and Pair of Fives)
e6a3a3d7: shows [Jc Th] (Pair of Aces and Pair of Jacks)
*** SHOWDOWN ***
e6a3a3d7 collected $0.42 from pot
*** SUMMARY ***
Total pot $0.44 | Rake $0.02 | Jackpot $0 | Bingo $0 | Fortune $0 | Tax $0
Board [Ah Jd Qd Ad 9h]
Seat 1: 55f38a46 (button) folded before Flop (didn't bet)
Seat 2: eeb4ff60 (small blind) folded before Flop
Seat 3: Hero (big blind) showed [5s 5d] and lost with Pair of Aces and Pair of Fives
Seat 4: 16db37a3 folded before Flop (didn't bet)
Seat 5: 3418c0f folded before Flop (didn't bet)
Seat 6: e6a3a3d7 showed [Jc Th] and won ($0.42) with Pair of Aces and Pair of Jacks


Poker Hand #RC2094680136: Hold'em No Limit ($0.02/$0.05) - 2023/12/27 21:24:51
Table 'RushAndCash3806402' 6-max Seat #1 is the button
Seat 1: 4329ea35 ($7.19 in chips)
Seat 2: 384d6fac ($5.14 in chips)
Seat 3: 5d2d5103 ($5.43 in chips)
Seat 4: Hero ($10.63 in chips)
Seat 5: 333ceba2 ($20.79 in chips)
Seat 6: a67d8432 ($10.72 in chips)
384d6fac: posts small blind $0.02
5d2d5103: posts big blind $0.05
*** HOLE CARDS ***
Dealt to 4329ea35 
Dealt to 384d6fac 
Dealt to 5d2d5103 
Dealt to Hero [Jh 9h]
Dealt to 333ceba2 
Dealt to a67d8432 
Hero: raises $0.05 to $0.1
333ceba2: folds
a67d8432: folds
4329ea35: calls $0.1
384d6fac: folds
5d2d5103: folds
*** FLOP *** [Qc 6h 2c]
Hero: checks
4329ea35: checks
*** TURN *** [Qc 6h 2c] [Ac]
Hero: checks
4329ea35: checks
*** RIVER *** [Qc 6h 2c Ac] [Kd]
Hero: checks
4329ea35: checks
Hero: shows [Jh 9h] (Ace-High)
4329ea35: shows [Js Ks] (Pair of Kings)
*** SHOWDOWN ***
4329ea35 collected $0.26 from pot
*** SUMMARY ***
Total pot $0.27 | Rake $0.01 | Jackpot $0 | Bingo $0 | Fortune $0 | Tax $0
Board [Qc 6h 2c Ac Kd]
Seat 1: 4329ea35 (button) showed [Js Ks] and won ($0.26) with Pair of Kings
Seat 2: 384d6fac (small blind) folded before Flop
Seat 3: 5d2d5103 (big blind) folded before Flop
Seat 4: Hero showed [Jh 9h] and lost with Ace-High
Seat 5: 333ceba2 folded before Flop (didn't bet)
Seat 6: a67d8432 folded before Flop (didn't bet)


Poker Hand #RC2094679914: Hold'em No Limit ($0.02/$0.05) - 2023/12/27 21:24:40
Table 'RushAndCash3806299' 6-max Seat #1 is the button
Seat 1: 87acde28 ($6.97 in chips)
Seat 2: Hero ($10.65 in chips)
Seat 3: 28cffda ($7.81 in chips)
Seat 4: 13aeadf3 ($5.75 in chips)
Seat 5: 6431e365 ($7.7 in chips)
Seat 6: c8fb6a44 ($6.06 in chips)
Hero: posts small blind $0.02
28cffda: posts big blind $0.05
*** HOLE CARDS ***
Dealt to 87acde28 
Dealt to Hero [2d Tc]
Dealt to 28cffda 
Dealt to 13aeadf3 
Dealt to 6431e365 
Dealt to c8fb6a44 
13aeadf3: folds
6431e365: raises $0.1 to $0.15
c8fb6a44: raises $0.28 to $0.43
87acde28: folds
Hero: folds
28cffda: folds
6431e365: folds
Uncalled bet ($0.28) returned to c8fb6a44
*** SHOWDOWN ***
c8fb6a44 collected $0.36 from pot
*** SUMMARY ***
Total pot $0.37 | Rake $0.01 | Jackpot $0 | Bingo $0 | Fortune $0 | Tax $0
Seat 1: 87acde28 (button) folded before Flop (didn't bet)
Seat 2: Hero (small blind) folded before Flop
Seat 3: 28cffda (big blind) folded before Flop
Seat 4: 13aeadf3 folded before Flop (didn't bet)
Seat 5: 6431e365 folded before Flop
Seat 6: c8fb6a44 collected ($0.36)


Poker Hand #RC2094679809: Hold'em No Limit ($0.02/$0.05) - 2023/12/27 21:24:36
Table 'RushAndCash3806248' 6-max Seat #1 is the button
Seat 1: 1031d375 ($5.07 in chips)
Seat 2: d2511a5c ($6.72 in chips)
Seat 3: d56b6fa1 ($6.54 in chips)
Seat 4: f9dc2aeb ($28.6 in chips)
Seat 5: 292278f1 ($7.88 in chips)
Seat 6: Hero ($10.65 in chips)
d2511a5c: posts small blind $0.02
d56b6fa1: posts big blind $0.05
*** HOLE CARDS ***
Dealt to 1031d375 
Dealt to d2511a5c 
Dealt to d56b6fa1 
Dealt to f9dc2aeb 
Dealt to 292278f1 
Dealt to Hero [8c 4s]
f9dc2aeb: raises $0.1 to $0.15
292278f1: folds
Hero: folds
1031d375: folds
d2511a5c: folds
d56b6fa1: folds
Uncalled bet ($0.1) returned to f9dc2aeb
*** SHOWDOWN ***
f9dc2aeb collected $0.12 from pot
*** SUMMARY ***
Total pot $0.12 | Rake $0 | Jackpot $0 | Bingo $0 | Fortune $0 | Tax $0
Seat 1: 1031d375 (button) folded before Flop (didn't bet)
Seat 2: d2511a5c (small blind) folded before Flop
Seat 3: d56b6fa1 (big blind) folded before Flop
Seat 4: f9dc2aeb collected ($0.12)
Seat 5: 292278f1 folded before Flop (didn't bet)
Seat 6: Hero folded before Flop (didn't bet)


Poker Hand #RC2094679639: Hold'em No Limit ($0.02/$0.05) - 2023/12/27 21:24:27
Table 'RushAndCash3806165' 6-max Seat #1 is the button
Seat 1: bc79e3f1 ($13.22 in chips)
Seat 2: a67d8432 ($10.72 in chips)
Seat 3: d4230c47 ($15.33 in chips)
Seat 4: 5a3f5337 ($2.98 in chips)
Seat 5: Hero ($10.65 in chips)
Seat 6: cbc529ce ($9.95 in chips)
a67d8432: posts small blind $0.02
d4230c47: posts big blind $0.05
*** HOLE CARDS ***
Dealt to bc79e3f1 
Dealt to a67d8432 
Dealt to d4230c47 
Dealt to 5a3f5337 
Dealt to Hero [5h 7h]
Dealt to cbc529ce 
5a3f5337: raises $0.05 to $0.1
Hero: folds
cbc529ce: folds
bc79e3f1: folds
a67d8432: folds
d4230c47: folds
Uncalled bet ($0.05) returned to 5a3f5337
*** SHOWDOWN ***
5a3f5337 collected $0.12 from pot
*** SUMMARY ***
Total pot $0.12 | Rake $0 | Jackpot $0 | Bingo $0 | Fortune $0 | Tax $0
Seat 1: bc79e3f1 (button) folded before Flop (didn't bet)
Seat 2: a67d8432 (small blind) folded before Flop
Seat 3: d4230c47 (big blind) folded before Flop
Seat 4: 5a3f5337 collected ($0.12)
Seat 5: Hero folded before Flop (didn't bet)
Seat 6: cbc529ce folded before Flop (didn't bet)


Poker Hand #RC2094679561: Hold'em No Limit ($0.02/$0.05) - 2023/12/27 21:24:23
Table 'RushAndCash3806129' 6-max Seat #1 is the button
Seat 1: 7f263f67 ($8.12 in chips)
Seat 2: 9429c263 ($9.5 in chips)
Seat 3: 3d951ecb ($5.46 in chips)
Seat 4: Hero ($10.65 in chips)
Seat 5: 51f23bfe ($9.79 in chips)
Seat 6: 99cc09db ($5.29 in chips)
9429c263: posts small blind $0.02
3d951ecb: posts big blind $0.05
*** HOLE CARDS ***
Dealt to 7f263f67 
Dealt to 9429c263 
Dealt to 3d951ecb 
Dealt to Hero [8d Ks]
Dealt to 51f23bfe 
Dealt to 99cc09db 
Hero: folds
51f23bfe: folds
99cc09db: folds
7f263f67: raises $0.1 to $0.15
9429c263: folds
3d951ecb: folds
Uncalled bet ($0.1) returned to 7f263f67
*** SHOWDOWN ***
7f263f67 collected $0.12 from pot
*** SUMMARY ***
Total pot $0.12 | Rake $0 | Jackpot $0 | Bingo $0 | Fortune $0 | Tax $0
Seat 1: 7f263f67 (button) collected ($0.12)
Seat 2: 9429c263 (small blind) folded before Flop
Seat 3: 3d951ecb (big blind) folded before Flop
Seat 4: Hero folded before Flop (didn't bet)
Seat 5: 51f23bfe folded before Flop (didn't bet)
Seat 6: 99cc09db folded before Flop (didn't bet)


Poker Hand #RC2094679493: Hold'em No Limit ($0.02/$0.05) - 2023/12/27 21:24:19
Table 'RushAndCash3806094' 6-max Seat #1 is the button
Seat 1: Hero ($10.65 in chips)
Seat 2: 49d204ad ($6.73 in chips)
Seat 3: e47262d ($4.93 in chips)
Seat 4: f100600f ($5.06 in chips)
Seat 5: 19879f5e ($4.93 in chips)
Seat 6: 3d4025bf ($5 in chips)
49d204ad: posts small blind $0.02
e47262d: posts big blind $0.05
*** HOLE CARDS ***
Dealt to Hero [6s Ah]
Dealt to 49d204ad 
Dealt to e47262d 
Dealt to f100600f 
Dealt to 19879f5e 
Dealt to 3d4025bf 
f100600f: folds
19879f5e: folds
3d4025bf: folds
Hero: folds
49d204ad: raises $0.05 to $0.1
e47262d: calls $0.05
*** FLOP *** [Tc 9d Jd]
49d204ad: checks
e47262d: bets $0.07
49d204ad: folds
Uncalled bet ($0.07) returned to e47262d
*** SHOWDOWN ***
e47262d collected $0.19 from pot
*** SUMMARY ***
Total pot $0.2 | Rake $0.01 | Jackpot $0 | Bingo $0 | Fortune $0 | Tax $0
Board [Tc 9d Jd]
Seat 1: Hero (button) folded before Flop (didn't bet)
Seat 2: 49d204ad (small blind) folded on the Flop
Seat 3: e47262d (big blind) won ($0.19)
Seat 4: f100600f folded before Flop (didn't bet)
Seat 5: 19879f5e folded before Flop (didn't bet)
Seat 6: 3d4025bf folded before Flop (didn't bet)


Poker Hand #RC2094679417: Hold'em No Limit ($0.02/$0.05) - 2023/12/27 21:24:16
Table 'RushAndCash3806061' 6-max Seat #1 is the button
Seat 1: b7dc02f3 ($8.28 in chips)
Seat 2: 79055c43 ($5.04 in chips)
Seat 3: 7f263f67 ($8.1 in chips)
Seat 4: 1ce331cb ($5.12 in chips)
Seat 5: Hero ($10.65 in chips)
Seat 6: 21c1390f ($5.07 in chips)
79055c43: posts small blind $0.02
7f263f67: posts big blind $0.05
*** HOLE CARDS ***
Dealt to b7dc02f3 
Dealt to 79055c43 
Dealt to 7f263f67 
Dealt to 1ce331cb 
Dealt to Hero [2d 5s]
Dealt to 21c1390f 
1ce331cb: folds
Hero: folds
21c1390f: folds
b7dc02f3: folds
79055c43: folds
Uncalled bet ($0.03) returned to 7f263f67
*** SHOWDOWN ***
7f263f67 collected $0.04 from pot
*** SUMMARY ***
Total pot $0.04 | Rake $0 | Jackpot $0 | Bingo $0 | Fortune $0 | Tax $0
Seat 1: b7dc02f3 (button) folded before Flop (didn't bet)
Seat 2: 79055c43 (small blind) folded before Flop
Seat 3: 7f263f67 (big blind) collected ($0.04)
Seat 4: 1ce331cb folded before Flop (didn't bet)
Seat 5: Hero folded before Flop (didn't bet)
Seat 6: 21c1390f folded before Flop (didn't bet)


Poker Hand #RC2094677965: Hold'em No Limit ($0.02/$0.05) - 2023/12/27 21:23:05
Table 'RushAndCash3805344' 6-max Seat #1 is the button
Seat 1: Hero ($9.29 in chips)
Seat 2: 7f263f67 ($9.63 in chips)
Seat 3: 3fdbaf1e ($5.29 in chips)
Seat 4: d56b6fa1 ($6.56 in chips)
Seat 5: 60cc4018 ($2.96 in chips)
Seat 6: 9c855748 ($3.85 in chips)
7f263f67: posts small blind $0.02
3fdbaf1e: posts big blind $0.05
*** HOLE CARDS ***
Dealt to Hero [6s 6c]
Dealt to 7f263f67 
Dealt to 3fdbaf1e 
Dealt to d56b6fa1 
Dealt to 60cc4018 
Dealt to 9c855748 
d56b6fa1: folds
60cc4018: folds
9c855748: folds
Hero: raises $0.08 to $0.13
7f263f67: raises $0.31 to $0.44
3fdbaf1e: folds
Hero: calls $0.31
*** FLOP *** [6h 5c Ts]
7f263f67: checks
Hero: bets $0.47
7f263f67: calls $0.47
*** TURN *** [6h 5c Ts] [5s]
7f263f67: checks
Hero: bets $0.62
7f263f67: calls $0.62
*** RIVER *** [6h 5c Ts 5s] [Td]
7f263f67: checks
Hero: checks
7f263f67: shows [Kc Ah] (Pair of Tens and Pair of Fives)
Hero: shows [6s 6c] (Sixes Full over Tens)
*** SHOWDOWN ***
Hero collected $2.89 from pot
*** SUMMARY ***
Total pot $3.11 | Rake $0.15 | Jackpot $0.07 | Bingo $0 | Fortune $0 | Tax $0
Board [6h 5c Ts 5s Td]
Seat 1: Hero (button) showed [6s 6c] and won ($2.89) with Sixes Full over Tens
Seat 2: 7f263f67 (small blind) showed [Kc Ah] and lost with Pair of Tens and Pair of Fives
Seat 3: 3fdbaf1e (big blind) folded before Flop
Seat 4: d56b6fa1 folded before Flop (didn't bet)
Seat 5: 60cc4018 folded before Flop (didn't bet)
Seat 6: 9c855748 folded before Flop (didn't bet)


Poker Hand #RC2094677892: Hold'em No Limit ($0.02/$0.05) - 2023/12/27 21:23:02
Table 'RushAndCash3805308' 6-max Seat #1 is the button
Seat 1: 69f7ac74 ($12.64 in chips)
Seat 2: Hero ($9.31 in chips)
Seat 3: 7f3a83e1 ($5.07 in chips)
Seat 4: 320a9cdc ($3.15 in chips)
Seat 5: 806e60a7 ($13.57 in chips)
Seat 6: 60cc4018 ($2.96 in chips)
Hero: posts small blind $0.02
7f3a83e1: posts big blind $0.05
*** HOLE CARDS ***
Dealt to 69f7ac74 
Dealt to Hero [2h 8c]
Dealt to 7f3a83e1 
Dealt to 320a9cdc 
Dealt to 806e60a7 
Dealt to 60cc4018 
320a9cdc: folds
806e60a7: folds
60cc4018: folds
69f7ac74: folds
Hero: folds
Uncalled bet ($0.03) returned to 7f3a83e1
*** SHOWDOWN ***
7f3a83e1 collected $0.04 from pot
*** SUMMARY ***
Total pot $0.04 | Rake $0 | Jackpot $0 | Bingo $0 | Fortune $0 | Tax $0
Seat 1: 69f7ac74 (button) folded before Flop (didn't bet)
Seat 2: Hero (small blind) folded before Flop
Seat 3: 7f3a83e1 (big blind) collected ($0.04)
Seat 4: 320a9cdc folded before Flop (didn't bet)
Seat 5: 806e60a7 folded before Flop (didn't bet)
Seat 6: 60cc4018 folded before Flop (didn't bet)


Poker Hand #RC2094677094: Hold'em No Limit ($0.02/$0.05) - 2023/12/27 21:22:23
Table 'RushAndCash3804932' 6-max Seat #1 is the button
Seat 1: f66da416 ($5 in chips)
Seat 2: fc10e886 ($10.18 in chips)
Seat 3: 87acde28 ($7.5 in chips)
Seat 4: Hero ($9.55 in chips)
Seat 5: c80cb8d4 ($5.79 in chips)
Seat 6: 28cffda ($8.14 in chips)
fc10e886: posts small blind $0.02
87acde28: posts big blind $0.05
*** HOLE CARDS ***
Dealt to f66da416 
Dealt to fc10e886 
Dealt to 87acde28 
Dealt to Hero [Kd Kc]
Dealt to c80cb8d4 
Dealt to 28cffda 
Hero: raises $0.05 to $0.1
c80cb8d4: calls $0.1
28cffda: folds
f66da416: folds
fc10e886: folds
87acde28: folds
*** FLOP *** [4s Ts 7c]
Hero: bets $0.14
c80cb8d4: calls $0.14
*** TURN *** [4s Ts 7c] [Ad]
Hero: checks
c80cb8d4: bets $0.42
Hero: folds
Uncalled bet ($0.42) returned to c80cb8d4
*** SHOWDOWN ***
c80cb8d4 collected $0.53 from pot
*** SUMMARY ***
Total pot $0.55 | Rake $0.02 | Jackpot $0 | Bingo $0 | Fortune $0 | Tax $0
Board [4s Ts 7c Ad]
Seat 1: f66da416 (button) folded before Flop (didn't bet)
Seat 2: fc10e886 (small blind) folded before Flop
Seat 3: 87acde28 (big blind) folded before Flop
Seat 4: Hero folded on the Turn
Seat 5: c80cb8d4 won ($0.53)
Seat 6: 28cffda folded before Flop (didn't bet)


Poker Hand #RC2094676536: Hold'em No Limit ($0.02/$0.05) - 2023/12/27 21:21:55
Table 'RushAndCash3804656' 6-max Seat #1 is the button
Seat 1: e88c36ac ($5.87 in chips)
Seat 2: e9d93b79 ($5.02 in chips)
Seat 3: Hero ($9.67 in chips)
Seat 4: 57ba2dfd ($3.67 in chips)
Seat 5: 14c369ea ($3.37 in chips)
Seat 6: 87acde28 ($7.37 in chips)
e9d93b79: posts small blind $0.02
Hero: posts big blind $0.05
*** HOLE CARDS ***
Dealt to e88c36ac 
Dealt to e9d93b79 
Dealt to Hero [7d 7s]
Dealt to 57ba2dfd 
Dealt to 14c369ea 
Dealt to 87acde28 
57ba2dfd: folds
14c369ea: folds
87acde28: raises $0.07 to $0.12
e88c36ac: folds
e9d93b79: folds
Hero: calls $0.07
*** FLOP *** [Ts Qs 5h]
Hero: checks
87acde28: bets $0.2
Hero: folds
Uncalled bet ($0.2) returned to 87acde28
*** SHOWDOWN ***
87acde28 collected $0.25 from pot
*** SUMMARY ***
Total pot $0.26 | Rake $0.01 | Jackpot $0 | Bingo $0 | Fortune $0 | Tax $0
Board [Ts Qs 5h]
Seat 1: e88c36ac (button) folded before Flop (didn't bet)
Seat 2: e9d93b79 (small blind) folded before Flop
Seat 3: Hero (big blind) folded on the Flop
Seat 4: 57ba2dfd folded before Flop (didn't bet)
Seat 5: 14c369ea folded before Flop (didn't bet)
Seat 6: 87acde28 won ($0.25)


Poker Hand #RC2094676468: Hold'em No Limit ($0.02/$0.05) - 2023/12/27 21:21:52
Table 'RushAndCash3804622' 6-max Seat #1 is the button
Seat 1: f8e9924c ($4.82 in chips)
Seat 2: a7bfee05 ($5.05 in chips)
Seat 3: 80d7389a ($7.19 in chips)
Seat 4: b2f778b3 ($12.82 in chips)
Seat 5: 14c369ea ($3.37 in chips)
Seat 6: Hero ($9.67 in chips)
a7bfee05: posts small blind $0.02
80d7389a: posts big blind $0.05
*** HOLE CARDS ***
Dealt to f8e9924c 
Dealt to a7bfee05 
Dealt to 80d7389a 
Dealt to b2f778b3 
Dealt to 14c369ea 
Dealt to Hero [Td 2d]
b2f778b3: folds
14c369ea: folds
Hero: folds
f8e9924c: raises $0.08 to $0.13
a7bfee05: folds
80d7389a: calls $0.08
*** FLOP *** [Js Th 5c]
80d7389a: checks
f8e9924c: bets $0.16
80d7389a: folds
Uncalled bet ($0.16) returned to f8e9924c
*** SHOWDOWN ***
f8e9924c collected $0.27 from pot
*** SUMMARY ***
Total pot $0.28 | Rake $0.01 | Jackpot $0 | Bingo $0 | Fortune $0 | Tax $0
Board [Js Th 5c]
Seat 1: f8e9924c (button) won ($0.27)
Seat 2: a7bfee05 (small blind) folded before Flop
Seat 3: 80d7389a (big blind) folded on the Flop
Seat 4: b2f778b3 folded before Flop (didn't bet)
Seat 5: 14c369ea folded before Flop (didn't bet)
Seat 6: Hero folded before Flop (didn't bet)


Poker Hand #RC2094676388: Hold'em No Limit ($0.02/$0.05) - 2023/12/27 21:21:48
Table 'RushAndCash3804582' 6-max Seat #1 is the button
Seat 1: 245b14fe ($5.84 in chips)
Seat 2: 2fbdc427 ($4.51 in chips)
Seat 3: b2f778b3 ($12.87 in chips)
Seat 4: Hero ($9.67 in chips)
Seat 5: 4da0542c ($5.37 in chips)
Seat 6: 333150d4 ($5 in chips)
2fbdc427: posts small blind $0.02
b2f778b3: posts big blind $0.05
*** HOLE CARDS ***
Dealt to 245b14fe 
Dealt to 2fbdc427 
Dealt to b2f778b3 
Dealt to Hero [Ks 6h]
Dealt to 4da0542c 
Dealt to 333150d4 
Hero: folds
4da0542c: folds
333150d4: folds
245b14fe: raises $0.08 to $0.13
2fbdc427: calls $0.11
b2f778b3: folds
*** FLOP *** [5h Ah Jd]
2fbdc427: checks
245b14fe: bets $0.16
2fbdc427: folds
Uncalled bet ($0.16) returned to 245b14fe
*** SHOWDOWN ***
245b14fe collected $0.3 from pot
*** SUMMARY ***
Total pot $0.31 | Rake $0.01 | Jackpot $0 | Bingo $0 | Fortune $0 | Tax $0
Board [5h Ah Jd]
Seat 1: 245b14fe (button) won ($0.3)
Seat 2: 2fbdc427 (small blind) folded on the Flop
Seat 3: b2f778b3 (big blind) folded before Flop
Seat 4: Hero folded before Flop (didn't bet)
Seat 5: 4da0542c folded before Flop (didn't bet)
Seat 6: 333150d4 folded before Flop (didn't bet)


Poker Hand #RC2094676245: Hold'em No Limit ($0.02/$0.05) - 2023/12/27 21:21:42
Table 'RushAndCash3804507' 6-max Seat #1 is the button
Seat 1: b921ba92 ($13.57 in chips)
Seat 2: ed041cf ($5.02 in chips)
Seat 3: Hero ($9.72 in chips)
Seat 4: 4ffb088b ($5.31 in chips)
Seat 5: c7d29ab9 ($5.3 in chips)
Seat 6: 333150d4 ($5 in chips)
ed041cf: posts small blind $0.02
Hero: posts big blind $0.05
*** HOLE CARDS ***
Dealt to b921ba92 
Dealt to ed041cf 
Dealt to Hero [Tc 8s]
Dealt to 4ffb088b 
Dealt to c7d29ab9 
Dealt to 333150d4 
4ffb088b: folds
c7d29ab9: folds
333150d4: folds
b921ba92: raises $0.07 to $0.12
ed041cf: folds
Hero: folds
Uncalled bet ($0.07) returned to b921ba92
*** SHOWDOWN ***
b921ba92 collected $0.12 from pot
*** SUMMARY ***
Total pot $0.12 | Rake $0 | Jackpot $0 | Bingo $0 | Fortune $0 | Tax $0
Seat 1: b921ba92 (button) collected ($0.12)
Seat 2: ed041cf (small blind) folded before Flop
Seat 3: Hero (big blind) folded before Flop
Seat 4: 4ffb088b folded before Flop (didn't bet)
Seat 5: c7d29ab9 folded before Flop (didn't bet)
Seat 6: 333150d4 folded before Flop (didn't bet)


Poker Hand #RC2094676133: Hold'em No Limit ($0.02/$0.05) - 2023/12/27 21:21:36
Table 'RushAndCash3804451' 6-max Seat #1 is the button
Seat 1: 8aeab93d ($5 in chips)
Seat 2: 633ada18 ($5.88 in chips)
Seat 3: ce4b1f8 ($2.16 in chips)
Seat 4: cb971fe5 ($5 in chips)
Seat 5: Hero ($9.72 in chips)
Seat 6: a5ef72f7 ($7.2 in chips)
633ada18: posts small blind $0.02
ce4b1f8: posts big blind $0.05
*** HOLE CARDS ***
Dealt to 8aeab93d 
Dealt to 633ada18 
Dealt to ce4b1f8 
Dealt to cb971fe5 
Dealt to Hero [Td Qh]
Dealt to a5ef72f7 
cb971fe5: folds
Hero: folds
a5ef72f7: folds
8aeab93d: raises $0.07 to $0.12
633ada18: folds
ce4b1f8: calls $0.07
*** FLOP *** [Th 9c Qd]
ce4b1f8: checks
8aeab93d: checks
*** TURN *** [Th 9c Qd] [5s]
ce4b1f8: checks
8aeab93d: checks
*** RIVER *** [Th 9c Qd 5s] [3d]
ce4b1f8: checks
8aeab93d: checks
ce4b1f8: shows [7d 4s] (Queen-High)
8aeab93d: shows [9h 6h] (Pair of Nines)
*** SHOWDOWN ***
8aeab93d collected $0.25 from pot
*** SUMMARY ***
Total pot $0.26 | Rake $0.01 | Jackpot $0 | Bingo $0 | Fortune $0 | Tax $0
Board [Th 9c Qd 5s 3d]
Seat 1: 8aeab93d (button) showed [9h 6h] and won ($0.25) with Pair of Nines
Seat 2: 633ada18 (small blind) folded before Flop
Seat 3: ce4b1f8 (big blind) showed [7d 4s] and lost with Queen-High
Seat 4: cb971fe5 folded before Flop (didn't bet)
Seat 5: Hero folded before Flop (didn't bet)
Seat 6: a5ef72f7 folded before Flop (didn't bet)


Poker Hand #RC2094676063: Hold'em No Limit ($0.02/$0.05) - 2023/12/27 21:21:33
Table 'RushAndCash3804416' 6-max Seat #1 is the button
Seat 1: 295c493 ($3.35 in chips)
Seat 2: Hero ($9.74 in chips)
Seat 3: 4b857f1e ($6.2 in chips)
Seat 4: ab59cb2 ($5.61 in chips)
Seat 5: 79a53f37 ($10.96 in chips)
Seat 6: 3f587bf6 ($8.36 in chips)
Hero: posts small blind $0.02
4b857f1e: posts big blind $0.05
*** HOLE CARDS ***
Dealt to 295c493 
Dealt to Hero [Td 6s]
Dealt to 4b857f1e 
Dealt to ab59cb2 
Dealt to 79a53f37 
Dealt to 3f587bf6 
ab59cb2: folds
79a53f37: raises $0.05 to $0.1
3f587bf6: folds
295c493: folds
Hero: folds
4b857f1e: folds
Uncalled bet ($0.05) returned to 79a53f37
*** SHOWDOWN ***
79a53f37 collected $0.12 from pot
*** SUMMARY ***
Total pot $0.12 | Rake $0 | Jackpot $0 | Bingo $0 | Fortune $0 | Tax $0
Seat 1: 295c493 (button) folded before Flop (didn't bet)
Seat 2: Hero (small blind) folded before Flop
Seat 3: 4b857f1e (big blind) folded before Flop
Seat 4: ab59cb2 folded before Flop (didn't bet)
Seat 5: 79a53f37 collected ($0.12)
Seat 6: 3f587bf6 folded before Flop (didn't bet)


Poker Hand #RC2094675996: Hold'em No Limit ($0.02/$0.05) - 2023/12/27 21:21:29
Table 'RushAndCash3804383' 6-max Seat #1 is the button
Seat 1: Hero ($9.74 in chips)
Seat 2: 39cd590d ($3.12 in chips)
Seat 3: a3ae3500 ($7.24 in chips)
Seat 4: 64a99d65 ($5.38 in chips)
Seat 5: 1336d3f3 ($5.07 in chips)
Seat 6: 3aa764ba ($6.06 in chips)
39cd590d: posts small blind $0.02
a3ae3500: posts big blind $0.05
*** HOLE CARDS ***
Dealt to Hero [7d 6h]
Dealt to 39cd590d 
Dealt to a3ae3500 
Dealt to 64a99d65 
Dealt to 1336d3f3 
Dealt to 3aa764ba 
64a99d65: raises $0.1 to $0.15
1336d3f3: calls $0.15
3aa764ba: folds
Hero: folds
39cd590d: folds
a3ae3500: folds
*** FLOP *** [8d 4c 7s]
64a99d65: bets $0.19
1336d3f3: calls $0.19
*** TURN *** [8d 4c 7s] [2s]
64a99d65: bets $0.57
1336d3f3: calls $0.57
*** RIVER *** [8d 4c 7s 2s] [Ts]
64a99d65: bets $1.42
1336d3f3: calls $1.42
64a99d65: shows [8s 8h] (Three Eights)
1336d3f3: shows [Kd Tc] (Pair of Tens)
*** SHOWDOWN ***
64a99d65 collected $4.51 from pot
*** SUMMARY ***
Total pot $4.73 | Rake $0.15 | Jackpot $0.07 | Bingo $0 | Fortune $0 | Tax $0
Board [8d 4c 7s 2s Ts]
Seat 1: Hero (button) folded before Flop (didn't bet)
Seat 2: 39cd590d (small blind) folded before Flop
Seat 3: a3ae3500 (big blind) folded before Flop
Seat 4: 64a99d65 showed [8s 8h] and won ($4.51) with Three Eights
Seat 5: 1336d3f3 showed [Kd Tc] and lost with Pair of Tens
Seat 6: 3aa764ba folded before Flop (didn't bet)


Poker Hand #RC2094675920: Hold'em No Limit ($0.02/$0.05) - 2023/12/27 21:21:25
Table 'RushAndCash3804346' 6-max Seat #1 is the button
Seat 1: e34e4787 ($5 in chips)
Seat 2: 3f587bf6 ($8.38 in chips)
Seat 3: 2e81a1b9 ($3.99 in chips)
Seat 4: Hero ($9.74 in chips)
Seat 5: 90080b9e ($5.02 in chips)
Seat 6: 869cd4a ($5 in chips)
3f587bf6: posts small blind $0.02
2e81a1b9: posts big blind $0.05
*** HOLE CARDS ***
Dealt to e34e4787 
Dealt to 3f587bf6 
Dealt to 2e81a1b9 
Dealt to Hero [9s 6h]
Dealt to 90080b9e 
Dealt to 869cd4a 
Hero: folds
90080b9e: folds
869cd4a: folds
e34e4787: folds
3f587bf6: folds
Uncalled bet ($0.03) returned to 2e81a1b9
*** SHOWDOWN ***
2e81a1b9 collected $0.04 from pot
*** SUMMARY ***
Total pot $0.04 | Rake $0 | Jackpot $0 | Bingo $0 | Fortune $0 | Tax $0
Seat 1: e34e4787 (button) folded before Flop (didn't bet)
Seat 2: 3f587bf6 (small blind) folded before Flop
Seat 3: 2e81a1b9 (big blind) collected ($0.04)
Seat 4: Hero folded before Flop (didn't bet)
Seat 5: 90080b9e folded before Flop (didn't bet)
Seat 6: 869cd4a folded before Flop (didn't bet)


Poker Hand #RC2094675822: Hold'em No Limit ($0.02/$0.05) - 2023/12/27 21:21:21
Table 'RushAndCash3804299' 6-max Seat #1 is the button
Seat 1: 8bff79df ($7.57 in chips)
Seat 2: 7d2ad224 ($5 in chips)
Seat 3: Hero ($9.79 in chips)
Seat 4: 633ada18 ($5.88 in chips)
Seat 5: 1f8f446a ($5.61 in chips)
Seat 6: 94497711 ($5 in chips)
7d2ad224: posts small blind $0.02
Hero: posts big blind $0.05
*** HOLE CARDS ***
Dealt to 8bff79df 
Dealt to 7d2ad224 
Dealt to Hero [Ks 6h]
Dealt to 633ada18 
Dealt to 1f8f446a 
Dealt to 94497711 
633ada18: folds
1f8f446a: folds
94497711: folds
8bff79df: folds
7d2ad224: raises $0.05 to $0.1
Hero: folds
Uncalled bet ($0.05) returned to 7d2ad224
*** SHOWDOWN ***
7d2ad224 collected $0.1 from pot
*** SUMMARY ***
Total pot $0.1 | Rake $0 | Jackpot $0 | Bingo $0 | Fortune $0 | Tax $0
Seat 1: 8bff79df (button) folded before Flop (didn't bet)
Seat 2: 7d2ad224 (small blind) collected ($0.1)
Seat 3: Hero (big blind) folded before Flop
Seat 4: 633ada18 folded before Flop (didn't bet)
Seat 5: 1f8f446a folded before Flop (didn't bet)
Seat 6: 94497711 folded before Flop (didn't bet)


Poker Hand #RC2094675751: Hold'em No Limit ($0.02/$0.05) - 2023/12/27 21:21:18
Table 'RushAndCash3804265' 6-max Seat #1 is the button
Seat 1: 8c9da424 ($5 in chips)
Seat 2: Hero ($9.81 in chips)
Seat 3: 28c93b77 ($5.82 in chips)
Seat 4: 9c0fd254 ($5.4 in chips)
Seat 5: efe1f2b5 ($11.54 in chips)
Seat 6: e8e85a69 ($5.36 in chips)
Hero: posts small blind $0.02
28c93b77: posts big blind $0.05
*** HOLE CARDS ***
Dealt to 8c9da424 
Dealt to Hero [6d 3s]
Dealt to 28c93b77 
Dealt to 9c0fd254 
Dealt to efe1f2b5 
Dealt to e8e85a69 
9c0fd254: folds
efe1f2b5: folds
e8e85a69: folds
8c9da424: raises $0.08 to $0.13
Hero: folds
28c93b77: folds
Uncalled bet ($0.08) returned to 8c9da424
*** SHOWDOWN ***
8c9da424 collected $0.12 from pot
*** SUMMARY ***
Total pot $0.12 | Rake $0 | Jackpot $0 | Bingo $0 | Fortune $0 | Tax $0
Seat 1: 8c9da424 (button) collected ($0.12)
Seat 2: Hero (small blind) folded before Flop
Seat 3: 28c93b77 (big blind) folded before Flop
Seat 4: 9c0fd254 folded before Flop (didn't bet)
Seat 5: efe1f2b5 folded before Flop (didn't bet)
Seat 6: e8e85a69 folded before Flop (didn't bet)


Poker Hand #RC2094675675: Hold'em No Limit ($0.02/$0.05) - 2023/12/27 21:21:13
Table 'RushAndCash3804227' 6-max Seat #1 is the button
Seat 1: 511583d3 ($9.85 in chips)
Seat 2: 1a55a4ac ($5 in chips)
Seat 3: e9a9e4b6 ($2.12 in chips)
Seat 4: f7afce21 ($3.33 in chips)
Seat 5: e10a687f ($10.55 in chips)
Seat 6: Hero ($9.81 in chips)
1a55a4ac: posts small blind $0.02
e9a9e4b6: posts big blind $0.05
*** HOLE CARDS ***
Dealt to 511583d3 
Dealt to 1a55a4ac 
Dealt to e9a9e4b6 
Dealt to f7afce21 
Dealt to e10a687f 
Dealt to Hero [6h 8d]
f7afce21: raises $0.08 to $0.13
e10a687f: folds
Hero: folds
511583d3: folds
1a55a4ac: folds
e9a9e4b6: folds
Uncalled bet ($0.08) returned to f7afce21
*** SHOWDOWN ***
f7afce21 collected $0.12 from pot
*** SUMMARY ***
Total pot $0.12 | Rake $0 | Jackpot $0 | Bingo $0 | Fortune $0 | Tax $0
Seat 1: 511583d3 (button) folded before Flop (didn't bet)
Seat 2: 1a55a4ac (small blind) folded before Flop
Seat 3: e9a9e4b6 (big blind) folded before Flop
Seat 4: f7afce21 collected ($0.12)
Seat 5: e10a687f folded before Flop (didn't bet)
Seat 6: Hero folded before Flop (didn't bet)


Poker Hand #RC2094675402: Hold'em No Limit ($0.02/$0.05) - 2023/12/27 21:21:00
Table 'RushAndCash3804093' 6-max Seat #1 is the button
Seat 1: c7d29ab9 ($5.21 in chips)
Seat 2: 99c31039 ($5.19 in chips)
Seat 3: 959f22e1 ($12.89 in chips)
Seat 4: 75e6f27d ($5.38 in chips)
Seat 5: Hero ($9.74 in chips)
Seat 6: 16c4771 ($5.24 in chips)
99c31039: posts small blind $0.02
959f22e1: posts big blind $0.05
*** HOLE CARDS ***
Dealt to c7d29ab9 
Dealt to 99c31039 
Dealt to 959f22e1 
Dealt to 75e6f27d 
Dealt to Hero [8h 7h]
Dealt to 16c4771 
75e6f27d: folds
Hero: raises $0.05 to $0.1
16c4771: folds
c7d29ab9: folds
99c31039: folds
959f22e1: folds
Uncalled bet ($0.05) returned to Hero
*** SHOWDOWN ***
Hero collected $0.12 from pot
*** SUMMARY ***
Total pot $0.12 | Rake $0 | Jackpot $0 | Bingo $0 | Fortune $0 | Tax $0
Seat 1: c7d29ab9 (button) folded before Flop (didn't bet)
Seat 2: 99c31039 (small blind) folded before Flop
Seat 3: 959f22e1 (big blind) folded before Flop
Seat 4: 75e6f27d folded before Flop (didn't bet)
Seat 5: Hero collected ($0.12)
Seat 6: 16c4771 folded before Flop (didn't bet)


Poker Hand #RC2094675108: Hold'em No Limit ($0.02/$0.05) - 2023/12/27 21:20:45
Table 'RushAndCash3803948' 6-max Seat #1 is the button
Seat 1: Hero ($9.58 in chips)
Seat 2: 7016f4d3 ($5.24 in chips)
Seat 3: a0193c4f ($6.63 in chips)
Seat 4: 227e3fcc ($5.46 in chips)
Seat 5: 959f22e1 ($12.99 in chips)
Seat 6: 61180884 ($11.22 in chips)
7016f4d3: posts small blind $0.02
a0193c4f: posts big blind $0.05
*** HOLE CARDS ***
Dealt to Hero [Td Ts]
Dealt to 7016f4d3 
Dealt to a0193c4f 
Dealt to 227e3fcc 
Dealt to 959f22e1 
Dealt to 61180884 
227e3fcc: folds
959f22e1: raises $0.05 to $0.1
61180884: folds
Hero: raises $0.32 to $0.42
7016f4d3: folds
a0193c4f: folds
959f22e1: folds
Uncalled bet ($0.32) returned to Hero
*** SHOWDOWN ***
Hero collected $0.26 from pot
*** SUMMARY ***
Total pot $0.27 | Rake $0.01 | Jackpot $0 | Bingo $0 | Fortune $0 | Tax $0
Seat 1: Hero (button) collected ($0.26)
Seat 2: 7016f4d3 (small blind) folded before Flop
Seat 3: a0193c4f (big blind) folded before Flop
Seat 4: 227e3fcc folded before Flop (didn't bet)
Seat 5: 959f22e1 folded before Flop
Seat 6: 61180884 folded before Flop (didn't bet)


Poker Hand #RC2094654235: Hold'em No Limit ($0.02/$0.05) - 2023/12/27 21:20:00
Table 'RushAndCash3803507' 6-max Seat #1 is the button
Seat 1: 4bf73170 ($6.71 in chips)
Seat 2: 8a2b3143 ($5 in chips)
Seat 3: a0193c4f ($6.57 in chips)
Seat 4: 91b73625 ($5.73 in chips)
Seat 5: 69b49daf ($2.42 in chips)
Seat 6: Hero ($9.53 in chips)
8a2b3143: posts small blind $0.02
a0193c4f: posts big blind $0.05
*** HOLE CARDS ***
Dealt to 4bf73170 
Dealt to 8a2b3143 
Dealt to a0193c4f 
Dealt to 91b73625 
Dealt to 69b49daf 
Dealt to Hero [Th Ks]
91b73625: raises $0.05 to $0.1
69b49daf: folds
Hero: raises $0.05 to $0.15
4bf73170: folds
8a2b3143: folds
a0193c4f: calls $0.1
91b73625: calls $0.05
*** FLOP *** [Kd 2s 2d]
a0193c4f: bets $0.16
91b73625: folds
Hero: calls $0.16
*** TURN *** [Kd 2s 2d] [8c]
a0193c4f: bets $0.27
Hero: calls $0.27
*** RIVER *** [Kd 2s 2d 8c] [Qd]
a0193c4f: checks
Hero: checks
a0193c4f: shows [7h Kh] (Pair of Kings and Pair of Twos)
Hero: shows [Th Ks] (Pair of Kings and Pair of Twos)
*** SHOWDOWN ***
a0193c4f collected $0.64 from pot
Hero collected $0.63 from pot
*** SUMMARY ***
Total pot $1.33 | Rake $0.06 | Jackpot $0 | Bingo $0 | Fortune $0 | Tax $0
Board [Kd 2s 2d 8c Qd]
Seat 1: 4bf73170 (button) folded before Flop (didn't bet)
Seat 2: 8a2b3143 (small blind) folded before Flop
Seat 3: a0193c4f (big blind) showed [7h Kh] and won ($0.64) with Pair of Kings and Pair of Twos
Seat 4: 91b73625 folded on the Flop
Seat 5: 69b49daf folded before Flop (didn't bet)
Seat 6: Hero showed [Th Ks] and won ($0.63) with Pair of Kings and Pair of Twos


Poker Hand #RC2094654001: Hold'em No Limit ($0.02/$0.05) - 2023/12/27 21:19:49
Table 'RushAndCash3803393' 6-max Seat #1 is the button
Seat 1: Hero ($9.53 in chips)
Seat 2: a0724968 ($5 in chips)
Seat 3: a1d661c3 ($5 in chips)
Seat 4: 89b9c786 ($7.84 in chips)
Seat 5: 2e4fbce8 ($5.19 in chips)
Seat 6: 9bd21f84 ($9.56 in chips)
a0724968: posts small blind $0.02
a1d661c3: posts big blind $0.05
*** HOLE CARDS ***
Dealt to Hero [Tc Kh]
Dealt to a0724968 
Dealt to a1d661c3 
Dealt to 89b9c786 
Dealt to 2e4fbce8 
Dealt to 9bd21f84 
89b9c786: folds
2e4fbce8: raises $0.06 to $0.11
9bd21f84: folds
Hero: folds
a0724968: folds
a1d661c3: folds
Uncalled bet ($0.06) returned to 2e4fbce8
*** SHOWDOWN ***
2e4fbce8 collected $0.12 from pot
*** SUMMARY ***
Total pot $0.12 | Rake $0 | Jackpot $0 | Bingo $0 | Fortune $0 | Tax $0
Seat 1: Hero (button) folded before Flop (didn't bet)
Seat 2: a0724968 (small blind) folded before Flop
Seat 3: a1d661c3 (big blind) folded before Flop
Seat 4: 89b9c786 folded before Flop (didn't bet)
Seat 5: 2e4fbce8 collected ($0.12)
Seat 6: 9bd21f84 folded before Flop (didn't bet)


Poker Hand #RC2094653816: Hold'em No Limit ($0.02/$0.05) - 2023/12/27 21:19:41
Table 'RushAndCash3803300' 6-max Seat #1 is the button
Seat 1: 99a77cfc ($7.53 in chips)
Seat 2: Hero ($9.55 in chips)
Seat 3: b963e604 ($6.3 in chips)
Seat 4: 4d4ebdf5 ($10.61 in chips)
Seat 5: ddd79037 ($6.43 in chips)
Seat 6: 9233e24b ($5 in chips)
Hero: posts small blind $0.02
b963e604: posts big blind $0.05
*** HOLE CARDS ***
Dealt to 99a77cfc 
Dealt to Hero [Ac 3h]
Dealt to b963e604 
Dealt to 4d4ebdf5 
Dealt to ddd79037 
Dealt to 9233e24b 
4d4ebdf5: folds
ddd79037: folds
9233e24b: folds
99a77cfc: folds
Hero: folds
Uncalled bet ($0.03) returned to b963e604
*** SHOWDOWN ***
b963e604 collected $0.04 from pot
*** SUMMARY ***
Total pot $0.04 | Rake $0 | Jackpot $0 | Bingo $0 | Fortune $0 | Tax $0
Seat 1: 99a77cfc (button) folded before Flop (didn't bet)
Seat 2: Hero (small blind) folded before Flop
Seat 3: b963e604 (big blind) collected ($0.04)
Seat 4: 4d4ebdf5 folded before Flop (didn't bet)
Seat 5: ddd79037 folded before Flop (didn't bet)
Seat 6: 9233e24b folded before Flop (didn't bet)


Poker Hand #RC2094653232: Hold'em No Limit ($0.02/$0.05) - 2023/12/27 21:19:12
Table 'RushAndCash3803007' 6-max Seat #1 is the button
Seat 1: 91b73625 ($5.85 in chips)
Seat 2: 806e60a7 ($10.86 in chips)
Seat 3: Hero ($9.7 in chips)
Seat 4: 4d4ebdf5 ($10.45 in chips)
Seat 5: af5127b8 ($6.19 in chips)
Seat 6: 292278f1 ($5.26 in chips)
806e60a7: posts small blind $0.02
Hero: posts big blind $0.05
*** HOLE CARDS ***
Dealt to 91b73625 
Dealt to 806e60a7 
Dealt to Hero [2c Qc]
Dealt to 4d4ebdf5 
Dealt to af5127b8 
Dealt to 292278f1 
4d4ebdf5: raises $0.1 to $0.15
af5127b8: folds
292278f1: folds
91b73625: folds
806e60a7: folds
Hero: calls $0.1
*** FLOP *** [Th 6h 6c]
Hero: checks
4d4ebdf5: checks
*** TURN *** [Th 6h 6c] [6s]
Hero: checks
4d4ebdf5: checks
*** RIVER *** [Th 6h 6c 6s] [9d]
Hero: checks
4d4ebdf5: checks
Hero: shows [2c Qc] (Three Sixes)
4d4ebdf5: shows [Ac Qs] (Three Sixes)
*** SHOWDOWN ***
4d4ebdf5 collected $0.31 from pot
*** SUMMARY ***
Total pot $0.32 | Rake $0.01 | Jackpot $0 | Bingo $0 | Fortune $0 | Tax $0
Board [Th 6h 6c 6s 9d]
Seat 1: 91b73625 (button) folded before Flop (didn't bet)
Seat 2: 806e60a7 (small blind) folded before Flop
Seat 3: Hero (big blind) showed [2c Qc] and lost with Three Sixes
Seat 4: 4d4ebdf5 showed [Ac Qs] and won ($0.31) with Three Sixes
Seat 5: af5127b8 folded before Flop (didn't bet)
Seat 6: 292278f1 folded before Flop (didn't bet)


Poker Hand #RC2094653150: Hold'em No Limit ($0.02/$0.05) - 2023/12/27 21:19:08
Table 'RushAndCash3802967' 6-max Seat #1 is the button
Seat 1: 17c2217a ($5.17 in chips)
Seat 2: 97ba59eb ($12.73 in chips)
Seat 3: 244d3655 ($5 in chips)
Seat 4: 5507970f ($4.7 in chips)
Seat 5: caff888b ($5 in chips)
Seat 6: Hero ($9.7 in chips)
97ba59eb: posts small blind $0.02
244d3655: posts big blind $0.05
*** HOLE CARDS ***
Dealt to 17c2217a 
Dealt to 97ba59eb 
Dealt to 244d3655 
Dealt to 5507970f 
Dealt to caff888b 
Dealt to Hero [4h Jd]
5507970f: raises $0.06 to $0.11
caff888b: folds
Hero: folds
17c2217a: calls $0.11
97ba59eb: folds
244d3655: folds
*** FLOP *** [Ac 4s 3d]
5507970f: checks
17c2217a: bets $0.11
5507970f: calls $0.11
*** TURN *** [Ac 4s 3d] [7s]
5507970f: checks
17c2217a: bets $0.14
5507970f: folds
Uncalled bet ($0.14) returned to 17c2217a
*** SHOWDOWN ***
17c2217a collected $0.49 from pot
*** SUMMARY ***
Total pot $0.51 | Rake $0.02 | Jackpot $0 | Bingo $0 | Fortune $0 | Tax $0
Board [Ac 4s 3d 7s]
Seat 1: 17c2217a (button) won ($0.49)
Seat 2: 97ba59eb (small blind) folded before Flop
Seat 3: 244d3655 (big blind) folded before Flop
Seat 4: 5507970f folded on the Turn
Seat 5: caff888b folded before Flop (didn't bet)
Seat 6: Hero folded before Flop (didn't bet)


Poker Hand #RC2094653085: Hold'em No Limit ($0.02/$0.05) - 2023/12/27 21:19:04
Table 'RushAndCash3802933' 6-max Seat #1 is the button
Seat 1: 874237f1 ($9.15 in chips)
Seat 2: b7a8048b ($5.03 in chips)
Seat 3: d4230c47 ($14.23 in chips)
Seat 4: 5105e96e ($5.59 in chips)
Seat 5: d2e84261 ($5.19 in chips)
Seat 6: Hero ($9.7 in chips)
b7a8048b: posts small blind $0.02
d4230c47: posts big blind $0.05
*** HOLE CARDS ***
Dealt to 874237f1 
Dealt to b7a8048b 
Dealt to d4230c47 
Dealt to 5105e96e 
Dealt to d2e84261 
Dealt to Hero [8s 7d]
5105e96e: folds
d2e84261: raises $0.1 to $0.15
Hero: folds
874237f1: folds
b7a8048b: folds
d4230c47: folds
Uncalled bet ($0.1) returned to d2e84261
*** SHOWDOWN ***
d2e84261 collected $0.12 from pot
*** SUMMARY ***
Total pot $0.12 | Rake $0 | Jackpot $0 | Bingo $0 | Fortune $0 | Tax $0
Seat 1: 874237f1 (button) folded before Flop (didn't bet)
Seat 2: b7a8048b (small blind) folded before Flop
Seat 3: d4230c47 (big blind) folded before Flop
Seat 4: 5105e96e folded before Flop (didn't bet)
Seat 5: d2e84261 collected ($0.12)
Seat 6: Hero folded before Flop (didn't bet)


Poker Hand #RC2094652732: Hold'em No Limit ($0.02/$0.05) - 2023/12/27 21:18:47
Table 'RushAndCash3802759' 6-max Seat #1 is the button
Seat 1: 2523e92d ($11.64 in chips)
Seat 2: 9d9e913 ($5.88 in chips)
Seat 3: 64413caa ($10.42 in chips)
Seat 4: 15116960 ($9.02 in chips)
Seat 5: 2ae4f009 ($5.52 in chips)
Seat 6: Hero ($9.8 in chips)
9d9e913: posts small blind $0.02
64413caa: posts big blind $0.05
*** HOLE CARDS ***
Dealt to 2523e92d 
Dealt to 9d9e913 
Dealt to 64413caa 
Dealt to 15116960 
Dealt to 2ae4f009 
Dealt to Hero [7h Qh]
15116960: folds
2ae4f009: folds
Hero: raises $0.05 to $0.1
2523e92d: folds
9d9e913: raises $0.25 to $0.35
64413caa: calls $0.3
Hero: folds
*** FLOP *** [3h Jd 6h]
9d9e913: bets $0.8
64413caa: raises $9.27 to $10.07 and is all-in
9d9e913: calls $4.73 and is all-in
Uncalled bet ($4.54) returned to 64413caa
64413caa: shows [Jc Ad] (Pair of Jacks)
9d9e913: shows [Kh Ks] (Pair of Kings)
9d9e913: Chooses to EV Cashout 
*** TURN *** [3h Jd 6h] [9s]
*** RIVER *** [3h Jd 6h 9s] [8s]
9d9e913: Pays Cashout Risk ($2.27)
*** SHOWDOWN ***
9d9e913 collected $11.64 from pot
*** SUMMARY ***
Total pot $11.86 | Rake $0.15 | Jackpot $0.07 | Bingo $0 | Fortune $0 | Tax $0
Board [3h Jd 6h 9s 8s]
Seat 1: 2523e92d (button) folded before Flop (didn't bet)
Seat 2: 9d9e913 (small blind) showed [Kh Ks] and won ($11.64) with Pair of Kings, Cashout Risk ($2.27)
Seat 3: 64413caa (big blind) showed [Jc Ad] and lost with Pair of Jacks
Seat 4: 15116960 folded before Flop (didn't bet)
Seat 5: 2ae4f009 folded before Flop (didn't bet)
Seat 6: Hero folded before Flop


Poker Hand #RC2094652588: Hold'em No Limit ($0.02/$0.05) - 2023/12/27 21:18:40
Table 'RushAndCash3802683' 6-max Seat #1 is the button
Seat 1: 209434da ($4.98 in chips)
Seat 2: Hero ($9.82 in chips)
Seat 3: 45d47230 ($5.06 in chips)
Seat 4: 80bc4dbd ($6.03 in chips)
Seat 5: a521e36b ($7.08 in chips)
Seat 6: 87525d4c ($7.8 in chips)
Hero: posts small blind $0.02
45d47230: posts big blind $0.05
*** HOLE CARDS ***
Dealt to 209434da 
Dealt to Hero [3d 2c]
Dealt to 45d47230 
Dealt to 80bc4dbd 
Dealt to a521e36b 
Dealt to 87525d4c 
80bc4dbd: folds
a521e36b: folds
87525d4c: raises $0.05 to $0.1
209434da: folds
Hero: folds
45d47230: calls $0.05
*** FLOP *** [Ts 6s 4s]
45d47230: checks
87525d4c: checks
*** TURN *** [Ts 6s 4s] [Jc]
45d47230: checks
87525d4c: checks
*** RIVER *** [Ts 6s 4s Jc] [4d]
45d47230: checks
87525d4c: checks
45d47230: shows [5h 6d] (Pair of Sixes and Pair of Fours)
87525d4c: shows [7s 8h] (Pair of Fours)
*** SHOWDOWN ***
45d47230 collected $0.21 from pot
*** SUMMARY ***
Total pot $0.22 | Rake $0.01 | Jackpot $0 | Bingo $0 | Fortune $0 | Tax $0
Board [Ts 6s 4s Jc 4d]
Seat 1: 209434da (button) folded before Flop (didn't bet)
Seat 2: Hero (small blind) folded before Flop
Seat 3: 45d47230 (big blind) showed [5h 6d] and won ($0.21) with Pair of Sixes and Pair of Fours
Seat 4: 80bc4dbd folded before Flop (didn't bet)
Seat 5: a521e36b folded before Flop (didn't bet)
Seat 6: 87525d4c showed [7s 8h] and lost with Pair of Fours


Poker Hand #RC2094652515: Hold'em No Limit ($0.02/$0.05) - 2023/12/27 21:18:36
Table 'RushAndCash3802646' 6-max Seat #1 is the button
Seat 1: e6b9db8a ($5.05 in chips)
Seat 2: 82f3a210 ($5.14 in chips)
Seat 3: 67e3d897 ($7.27 in chips)
Seat 4: d399ee46 ($9.54 in chips)
Seat 5: 97ba59eb ($12.71 in chips)
Seat 6: Hero ($9.82 in chips)
82f3a210: posts small blind $0.02
67e3d897: posts big blind $0.05
*** HOLE CARDS ***
Dealt to e6b9db8a 
Dealt to 82f3a210 
Dealt to 67e3d897 
Dealt to d399ee46 
Dealt to 97ba59eb 
Dealt to Hero [4h 7h]
d399ee46: folds
97ba59eb: raises $0.06 to $0.11
Hero: folds
e6b9db8a: folds
82f3a210: folds
67e3d897: folds
Uncalled bet ($0.06) returned to 97ba59eb
*** SHOWDOWN ***
97ba59eb collected $0.12 from pot
*** SUMMARY ***
Total pot $0.12 | Rake $0 | Jackpot $0 | Bingo $0 | Fortune $0 | Tax $0
Seat 1: e6b9db8a (button) folded before Flop (didn't bet)
Seat 2: 82f3a210 (small blind) folded before Flop
Seat 3: 67e3d897 (big blind) folded before Flop
Seat 4: d399ee46 folded before Flop (didn't bet)
Seat 5: 97ba59eb collected ($0.12)
Seat 6: Hero folded before Flop (didn't bet)


Poker Hand #RC2094652291: Hold'em No Limit ($0.02/$0.05) - 2023/12/27 21:18:25
Table 'RushAndCash3802533' 6-max Seat #1 is the button
Seat 1: 3b9a22be ($14.01 in chips)
Seat 2: e16e04ba ($6.63 in chips)
Seat 3: Hero ($9.87 in chips)
Seat 4: dc8f15a1 ($8.5 in chips)
Seat 5: bc3ad22a ($5.15 in chips)
Seat 6: 772ac938 ($6.13 in chips)
e16e04ba: posts small blind $0.02
Hero: posts big blind $0.05
*** HOLE CARDS ***
Dealt to 3b9a22be 
Dealt to e16e04ba 
Dealt to Hero [5s 3c]
Dealt to dc8f15a1 
Dealt to bc3ad22a 
Dealt to 772ac938 
dc8f15a1: raises $0.06 to $0.11
bc3ad22a: folds
772ac938: calls $0.11
3b9a22be: folds
e16e04ba: folds
Hero: folds
*** FLOP *** [Kd 8c Qs]
dc8f15a1: bets $0.1
772ac938: calls $0.1
*** TURN *** [Kd 8c Qs] [Qd]
dc8f15a1: checks
772ac938: checks
*** RIVER *** [Kd 8c Qs Qd] [Th]
dc8f15a1: checks
772ac938: checks
dc8f15a1: shows [Kc 7c] (Pair of Kings and Pair of Queens)
772ac938: shows [7d 7s] (Pair of Queens and Pair of Sevens)
*** SHOWDOWN ***
dc8f15a1 collected $0.47 from pot
*** SUMMARY ***
Total pot $0.49 | Rake $0.02 | Jackpot $0 | Bingo $0 | Fortune $0 | Tax $0
Board [Kd 8c Qs Qd Th]
Seat 1: 3b9a22be (button) folded before Flop (didn't bet)
Seat 2: e16e04ba (small blind) folded before Flop
Seat 3: Hero (big blind) folded before Flop
Seat 4: dc8f15a1 showed [Kc 7c] and won ($0.47) with Pair of Kings and Pair of Queens
Seat 5: bc3ad22a folded before Flop (didn't bet)
Seat 6: 772ac938 showed [7d 7s] and lost with Pair of Queens and Pair of Sevens


Poker Hand #RC2094652191: Hold'em No Limit ($0.02/$0.05) - 2023/12/27 21:18:20
Table 'RushAndCash3802481' 6-max Seat #1 is the button
Seat 1: Hero ($9.87 in chips)
Seat 2: cece2bcb ($9.71 in chips)
Seat 3: 7aad2653 ($9.26 in chips)
Seat 4: e88c36ac ($6.49 in chips)
Seat 5: 23defde5 ($12 in chips)
Seat 6: 4a471529 ($7.28 in chips)
cece2bcb: posts small blind $0.02
7aad2653: posts big blind $0.05
*** HOLE CARDS ***
Dealt to Hero [5s Qc]
Dealt to cece2bcb 
Dealt to 7aad2653 
Dealt to e88c36ac 
Dealt to 23defde5 
Dealt to 4a471529 
e88c36ac: folds
23defde5: folds
4a471529: folds
Hero: folds
cece2bcb: folds
Uncalled bet ($0.03) returned to 7aad2653
*** SHOWDOWN ***
7aad2653 collected $0.04 from pot
*** SUMMARY ***
Total pot $0.04 | Rake $0 | Jackpot $0 | Bingo $0 | Fortune $0 | Tax $0
Seat 1: Hero (button) folded before Flop (didn't bet)
Seat 2: cece2bcb (small blind) folded before Flop
Seat 3: 7aad2653 (big blind) collected ($0.04)
Seat 4: e88c36ac folded before Flop (didn't bet)
Seat 5: 23defde5 folded before Flop (didn't bet)
Seat 6: 4a471529 folded before Flop (didn't bet)


Poker Hand #RC2094651633: Hold'em No Limit ($0.02/$0.05) - 2023/12/27 21:17:52
Table 'RushAndCash3802209' 6-max Seat #1 is the button
Seat 1: eb42d0a ($1.77 in chips)
Seat 2: Hero ($9.97 in chips)
Seat 3: 4a471529 ($7.38 in chips)
Seat 4: 23defde5 ($11.81 in chips)
Seat 5: 3b59ca4e ($5.53 in chips)
Seat 6: daac7685 ($5.65 in chips)
Hero: posts small blind $0.02
4a471529: posts big blind $0.05
*** HOLE CARDS ***
Dealt to eb42d0a 
Dealt to Hero [5c Tc]
Dealt to 4a471529 
Dealt to 23defde5 
Dealt to 3b59ca4e 
Dealt to daac7685 
23defde5: raises $0.05 to $0.1
3b59ca4e: folds
daac7685: folds
eb42d0a: folds
Hero: calls $0.08
4a471529: calls $0.05
*** FLOP *** [5d Jh 3h]
Hero: checks
4a471529: checks
23defde5: bets $0.15
Hero: folds
4a471529: folds
Uncalled bet ($0.15) returned to 23defde5
*** SHOWDOWN ***
23defde5 collected $0.29 from pot
*** SUMMARY ***
Total pot $0.3 | Rake $0.01 | Jackpot $0 | Bingo $0 | Fortune $0 | Tax $0
Board [5d Jh 3h]
Seat 1: eb42d0a (button) folded before Flop (didn't bet)
Seat 2: Hero (small blind) folded on the Flop
Seat 3: 4a471529 (big blind) folded on the Flop
Seat 4: 23defde5 won ($0.29)
Seat 5: 3b59ca4e folded before Flop (didn't bet)
Seat 6: daac7685 folded before Flop (didn't bet)


Poker Hand #RC2094651566: Hold'em No Limit ($0.02/$0.05) - 2023/12/27 21:17:48
Table 'RushAndCash3802174' 6-max Seat #1 is the button
Seat 1: 569fffe7 ($4.22 in chips)
Seat 2: 9c6bbe91 ($5.02 in chips)
Seat 3: 89b9c786 ($7.86 in chips)
Seat 4: e11b6f8f ($13.16 in chips)
Seat 5: b3ddb34b ($3.44 in chips)
Seat 6: Hero ($9.97 in chips)
9c6bbe91: posts small blind $0.02
89b9c786: posts big blind $0.05
*** HOLE CARDS ***
Dealt to 569fffe7 
Dealt to 9c6bbe91 
Dealt to 89b9c786 
Dealt to e11b6f8f 
Dealt to b3ddb34b 
Dealt to Hero [3c Ah]
e11b6f8f: folds
b3ddb34b: folds
Hero: folds
569fffe7: folds
9c6bbe91: raises $0.1 to $0.15
89b9c786: folds
Uncalled bet ($0.1) returned to 9c6bbe91
*** SHOWDOWN ***
9c6bbe91 collected $0.1 from pot
*** SUMMARY ***
Total pot $0.1 | Rake $0 | Jackpot $0 | Bingo $0 | Fortune $0 | Tax $0
Seat 1: 569fffe7 (button) folded before Flop (didn't bet)
Seat 2: 9c6bbe91 (small blind) collected ($0.1)
Seat 3: 89b9c786 (big blind) folded before Flop
Seat 4: e11b6f8f folded before Flop (didn't bet)
Seat 5: b3ddb34b folded before Flop (didn't bet)
Seat 6: Hero folded before Flop (didn't bet)


Poker Hand #RC2094651491: Hold'em No Limit ($0.02/$0.05) - 2023/12/27 21:17:45
Table 'RushAndCash3802135' 6-max Seat #1 is the button
Seat 1: d1e05b05 ($4.93 in chips)
Seat 2: d226d3fd ($3.25 in chips)
Seat 3: Hero ($10.02 in chips)
Seat 4: 51c7aec9 ($5.26 in chips)
Seat 5: 9a2af966 ($5.07 in chips)
Seat 6: 13aeadf3 ($5 in chips)
d226d3fd: posts small blind $0.02
Hero: posts big blind $0.05
*** HOLE CARDS ***
Dealt to d1e05b05 
Dealt to d226d3fd 
Dealt to Hero [2c Qd]
Dealt to 51c7aec9 
Dealt to 9a2af966 
Dealt to 13aeadf3 
51c7aec9: folds
9a2af966: raises $0.08 to $0.13
13aeadf3: raises $0.27 to $0.4
d1e05b05: calls $0.4
d226d3fd: folds
Hero: folds
9a2af966: folds
*** FLOP *** [Kh 3s 7d]
13aeadf3: bets $0.33
d1e05b05: calls $0.33
*** TURN *** [Kh 3s 7d] [Ks]
13aeadf3: checks
d1e05b05: bets $0.55
13aeadf3: folds
Uncalled bet ($0.55) returned to d1e05b05
*** SHOWDOWN ***
d1e05b05 collected $1.51 from pot
*** SUMMARY ***
Total pot $1.66 | Rake $0.08 | Jackpot $0.07 | Bingo $0 | Fortune $0 | Tax $0
Board [Kh 3s 7d Ks]
Seat 1: d1e05b05 (button) won ($1.51)
Seat 2: d226d3fd (small blind) folded before Flop
Seat 3: Hero (big blind) folded before Flop
Seat 4: 51c7aec9 folded before Flop (didn't bet)
Seat 5: 9a2af966 folded before Flop
Seat 6: 13aeadf3 folded on the Turn


Poker Hand #RC2094651422: Hold'em No Limit ($0.02/$0.05) - 2023/12/27 21:17:41
Table 'RushAndCash3802100' 6-max Seat #1 is the button
Seat 1: 1b28deb0 ($6.68 in chips)
Seat 2: 408d461e ($7.94 in chips)
Seat 3: 33d9f11b ($5.53 in chips)
Seat 4: bcf443b6 ($6.33 in chips)
Seat 5: e7bab50e ($5.12 in chips)
Seat 6: Hero ($10.02 in chips)
408d461e: posts small blind $0.02
33d9f11b: posts big blind $0.05
*** HOLE CARDS ***
Dealt to 1b28deb0 
Dealt to 408d461e 
Dealt to 33d9f11b 
Dealt to bcf443b6 
Dealt to e7bab50e 
Dealt to Hero [9d 5c]
bcf443b6: raises $0.05 to $0.1
e7bab50e: raises $0.2 to $0.3
Hero: folds
1b28deb0: folds
408d461e: folds
33d9f11b: folds
bcf443b6: folds
Uncalled bet ($0.2) returned to e7bab50e
*** SHOWDOWN ***
e7bab50e collected $0.26 from pot
*** SUMMARY ***
Total pot $0.27 | Rake $0.01 | Jackpot $0 | Bingo $0 | Fortune $0 | Tax $0
Seat 1: 1b28deb0 (button) folded before Flop (didn't bet)
Seat 2: 408d461e (small blind) folded before Flop
Seat 3: 33d9f11b (big blind) folded before Flop
Seat 4: bcf443b6 folded before Flop
Seat 5: e7bab50e collected ($0.26)
Seat 6: Hero folded before Flop (didn't bet)


Poker Hand #RC2094651352: Hold'em No Limit ($0.02/$0.05) - 2023/12/27 21:17:38
Table 'RushAndCash3802065' 6-max Seat #1 is the button
Seat 1: 24d191e2 ($4.64 in chips)
Seat 2: a53d5fed ($6.37 in chips)
Seat 3: ed041cf ($0.66 in chips)
Seat 4: b881f476 ($5 in chips)
Seat 5: b6f6c90b ($10.86 in chips)
Seat 6: Hero ($10.02 in chips)
a53d5fed: posts small blind $0.02
ed041cf: posts big blind $0.05
*** HOLE CARDS ***
Dealt to 24d191e2 
Dealt to a53d5fed 
Dealt to ed041cf 
Dealt to b881f476 
Dealt to b6f6c90b 
Dealt to Hero [9c Jh]
b881f476: folds
b6f6c90b: folds
Hero: folds
24d191e2: raises $0.05 to $0.1
a53d5fed: folds
ed041cf: folds
Uncalled bet ($0.05) returned to 24d191e2
*** SHOWDOWN ***
24d191e2 collected $0.12 from pot
*** SUMMARY ***
Total pot $0.12 | Rake $0 | Jackpot $0 | Bingo $0 | Fortune $0 | Tax $0
Seat 1: 24d191e2 (button) collected ($0.12)
Seat 2: a53d5fed (small blind) folded before Flop
Seat 3: ed041cf (big blind) folded before Flop
Seat 4: b881f476 folded before Flop (didn't bet)
Seat 5: b6f6c90b folded before Flop (didn't bet)
Seat 6: Hero folded before Flop (didn't bet)


Poker Hand #RC2094650278: Hold'em No Limit ($0.02/$0.05) - 2023/12/27 21:16:45
Table 'RushAndCash3801542' 6-max Seat #1 is the button
Seat 1: ed041cf ($5.74 in chips)
Seat 2: 46a86d2c ($3.31 in chips)
Seat 3: cd38b1cb ($7.76 in chips)
Seat 4: bc902f73 ($2.78 in chips)
Seat 5: 40758d6c ($5 in chips)
Seat 6: Hero ($5.08 in chips)
46a86d2c: posts small blind $0.02
cd38b1cb: posts big blind $0.05
*** HOLE CARDS ***
Dealt to ed041cf 
Dealt to 46a86d2c 
Dealt to cd38b1cb 
Dealt to bc902f73 
Dealt to 40758d6c 
Dealt to Hero [Ac Kc]
bc902f73: folds
40758d6c: folds
Hero: raises $0.05 to $0.1
ed041cf: raises $0.21 to $0.31
46a86d2c: folds
cd38b1cb: folds
Hero: calls $0.21
*** FLOP *** [As 7c 2c]
Hero: checks
ed041cf: bets $0.23
Hero: raises $0.38 to $0.61
ed041cf: calls $0.38
*** TURN *** [As 7c 2c] [4d]
Hero: bets $4.16 and is all-in
ed041cf: calls $4.16
Hero: shows [Ac Kc] (Pair of Aces)
ed041cf: shows [Qc Ad] (Pair of Aces)
*** FIRST RIVER *** [As 7c 2c 4d] [3s]
*** SECOND RIVER *** [As 7c 2c 4d] [5h]
*** FIRST SHOWDOWN ***
Hero collected $5.01 from pot
*** SECOND SHOWDOWN ***
Hero collected $5.01 from pot
*** SUMMARY ***
Total pot $10.23 | Rake $0.14 | Jackpot $0.07 | Bingo $0 | Fortune $0 | Tax $0
Hand was run two times
FIRST Board [As 7c 2c 4d 3s]
SECOND Board [5h]
Seat 1: ed041cf (button) showed [Qc Ad] and lost with Pair of Aces, and lost
Seat 2: 46a86d2c (small blind) folded before Flop
Seat 3: cd38b1cb (big blind) folded before Flop
Seat 4: bc902f73 folded before Flop (didn't bet)
Seat 5: 40758d6c folded before Flop (didn't bet)
Seat 6: Hero showed [Ac Kc] and won ($5.01) with Pair of Aces, and won ($5.01)


Poker Hand #RC2094650155: Hold'em No Limit ($0.02/$0.05) - 2023/12/27 21:16:40
Table 'RushAndCash3801482' 6-max Seat #1 is the button
Seat 1: Hero ($5.08 in chips)
Seat 2: 1ce331cb ($5.05 in chips)
Seat 3: dc8f15a1 ($8.43 in chips)
Seat 4: 87acde28 ($7.77 in chips)
Seat 5: 96be9ef9 ($5.24 in chips)
Seat 6: 781c4a9a ($2.13 in chips)
1ce331cb: posts small blind $0.02
dc8f15a1: posts big blind $0.05
*** HOLE CARDS ***
Dealt to Hero [8s 4d]
Dealt to 1ce331cb 
Dealt to dc8f15a1 
Dealt to 87acde28 
Dealt to 96be9ef9 
Dealt to 781c4a9a 
87acde28: raises $0.05 to $0.1
96be9ef9: folds
781c4a9a: calls $0.1
Hero: folds
1ce331cb: folds
dc8f15a1: folds
*** FLOP *** [9c 3s 4c]
87acde28: bets $0.14
781c4a9a: folds
Uncalled bet ($0.14) returned to 87acde28
*** SHOWDOWN ***
87acde28 collected $0.26 from pot
*** SUMMARY ***
Total pot $0.27 | Rake $0.01 | Jackpot $0 | Bingo $0 | Fortune $0 | Tax $0
Board [9c 3s 4c]
Seat 1: Hero (button) folded before Flop (didn't bet)
Seat 2: 1ce331cb (small blind) folded before Flop
Seat 3: dc8f15a1 (big blind) folded before Flop
Seat 4: 87acde28 won ($0.26)
Seat 5: 96be9ef9 folded before Flop (didn't bet)
Seat 6: 781c4a9a folded on the Flop


Poker Hand #RC2094649842: Hold'em No Limit ($0.02/$0.05) - 2023/12/27 21:16:25
Table 'RushAndCash3801332' 6-max Seat #1 is the button
Seat 1: 2c2f32e2 ($2.22 in chips)
Seat 2: Hero ($5.1 in chips)
Seat 3: 629cdcea ($5 in chips)
Seat 4: ea2d30d8 ($8.07 in chips)
Seat 5: 3f587bf6 ($5 in chips)
Seat 6: 835cf516 ($5.48 in chips)
Hero: posts small blind $0.02
629cdcea: posts big blind $0.05
*** HOLE CARDS ***
Dealt to 2c2f32e2 
Dealt to Hero [6d 4d]
Dealt to 629cdcea 
Dealt to ea2d30d8 
Dealt to 3f587bf6 
Dealt to 835cf516 
ea2d30d8: folds
3f587bf6: folds
835cf516: raises $0.1 to $0.15
2c2f32e2: folds
Hero: folds
629cdcea: folds
Uncalled bet ($0.1) returned to 835cf516
*** SHOWDOWN ***
835cf516 collected $0.12 from pot
*** SUMMARY ***
Total pot $0.12 | Rake $0 | Jackpot $0 | Bingo $0 | Fortune $0 | Tax $0
Seat 1: 2c2f32e2 (button) folded before Flop (didn't bet)
Seat 2: Hero (small blind) folded before Flop
Seat 3: 629cdcea (big blind) folded before Flop
Seat 4: ea2d30d8 folded before Flop (didn't bet)
Seat 5: 3f587bf6 folded before Flop (didn't bet)
Seat 6: 835cf516 collected ($0.12)


Poker Hand #RC2094649765: Hold'em No Limit ($0.02/$0.05) - 2023/12/27 21:16:21
Table 'RushAndCash3801293' 6-max Seat #1 is the button
Seat 1: 62f7a9cd ($7.27 in chips)
Seat 2: 4a0549bf ($5 in chips)
Seat 3: Hero ($5.15 in chips)
Seat 4: 80bc4dbd ($6.73 in chips)
Seat 5: 209434da ($3.66 in chips)
Seat 6: 1d555d84 ($5 in chips)
4a0549bf: posts small blind $0.02
Hero: posts big blind $0.05
*** HOLE CARDS ***
Dealt to 62f7a9cd 
Dealt to 4a0549bf 
Dealt to Hero [6d Js]
Dealt to 80bc4dbd 
Dealt to 209434da 
Dealt to 1d555d84 
80bc4dbd: folds
209434da: folds
1d555d84: raises $0.1 to $0.15
62f7a9cd: folds
4a0549bf: folds
Hero: folds
Uncalled bet ($0.1) returned to 1d555d84
*** SHOWDOWN ***
1d555d84 collected $0.12 from pot
*** SUMMARY ***
Total pot $0.12 | Rake $0 | Jackpot $0 | Bingo $0 | Fortune $0 | Tax $0
Seat 1: 62f7a9cd (button) folded before Flop (didn't bet)
Seat 2: 4a0549bf (small blind) folded before Flop
Seat 3: Hero (big blind) folded before Flop
Seat 4: 80bc4dbd folded before Flop (didn't bet)
Seat 5: 209434da folded before Flop (didn't bet)
Seat 6: 1d555d84 collected ($0.12)


Poker Hand #RC2094649697: Hold'em No Limit ($0.02/$0.05) - 2023/12/27 21:16:17
Table 'RushAndCash3801258' 6-max Seat #1 is the button
Seat 1: c9d1a1bc ($8.65 in chips)
Seat 2: f35b3ca8 ($5.02 in chips)
Seat 3: e0a9e942 ($5.69 in chips)
Seat 4: b0596725 ($5 in chips)
Seat 5: Hero ($5.15 in chips)
Seat 6: a1066280 ($7.28 in chips)
f35b3ca8: posts small blind $0.02
e0a9e942: posts big blind $0.05
*** HOLE CARDS ***
Dealt to c9d1a1bc 
Dealt to f35b3ca8 
Dealt to e0a9e942 
Dealt to b0596725 
Dealt to Hero [7d 6s]
Dealt to a1066280 
b0596725: folds
Hero: folds
a1066280: folds
c9d1a1bc: folds
f35b3ca8: raises $0.1 to $0.15
e0a9e942: folds
Uncalled bet ($0.1) returned to f35b3ca8
*** SHOWDOWN ***
f35b3ca8 collected $0.1 from pot
*** SUMMARY ***
Total pot $0.1 | Rake $0 | Jackpot $0 | Bingo $0 | Fortune $0 | Tax $0
Seat 1: c9d1a1bc (button) folded before Flop (didn't bet)
Seat 2: f35b3ca8 (small blind) collected ($0.1)
Seat 3: e0a9e942 (big blind) folded before Flop
Seat 4: b0596725 folded before Flop (didn't bet)
Seat 5: Hero folded before Flop (didn't bet)
Seat 6: a1066280 folded before Flop (didn't bet)


Poker Hand #RC2094648755: Hold'em No Limit ($0.02/$0.05) - 2023/12/27 21:15:30
Table 'RushAndCash3800800' 6-max Seat #1 is the button
Seat 1: Hero ($5.28 in chips)
Seat 2: 4d4ebdf5 ($5.34 in chips)
Seat 3: ddd79037 ($6.57 in chips)
Seat 4: 464a52ce ($16.94 in chips)
Seat 5: e33e9848 ($11.55 in chips)
Seat 6: 2a55aa6 ($5 in chips)
4d4ebdf5: posts small blind $0.02
ddd79037: posts big blind $0.05
*** HOLE CARDS ***
Dealt to Hero [As 6s]
Dealt to 4d4ebdf5 
Dealt to ddd79037 
Dealt to 464a52ce 
Dealt to e33e9848 
Dealt to 2a55aa6 
464a52ce: raises $0.08 to $0.13
e33e9848: folds
2a55aa6: folds
Hero: calls $0.13
4d4ebdf5: folds
ddd79037: calls $0.08
*** FLOP *** [Qc 8s Tc]
ddd79037: checks
464a52ce: bets $0.1
Hero: folds
ddd79037: calls $0.1
*** TURN *** [Qc 8s Tc] [2d]
ddd79037: checks
464a52ce: checks
*** RIVER *** [Qc 8s Tc 2d] [9h]
ddd79037: bets $0.21
464a52ce: raises $0.43 to $0.64
ddd79037: calls $0.43
464a52ce: shows [Jd Jc] (Queens-High Straight)
ddd79037: shows [Js 8c] (Queens-High Straight)
*** SHOWDOWN ***
ddd79037 collected $0.86 from pot
464a52ce collected $0.87 from pot
*** SUMMARY ***
Total pot $1.89 | Rake $0.09 | Jackpot $0.07 | Bingo $0 | Fortune $0 | Tax $0
Board [Qc 8s Tc 2d 9h]
Seat 1: Hero (button) folded on the Flop
Seat 2: 4d4ebdf5 (small blind) folded before Flop
Seat 3: ddd79037 (big blind) showed [Js 8c] and won ($0.86) with Queens-High Straight
Seat 4: 464a52ce showed [Jd Jc] and won ($0.87) with Queens-High Straight
Seat 5: e33e9848 folded before Flop (didn't bet)
Seat 6: 2a55aa6 folded before Flop (didn't bet)


Poker Hand #RC2094648046: Hold'em No Limit ($0.02/$0.05) - 2023/12/27 21:14:53
Table 'RushAndCash3800457' 6-max Seat #1 is the button
Seat 1: 6621b2a0 ($5.26 in chips)
Seat 2: 825f9b92 ($5.82 in chips)
Seat 3: efe1f2b5 ($7.73 in chips)
Seat 4: f277bf46 ($2.09 in chips)
Seat 5: Hero ($5.07 in chips)
Seat 6: 27bbac55 ($10.42 in chips)
825f9b92: posts small blind $0.02
efe1f2b5: posts big blind $0.05
*** HOLE CARDS ***
Dealt to 6621b2a0 
Dealt to 825f9b92 
Dealt to efe1f2b5 
Dealt to f277bf46 
Dealt to Hero [Th Ac]
Dealt to 27bbac55 
f277bf46: folds
Hero: raises $0.05 to $0.1
27bbac55: folds
6621b2a0: folds
825f9b92: folds
efe1f2b5: calls $0.05
*** FLOP *** [Qh Ts 7c]
efe1f2b5: checks
Hero: checks
*** TURN *** [Qh Ts 7c] [Qd]
efe1f2b5: bets $0.11
Hero: calls $0.11
*** RIVER *** [Qh Ts 7c Qd] [7h]
efe1f2b5: checks
Hero: checks
efe1f2b5: shows [Ad 4d] (Pair of Queens and Pair of Sevens)
Hero: shows [Th Ac] (Pair of Queens and Pair of Tens)
*** SHOWDOWN ***
Hero collected $0.42 from pot
*** SUMMARY ***
Total pot $0.44 | Rake $0.02 | Jackpot $0 | Bingo $0 | Fortune $0 | Tax $0
Board [Qh Ts 7c Qd 7h]
Seat 1: 6621b2a0 (button) folded before Flop (didn't bet)
Seat 2: 825f9b92 (small blind) folded before Flop
Seat 3: efe1f2b5 (big blind) showed [Ad 4d] and lost with Pair of Queens and Pair of Sevens
Seat 4: f277bf46 folded before Flop (didn't bet)
Seat 5: Hero showed [Th Ac] and won ($0.42) with Pair of Queens and Pair of Tens
Seat 6: 27bbac55 folded before Flop (didn't bet)


Poker Hand #RC2094647956: Hold'em No Limit ($0.02/$0.05) - 2023/12/27 21:14:49
Table 'RushAndCash3800413' 6-max Seat #1 is the button
Seat 1: d29a0c0f ($10.94 in chips)
Seat 2: ca5575d2 ($4.62 in chips)
Seat 3: 49a7ad82 ($6.05 in chips)
Seat 4: a5b192e7 ($5 in chips)
Seat 5: f205f128 ($6.03 in chips)
Seat 6: Hero ($5.07 in chips)
ca5575d2: posts small blind $0.02
49a7ad82: posts big blind $0.05
*** HOLE CARDS ***
Dealt to d29a0c0f 
Dealt to ca5575d2 
Dealt to 49a7ad82 
Dealt to a5b192e7 
Dealt to f205f128 
Dealt to Hero [Ks 3d]
a5b192e7: calls $0.05
f205f128: folds
Hero: folds
d29a0c0f: folds
ca5575d2: folds
49a7ad82: raises $0.05 to $0.1
a5b192e7: calls $0.05
*** FLOP *** [Kh Js 6d]
49a7ad82: bets $0.11
a5b192e7: folds
Uncalled bet ($0.11) returned to 49a7ad82
*** SHOWDOWN ***
49a7ad82 collected $0.21 from pot
*** SUMMARY ***
Total pot $0.22 | Rake $0.01 | Jackpot $0 | Bingo $0 | Fortune $0 | Tax $0
Board [Kh Js 6d]
Seat 1: d29a0c0f (button) folded before Flop (didn't bet)
Seat 2: ca5575d2 (small blind) folded before Flop
Seat 3: 49a7ad82 (big blind) won ($0.21)
Seat 4: a5b192e7 folded on the Flop
Seat 5: f205f128 folded before Flop (didn't bet)
Seat 6: Hero folded before Flop (didn't bet)


Poker Hand #RC2094647884: Hold'em No Limit ($0.02/$0.05) - 2023/12/27 21:14:45
Table 'RushAndCash3800378' 6-max Seat #1 is the button
Seat 1: b3058cb1 ($6.38 in chips)
Seat 2: Hero ($5.09 in chips)
Seat 3: 98e6c223 ($2.96 in chips)
Seat 4: 7cfc0b19 ($4.22 in chips)
Seat 5: 6c835b69 ($11.46 in chips)
Seat 6: 8c1838da ($10.33 in chips)
Hero: posts small blind $0.02
98e6c223: posts big blind $0.05
*** HOLE CARDS ***
Dealt to b3058cb1 
Dealt to Hero [2h 8c]
Dealt to 98e6c223 
Dealt to 7cfc0b19 
Dealt to 6c835b69 
Dealt to 8c1838da 
7cfc0b19: folds
6c835b69: raises $0.08 to $0.13
8c1838da: folds
b3058cb1: folds
Hero: folds
98e6c223: folds
Uncalled bet ($0.08) returned to 6c835b69
*** SHOWDOWN ***
6c835b69 collected $0.12 from pot
*** SUMMARY ***
Total pot $0.12 | Rake $0 | Jackpot $0 | Bingo $0 | Fortune $0 | Tax $0
Seat 1: b3058cb1 (button) folded before Flop (didn't bet)
Seat 2: Hero (small blind) folded before Flop
Seat 3: 98e6c223 (big blind) folded before Flop
Seat 4: 7cfc0b19 folded before Flop (didn't bet)
Seat 5: 6c835b69 collected ($0.12)
Seat 6: 8c1838da folded before Flop (didn't bet)


Poker Hand #RC2094647783: Hold'em No Limit ($0.02/$0.05) - 2023/12/27 21:14:40
Table 'RushAndCash3800329' 6-max Seat #1 is the button
Seat 1: f205f128 ($6.03 in chips)
Seat 2: 7e545c99 ($2.52 in chips)
Seat 3: 67a8d5f5 ($5 in chips)
Seat 4: 88ac0764 ($5.07 in chips)
Seat 5: Hero ($5.09 in chips)
Seat 6: a1066280 ($7.14 in chips)
7e545c99: posts small blind $0.02
67a8d5f5: posts big blind $0.05
*** HOLE CARDS ***
Dealt to f205f128 
Dealt to 7e545c99 
Dealt to 67a8d5f5 
Dealt to 88ac0764 
Dealt to Hero [2h Qd]
Dealt to a1066280 
88ac0764: folds
Hero: folds
a1066280: folds
f205f128: folds
7e545c99: raises $0.05 to $0.1
67a8d5f5: calls $0.05
*** FLOP *** [2c Jc Kd]
7e545c99: bets $0.06
67a8d5f5: calls $0.06
*** TURN *** [2c Jc Kd] [6h]
7e545c99: bets $0.16
67a8d5f5: folds
Uncalled bet ($0.16) returned to 7e545c99
*** SHOWDOWN ***
7e545c99 collected $0.31 from pot
*** SUMMARY ***
Total pot $0.32 | Rake $0.01 | Jackpot $0 | Bingo $0 | Fortune $0 | Tax $0
Board [2c Jc Kd 6h]
Seat 1: f205f128 (button) folded before Flop (didn't bet)
Seat 2: 7e545c99 (small blind) won ($0.31)
Seat 3: 67a8d5f5 (big blind) folded on the Turn
Seat 4: 88ac0764 folded before Flop (didn't bet)
Seat 5: Hero folded before Flop (didn't bet)
Seat 6: a1066280 folded before Flop (didn't bet)


Poker Hand #RC2094647713: Hold'em No Limit ($0.02/$0.05) - 2023/12/27 21:14:36
Table 'RushAndCash3800295' 6-max Seat #1 is the button
Seat 1: 5105e96e ($5.49 in chips)
Seat 2: 8ec22134 ($5 in chips)
Seat 3: b3affd25 ($1.8 in chips)
Seat 4: 8d50d7f1 ($11.62 in chips)
Seat 5: 64413caa ($6.21 in chips)
Seat 6: Hero ($5.09 in chips)
8ec22134: posts small blind $0.02
b3affd25: posts big blind $0.05
*** HOLE CARDS ***
Dealt to 5105e96e 
Dealt to 8ec22134 
Dealt to b3affd25 
Dealt to 8d50d7f1 
Dealt to 64413caa 
Dealt to Hero [Ts 4d]
8d50d7f1: raises $0.1 to $0.15
64413caa: folds
Hero: folds
5105e96e: folds
8ec22134: folds
b3affd25: folds
Uncalled bet ($0.1) returned to 8d50d7f1
*** SHOWDOWN ***
8d50d7f1 collected $0.12 from pot
*** SUMMARY ***
Total pot $0.12 | Rake $0 | Jackpot $0 | Bingo $0 | Fortune $0 | Tax $0
Seat 1: 5105e96e (button) folded before Flop (didn't bet)
Seat 2: 8ec22134 (small blind) folded before Flop
Seat 3: b3affd25 (big blind) folded before Flop
Seat 4: 8d50d7f1 collected ($0.12)
Seat 5: 64413caa folded before Flop (didn't bet)
Seat 6: Hero folded before Flop (didn't bet)


Poker Hand #RC2094647637: Hold'em No Limit ($0.02/$0.05) - 2023/12/27 21:14:32
Table 'RushAndCash3800257' 6-max Seat #1 is the button
Seat 1: Hero ($5.09 in chips)
Seat 2: 18777630 ($5.08 in chips)
Seat 3: f205f128 ($6.08 in chips)
Seat 4: bcc21958 ($5.19 in chips)
Seat 5: eb5602d2 ($12.05 in chips)
Seat 6: 18f4a2d8 ($5.24 in chips)
18777630: posts small blind $0.02
f205f128: posts big blind $0.05
*** HOLE CARDS ***
Dealt to Hero [As 7c]
Dealt to 18777630 
Dealt to f205f128 
Dealt to bcc21958 
Dealt to eb5602d2 
Dealt to 18f4a2d8 
bcc21958: folds
eb5602d2: raises $0.13 to $0.18
18f4a2d8: folds
Hero: folds
18777630: folds
f205f128: folds
Uncalled bet ($0.13) returned to eb5602d2
*** SHOWDOWN ***
eb5602d2 collected $0.12 from pot
*** SUMMARY ***
Total pot $0.12 | Rake $0 | Jackpot $0 | Bingo $0 | Fortune $0 | Tax $0
Seat 1: Hero (button) folded before Flop (didn't bet)
Seat 2: 18777630 (small blind) folded before Flop
Seat 3: f205f128 (big blind) folded before Flop
Seat 4: bcc21958 folded before Flop (didn't bet)
Seat 5: eb5602d2 collected ($0.12)
Seat 6: 18f4a2d8 folded before Flop (didn't bet)


Poker Hand #RC2094647297: Hold'em No Limit ($0.02/$0.05) - 2023/12/27 21:14:13
Table 'RushAndCash3800092' 6-max Seat #1 is the button
Seat 1: 321b9b2c ($3.05 in chips)
Seat 2: 3c08ca94 ($5 in chips)
Seat 3: Hero ($5.07 in chips)
Seat 4: 40459f94 ($6.22 in chips)
Seat 5: 2c0902b1 ($6.77 in chips)
Seat 6: ed041cf ($4.55 in chips)
3c08ca94: posts small blind $0.02
Hero: posts big blind $0.05
*** HOLE CARDS ***
Dealt to 321b9b2c 
Dealt to 3c08ca94 
Dealt to Hero [Ts Tc]
Dealt to 40459f94 
Dealt to 2c0902b1 
Dealt to ed041cf 
40459f94: folds
2c0902b1: folds
ed041cf: folds
321b9b2c: folds
3c08ca94: folds
Uncalled bet ($0.03) returned to Hero
*** SHOWDOWN ***
Hero collected $0.04 from pot
*** SUMMARY ***
Total pot $0.04 | Rake $0 | Jackpot $0 | Bingo $0 | Fortune $0 | Tax $0
Seat 1: 321b9b2c (button) folded before Flop (didn't bet)
Seat 2: 3c08ca94 (small blind) folded before Flop
Seat 3: Hero (big blind) collected ($0.04)
Seat 4: 40459f94 folded before Flop (didn't bet)
Seat 5: 2c0902b1 folded before Flop (didn't bet)
Seat 6: ed041cf folded before Flop (didn't bet)


Poker Hand #RC2094647105: Hold'em No Limit ($0.02/$0.05) - 2023/12/27 21:14:03
Table 'RushAndCash3800000' 6-max Seat #1 is the button
Seat 1: f7bb7d2b ($5.66 in chips)
Seat 2: Hero ($5.02 in chips)
Seat 3: c402bc27 ($15.52 in chips)
Seat 4: 408d461e ($5.51 in chips)
Seat 5: 6f697def ($4.44 in chips)
Seat 6: 1ab21c81 ($14.6 in chips)
Hero: posts small blind $0.02
c402bc27: posts big blind $0.05
*** HOLE CARDS ***
Dealt to f7bb7d2b 
Dealt to Hero [5c 3c]
Dealt to c402bc27 
Dealt to 408d461e 
Dealt to 6f697def 
Dealt to 1ab21c81 
408d461e: folds
6f697def: folds
1ab21c81: folds
f7bb7d2b: folds
Hero: raises $0.1 to $0.15
c402bc27: folds
Uncalled bet ($0.1) returned to Hero
*** SHOWDOWN ***
Hero collected $0.1 from pot
*** SUMMARY ***
Total pot $0.1 | Rake $0 | Jackpot $0 | Bingo $0 | Fortune $0 | Tax $0
Seat 1: f7bb7d2b (button) folded before Flop (didn't bet)
Seat 2: Hero (small blind) collected ($0.1)
Seat 3: c402bc27 (big blind) folded before Flop
Seat 4: 408d461e folded before Flop (didn't bet)
Seat 5: 6f697def folded before Flop (didn't bet)
Seat 6: 1ab21c81 folded before Flop (didn't bet)


Poker Hand #RC2094646989: Hold'em No Limit ($0.02/$0.05) - 2023/12/27 21:13:57
Table 'RushAndCash3799943' 6-max Seat #1 is the button
Seat 1: 7a27a34f ($11.3 in chips)
Seat 2: 8aeab93d ($5.07 in chips)
Seat 3: 2e81a1b9 ($5.37 in chips)
Seat 4: Hero ($5.02 in chips)
Seat 5: d557ab62 ($12.27 in chips)
Seat 6: 89b6de64 ($16.53 in chips)
8aeab93d: posts small blind $0.02
2e81a1b9: posts big blind $0.05
*** HOLE CARDS ***
Dealt to 7a27a34f 
Dealt to 8aeab93d 
Dealt to 2e81a1b9 
Dealt to Hero [Jh 2h]
Dealt to d557ab62 
Dealt to 89b6de64 
Hero: folds
d557ab62: folds
89b6de64: folds
7a27a34f: raises $0.06 to $0.11
8aeab93d: folds
2e81a1b9: folds
Uncalled bet ($0.06) returned to 7a27a34f
*** SHOWDOWN ***
7a27a34f collected $0.12 from pot
*** SUMMARY ***
Total pot $0.12 | Rake $0 | Jackpot $0 | Bingo $0 | Fortune $0 | Tax $0
Seat 1: 7a27a34f (button) collected ($0.12)
Seat 2: 8aeab93d (small blind) folded before Flop
Seat 3: 2e81a1b9 (big blind) folded before Flop
Seat 4: Hero folded before Flop (didn't bet)
Seat 5: d557ab62 folded before Flop (didn't bet)
Seat 6: 89b6de64 folded before Flop (didn't bet)


Poker Hand #RC2094646904: Hold'em No Limit ($0.02/$0.05) - 2023/12/27 21:13:53
Table 'RushAndCash3799902' 6-max Seat #1 is the button
Seat 1: 2d5e9ec5 ($7.53 in chips)
Seat 2: 9c0fd254 ($6.28 in chips)
Seat 3: 766b77e7 ($5.98 in chips)
Seat 4: Hero ($5.02 in chips)
Seat 5: d67a4d8c ($6.84 in chips)
Seat 6: f1812546 ($5 in chips)
9c0fd254: posts small blind $0.02
766b77e7: posts big blind $0.05
*** HOLE CARDS ***
Dealt to 2d5e9ec5 
Dealt to 9c0fd254 
Dealt to 766b77e7 
Dealt to Hero [7s Kh]
Dealt to d67a4d8c 
Dealt to f1812546 
Hero: folds
d67a4d8c: folds
f1812546: folds
2d5e9ec5: folds
9c0fd254: folds
Uncalled bet ($0.03) returned to 766b77e7
*** SHOWDOWN ***
766b77e7 collected $0.04 from pot
*** SUMMARY ***
Total pot $0.04 | Rake $0 | Jackpot $0 | Bingo $0 | Fortune $0 | Tax $0
Seat 1: 2d5e9ec5 (button) folded before Flop (didn't bet)
Seat 2: 9c0fd254 (small blind) folded before Flop
Seat 3: 766b77e7 (big blind) collected ($0.04)
Seat 4: Hero folded before Flop (didn't bet)
Seat 5: d67a4d8c folded before Flop (didn't bet)
Seat 6: f1812546 folded before Flop (didn't bet)


Poker Hand #RC2094646723: Hold'em No Limit ($0.02/$0.05) - 2023/12/27 21:13:43
Table 'RushAndCash3799810' 6-max Seat #1 is the button
Seat 1: 4c5efad8 ($3.49 in chips)
Seat 2: 14d54b41 ($9.25 in chips)
Seat 3: Hero ($5 in chips)
Seat 4: a66ba699 ($5.48 in chips)
Seat 5: a0193c4f ($8.56 in chips)
Seat 6: bcc21958 ($5.07 in chips)
14d54b41: posts small blind $0.02
Hero: posts big blind $0.05
*** HOLE CARDS ***
Dealt to 4c5efad8 
Dealt to 14d54b41 
Dealt to Hero [Kd Qs]
Dealt to a66ba699 
Dealt to a0193c4f 
Dealt to bcc21958 
a66ba699: folds
a0193c4f: folds
bcc21958: folds
4c5efad8: folds
14d54b41: folds
Uncalled bet ($0.03) returned to Hero
*** SHOWDOWN ***
Hero collected $0.04 from pot
*** SUMMARY ***
Total pot $0.04 | Rake $0 | Jackpot $0 | Bingo $0 | Fortune $0 | Tax $0
Seat 1: 4c5efad8 (button) folded before Flop (didn't bet)
Seat 2: 14d54b41 (small blind) folded before Flop
Seat 3: Hero (big blind) collected ($0.04)
Seat 4: a66ba699 folded before Flop (didn't bet)
Seat 5: a0193c4f folded before Flop (didn't bet)
Seat 6: bcc21958 folded before Flop (didn't bet)


Poker Hand #RC2094646589: Hold'em No Limit ($0.02/$0.05) - 2023/12/27 21:13:36
Table 'RushAndCash3799741' 6-max Seat #1 is the button
Seat 1: Hero ($5 in chips)
Seat 2: e33e9848 ($10.17 in chips)
Seat 3: 322117f9 ($6.58 in chips)
Seat 4: 166d767c ($5.13 in chips)
Seat 5: 1869aa38 ($9.82 in chips)
Seat 6: 959f22e1 ($10.81 in chips)
e33e9848: posts small blind $0.02
322117f9: posts big blind $0.05
*** HOLE CARDS ***
Dealt to Hero [7s 8c]
Dealt to e33e9848 
Dealt to 322117f9 
Dealt to 166d767c 
Dealt to 1869aa38 
Dealt to 959f22e1 
166d767c: raises $0.15 to $0.2
1869aa38: folds
959f22e1: folds
Hero: folds
e33e9848: calls $0.18
322117f9: folds
*** FLOP *** [3s Ac Kc]
e33e9848: bets $0.17
166d767c: calls $0.17
*** TURN *** [3s Ac Kc] [5h]
e33e9848: checks
166d767c: checks
*** RIVER *** [3s Ac Kc 5h] [4s]
e33e9848: bets $1.1
166d767c: calls $1.1
e33e9848: shows [2d 2h] (Fives-High Straight)
166d767c: shows [Ts Tc] (Pair of Tens)
*** SHOWDOWN ***
e33e9848 collected $2.78 from pot
*** SUMMARY ***
Total pot $2.99 | Rake $0.14 | Jackpot $0.07 | Bingo $0 | Fortune $0 | Tax $0
Board [3s Ac Kc 5h 4s]
Seat 1: Hero (button) folded before Flop (didn't bet)
Seat 2: e33e9848 (small blind) showed [2d 2h] and won ($2.78) with Fives-High Straight
Seat 3: 322117f9 (big blind) folded before Flop
Seat 4: 166d767c showed [Ts Tc] and lost with Pair of Tens
Seat 5: 1869aa38 folded before Flop (didn't bet)
Seat 6: 959f22e1 folded before Flop (didn't bet)


Poker Hand #RC2094646358: Hold'em No Limit ($0.02/$0.05) - 2023/12/27 21:13:25
Table 'RushAndCash3799626' 6-max Seat #1 is the button
Seat 1: c5f04825 ($6.42 in chips)
Seat 2: 16db37a3 ($13.04 in chips)
Seat 3: 1a31c869 ($4.3 in chips)
Seat 4: 1869aa38 ($9.87 in chips)
Seat 5: Hero ($5 in chips)
Seat 6: f7bb7d2b ($5.79 in chips)
16db37a3: posts small blind $0.02
1a31c869: posts big blind $0.05
*** HOLE CARDS ***
Dealt to c5f04825 
Dealt to 16db37a3 
Dealt to 1a31c869 
Dealt to 1869aa38 
Dealt to Hero [Td Qs]
Dealt to f7bb7d2b 
1869aa38: folds
Hero: folds
f7bb7d2b: folds
c5f04825: folds
16db37a3: calls $0.03
1a31c869: checks
*** FLOP *** [3d Ad 7d]
16db37a3: checks
1a31c869: checks
*** TURN *** [3d Ad 7d] [9h]
16db37a3: checks
1a31c869: bets $0.05
16db37a3: calls $0.05
*** RIVER *** [3d Ad 7d 9h] [Tc]
16db37a3: bets $0.2
1a31c869: calls $0.2
16db37a3: shows [6h 8s] (Tens-High Straight)
1a31c869: shows [9d Ts] (Pair of Tens and Pair of Nines)
*** SHOWDOWN ***
16db37a3 collected $0.57 from pot
*** SUMMARY ***
Total pot $0.6 | Rake $0.03 | Jackpot $0 | Bingo $0 | Fortune $0 | Tax $0
Board [3d Ad 7d 9h Tc]
Seat 1: c5f04825 (button) folded before Flop (didn't bet)
Seat 2: 16db37a3 (small blind) showed [6h 8s] and won ($0.57) with Tens-High Straight
Seat 3: 1a31c869 (big blind) showed [9d Ts] and lost with Pair of Tens and Pair of Nines
Seat 4: 1869aa38 folded before Flop (didn't bet)
Seat 5: Hero folded before Flop (didn't bet)
Seat 6: f7bb7d2b folded before Flop (didn't bet)


Poker Hand #RC2094646294: Hold'em No Limit ($0.02/$0.05) - 2023/12/27 21:13:21
Table 'RushAndCash3799596' 6-max Seat #1 is the button
Seat 1: c2f9e0f9 ($6.78 in chips)
Seat 2: eaaee430 ($5.02 in chips)
Seat 3: 9ac410bf ($4.93 in chips)
Seat 4: Hero ($5 in chips)
Seat 5: 1a31c869 ($4.3 in chips)
Seat 6: c9d1a1bc ($8.5 in chips)
eaaee430: posts small blind $0.02
9ac410bf: posts big blind $0.05
*** HOLE CARDS ***
Dealt to c2f9e0f9 
Dealt to eaaee430 
Dealt to 9ac410bf 
Dealt to Hero [4c 7d]
Dealt to 1a31c869 
Dealt to c9d1a1bc 
Hero: folds
1a31c869: folds
c9d1a1bc: raises $0.1 to $0.15
c2f9e0f9: folds
eaaee430: folds
9ac410bf: calls $0.1
*** FLOP *** [Qh Ah 5d]
9ac410bf: checks
c9d1a1bc: bets $0.16
9ac410bf: folds
Uncalled bet ($0.16) returned to c9d1a1bc
*** SHOWDOWN ***
c9d1a1bc collected $0.31 from pot
*** SUMMARY ***
Total pot $0.32 | Rake $0.01 | Jackpot $0 | Bingo $0 | Fortune $0 | Tax $0
Board [Qh Ah 5d]
Seat 1: c2f9e0f9 (button) folded before Flop (didn't bet)
Seat 2: eaaee430 (small blind) folded before Flop
Seat 3: 9ac410bf (big blind) folded on the Flop
Seat 4: Hero folded before Flop (didn't bet)
Seat 5: 1a31c869 folded before Flop (didn't bet)
Seat 6: c9d1a1bc won ($0.31)


Poker Hand #RC2094645230: Hold'em No Limit ($0.02/$0.05) - 2023/12/27 21:12:27
Table 'RushAndCash3799080' 6-max Seat #1 is the button
Seat 1: d374c846 ($8.88 in chips)
Seat 2: Hero ($5.02 in chips)
Seat 3: a2949445 ($5.18 in chips)
Seat 4: 8f7d1c8f ($11.72 in chips)
Seat 5: 770cf96b ($7.31 in chips)
Seat 6: cd5cdd0e ($5 in chips)
Hero: posts small blind $0.02
a2949445: posts big blind $0.05
*** HOLE CARDS ***
Dealt to d374c846 
Dealt to Hero [Qh Ah]
Dealt to a2949445 
Dealt to 8f7d1c8f 
Dealt to 770cf96b 
Dealt to cd5cdd0e 
8f7d1c8f: folds
770cf96b: folds
cd5cdd0e: raises $0.05 to $0.1
d374c846: folds
Hero: raises $0.25 to $0.35
a2949445: folds
cd5cdd0e: calls $0.25
*** FLOP *** [6s Kc 7d]
Hero: bets $0.25
cd5cdd0e: calls $0.25
*** TURN *** [6s Kc 7d] [5h]
Hero: bets $0.73
cd5cdd0e: calls $0.73
*** RIVER *** [6s Kc 7d 5h] [3h]
Hero: checks
cd5cdd0e: bets $3.26
Hero: folds
Uncalled bet ($3.26) returned to cd5cdd0e
*** SHOWDOWN ***
cd5cdd0e collected $2.51 from pot
*** SUMMARY ***
Total pot $2.71 | Rake $0.13 | Jackpot $0.07 | Bingo $0 | Fortune $0 | Tax $0
Board [6s Kc 7d 5h 3h]
Seat 1: d374c846 (button) folded before Flop (didn't bet)
Seat 2: Hero (small blind) folded on the River
Seat 3: a2949445 (big blind) folded before Flop
Seat 4: 8f7d1c8f folded before Flop (didn't bet)
Seat 5: 770cf96b folded before Flop (didn't bet)
Seat 6: cd5cdd0e won ($2.51)


Poker Hand #RC2094645162: Hold'em No Limit ($0.02/$0.05) - 2023/12/27 21:12:24
Table 'RushAndCash3799040' 6-max Seat #1 is the button
Seat 1: 51c7aec9 ($5.12 in chips)
Seat 2: c183b7f3 ($1.98 in chips)
Seat 3: d399ee46 ($10.31 in chips)
Seat 4: c2f9e0f9 ($6.69 in chips)
Seat 5: Hero ($5.02 in chips)
Seat 6: 306d378d ($5.07 in chips)
c183b7f3: posts small blind $0.02
d399ee46: posts big blind $0.05
*** HOLE CARDS ***
Dealt to 51c7aec9 
Dealt to c183b7f3 
Dealt to d399ee46 
Dealt to c2f9e0f9 
Dealt to Hero [5h 9c]
Dealt to 306d378d 
c2f9e0f9: folds
Hero: folds
306d378d: folds
51c7aec9: folds
c183b7f3: calls $0.03
d399ee46: checks
*** FLOP *** [9d 6d 4d]
c183b7f3: bets $0.05
d399ee46: folds
Uncalled bet ($0.05) returned to c183b7f3
*** SHOWDOWN ***
c183b7f3 collected $0.1 from pot
*** SUMMARY ***
Total pot $0.1 | Rake $0 | Jackpot $0 | Bingo $0 | Fortune $0 | Tax $0
Board [9d 6d 4d]
Seat 1: 51c7aec9 (button) folded before Flop (didn't bet)
Seat 2: c183b7f3 (small blind) won ($0.1)
Seat 3: d399ee46 (big blind) folded on the Flop
Seat 4: c2f9e0f9 folded before Flop (didn't bet)
Seat 5: Hero folded before Flop (didn't bet)
Seat 6: 306d378d folded before Flop (didn't bet)


Poker Hand #RC2094645021: Hold'em No Limit ($0.02/$0.05) - 2023/12/27 21:12:16
Table 'RushAndCash3798962' 6-max Seat #1 is the button
Seat 1: 42606853 ($12.96 in chips)
Seat 2: b173acdd ($9.76 in chips)
Seat 3: Hero ($5.07 in chips)
Seat 4: a0193c4f ($8.37 in chips)
Seat 5: 8a2b3143 ($5.61 in chips)
Seat 6: 517ef6f4 ($3.64 in chips)
b173acdd: posts small blind $0.02
Hero: posts big blind $0.05
*** HOLE CARDS ***
Dealt to 42606853 
Dealt to b173acdd 
Dealt to Hero [6s 8h]
Dealt to a0193c4f 
Dealt to 8a2b3143 
Dealt to 517ef6f4 
a0193c4f: folds
8a2b3143: folds
517ef6f4: folds
42606853: raises $0.08 to $0.13
b173acdd: calls $0.11
Hero: folds
*** FLOP *** [Ks 7s 9h]
b173acdd: checks
42606853: bets $0.16
b173acdd: calls $0.16
*** TURN *** [Ks 7s 9h] [7c]
b173acdd: bets $0.05
42606853: calls $0.05
*** RIVER *** [Ks 7s 9h 7c] [Ad]
b173acdd: checks
42606853: checks
b173acdd: shows [As 8s] (Pair of Aces and Pair of Sevens)
42606853: shows [Kd Js] (Pair of Kings and Pair of Sevens)
*** SHOWDOWN ***
b173acdd collected $0.7 from pot
*** SUMMARY ***
Total pot $0.73 | Rake $0.03 | Jackpot $0 | Bingo $0 | Fortune $0 | Tax $0
Board [Ks 7s 9h 7c Ad]
Seat 1: 42606853 (button) showed [Kd Js] and lost with Pair of Kings and Pair of Sevens
Seat 2: b173acdd (small blind) showed [As 8s] and won ($0.7) with Pair of Aces and Pair of Sevens
Seat 3: Hero (big blind) folded before Flop
Seat 4: a0193c4f folded before Flop (didn't bet)
Seat 5: 8a2b3143 folded before Flop (didn't bet)
Seat 6: 517ef6f4 folded before Flop (didn't bet)


Poker Hand #RC2094644948: Hold'em No Limit ($0.02/$0.05) - 2023/12/27 21:12:12
Table 'RushAndCash3798924' 6-max Seat #1 is the button
Seat 1: Hero ($5.07 in chips)
Seat 2: fcf84949 ($5 in chips)
Seat 3: 899569f8 ($18.97 in chips)
Seat 4: 42606853 ($12.96 in chips)
Seat 5: 210220d0 ($5 in chips)
Seat 6: 33bd9dde ($4.72 in chips)
fcf84949: posts small blind $0.02
899569f8: posts big blind $0.05
*** HOLE CARDS ***
Dealt to Hero [Ac 9s]
Dealt to fcf84949 
Dealt to 899569f8 
Dealt to 42606853 
Dealt to 210220d0 
Dealt to 33bd9dde 
42606853: folds
210220d0: raises $0.07 to $0.12
33bd9dde: folds
Hero: folds
fcf84949: folds
899569f8: calls $0.07
*** FLOP *** [6c 6d 2d]
899569f8: checks
210220d0: bets $0.13
899569f8: folds
Uncalled bet ($0.13) returned to 210220d0
*** SHOWDOWN ***
210220d0 collected $0.25 from pot
*** SUMMARY ***
Total pot $0.26 | Rake $0.01 | Jackpot $0 | Bingo $0 | Fortune $0 | Tax $0
Board [6c 6d 2d]
Seat 1: Hero (button) folded before Flop (didn't bet)
Seat 2: fcf84949 (small blind) folded before Flop
Seat 3: 899569f8 (big blind) folded on the Flop
Seat 4: 42606853 folded before Flop (didn't bet)
Seat 5: 210220d0 won ($0.25)
Seat 6: 33bd9dde folded before Flop (didn't bet)


Poker Hand #RC2094644878: Hold'em No Limit ($0.02/$0.05) - 2023/12/27 21:12:09
Table 'RushAndCash3798888' 6-max Seat #1 is the button
Seat 1: 306d378d ($5 in chips)
Seat 2: 40758d6c ($5.79 in chips)
Seat 3: 2679c662 ($3.77 in chips)
Seat 4: Hero ($5.07 in chips)
Seat 5: 33bd9dde ($4.72 in chips)
Seat 6: b7228197 ($5 in chips)
40758d6c: posts small blind $0.02
2679c662: posts big blind $0.05
*** HOLE CARDS ***
Dealt to 306d378d 
Dealt to 40758d6c 
Dealt to 2679c662 
Dealt to Hero [9s 8h]
Dealt to 33bd9dde 
Dealt to b7228197 
Hero: folds
33bd9dde: folds
b7228197: folds
306d378d: raises $0.08 to $0.13
40758d6c: folds
2679c662: folds
Uncalled bet ($0.08) returned to 306d378d
*** SHOWDOWN ***
306d378d collected $0.12 from pot
*** SUMMARY ***
Total pot $0.12 | Rake $0 | Jackpot $0 | Bingo $0 | Fortune $0 | Tax $0
Seat 1: 306d378d (button) collected ($0.12)
Seat 2: 40758d6c (small blind) folded before Flop
Seat 3: 2679c662 (big blind) folded before Flop
Seat 4: Hero folded before Flop (didn't bet)
Seat 5: 33bd9dde folded before Flop (didn't bet)
Seat 6: b7228197 folded before Flop (didn't bet)


Poker Hand #RC2094644804: Hold'em No Limit ($0.02/$0.05) - 2023/12/27 21:12:05
Table 'RushAndCash3798848' 6-max Seat #1 is the button
Seat 1: 9c19f0ff ($5 in chips)
Seat 2: 2e81a1b9 ($5.57 in chips)
Seat 3: d648759 ($14.54 in chips)
Seat 4: 874237f1 ($8.04 in chips)
Seat 5: 835cf516 ($5.7 in chips)
Seat 6: Hero ($5.07 in chips)
2e81a1b9: posts small blind $0.02
d648759: posts big blind $0.05
*** HOLE CARDS ***
Dealt to 9c19f0ff 
Dealt to 2e81a1b9 
Dealt to d648759 
Dealt to 874237f1 
Dealt to 835cf516 
Dealt to Hero [Ad 7c]
874237f1: folds
835cf516: raises $0.1 to $0.15
Hero: folds
9c19f0ff: folds
2e81a1b9: folds
d648759: folds
Uncalled bet ($0.1) returned to 835cf516
*** SHOWDOWN ***
835cf516 collected $0.12 from pot
*** SUMMARY ***
Total pot $0.12 | Rake $0 | Jackpot $0 | Bingo $0 | Fortune $0 | Tax $0
Seat 1: 9c19f0ff (button) folded before Flop (didn't bet)
Seat 2: 2e81a1b9 (small blind) folded before Flop
Seat 3: d648759 (big blind) folded before Flop
Seat 4: 874237f1 folded before Flop (didn't bet)
Seat 5: 835cf516 collected ($0.12)
Seat 6: Hero folded before Flop (didn't bet)


Poker Hand #RC2094624546: Hold'em No Limit ($0.02/$0.05) - 2023/12/27 21:11:51
Table 'RushAndCash3798716' 6-max Seat #1 is the button
Seat 1: bf02d9b6 ($4.82 in chips)
Seat 2: 245b14fe ($4.34 in chips)
Seat 3: b9aa90d9 ($11.98 in chips)
Seat 4: Hero ($5 in chips)
Seat 5: 81c77fb7 ($5.24 in chips)
Seat 6: 8f72056d ($6.7 in chips)
245b14fe: posts small blind $0.02
b9aa90d9: posts big blind $0.05
*** HOLE CARDS ***
Dealt to bf02d9b6 
Dealt to 245b14fe 
Dealt to b9aa90d9 
Dealt to Hero [Jd Td]
Dealt to 81c77fb7 
Dealt to 8f72056d 
Hero: raises $0.05 to $0.1
81c77fb7: folds
8f72056d: folds
bf02d9b6: folds
245b14fe: folds
b9aa90d9: folds
Uncalled bet ($0.05) returned to Hero
*** SHOWDOWN ***
Hero collected $0.12 from pot
*** SUMMARY ***
Total pot $0.12 | Rake $0 | Jackpot $0 | Bingo $0 | Fortune $0 | Tax $0
Seat 1: bf02d9b6 (button) folded before Flop (didn't bet)
Seat 2: 245b14fe (small blind) folded before Flop
Seat 3: b9aa90d9 (big blind) folded before Flop
Seat 4: Hero collected ($0.12)
Seat 5: 81c77fb7 folded before Flop (didn't bet)
Seat 6: 8f72056d folded before Flop (didn't bet)


Poker Hand #RC2094624123: Hold'em No Limit ($0.02/$0.05) - 2023/12/27 21:11:29
Table 'RushAndCash3798510' 6-max Seat #1 is the button
Seat 1: 4d2ad130 ($5 in chips)
Seat 2: 88ac0764 ($5.14 in chips)
Seat 3: b15f02a3 ($16.96 in chips)
Seat 4: 1c22b9b5 ($9.57 in chips)
Seat 5: 19b51c07 ($10.48 in chips)
Seat 6: Hero ($5.02 in chips)
88ac0764: posts small blind $0.02
b15f02a3: posts big blind $0.05
*** HOLE CARDS ***
Dealt to 4d2ad130 
Dealt to 88ac0764 
Dealt to b15f02a3 
Dealt to 1c22b9b5 
Dealt to 19b51c07 
Dealt to Hero [7d 8d]
1c22b9b5: folds
19b51c07: folds
Hero: raises $0.05 to $0.1
4d2ad130: calls $0.1
88ac0764: folds
b15f02a3: folds
*** FLOP *** [Kh Ac 9s]
Hero: checks
4d2ad130: bets $0.14
Hero: folds
Uncalled bet ($0.14) returned to 4d2ad130
*** SHOWDOWN ***
4d2ad130 collected $0.26 from pot
*** SUMMARY ***
Total pot $0.27 | Rake $0.01 | Jackpot $0 | Bingo $0 | Fortune $0 | Tax $0
Board [Kh Ac 9s]
Seat 1: 4d2ad130 (button) won ($0.26)
Seat 2: 88ac0764 (small blind) folded before Flop
Seat 3: b15f02a3 (big blind) folded before Flop
Seat 4: 1c22b9b5 folded before Flop (didn't bet)
Seat 5: 19b51c07 folded before Flop (didn't bet)
Seat 6: Hero folded on the Flop


Poker Hand #RC2094624049: Hold'em No Limit ($0.02/$0.05) - 2023/12/27 21:11:25
Table 'RushAndCash3798476' 6-max Seat #1 is the button
Seat 1: Hero ($5.02 in chips)
Seat 2: f606596 ($4.79 in chips)
Seat 3: 8502c1be ($5.14 in chips)
Seat 4: b15f02a3 ($16.96 in chips)
Seat 5: 1c22b9b5 ($9.57 in chips)
Seat 6: 1920ea44 ($6.15 in chips)
f606596: posts small blind $0.02
8502c1be: posts big blind $0.05
*** HOLE CARDS ***
Dealt to Hero [9c 4d]
Dealt to f606596 
Dealt to 8502c1be 
Dealt to b15f02a3 
Dealt to 1c22b9b5 
Dealt to 1920ea44 
b15f02a3: folds
1c22b9b5: folds
1920ea44: raises $0.06 to $0.11
Hero: folds
f606596: calls $0.09
8502c1be: calls $0.06
*** FLOP *** [5s Qs Ts]
f606596: checks
8502c1be: checks
1920ea44: checks
*** TURN *** [5s Qs Ts] [5d]
f606596: checks
8502c1be: checks
1920ea44: bets $0.1
f606596: raises $0.18 to $0.28
8502c1be: folds
1920ea44: calls $0.18
*** RIVER *** [5s Qs Ts 5d] [5c]
f606596: checks
1920ea44: checks
f606596: shows [9s Kc] (Three Fives)
1920ea44: shows [As 2s] (Ace High Flush)
*** SHOWDOWN ***
1920ea44 collected $0.85 from pot
*** SUMMARY ***
Total pot $0.89 | Rake $0.04 | Jackpot $0 | Bingo $0 | Fortune $0 | Tax $0
Board [5s Qs Ts 5d 5c]
Seat 1: Hero (button) folded before Flop (didn't bet)
Seat 2: f606596 (small blind) showed [9s Kc] and lost with Three Fives
Seat 3: 8502c1be (big blind) folded on the Turn
Seat 4: b15f02a3 folded before Flop (didn't bet)
Seat 5: 1c22b9b5 folded before Flop (didn't bet)
Seat 6: 1920ea44 showed [As 2s] and won ($0.85) with Ace High Flush


Poker Hand #RC2094623737: Hold'em No Limit ($0.02/$0.05) - 2023/12/27 21:11:08
Table 'RushAndCash3798332' 6-max Seat #1 is the button
Seat 1: a7cda06b ($8.3 in chips)
Seat 2: fd515659 ($2.85 in chips)
Seat 3: Hero ($5 in chips)
Seat 4: 9a47c457 ($5.69 in chips)
Seat 5: 8d34bb34 ($5 in chips)
Seat 6: d94cce2e ($5.17 in chips)
fd515659: posts small blind $0.02
Hero: posts big blind $0.05
*** HOLE CARDS ***
Dealt to a7cda06b 
Dealt to fd515659 
Dealt to Hero [Jh 9h]
Dealt to 9a47c457 
Dealt to 8d34bb34 
Dealt to d94cce2e 
9a47c457: folds
8d34bb34: folds
d94cce2e: folds
a7cda06b: folds
fd515659: folds
Uncalled bet ($0.03) returned to Hero
*** SHOWDOWN ***
Hero collected $0.04 from pot
*** SUMMARY ***
Total pot $0.04 | Rake $0 | Jackpot $0 | Bingo $0 | Fortune $0 | Tax $0
Seat 1: a7cda06b (button) folded before Flop (didn't bet)
Seat 2: fd515659 (small blind) folded before Flop
Seat 3: Hero (big blind) collected ($0.04)
Seat 4: 9a47c457 folded before Flop (didn't bet)
Seat 5: 8d34bb34 folded before Flop (didn't bet)
Seat 6: d94cce2e folded before Flop (didn't bet)


Poker Hand #RC2094623672: Hold'em No Limit ($0.02/$0.05) - 2023/12/27 21:11:05
Table 'RushAndCash3798301' 6-max Seat #1 is the button
Seat 1: 4f4a5f3a ($5 in chips)
Seat 2: 7aad2653 ($5.04 in chips)
Seat 3: 314d6258 ($6.65 in chips)
Seat 4: 6b4efc04 ($6.37 in chips)
Seat 5: Hero ($5 in chips)
Seat 6: fd515659 ($2.85 in chips)
7aad2653: posts small blind $0.02
314d6258: posts big blind $0.05
*** HOLE CARDS ***
Dealt to 4f4a5f3a 
Dealt to 7aad2653 
Dealt to 314d6258 
Dealt to 6b4efc04 
Dealt to Hero [7h As]
Dealt to fd515659 
6b4efc04: raises $0.06 to $0.11
Hero: folds
fd515659: folds
4f4a5f3a: folds
7aad2653: calls $0.09
314d6258: folds
*** FLOP *** [9d 8d 5c]
7aad2653: bets $0.1
6b4efc04: calls $0.1
*** TURN *** [9d 8d 5c] [Jc]
7aad2653: bets $0.21
6b4efc04: calls $0.21
*** RIVER *** [9d 8d 5c Jc] [8s]
7aad2653: checks
6b4efc04: bets $1.12
7aad2653: calls $1.12
6b4efc04: shows [Kc Ks] (Pair of Kings and Pair of Eights)
7aad2653: shows [7s 9s] (Pair of Nines and Pair of Eights)
*** SHOWDOWN ***
6b4efc04 collected $2.91 from pot
*** SUMMARY ***
Total pot $3.13 | Rake $0.15 | Jackpot $0.07 | Bingo $0 | Fortune $0 | Tax $0
Board [9d 8d 5c Jc 8s]
Seat 1: 4f4a5f3a (button) folded before Flop (didn't bet)
Seat 2: 7aad2653 (small blind) showed [7s 9s] and lost with Pair of Nines and Pair of Eights
Seat 3: 314d6258 (big blind) folded before Flop
Seat 4: 6b4efc04 showed [Kc Ks] and won ($2.91) with Pair of Kings and Pair of Eights
Seat 5: Hero folded before Flop (didn't bet)
Seat 6: fd515659 folded before Flop (didn't bet)


Poker Hand #RC2094623597: Hold'em No Limit ($0.02/$0.05) - 2023/12/27 21:11:01
Table 'RushAndCash3798265' 6-max Seat #1 is the button
Seat 1: 3730e16c ($5.65 in chips)
Seat 2: 4a471529 ($5.36 in chips)
Seat 3: 811a4b4f ($5.61 in chips)
Seat 4: Hero ($5 in chips)
Seat 5: a6d86089 ($6.13 in chips)
Seat 6: 596ebc2d ($4.82 in chips)
4a471529: posts small blind $0.02
811a4b4f: posts big blind $0.05
*** HOLE CARDS ***
Dealt to 3730e16c 
Dealt to 4a471529 
Dealt to 811a4b4f 
Dealt to Hero [Ks 7c]
Dealt to a6d86089 
Dealt to 596ebc2d 
Hero: folds
a6d86089: folds
596ebc2d: folds
3730e16c: raises $0.08 to $0.13
4a471529: folds
811a4b4f: calls $0.08
*** FLOP *** [5h 6d Jc]
811a4b4f: checks
3730e16c: checks
*** TURN *** [5h 6d Jc] [3c]
811a4b4f: checks
3730e16c: bets $0.21
811a4b4f: folds
Uncalled bet ($0.21) returned to 3730e16c
*** SHOWDOWN ***
3730e16c collected $0.27 from pot
*** SUMMARY ***
Total pot $0.28 | Rake $0.01 | Jackpot $0 | Bingo $0 | Fortune $0 | Tax $0
Board [5h 6d Jc 3c]
Seat 1: 3730e16c (button) won ($0.27)
Seat 2: 4a471529 (small blind) folded before Flop
Seat 3: 811a4b4f (big blind) folded on the Turn
Seat 4: Hero folded before Flop (didn't bet)
Seat 5: a6d86089 folded before Flop (didn't bet)
Seat 6: 596ebc2d folded before Flop (didn't bet)


Poker Hand #RC2094623524: Hold'em No Limit ($0.02/$0.05) - 2023/12/27 21:10:57
Table 'RushAndCash3798232' 6-max Seat #1 is the button
Seat 1: Hero ($5 in chips)
Seat 2: 74882d05 ($3.59 in chips)
Seat 3: d7c33821 ($6.41 in chips)
Seat 4: a6d86089 ($6.13 in chips)
Seat 5: f57e179a ($4.07 in chips)
Seat 6: 1c22b9b5 ($9.64 in chips)
74882d05: posts small blind $0.02
d7c33821: posts big blind $0.05
*** HOLE CARDS ***
Dealt to Hero [3s 8c]
Dealt to 74882d05 
Dealt to d7c33821 
Dealt to a6d86089 
Dealt to f57e179a 
Dealt to 1c22b9b5 
a6d86089: folds
f57e179a: folds
1c22b9b5: folds
Hero: folds
74882d05: raises $0.08 to $0.13
d7c33821: folds
Uncalled bet ($0.08) returned to 74882d05
*** SHOWDOWN ***
74882d05 collected $0.1 from pot
*** SUMMARY ***
Total pot $0.1 | Rake $0 | Jackpot $0 | Bingo $0 | Fortune $0 | Tax $0
Seat 1: Hero (button) folded before Flop (didn't bet)
Seat 2: 74882d05 (small blind) collected ($0.1)
Seat 3: d7c33821 (big blind) folded before Flop
Seat 4: a6d86089 folded before Flop (didn't bet)
Seat 5: f57e179a folded before Flop (didn't bet)
Seat 6: 1c22b9b5 folded before Flop (didn't bet)


Poker Hand #RC2094623384: Hold'em No Limit ($0.02/$0.05) - 2023/12/27 21:10:49
Table 'RushAndCash3798160' 6-max Seat #1 is the button
Seat 1: 633ada18 ($5 in chips)
Seat 2: Hero ($5 in chips)
Seat 3: 4bf73170 ($6.89 in chips)
Seat 4: 768ccfca ($5.42 in chips)
Seat 5: 18e28073 ($4.96 in chips)
Seat 6: bf7097d8 ($1.56 in chips)
Hero: posts small blind $0.02
4bf73170: posts big blind $0.05
*** HOLE CARDS ***
Dealt to 633ada18 
Dealt to Hero [Jh 7d]
Dealt to 4bf73170 
Dealt to 768ccfca 
Dealt to 18e28073 
Dealt to bf7097d8 
768ccfca: folds
18e28073: raises $0.06 to $0.11
bf7097d8: calls $0.11
633ada18: folds
Hero: folds
4bf73170: raises $0.53 to $0.64
18e28073: folds
bf7097d8: folds
Uncalled bet ($0.53) returned to 4bf73170
*** SHOWDOWN ***
4bf73170 collected $0.34 from pot
*** SUMMARY ***
Total pot $0.35 | Rake $0.01 | Jackpot $0 | Bingo $0 | Fortune $0 | Tax $0
Seat 1: 633ada18 (button) folded before Flop (didn't bet)
Seat 2: Hero (small blind) folded before Flop
Seat 3: 4bf73170 (big blind) collected ($0.34)
Seat 4: 768ccfca folded before Flop (didn't bet)
Seat 5: 18e28073 folded before Flop
Seat 6: bf7097d8 folded before Flop


Poker Hand #RC2094623246: Hold'em No Limit ($0.02/$0.05) - 2023/12/27 21:10:41
Table 'RushAndCash3798097' 6-max Seat #1 is the button
Seat 1: ddd79037 ($5.96 in chips)
Seat 2: Hero ($5 in chips)
Seat 3: 52dc12c9 ($5.56 in chips)
Seat 4: 474b1213 ($12.08 in chips)
Seat 5: 40758d6c ($5.51 in chips)
Seat 6: 53085a55 ($5.25 in chips)
Hero: posts small blind $0.02
52dc12c9: posts big blind $0.05
*** HOLE CARDS ***
Dealt to ddd79037 
Dealt to Hero [2d Th]
Dealt to 52dc12c9 
Dealt to 474b1213 
Dealt to 40758d6c 
Dealt to 53085a55 
474b1213: folds
40758d6c: raises $0.08 to $0.13
53085a55: folds
ddd79037: folds
Hero: folds
52dc12c9: folds
Uncalled bet ($0.08) returned to 40758d6c
*** SHOWDOWN ***
40758d6c collected $0.12 from pot
*** SUMMARY ***
Total pot $0.12 | Rake $0 | Jackpot $0 | Bingo $0 | Fortune $0 | Tax $0
Seat 1: ddd79037 (button) folded before Flop (didn't bet)
Seat 2: Hero (small blind) folded before Flop
Seat 3: 52dc12c9 (big blind) folded before Flop
Seat 4: 474b1213 folded before Flop (didn't bet)
Seat 5: 40758d6c collected ($0.12)
Seat 6: 53085a55 folded before Flop (didn't bet)


Poker Hand #RC2094622163: Hold'em No Limit ($0.02/$0.05) - 2023/12/27 21:09:44
Table 'RushAndCash3797568' 6-max Seat #1 is the button
Seat 1: 633ada18 ($5.12 in chips)
Seat 2: c5f04825 ($6.37 in chips)
Seat 3: Hero ($5 in chips)
Seat 4: 934d578e ($1.25 in chips)
Seat 5: 39b64697 ($5 in chips)
Seat 6: 1952a42a ($2.03 in chips)
c5f04825: posts small blind $0.02
Hero: posts big blind $0.05
*** HOLE CARDS ***
Dealt to 633ada18 
Dealt to c5f04825 
Dealt to Hero [8h Kh]
Dealt to 934d578e 
Dealt to 39b64697 
Dealt to 1952a42a 
934d578e: folds
39b64697: folds
1952a42a: raises $0.1 to $0.15
633ada18: folds
c5f04825: folds
Hero: calls $0.1
*** FLOP *** [4s Ts 8d]
Hero: checks
1952a42a: bets $0.13
Hero: calls $0.13
*** TURN *** [4s Ts 8d] [Qh]
Hero: checks
1952a42a: bets $0.31
Hero: folds
Uncalled bet ($0.31) returned to 1952a42a
*** SHOWDOWN ***
1952a42a collected $0.56 from pot
*** SUMMARY ***
Total pot $0.58 | Rake $0.02 | Jackpot $0 | Bingo $0 | Fortune $0 | Tax $0
Board [4s Ts 8d Qh]
Seat 1: 633ada18 (button) folded before Flop (didn't bet)
Seat 2: c5f04825 (small blind) folded before Flop
Seat 3: Hero (big blind) folded on the Turn
Seat 4: 934d578e folded before Flop (didn't bet)
Seat 5: 39b64697 folded before Flop (didn't bet)
Seat 6: 1952a42a won ($0.56)


Poker Hand #RC2094622093: Hold'em No Limit ($0.02/$0.05) - 2023/12/27 21:09:40
Table 'RushAndCash3797534' 6-max Seat #1 is the button
Seat 1: aa286bd3 ($7.98 in chips)
Seat 2: 802b86d ($5.6 in chips)
Seat 3: 9d2a004e ($5.69 in chips)
Seat 4: Hero ($5 in chips)
Seat 5: 7434f2f7 ($6.42 in chips)
Seat 6: 6fe5b0e5 ($5.48 in chips)
802b86d: posts small blind $0.02
9d2a004e: posts big blind $0.05
*** HOLE CARDS ***
Dealt to aa286bd3 
Dealt to 802b86d 
Dealt to 9d2a004e 
Dealt to Hero [Ac 8s]
Dealt to 7434f2f7 
Dealt to 6fe5b0e5 
Hero: folds
7434f2f7: folds
6fe5b0e5: folds
aa286bd3: folds
802b86d: folds
Uncalled bet ($0.03) returned to 9d2a004e
*** SHOWDOWN ***
9d2a004e collected $0.04 from pot
*** SUMMARY ***
Total pot $0.04 | Rake $0 | Jackpot $0 | Bingo $0 | Fortune $0 | Tax $0
Seat 1: aa286bd3 (button) folded before Flop (didn't bet)
Seat 2: 802b86d (small blind) folded before Flop
Seat 3: 9d2a004e (big blind) collected ($0.04)
Seat 4: Hero folded before Flop (didn't bet)
Seat 5: 7434f2f7 folded before Flop (didn't bet)
Seat 6: 6fe5b0e5 folded before Flop (didn't bet)


Poker Hand #RC2094622025: Hold'em No Limit ($0.02/$0.05) - 2023/12/27 21:09:37
Table 'RushAndCash3797500' 6-max Seat #1 is the button
Seat 1: ea506754 ($3.7 in chips)
Seat 2: 848770d0 ($5.35 in chips)
Seat 3: 629cdcea ($5.23 in chips)
Seat 4: 295c493 ($5 in chips)
Seat 5: Hero ($5 in chips)
Seat 6: 24862006 ($5.6 in chips)
848770d0: posts small blind $0.02
629cdcea: posts big blind $0.05
*** HOLE CARDS ***
Dealt to ea506754 
Dealt to 848770d0 
Dealt to 629cdcea 
Dealt to 295c493 
Dealt to Hero [Kd 2h]
Dealt to 24862006 
295c493: folds
Hero: folds
24862006: calls $0.05
ea506754: folds
848770d0: calls $0.03
629cdcea: checks
*** FLOP *** [Jc 4c 3h]
848770d0: bets $0.08
629cdcea: folds
24862006: raises $0.12 to $0.2
848770d0: calls $0.12
*** TURN *** [Jc 4c 3h] [7s]
848770d0: checks
24862006: checks
*** RIVER *** [Jc 4c 3h 7s] [6s]
848770d0: checks
24862006: checks
848770d0: shows [2s 5s] (Sevens-High Straight)
24862006: shows [Qh Js] (Pair of Jacks)
*** SHOWDOWN ***
848770d0 collected $0.53 from pot
*** SUMMARY ***
Total pot $0.55 | Rake $0.02 | Jackpot $0 | Bingo $0 | Fortune $0 | Tax $0
Board [Jc 4c 3h 7s 6s]
Seat 1: ea506754 (button) folded before Flop (didn't bet)
Seat 2: 848770d0 (small blind) showed [2s 5s] and won ($0.53) with Sevens-High Straight
Seat 3: 629cdcea (big blind) folded on the Flop
Seat 4: 295c493 folded before Flop (didn't bet)
Seat 5: Hero folded before Flop (didn't bet)
Seat 6: 24862006 showed [Qh Js] and lost with Pair of Jacks


Poker Hand #RC2094621950: Hold'em No Limit ($0.02/$0.05) - 2023/12/27 21:09:33
Table 'RushAndCash3797464' 6-max Seat #1 is the button
Seat 1: c7d29ab9 ($5.09 in chips)
Seat 2: 6e63b45 ($4.95 in chips)
Seat 3: fe92596e ($8.38 in chips)
Seat 4: 9f73cd48 ($5.57 in chips)
Seat 5: b0d5aa2f ($5 in chips)
Seat 6: Hero ($5 in chips)
6e63b45: posts small blind $0.02
fe92596e: posts big blind $0.05
*** HOLE CARDS ***
Dealt to c7d29ab9 
Dealt to 6e63b45 
Dealt to fe92596e 
Dealt to 9f73cd48 
Dealt to b0d5aa2f 
Dealt to Hero [Qc 2c]
9f73cd48: folds
b0d5aa2f: folds
Hero: folds
c7d29ab9: raises $0.08 to $0.13
6e63b45: folds
fe92596e: folds
Uncalled bet ($0.08) returned to c7d29ab9
*** SHOWDOWN ***
c7d29ab9 collected $0.12 from pot
*** SUMMARY ***
Total pot $0.12 | Rake $0 | Jackpot $0 | Bingo $0 | Fortune $0 | Tax $0
Seat 1: c7d29ab9 (button) collected ($0.12)
Seat 2: 6e63b45 (small blind) folded before Flop
Seat 3: fe92596e (big blind) folded before Flop
Seat 4: 9f73cd48 folded before Flop (didn't bet)
Seat 5: b0d5aa2f folded before Flop (didn't bet)
Seat 6: Hero folded before Flop (didn't bet)


Poker Hand #RC2094621879: Hold'em No Limit ($0.02/$0.05) - 2023/12/27 21:09:29
Table 'RushAndCash3797427' 6-max Seat #1 is the button
Seat 1: 7c9867dc ($5 in chips)
Seat 2: a7bfee05 ($5.01 in chips)
Seat 3: 8502c1be ($5.82 in chips)
Seat 4: Hero ($5 in chips)
Seat 5: 9233e24b ($5.11 in chips)
Seat 6: 2e75303d ($6.06 in chips)
a7bfee05: posts small blind $0.02
8502c1be: posts big blind $0.05
*** HOLE CARDS ***
Dealt to 7c9867dc 
Dealt to a7bfee05 
Dealt to 8502c1be 
Dealt to Hero [8h Js]
Dealt to 9233e24b 
Dealt to 2e75303d 
Hero: folds
9233e24b: raises $0.05 to $0.1
2e75303d: folds
7c9867dc: folds
a7bfee05: folds
8502c1be: folds
Uncalled bet ($0.05) returned to 9233e24b
*** SHOWDOWN ***
9233e24b collected $0.12 from pot
*** SUMMARY ***
Total pot $0.12 | Rake $0 | Jackpot $0 | Bingo $0 | Fortune $0 | Tax $0
Seat 1: 7c9867dc (button) folded before Flop (didn't bet)
Seat 2: a7bfee05 (small blind) folded before Flop
Seat 3: 8502c1be (big blind) folded before Flop
Seat 4: Hero folded before Flop (didn't bet)
Seat 5: 9233e24b collected ($0.12)
Seat 6: 2e75303d folded before Flop (didn't bet)


Poker Hand #RC2094621200: Hold'em No Limit ($0.02/$0.05) - 2023/12/27 21:08:55
Table 'RushAndCash3797091' 6-max Seat #1 is the button
Seat 1: Hero ($5.16 in chips)
Seat 2: 322117f9 ($5.05 in chips)
Seat 3: 314d6258 ($5.91 in chips)
Seat 4: 50c78359 ($5.26 in chips)
Seat 5: 6ed64054 ($7.53 in chips)
Seat 6: 2fbdc427 ($3.95 in chips)
322117f9: posts small blind $0.02
314d6258: posts big blind $0.05
*** HOLE CARDS ***
Dealt to Hero [Qh As]
Dealt to 322117f9 
Dealt to 314d6258 
Dealt to 50c78359 
Dealt to 6ed64054 
Dealt to 2fbdc427 
50c78359: raises $0.06 to $0.11
6ed64054: folds
2fbdc427: folds
Hero: raises $0.29 to $0.4
322117f9: folds
314d6258: folds
50c78359: raises $0.65 to $1.05
Hero: folds
Uncalled bet ($0.65) returned to 50c78359
*** SHOWDOWN ***
50c78359 collected $0.83 from pot
*** SUMMARY ***
Total pot $0.87 | Rake $0.04 | Jackpot $0 | Bingo $0 | Fortune $0 | Tax $0
Seat 1: Hero (button) folded before Flop
Seat 2: 322117f9 (small blind) folded before Flop
Seat 3: 314d6258 (big blind) folded before Flop
Seat 4: 50c78359 collected ($0.83)
Seat 5: 6ed64054 folded before Flop (didn't bet)
Seat 6: 2fbdc427 folded before Flop (didn't bet)


Poker Hand #RC2094620951: Hold'em No Limit ($0.02/$0.05) - 2023/12/27 21:08:42
Table 'RushAndCash3796971' 6-max Seat #1 is the button
Seat 1: bf66b573 ($5 in chips)
Seat 2: f2893c22 ($4.85 in chips)
Seat 3: Hero ($5.21 in chips)
Seat 4: b921ba92 ($7.25 in chips)
Seat 5: 52120f98 ($18.85 in chips)
Seat 6: 16390841 ($5.16 in chips)
f2893c22: posts small blind $0.02
Hero: posts big blind $0.05
*** HOLE CARDS ***
Dealt to bf66b573 
Dealt to f2893c22 
Dealt to Hero [4h 2c]
Dealt to b921ba92 
Dealt to 52120f98 
Dealt to 16390841 
b921ba92: folds
52120f98: folds
16390841: folds
bf66b573: folds
f2893c22: raises $0.05 to $0.1
Hero: folds
Uncalled bet ($0.05) returned to f2893c22
*** SHOWDOWN ***
f2893c22 collected $0.1 from pot
*** SUMMARY ***
Total pot $0.1 | Rake $0 | Jackpot $0 | Bingo $0 | Fortune $0 | Tax $0
Seat 1: bf66b573 (button) folded before Flop (didn't bet)
Seat 2: f2893c22 (small blind) collected ($0.1)
Seat 3: Hero (big blind) folded before Flop
Seat 4: b921ba92 folded before Flop (didn't bet)
Seat 5: 52120f98 folded before Flop (didn't bet)
Seat 6: 16390841 folded before Flop (didn't bet)


Poker Hand #RC2094620854: Hold'em No Limit ($0.02/$0.05) - 2023/12/27 21:08:37
Table 'RushAndCash3796925' 6-max Seat #1 is the button
Seat 1: f06fe10f ($9.19 in chips)
Seat 2: 629cdcea ($5.11 in chips)
Seat 3: 885703cf ($5.95 in chips)
Seat 4: Hero ($5.21 in chips)
Seat 5: 4cce8b54 ($5.72 in chips)
Seat 6: 8279270c ($4.8 in chips)
629cdcea: posts small blind $0.02
885703cf: posts big blind $0.05
*** HOLE CARDS ***
Dealt to f06fe10f 
Dealt to 629cdcea 
Dealt to 885703cf 
Dealt to Hero [2c 9s]
Dealt to 4cce8b54 
Dealt to 8279270c 
Hero: folds
4cce8b54: folds
8279270c: folds
f06fe10f: folds
629cdcea: folds
Uncalled bet ($0.03) returned to 885703cf
*** SHOWDOWN ***
885703cf collected $0.04 from pot
*** SUMMARY ***
Total pot $0.04 | Rake $0 | Jackpot $0 | Bingo $0 | Fortune $0 | Tax $0
Seat 1: f06fe10f (button) folded before Flop (didn't bet)
Seat 2: 629cdcea (small blind) folded before Flop
Seat 3: 885703cf (big blind) collected ($0.04)
Seat 4: Hero folded before Flop (didn't bet)
Seat 5: 4cce8b54 folded before Flop (didn't bet)
Seat 6: 8279270c folded before Flop (didn't bet)


Poker Hand #RC2094620699: Hold'em No Limit ($0.02/$0.05) - 2023/12/27 21:08:29
Table 'RushAndCash3796849' 6-max Seat #1 is the button
Seat 1: 5d3d3bbe ($5.78 in chips)
Seat 2: Hero ($5.23 in chips)
Seat 3: 86805dc6 ($5.64 in chips)
Seat 4: 2336d0e7 ($7.91 in chips)
Seat 5: 3893948d ($9.16 in chips)
Seat 6: aa286bd3 ($8.11 in chips)
Hero: posts small blind $0.02
86805dc6: posts big blind $0.05
*** HOLE CARDS ***
Dealt to 5d3d3bbe 
Dealt to Hero [Qc 3s]
Dealt to 86805dc6 
Dealt to 2336d0e7 
Dealt to 3893948d 
Dealt to aa286bd3 
2336d0e7: folds
3893948d: folds
aa286bd3: folds
5d3d3bbe: folds
Hero: folds
Uncalled bet ($0.03) returned to 86805dc6
*** SHOWDOWN ***
86805dc6 collected $0.04 from pot
*** SUMMARY ***
Total pot $0.04 | Rake $0 | Jackpot $0 | Bingo $0 | Fortune $0 | Tax $0
Seat 1: 5d3d3bbe (button) folded before Flop (didn't bet)
Seat 2: Hero (small blind) folded before Flop
Seat 3: 86805dc6 (big blind) collected ($0.04)
Seat 4: 2336d0e7 folded before Flop (didn't bet)
Seat 5: 3893948d folded before Flop (didn't bet)
Seat 6: aa286bd3 folded before Flop (didn't bet)


Poker Hand #RC2094620584: Hold'em No Limit ($0.02/$0.05) - 2023/12/27 21:08:23
Table 'RushAndCash3796793' 6-max Seat #1 is the button
Seat 1: 31b97f11 ($5.11 in chips)
Seat 2: Hero ($5.25 in chips)
Seat 3: 1f61adb3 ($3.75 in chips)
Seat 4: a61fa0e1 ($8.48 in chips)
Seat 5: 57c77a71 ($9.58 in chips)
Seat 6: df6fad0a ($6.29 in chips)
Hero: posts small blind $0.02
1f61adb3: posts big blind $0.05
*** HOLE CARDS ***
Dealt to 31b97f11 
Dealt to Hero [3d 6s]
Dealt to 1f61adb3 
Dealt to a61fa0e1 
Dealt to 57c77a71 
Dealt to df6fad0a 
a61fa0e1: folds
57c77a71: folds
df6fad0a: raises $0.05 to $0.1
31b97f11: raises $0.2 to $0.3
Hero: folds
1f61adb3: folds
df6fad0a: raises $0.6 to $0.9
31b97f11: calls $0.6
*** FLOP *** [Qd 5s 9h]
df6fad0a: bets $0.77
31b97f11: folds
Uncalled bet ($0.77) returned to df6fad0a
*** SHOWDOWN ***
df6fad0a collected $1.71 from pot
*** SUMMARY ***
Total pot $1.87 | Rake $0.09 | Jackpot $0.07 | Bingo $0 | Fortune $0 | Tax $0
Board [Qd 5s 9h]
Seat 1: 31b97f11 (button) folded on the Flop
Seat 2: Hero (small blind) folded before Flop
Seat 3: 1f61adb3 (big blind) folded before Flop
Seat 4: a61fa0e1 folded before Flop (didn't bet)
Seat 5: 57c77a71 folded before Flop (didn't bet)
Seat 6: df6fad0a won ($1.71)


Poker Hand #RC2094620515: Hold'em No Limit ($0.02/$0.05) - 2023/12/27 21:08:19
Table 'RushAndCash3796761' 6-max Seat #1 is the button
Seat 1: d2511a5c ($5 in chips)
Seat 2: 451cabba ($5 in chips)
Seat 3: 755c6599 ($5.6 in chips)
Seat 4: Hero ($5.25 in chips)
Seat 5: f06fe10f ($9.19 in chips)
Seat 6: dd0f2300 ($8.92 in chips)
451cabba: posts small blind $0.02
755c6599: posts big blind $0.05
*** HOLE CARDS ***
Dealt to d2511a5c 
Dealt to 451cabba 
Dealt to 755c6599 
Dealt to Hero [Jh 8c]
Dealt to f06fe10f 
Dealt to dd0f2300 
Hero: folds
f06fe10f: folds
dd0f2300: folds
d2511a5c: folds
451cabba: folds
Uncalled bet ($0.03) returned to 755c6599
*** SHOWDOWN ***
755c6599 collected $0.04 from pot
*** SUMMARY ***
Total pot $0.04 | Rake $0 | Jackpot $0 | Bingo $0 | Fortune $0 | Tax $0
Seat 1: d2511a5c (button) folded before Flop (didn't bet)
Seat 2: 451cabba (small blind) folded before Flop
Seat 3: 755c6599 (big blind) collected ($0.04)
Seat 4: Hero folded before Flop (didn't bet)
Seat 5: f06fe10f folded before Flop (didn't bet)
Seat 6: dd0f2300 folded before Flop (didn't bet)


Poker Hand #RC2094620109: Hold'em No Limit ($0.02/$0.05) - 2023/12/27 21:07:57
Table 'RushAndCash3796569' 6-max Seat #1 is the button
Seat 1: 18d5b7d0 ($12.59 in chips)
Seat 2: e58714cd ($5 in chips)
Seat 3: Hero ($5.37 in chips)
Seat 4: ca4183 ($5.12 in chips)
Seat 5: ec6526db ($5.1 in chips)
Seat 6: dd0f2300 ($8.79 in chips)
e58714cd: posts small blind $0.02
Hero: posts big blind $0.05
*** HOLE CARDS ***
Dealt to 18d5b7d0 
Dealt to e58714cd 
Dealt to Hero [4h Jh]
Dealt to ca4183 
Dealt to ec6526db 
Dealt to dd0f2300 
ca4183: folds
ec6526db: folds
dd0f2300: raises $0.07 to $0.12
18d5b7d0: folds
e58714cd: folds
Hero: calls $0.07
*** FLOP *** [Qs 4c Qd]
Hero: checks
dd0f2300: bets $0.1
Hero: folds
Uncalled bet ($0.1) returned to dd0f2300
*** SHOWDOWN ***
dd0f2300 collected $0.25 from pot
*** SUMMARY ***
Total pot $0.26 | Rake $0.01 | Jackpot $0 | Bingo $0 | Fortune $0 | Tax $0
Board [Qs 4c Qd]
Seat 1: 18d5b7d0 (button) folded before Flop (didn't bet)
Seat 2: e58714cd (small blind) folded before Flop
Seat 3: Hero (big blind) folded on the Flop
Seat 4: ca4183 folded before Flop (didn't bet)
Seat 5: ec6526db folded before Flop (didn't bet)
Seat 6: dd0f2300 won ($0.25)


Poker Hand #RC2094620044: Hold'em No Limit ($0.02/$0.05) - 2023/12/27 21:07:53
Table 'RushAndCash3796538' 6-max Seat #1 is the button
Seat 1: 3786a0b3 ($7.12 in chips)
Seat 2: 35765f35 ($5.95 in chips)
Seat 3: 12f62865 ($5.65 in chips)
Seat 4: Hero ($5.37 in chips)
Seat 5: cf617ccd ($5.24 in chips)
Seat 6: 2af2d2a2 ($5.61 in chips)
35765f35: posts small blind $0.02
12f62865: posts big blind $0.05
*** HOLE CARDS ***
Dealt to 3786a0b3 
Dealt to 35765f35 
Dealt to 12f62865 
Dealt to Hero [7c Tc]
Dealt to cf617ccd 
Dealt to 2af2d2a2 
Hero: folds
cf617ccd: raises $0.08 to $0.13
2af2d2a2: folds
3786a0b3: folds
35765f35: folds
12f62865: folds
Uncalled bet ($0.08) returned to cf617ccd
*** SHOWDOWN ***
cf617ccd collected $0.12 from pot
*** SUMMARY ***
Total pot $0.12 | Rake $0 | Jackpot $0 | Bingo $0 | Fortune $0 | Tax $0
Seat 1: 3786a0b3 (button) folded before Flop (didn't bet)
Seat 2: 35765f35 (small blind) folded before Flop
Seat 3: 12f62865 (big blind) folded before Flop
Seat 4: Hero folded before Flop (didn't bet)
Seat 5: cf617ccd collected ($0.12)
Seat 6: 2af2d2a2 folded before Flop (didn't bet)


Poker Hand #RC2094619887: Hold'em No Limit ($0.02/$0.05) - 2023/12/27 21:07:45
Table 'RushAndCash3796457' 6-max Seat #1 is the button
Seat 1: 97c02b3c ($11.27 in chips)
Seat 2: 77e4d469 ($6.49 in chips)
Seat 3: 442f5b0b ($7.78 in chips)
Seat 4: 88ac0764 ($5.09 in chips)
Seat 5: Hero ($5.37 in chips)
Seat 6: 3fdbaf1e ($5.27 in chips)
77e4d469: posts small blind $0.02
442f5b0b: posts big blind $0.05
*** HOLE CARDS ***
Dealt to 97c02b3c 
Dealt to 77e4d469 
Dealt to 442f5b0b 
Dealt to 88ac0764 
Dealt to Hero [7d 8s]
Dealt to 3fdbaf1e 
88ac0764: raises $0.05 to $0.1
Hero: folds
3fdbaf1e: raises $0.22 to $0.32
97c02b3c: folds
77e4d469: folds
442f5b0b: folds
88ac0764: calls $0.22
*** FLOP *** [Ah Js 3c]
88ac0764: checks
3fdbaf1e: bets $0.24
88ac0764: calls $0.24
*** TURN *** [Ah Js 3c] [2h]
88ac0764: checks
3fdbaf1e: checks
*** RIVER *** [Ah Js 3c 2h] [4d]
88ac0764: checks
3fdbaf1e: checks
88ac0764: shows [Qs Ks] (Ace-High)
3fdbaf1e: shows [Td As] (Pair of Aces)
*** SHOWDOWN ***
3fdbaf1e collected $1.13 from pot
*** SUMMARY ***
Total pot $1.19 | Rake $0.06 | Jackpot $0 | Bingo $0 | Fortune $0 | Tax $0
Board [Ah Js 3c 2h 4d]
Seat 1: 97c02b3c (button) folded before Flop (didn't bet)
Seat 2: 77e4d469 (small blind) folded before Flop
Seat 3: 442f5b0b (big blind) folded before Flop
Seat 4: 88ac0764 showed [Qs Ks] and lost with Ace-High
Seat 5: Hero folded before Flop (didn't bet)
Seat 6: 3fdbaf1e showed [Td As] and won ($1.13) with Pair of Aces


Poker Hand #RC2094619809: Hold'em No Limit ($0.02/$0.05) - 2023/12/27 21:07:40
Table 'RushAndCash3796419' 6-max Seat #1 is the button
Seat 1: Hero ($5.37 in chips)
Seat 2: 58541d68 ($6.32 in chips)
Seat 3: cfa33b6a ($7.35 in chips)
Seat 4: 6b4efc04 ($5 in chips)
Seat 5: 50c78359 ($5.09 in chips)
Seat 6: 2fbdc427 ($4.06 in chips)
58541d68: posts small blind $0.02
cfa33b6a: posts big blind $0.05
*** HOLE CARDS ***
Dealt to Hero [8d 3d]
Dealt to 58541d68 
Dealt to cfa33b6a 
Dealt to 6b4efc04 
Dealt to 50c78359 
Dealt to 2fbdc427 
6b4efc04: folds
50c78359: raises $0.06 to $0.11
2fbdc427: calls $0.11
Hero: folds
58541d68: folds
cfa33b6a: folds
*** FLOP *** [6d 2c 3c]
50c78359: checks
2fbdc427: checks
*** TURN *** [6d 2c 3c] [8h]
50c78359: checks
2fbdc427: checks
*** RIVER *** [6d 2c 3c 8h] [4d]
50c78359: bets $0.2
2fbdc427: folds
Uncalled bet ($0.2) returned to 50c78359
*** SHOWDOWN ***
50c78359 collected $0.28 from pot
*** SUMMARY ***
Total pot $0.29 | Rake $0.01 | Jackpot $0 | Bingo $0 | Fortune $0 | Tax $0
Board [6d 2c 3c 8h 4d]
Seat 1: Hero (button) folded before Flop (didn't bet)
Seat 2: 58541d68 (small blind) folded before Flop
Seat 3: cfa33b6a (big blind) folded before Flop
Seat 4: 6b4efc04 folded before Flop (didn't bet)
Seat 5: 50c78359 won ($0.28)
Seat 6: 2fbdc427 folded on the River


Poker Hand #RC2094619344: Hold'em No Limit ($0.02/$0.05) - 2023/12/27 21:07:16
Table 'RushAndCash3796188' 6-max Seat #1 is the button
Seat 1: 7a27a34f ($12.17 in chips)
Seat 2: 6ad8e80e ($5.93 in chips)
Seat 3: 50c78359 ($5.19 in chips)
Seat 4: 51c7aec9 ($5.84 in chips)
Seat 5: 9f73cd48 ($5.57 in chips)
Seat 6: Hero ($5.26 in chips)
6ad8e80e: posts small blind $0.02
50c78359: posts big blind $0.05
*** HOLE CARDS ***
Dealt to 7a27a34f 
Dealt to 6ad8e80e 
Dealt to 50c78359 
Dealt to 51c7aec9 
Dealt to 9f73cd48 
Dealt to Hero [Js Ad]
51c7aec9: folds
9f73cd48: folds
Hero: raises $0.05 to $0.1
7a27a34f: folds
6ad8e80e: folds
50c78359: calls $0.05
*** FLOP *** [Ac Jh 8h]
50c78359: checks
Hero: bets $0.1
50c78359: folds
Uncalled bet ($0.1) returned to Hero
*** SHOWDOWN ***
Hero collected $0.21 from pot
*** SUMMARY ***
Total pot $0.22 | Rake $0.01 | Jackpot $0 | Bingo $0 | Fortune $0 | Tax $0
Board [Ac Jh 8h]
Seat 1: 7a27a34f (button) folded before Flop (didn't bet)
Seat 2: 6ad8e80e (small blind) folded before Flop
Seat 3: 50c78359 (big blind) folded on the Flop
Seat 4: 51c7aec9 folded before Flop (didn't bet)
Seat 5: 9f73cd48 folded before Flop (didn't bet)
Seat 6: Hero won ($0.21)


Poker Hand #RC2094618718: Hold'em No Limit ($0.02/$0.05) - 2023/12/27 21:06:42
Table 'RushAndCash3795891' 6-max Seat #1 is the button
Seat 1: 6b58deaf ($5.51 in chips)
Seat 2: ad278b19 ($7.3 in chips)
Seat 3: Hero ($5.05 in chips)
Seat 4: 755c6599 ($5.01 in chips)
Seat 5: 78dd4e29 ($7.53 in chips)
Seat 6: 57c77a71 ($9.61 in chips)
ad278b19: posts small blind $0.02
Hero: posts big blind $0.05
*** HOLE CARDS ***
Dealt to 6b58deaf 
Dealt to ad278b19 
Dealt to Hero [Qc Ah]
Dealt to 755c6599 
Dealt to 78dd4e29 
Dealt to 57c77a71 
755c6599: raises $0.05 to $0.1
78dd4e29: folds
57c77a71: calls $0.1
6b58deaf: folds
ad278b19: folds
Hero: calls $0.05
*** FLOP *** [7h 8s 4h]
Hero: checks
755c6599: checks
57c77a71: checks
*** TURN *** [7h 8s 4h] [Qh]
Hero: checks
755c6599: checks
57c77a71: checks
*** RIVER *** [7h 8s 4h Qh] [7c]
Hero: bets $0.16
755c6599: folds
57c77a71: folds
Uncalled bet ($0.16) returned to Hero
*** SHOWDOWN ***
Hero collected $0.31 from pot
*** SUMMARY ***
Total pot $0.32 | Rake $0.01 | Jackpot $0 | Bingo $0 | Fortune $0 | Tax $0
Board [7h 8s 4h Qh 7c]
Seat 1: 6b58deaf (button) folded before Flop (didn't bet)
Seat 2: ad278b19 (small blind) folded before Flop
Seat 3: Hero (big blind) won ($0.31)
Seat 4: 755c6599 folded on the River
Seat 5: 78dd4e29 folded before Flop (didn't bet)
Seat 6: 57c77a71 folded on the River


Poker Hand #RC2094618652: Hold'em No Limit ($0.02/$0.05) - 2023/12/27 21:06:38
Table 'RushAndCash3795859' 6-max Seat #1 is the button
Seat 1: 69f7ac74 ($8.82 in chips)
Seat 2: 2dedd418 ($9.65 in chips)
Seat 3: d2de188f ($4.87 in chips)
Seat 4: 1119892c ($5 in chips)
Seat 5: 869cd4a ($5.17 in chips)
Seat 6: Hero ($5.05 in chips)
2dedd418: posts small blind $0.02
d2de188f: posts big blind $0.05
*** HOLE CARDS ***
Dealt to 69f7ac74 
Dealt to 2dedd418 
Dealt to d2de188f 
Dealt to 1119892c 
Dealt to 869cd4a 
Dealt to Hero [Jh 3s]
1119892c: folds
869cd4a: folds
Hero: folds
69f7ac74: raises $0.08 to $0.13
2dedd418: folds
d2de188f: folds
Uncalled bet ($0.08) returned to 69f7ac74
*** SHOWDOWN ***
69f7ac74 collected $0.12 from pot
*** SUMMARY ***
Total pot $0.12 | Rake $0 | Jackpot $0 | Bingo $0 | Fortune $0 | Tax $0
Seat 1: 69f7ac74 (button) collected ($0.12)
Seat 2: 2dedd418 (small blind) folded before Flop
Seat 3: d2de188f (big blind) folded before Flop
Seat 4: 1119892c folded before Flop (didn't bet)
Seat 5: 869cd4a folded before Flop (didn't bet)
Seat 6: Hero folded before Flop (didn't bet)


Poker Hand #RC2094618580: Hold'em No Limit ($0.02/$0.05) - 2023/12/27 21:06:35
Table 'RushAndCash3795825' 6-max Seat #1 is the button
Seat 1: Hero ($5.05 in chips)
Seat 2: 835cf516 ($5.88 in chips)
Seat 3: 6e27dad2 ($3.02 in chips)
Seat 4: 69f7ac74 ($8.82 in chips)
Seat 5: 959f22e1 ($10.6 in chips)
Seat 6: ff503359 ($6.08 in chips)
835cf516: posts small blind $0.02
6e27dad2: posts big blind $0.05
*** HOLE CARDS ***
Dealt to Hero [2c 5d]
Dealt to 835cf516 
Dealt to 6e27dad2 
Dealt to 69f7ac74 
Dealt to 959f22e1 
Dealt to ff503359 
69f7ac74: folds
959f22e1: folds
ff503359: folds
Hero: folds
835cf516: raises $0.1 to $0.15
6e27dad2: calls $0.1
*** FLOP *** [8h Kh 6d]
835cf516: bets $0.15
6e27dad2: folds
Uncalled bet ($0.15) returned to 835cf516
*** SHOWDOWN ***
835cf516 collected $0.29 from pot
*** SUMMARY ***
Total pot $0.3 | Rake $0.01 | Jackpot $0 | Bingo $0 | Fortune $0 | Tax $0
Board [8h Kh 6d]
Seat 1: Hero (button) folded before Flop (didn't bet)
Seat 2: 835cf516 (small blind) won ($0.29)
Seat 3: 6e27dad2 (big blind) folded on the Flop
Seat 4: 69f7ac74 folded before Flop (didn't bet)
Seat 5: 959f22e1 folded before Flop (didn't bet)
Seat 6: ff503359 folded before Flop (didn't bet)


Poker Hand #RC2094618207: Hold'em No Limit ($0.02/$0.05) - 2023/12/27 21:06:15
Table 'RushAndCash3795629' 6-max Seat #1 is the button
Seat 1: 135f3775 ($3.85 in chips)
Seat 2: Hero ($5 in chips)
Seat 3: aa286bd3 ($8.71 in chips)
Seat 4: d80d70f1 ($7.73 in chips)
Seat 5: c1959558 ($5.07 in chips)
Seat 6: 4586441b ($5.16 in chips)
Hero: posts small blind $0.02
aa286bd3: posts big blind $0.05
*** HOLE CARDS ***
Dealt to 135f3775 
Dealt to Hero [Th 5h]
Dealt to aa286bd3 
Dealt to d80d70f1 
Dealt to c1959558 
Dealt to 4586441b 
d80d70f1: folds
c1959558: folds
4586441b: folds
135f3775: folds
Hero: raises $0.1 to $0.15
aa286bd3: folds
Uncalled bet ($0.1) returned to Hero
*** SHOWDOWN ***
Hero collected $0.1 from pot
*** SUMMARY ***
Total pot $0.1 | Rake $0 | Jackpot $0 | Bingo $0 | Fortune $0 | Tax $0
Seat 1: 135f3775 (button) folded before Flop (didn't bet)
Seat 2: Hero (small blind) collected ($0.1)
Seat 3: aa286bd3 (big blind) folded before Flop
Seat 4: d80d70f1 folded before Flop (didn't bet)
Seat 5: c1959558 folded before Flop (didn't bet)
Seat 6: 4586441b folded before Flop (didn't bet)


Poker Hand #RC2094617822: Hold'em No Limit ($0.02/$0.05) - 2023/12/27 21:05:53
Table 'RushAndCash3795429' 6-max Seat #1 is the button
Seat 1: 29dcfb95 ($5 in chips)
Seat 2: a4497405 ($5.03 in chips)
Seat 3: 73fcd255 ($7.3 in chips)
Seat 4: d6653ed3 ($5 in chips)
Seat 5: 9f8b063a ($4.97 in chips)
Seat 6: Hero ($5 in chips)
a4497405: posts small blind $0.02
73fcd255: posts big blind $0.05
*** HOLE CARDS ***
Dealt to 29dcfb95 
Dealt to a4497405 
Dealt to 73fcd255 
Dealt to d6653ed3 
Dealt to 9f8b063a 
Dealt to Hero [Qd Th]
d6653ed3: raises $0.05 to $0.1
9f8b063a: folds
Hero: folds
29dcfb95: folds
a4497405: folds
73fcd255: folds
Uncalled bet ($0.05) returned to d6653ed3
*** SHOWDOWN ***
d6653ed3 collected $0.12 from pot
*** SUMMARY ***
Total pot $0.12 | Rake $0 | Jackpot $0 | Bingo $0 | Fortune $0 | Tax $0
Seat 1: 29dcfb95 (button) folded before Flop (didn't bet)
Seat 2: a4497405 (small blind) folded before Flop
Seat 3: 73fcd255 (big blind) folded before Flop
Seat 4: d6653ed3 collected ($0.12)
Seat 5: 9f8b063a folded before Flop (didn't bet)
Seat 6: Hero folded before Flop (didn't bet)


Poker Hand #RC2094617746: Hold'em No Limit ($0.02/$0.05) - 2023/12/27 21:05:49
Table 'RushAndCash3795389' 6-max Seat #1 is the button
Seat 1: 29345a5a ($4.64 in chips)
Seat 2: fa338ba2 ($3.29 in chips)
Seat 3: 62f7a9cd ($5.35 in chips)
Seat 4: Hero ($5 in chips)
Seat 5: e6b9db8a ($5.07 in chips)
Seat 6: 689e5657 ($3.97 in chips)
fa338ba2: posts small blind $0.02
62f7a9cd: posts big blind $0.05
*** HOLE CARDS ***
Dealt to 29345a5a 
Dealt to fa338ba2 
Dealt to 62f7a9cd 
Dealt to Hero [2d 8d]
Dealt to e6b9db8a 
Dealt to 689e5657 
Hero: folds
e6b9db8a: raises $0.05 to $0.1
689e5657: folds
29345a5a: raises $0.25 to $0.35
fa338ba2: folds
62f7a9cd: folds
e6b9db8a: folds
Uncalled bet ($0.25) returned to 29345a5a
*** SHOWDOWN ***
29345a5a collected $0.26 from pot
*** SUMMARY ***
Total pot $0.27 | Rake $0.01 | Jackpot $0 | Bingo $0 | Fortune $0 | Tax $0
Seat 1: 29345a5a (button) collected ($0.26)
Seat 2: fa338ba2 (small blind) folded before Flop
Seat 3: 62f7a9cd (big blind) folded before Flop
Seat 4: Hero folded before Flop (didn't bet)
Seat 5: e6b9db8a folded before Flop
Seat 6: 689e5657 folded before Flop (didn't bet)


Poker Hand #RC2094616725: Hold'em No Limit ($0.02/$0.05) - 2023/12/27 21:04:53
Table 'RushAndCash3794885' 6-max Seat #1 is the button
Seat 1: 26c09e5f ($5.21 in chips)
Seat 2: Hero ($5.87 in chips)
Seat 3: 53085a55 ($5 in chips)
Seat 4: 8aeab93d ($6.66 in chips)
Seat 5: 1e4d2e5d ($3.04 in chips)
Seat 6: 7a27a34f ($11.24 in chips)
Hero: posts small blind $0.02
53085a55: posts big blind $0.05
*** HOLE CARDS ***
Dealt to 26c09e5f 
Dealt to Hero [Ad Qd]
Dealt to 53085a55 
Dealt to 8aeab93d 
Dealt to 1e4d2e5d 
Dealt to 7a27a34f 
8aeab93d: raises $0.09 to $0.14
1e4d2e5d: folds
7a27a34f: calls $0.14
26c09e5f: folds
Hero: raises $0.36 to $0.5
53085a55: folds
8aeab93d: folds
7a27a34f: calls $0.36
*** FLOP *** [9d 8c Kh]
Hero: bets $0.4
7a27a34f: calls $0.4
*** TURN *** [9d 8c Kh] [Qs]
Hero: checks
7a27a34f: bets $1.5
Hero: folds
Uncalled bet ($1.5) returned to 7a27a34f
*** SHOWDOWN ***
7a27a34f collected $1.83 from pot
*** SUMMARY ***
Total pot $1.99 | Rake $0.09 | Jackpot $0.07 | Bingo $0 | Fortune $0 | Tax $0
Board [9d 8c Kh Qs]
Seat 1: 26c09e5f (button) folded before Flop (didn't bet)
Seat 2: Hero (small blind) folded on the Turn
Seat 3: 53085a55 (big blind) folded before Flop
Seat 4: 8aeab93d folded before Flop
Seat 5: 1e4d2e5d folded before Flop (didn't bet)
Seat 6: 7a27a34f won ($1.83)


Poker Hand #RC2094616570: Hold'em No Limit ($0.02/$0.05) - 2023/12/27 21:04:44
Table 'RushAndCash3794813' 6-max Seat #1 is the button
Seat 1: ef1f71d1 ($6.16 in chips)
Seat 2: a0193c4f ($10.45 in chips)
Seat 3: Hero ($5.85 in chips)
Seat 4: 4873e51e ($5.38 in chips)
Seat 5: c80cb8d4 ($5.39 in chips)
Seat 6: bc902f73 ($5.16 in chips)
a0193c4f: posts small blind $0.02
Hero: posts big blind $0.05
*** HOLE CARDS ***
Dealt to ef1f71d1 
Dealt to a0193c4f 
Dealt to Hero [7h Ts]
Dealt to 4873e51e 
Dealt to c80cb8d4 
Dealt to bc902f73 
4873e51e: folds
c80cb8d4: folds
bc902f73: folds
ef1f71d1: folds
a0193c4f: folds
Uncalled bet ($0.03) returned to Hero
*** SHOWDOWN ***
Hero collected $0.04 from pot
*** SUMMARY ***
Total pot $0.04 | Rake $0 | Jackpot $0 | Bingo $0 | Fortune $0 | Tax $0
Seat 1: ef1f71d1 (button) folded before Flop (didn't bet)
Seat 2: a0193c4f (small blind) folded before Flop
Seat 3: Hero (big blind) collected ($0.04)
Seat 4: 4873e51e folded before Flop (didn't bet)
Seat 5: c80cb8d4 folded before Flop (didn't bet)
Seat 6: bc902f73 folded before Flop (didn't bet)


Poker Hand #RC2094615942: Hold'em No Limit ($0.02/$0.05) - 2023/12/27 21:04:10
Table 'RushAndCash3794491' 6-max Seat #1 is the button
Seat 1: Hero ($5.68 in chips)
Seat 2: b7dc02f3 ($7.63 in chips)
Seat 3: 3281748d ($12.68 in chips)
Seat 4: 6a8911fc ($5 in chips)
Seat 5: b0596725 ($5.94 in chips)
Seat 6: d4230c47 ($11.73 in chips)
b7dc02f3: posts small blind $0.02
3281748d: posts big blind $0.05
*** HOLE CARDS ***
Dealt to Hero [7h Jh]
Dealt to b7dc02f3 
Dealt to 3281748d 
Dealt to 6a8911fc 
Dealt to b0596725 
Dealt to d4230c47 
6a8911fc: folds
b0596725: folds
d4230c47: folds
Hero: raises $0.08 to $0.13
b7dc02f3: calls $0.11
3281748d: folds
*** FLOP *** [5d 7d 4c]
b7dc02f3: checks
Hero: bets $0.1
b7dc02f3: folds
Uncalled bet ($0.1) returned to Hero
*** SHOWDOWN ***
Hero collected $0.3 from pot
*** SUMMARY ***
Total pot $0.31 | Rake $0.01 | Jackpot $0 | Bingo $0 | Fortune $0 | Tax $0
Board [5d 7d 4c]
Seat 1: Hero (button) won ($0.3)
Seat 2: b7dc02f3 (small blind) folded on the Flop
Seat 3: 3281748d (big blind) folded before Flop
Seat 4: 6a8911fc folded before Flop (didn't bet)
Seat 5: b0596725 folded before Flop (didn't bet)
Seat 6: d4230c47 folded before Flop (didn't bet)


Poker Hand #RC2094615497: Hold'em No Limit ($0.02/$0.05) - 2023/12/27 21:03:45
Table 'RushAndCash3794260' 6-max Seat #1 is the button
Seat 1: daba542e ($3.93 in chips)
Seat 2: d7b73e59 ($11.9 in chips)
Seat 3: d4230c47 ($11.62 in chips)
Seat 4: Hero ($5.78 in chips)
Seat 5: a2e6da2b ($5.19 in chips)
Seat 6: fbfef877 ($6.65 in chips)
d7b73e59: posts small blind $0.02
d4230c47: posts big blind $0.05
*** HOLE CARDS ***
Dealt to daba542e 
Dealt to d7b73e59 
Dealt to d4230c47 
Dealt to Hero [9h 8h]
Dealt to a2e6da2b 
Dealt to fbfef877 
Hero: raises $0.05 to $0.1
a2e6da2b: folds
fbfef877: folds
daba542e: folds
d7b73e59: folds
d4230c47: raises $0.22 to $0.32
Hero: folds
Uncalled bet ($0.22) returned to d4230c47
*** SHOWDOWN ***
d4230c47 collected $0.21 from pot
*** SUMMARY ***
Total pot $0.22 | Rake $0.01 | Jackpot $0 | Bingo $0 | Fortune $0 | Tax $0
Seat 1: daba542e (button) folded before Flop (didn't bet)
Seat 2: d7b73e59 (small blind) folded before Flop
Seat 3: d4230c47 (big blind) collected ($0.21)
Seat 4: Hero folded before Flop
Seat 5: a2e6da2b folded before Flop (didn't bet)
Seat 6: fbfef877 folded before Flop (didn't bet)


Poker Hand #RC2094615428: Hold'em No Limit ($0.02/$0.05) - 2023/12/27 21:03:42
Table 'RushAndCash3794227' 6-max Seat #1 is the button
Seat 1: 58541d68 ($5 in chips)
Seat 2: 159bec7c ($5.38 in chips)
Seat 3: 5aa834d5 ($5.52 in chips)
Seat 4: e11b6f8f ($5.62 in chips)
Seat 5: Hero ($5.78 in chips)
Seat 6: 17af1c4b ($5 in chips)
159bec7c: posts small blind $0.02
5aa834d5: posts big blind $0.05
*** HOLE CARDS ***
Dealt to 58541d68 
Dealt to 159bec7c 
Dealt to 5aa834d5 
Dealt to e11b6f8f 
Dealt to Hero [Kd 6s]
Dealt to 17af1c4b 
e11b6f8f: folds
Hero: folds
17af1c4b: folds
58541d68: folds
159bec7c: raises $0.07 to $0.12
5aa834d5: calls $0.07
*** FLOP *** [3h 2c 6d]
159bec7c: checks
5aa834d5: checks
*** TURN *** [3h 2c 6d] [3s]
159bec7c: checks
5aa834d5: bets $0.06
159bec7c: folds
Uncalled bet ($0.06) returned to 5aa834d5
*** SHOWDOWN ***
5aa834d5 collected $0.23 from pot
*** SUMMARY ***
Total pot $0.24 | Rake $0.01 | Jackpot $0 | Bingo $0 | Fortune $0 | Tax $0
Board [3h 2c 6d 3s]
Seat 1: 58541d68 (button) folded before Flop (didn't bet)
Seat 2: 159bec7c (small blind) folded on the Turn
Seat 3: 5aa834d5 (big blind) won ($0.23)
Seat 4: e11b6f8f folded before Flop (didn't bet)
Seat 5: Hero folded before Flop (didn't bet)
Seat 6: 17af1c4b folded before Flop (didn't bet)


Poker Hand #RC2094615290: Hold'em No Limit ($0.02/$0.05) - 2023/12/27 21:03:34
Table 'RushAndCash3794160' 6-max Seat #1 is the button
Seat 1: 589cc4e2 ($5.2 in chips)
Seat 2: bc1b75a ($5.02 in chips)
Seat 3: a90cdcc9 ($1.85 in chips)
Seat 4: 738185d9 ($5.42 in chips)
Seat 5: eda74cec ($5 in chips)
Seat 6: Hero ($5.78 in chips)
bc1b75a: posts small blind $0.02
a90cdcc9: posts big blind $0.05
*** HOLE CARDS ***
Dealt to 589cc4e2 
Dealt to bc1b75a 
Dealt to a90cdcc9 
Dealt to 738185d9 
Dealt to eda74cec 
Dealt to Hero [9c 6c]
738185d9: raises $0.08 to $0.13
eda74cec: folds
Hero: folds
589cc4e2: folds
bc1b75a: folds
a90cdcc9: folds
Uncalled bet ($0.08) returned to 738185d9
*** SHOWDOWN ***
738185d9 collected $0.12 from pot
*** SUMMARY ***
Total pot $0.12 | Rake $0 | Jackpot $0 | Bingo $0 | Fortune $0 | Tax $0
Seat 1: 589cc4e2 (button) folded before Flop (didn't bet)
Seat 2: bc1b75a (small blind) folded before Flop
Seat 3: a90cdcc9 (big blind) folded before Flop
Seat 4: 738185d9 collected ($0.12)
Seat 5: eda74cec folded before Flop (didn't bet)
Seat 6: Hero folded before Flop (didn't bet)


Poker Hand #RC2094615224: Hold'em No Limit ($0.02/$0.05) - 2023/12/27 21:03:31
Table 'RushAndCash3794127' 6-max Seat #1 is the button
Seat 1: Hero ($5.78 in chips)
Seat 2: 8ab1dee2 ($4.15 in chips)
Seat 3: 9f73cd48 ($5.13 in chips)
Seat 4: 3b59ca4e ($6.52 in chips)
Seat 5: fe92596e ($8.33 in chips)
Seat 6: 76b3c4d0 ($5 in chips)
8ab1dee2: posts small blind $0.02
9f73cd48: posts big blind $0.05
*** HOLE CARDS ***
Dealt to Hero [5h 7d]
Dealt to 8ab1dee2 
Dealt to 9f73cd48 
Dealt to 3b59ca4e 
Dealt to fe92596e 
Dealt to 76b3c4d0 
3b59ca4e: folds
fe92596e: folds
76b3c4d0: folds
Hero: folds
8ab1dee2: folds
Uncalled bet ($0.03) returned to 9f73cd48
*** SHOWDOWN ***
9f73cd48 collected $0.04 from pot
*** SUMMARY ***
Total pot $0.04 | Rake $0 | Jackpot $0 | Bingo $0 | Fortune $0 | Tax $0
Seat 1: Hero (button) folded before Flop (didn't bet)
Seat 2: 8ab1dee2 (small blind) folded before Flop
Seat 3: 9f73cd48 (big blind) collected ($0.04)
Seat 4: 3b59ca4e folded before Flop (didn't bet)
Seat 5: fe92596e folded before Flop (didn't bet)
Seat 6: 76b3c4d0 folded before Flop (didn't bet)


Poker Hand #RC2094615020: Hold'em No Limit ($0.02/$0.05) - 2023/12/27 21:03:20
Table 'RushAndCash3794024' 6-max Seat #1 is the button
Seat 1: 3281748d ($12.59 in chips)
Seat 2: Hero ($5.73 in chips)
Seat 3: 79098a78 ($5.02 in chips)
Seat 4: 8f1669a8 ($5 in chips)
Seat 5: dd0f2300 ($9.32 in chips)
Seat 6: 1b99ba34 ($9.47 in chips)
Hero: posts small blind $0.02
79098a78: posts big blind $0.05
*** HOLE CARDS ***
Dealt to 3281748d 
Dealt to Hero [4h 2d]
Dealt to 79098a78 
Dealt to 8f1669a8 
Dealt to dd0f2300 
Dealt to 1b99ba34 
8f1669a8: folds
dd0f2300: folds
1b99ba34: folds
3281748d: raises $0.08 to $0.13
Hero: folds
79098a78: folds
Uncalled bet ($0.08) returned to 3281748d
*** SHOWDOWN ***
3281748d collected $0.12 from pot
*** SUMMARY ***
Total pot $0.12 | Rake $0 | Jackpot $0 | Bingo $0 | Fortune $0 | Tax $0
Seat 1: 3281748d (button) collected ($0.12)
Seat 2: Hero (small blind) folded before Flop
Seat 3: 79098a78 (big blind) folded before Flop
Seat 4: 8f1669a8 folded before Flop (didn't bet)
Seat 5: dd0f2300 folded before Flop (didn't bet)
Seat 6: 1b99ba34 folded before Flop (didn't bet)


Poker Hand #RC2094614944: Hold'em No Limit ($0.02/$0.05) - 2023/12/27 21:03:15
Table 'RushAndCash3793986' 6-max Seat #1 is the button
Seat 1: cf617ccd ($5.93 in chips)
Seat 2: 981110b3 ($15.99 in chips)
Seat 3: Hero ($5.78 in chips)
Seat 4: 3a94b99b ($17.68 in chips)
Seat 5: b3ddb34b ($3.77 in chips)
Seat 6: 17af1c4b ($5 in chips)
981110b3: posts small blind $0.02
Hero: posts big blind $0.05
*** HOLE CARDS ***
Dealt to cf617ccd 
Dealt to 981110b3 
Dealt to Hero [4h 8c]
Dealt to 3a94b99b 
Dealt to b3ddb34b 
Dealt to 17af1c4b 
3a94b99b: folds
b3ddb34b: folds
17af1c4b: folds
cf617ccd: folds
981110b3: folds
Uncalled bet ($0.03) returned to Hero
*** SHOWDOWN ***
Hero collected $0.04 from pot
*** SUMMARY ***
Total pot $0.04 | Rake $0 | Jackpot $0 | Bingo $0 | Fortune $0 | Tax $0
Seat 1: cf617ccd (button) folded before Flop (didn't bet)
Seat 2: 981110b3 (small blind) folded before Flop
Seat 3: Hero (big blind) collected ($0.04)
Seat 4: 3a94b99b folded before Flop (didn't bet)
Seat 5: b3ddb34b folded before Flop (didn't bet)
Seat 6: 17af1c4b folded before Flop (didn't bet)


Poker Hand #RC2094614877: Hold'em No Limit ($0.02/$0.05) - 2023/12/27 21:03:12
Table 'RushAndCash3793951' 6-max Seat #1 is the button
Seat 1: 2bf8611f ($5.24 in chips)
Seat 2: cbc529ce ($5.83 in chips)
Seat 3: 4843f7e6 ($1.98 in chips)
Seat 4: Hero ($5.78 in chips)
Seat 5: 48480486 ($15.21 in chips)
Seat 6: cb971fe5 ($5 in chips)
cbc529ce: posts small blind $0.02
4843f7e6: posts big blind $0.05
*** HOLE CARDS ***
Dealt to 2bf8611f 
Dealt to cbc529ce 
Dealt to 4843f7e6 
Dealt to Hero [Kd 8s]
Dealt to 48480486 
Dealt to cb971fe5 
Hero: folds
48480486: folds
cb971fe5: folds
2bf8611f: raises $0.1 to $0.15
cbc529ce: raises $0.4 to $0.55
4843f7e6: folds
2bf8611f: folds
Uncalled bet ($0.4) returned to cbc529ce
*** SHOWDOWN ***
cbc529ce collected $0.34 from pot
*** SUMMARY ***
Total pot $0.35 | Rake $0.01 | Jackpot $0 | Bingo $0 | Fortune $0 | Tax $0
Seat 1: 2bf8611f (button) folded before Flop
Seat 2: cbc529ce (small blind) collected ($0.34)
Seat 3: 4843f7e6 (big blind) folded before Flop
Seat 4: Hero folded before Flop (didn't bet)
Seat 5: 48480486 folded before Flop (didn't bet)
Seat 6: cb971fe5 folded before Flop (didn't bet)


Poker Hand #RC2094614804: Hold'em No Limit ($0.02/$0.05) - 2023/12/27 21:03:08
Table 'RushAndCash3793911' 6-max Seat #1 is the button
Seat 1: bfa824ef ($5.15 in chips)
Seat 2: 9ed383ac ($3.87 in chips)
Seat 3: 4c4e9d9 ($3.46 in chips)
Seat 4: 1df8161 ($5.52 in chips)
Seat 5: 689e5657 ($4.06 in chips)
Seat 6: Hero ($5.78 in chips)
9ed383ac: posts small blind $0.02
4c4e9d9: posts big blind $0.05
*** HOLE CARDS ***
Dealt to bfa824ef 
Dealt to 9ed383ac 
Dealt to 4c4e9d9 
Dealt to 1df8161 
Dealt to 689e5657 
Dealt to Hero [3h 7c]
1df8161: raises $0.08 to $0.13
689e5657: folds
Hero: folds
bfa824ef: folds
9ed383ac: folds
4c4e9d9: calls $0.08
*** FLOP *** [Kd 9d 2s]
4c4e9d9: checks
1df8161: bets $0.21
4c4e9d9: calls $0.21
*** TURN *** [Kd 9d 2s] [4h]
4c4e9d9: checks
1df8161: bets $0.94
4c4e9d9: calls $0.94
*** RIVER *** [Kd 9d 2s 4h] [8d]
4c4e9d9: checks
1df8161: checks
4c4e9d9: shows [Kh Qd] (Pair of Kings)
1df8161: shows [Ks Ah] (Pair of Kings)
*** SHOWDOWN ***
1df8161 collected $2.39 from pot
*** SUMMARY ***
Total pot $2.58 | Rake $0.12 | Jackpot $0.07 | Bingo $0 | Fortune $0 | Tax $0
Board [Kd 9d 2s 4h 8d]
Seat 1: bfa824ef (button) folded before Flop (didn't bet)
Seat 2: 9ed383ac (small blind) folded before Flop
Seat 3: 4c4e9d9 (big blind) showed [Kh Qd] and lost with Pair of Kings
Seat 4: 1df8161 showed [Ks Ah] and won ($2.39) with Pair of Kings
Seat 5: 689e5657 folded before Flop (didn't bet)
Seat 6: Hero folded before Flop (didn't bet)


Poker Hand #RC2094594739: Hold'em No Limit ($0.02/$0.05) - 2023/12/27 21:03:04
Table 'RushAndCash3793880' 6-max Seat #1 is the button
Seat 1: 1f61adb3 ($3.8 in chips)
Seat 2: 8f1669a8 ($5.07 in chips)
Seat 3: 636ea425 ($5 in chips)
Seat 4: 694a1ecb ($4.78 in chips)
Seat 5: Hero ($5.78 in chips)
Seat 6: bfa824ef ($5.15 in chips)
8f1669a8: posts small blind $0.02
636ea425: posts big blind $0.05
*** HOLE CARDS ***
Dealt to 1f61adb3 
Dealt to 8f1669a8 
Dealt to 636ea425 
Dealt to 694a1ecb 
Dealt to Hero [Qc 2s]
Dealt to bfa824ef 
694a1ecb: folds
Hero: folds
bfa824ef: folds
1f61adb3: raises $0.05 to $0.1
8f1669a8: folds
636ea425: folds
Uncalled bet ($0.05) returned to 1f61adb3
*** SHOWDOWN ***
1f61adb3 collected $0.12 from pot
*** SUMMARY ***
Total pot $0.12 | Rake $0 | Jackpot $0 | Bingo $0 | Fortune $0 | Tax $0
Seat 1: 1f61adb3 (button) collected ($0.12)
Seat 2: 8f1669a8 (small blind) folded before Flop
Seat 3: 636ea425 (big blind) folded before Flop
Seat 4: 694a1ecb folded before Flop (didn't bet)
Seat 5: Hero folded before Flop (didn't bet)
Seat 6: bfa824ef folded before Flop (didn't bet)


Poker Hand #RC2094594675: Hold'em No Limit ($0.02/$0.05) - 2023/12/27 21:03:01
Table 'RushAndCash3793849' 6-max Seat #1 is the button
Seat 1: b59abcaa ($11.79 in chips)
Seat 2: 874237f1 ($10.5 in chips)
Seat 3: f87a2c19 ($7 in chips)
Seat 4: Hero ($5.78 in chips)
Seat 5: 14d54b41 ($9.76 in chips)
Seat 6: 33c99ba6 ($5 in chips)
874237f1: posts small blind $0.02
f87a2c19: posts big blind $0.05
*** HOLE CARDS ***
Dealt to b59abcaa 
Dealt to 874237f1 
Dealt to f87a2c19 
Dealt to Hero [9c Ad]
Dealt to 14d54b41 
Dealt to 33c99ba6 
Hero: folds
14d54b41: folds
33c99ba6: raises $0.1 to $0.15
b59abcaa: raises $0.4 to $0.55
874237f1: folds
f87a2c19: raises $0.55 to $1.1
33c99ba6: folds
b59abcaa: calls $0.55
*** FLOP *** [6d Qs Ac]
f87a2c19: bets $0.55
b59abcaa: folds
Uncalled bet ($0.55) returned to f87a2c19
*** SHOWDOWN ***
f87a2c19 collected $2.19 from pot
*** SUMMARY ***
Total pot $2.37 | Rake $0.11 | Jackpot $0.07 | Bingo $0 | Fortune $0 | Tax $0
Board [6d Qs Ac]
Seat 1: b59abcaa (button) folded on the Flop
Seat 2: 874237f1 (small blind) folded before Flop
Seat 3: f87a2c19 (big blind) won ($2.19)
Seat 4: Hero folded before Flop (didn't bet)
Seat 5: 14d54b41 folded before Flop (didn't bet)
Seat 6: 33c99ba6 folded before Flop


Poker Hand #RC2094594414: Hold'em No Limit ($0.02/$0.05) - 2023/12/27 21:02:46
Table 'RushAndCash3793723' 6-max Seat #1 is the button
Seat 1: 1f61adb3 ($3.87 in chips)
Seat 2: Hero ($5.73 in chips)
Seat 3: b0d5aa2f ($5 in chips)
Seat 4: f9f34b4c ($7.99 in chips)
Seat 5: de8bf76e ($7.51 in chips)
Seat 6: fd90de27 ($6.68 in chips)
Hero: posts small blind $0.02
b0d5aa2f: posts big blind $0.05
*** HOLE CARDS ***
Dealt to 1f61adb3 
Dealt to Hero [Kd Qd]
Dealt to b0d5aa2f 
Dealt to f9f34b4c 
Dealt to de8bf76e 
Dealt to fd90de27 
f9f34b4c: folds
de8bf76e: folds
fd90de27: folds
1f61adb3: folds
Hero: raises $0.1 to $0.15
b0d5aa2f: folds
Uncalled bet ($0.1) returned to Hero
*** SHOWDOWN ***
Hero collected $0.1 from pot
*** SUMMARY ***
Total pot $0.1 | Rake $0 | Jackpot $0 | Bingo $0 | Fortune $0 | Tax $0
Seat 1: 1f61adb3 (button) folded before Flop (didn't bet)
Seat 2: Hero (small blind) collected ($0.1)
Seat 3: b0d5aa2f (big blind) folded before Flop
Seat 4: f9f34b4c folded before Flop (didn't bet)
Seat 5: de8bf76e folded before Flop (didn't bet)
Seat 6: fd90de27 folded before Flop (didn't bet)


Poker Hand #RC2094594354: Hold'em No Limit ($0.02/$0.05) - 2023/12/27 21:02:43
Table 'RushAndCash3793693' 6-max Seat #1 is the button
Seat 1: c94b4e1d ($14.71 in chips)
Seat 2: 119a5dc4 ($5.19 in chips)
Seat 3: Hero ($5.78 in chips)
Seat 4: fd515659 ($2.95 in chips)
Seat 5: 40758d6c ($5.04 in chips)
Seat 6: c1959558 ($5.09 in chips)
119a5dc4: posts small blind $0.02
Hero: posts big blind $0.05
*** HOLE CARDS ***
Dealt to c94b4e1d 
Dealt to 119a5dc4 
Dealt to Hero [6s 4d]
Dealt to fd515659 
Dealt to 40758d6c 
Dealt to c1959558 
fd515659: raises $0.07 to $0.12
40758d6c: folds
c1959558: folds
c94b4e1d: folds
119a5dc4: calls $0.1
Hero: folds
*** FLOP *** [8h Th Jh]
119a5dc4: checks
fd515659: bets $0.1
119a5dc4: calls $0.1
*** TURN *** [8h Th Jh] [Qd]
119a5dc4: checks
fd515659: bets $0.17
119a5dc4: folds
Uncalled bet ($0.17) returned to fd515659
*** SHOWDOWN ***
fd515659 collected $0.47 from pot
*** SUMMARY ***
Total pot $0.49 | Rake $0.02 | Jackpot $0 | Bingo $0 | Fortune $0 | Tax $0
Board [8h Th Jh Qd]
Seat 1: c94b4e1d (button) folded before Flop (didn't bet)
Seat 2: 119a5dc4 (small blind) folded on the Turn
Seat 3: Hero (big blind) folded before Flop
Seat 4: fd515659 won ($0.47)
Seat 5: 40758d6c folded before Flop (didn't bet)
Seat 6: c1959558 folded before Flop (didn't bet)


Poker Hand #RC2094593870: Hold'em No Limit ($0.02/$0.05) - 2023/12/27 21:02:15
Table 'RushAndCash3793444' 6-max Seat #1 is the button
Seat 1: Hero ($5.91 in chips)
Seat 2: 98017a0e ($4.95 in chips)
Seat 3: cfa33b6a ($8.56 in chips)
Seat 4: 119a5dc4 ($5 in chips)
Seat 5: e9d4b33a ($5.93 in chips)
Seat 6: 3f587bf6 ($5.44 in chips)
98017a0e: posts small blind $0.02
cfa33b6a: posts big blind $0.05
*** HOLE CARDS ***
Dealt to Hero [3h Ah]
Dealt to 98017a0e 
Dealt to cfa33b6a 
Dealt to 119a5dc4 
Dealt to e9d4b33a 
Dealt to 3f587bf6 
119a5dc4: raises $0.08 to $0.13
e9d4b33a: folds
3f587bf6: folds
Hero: calls $0.13
98017a0e: folds
cfa33b6a: folds
*** FLOP *** [Qs Ts 6d]
119a5dc4: checks
Hero: checks
*** TURN *** [Qs Ts 6d] [8s]
119a5dc4: bets $0.17
Hero: folds
Uncalled bet ($0.17) returned to 119a5dc4
*** SHOWDOWN ***
119a5dc4 collected $0.32 from pot
*** SUMMARY ***
Total pot $0.33 | Rake $0.01 | Jackpot $0 | Bingo $0 | Fortune $0 | Tax $0
Board [Qs Ts 6d 8s]
Seat 1: Hero (button) folded on the Turn
Seat 2: 98017a0e (small blind) folded before Flop
Seat 3: cfa33b6a (big blind) folded before Flop
Seat 4: 119a5dc4 won ($0.32)
Seat 5: e9d4b33a folded before Flop (didn't bet)
Seat 6: 3f587bf6 folded before Flop (didn't bet)


Poker Hand #RC2094593695: Hold'em No Limit ($0.02/$0.05) - 2023/12/27 21:02:06
Table 'RushAndCash3793359' 6-max Seat #1 is the button
Seat 1: 58541d68 ($5 in chips)
Seat 2: 1119892c ($5 in chips)
Seat 3: 2a55aa6 ($5 in chips)
Seat 4: Hero ($5.84 in chips)
Seat 5: 45e460c8 ($5 in chips)
Seat 6: 643372c4 ($5.34 in chips)
1119892c: posts small blind $0.02
2a55aa6: posts big blind $0.05
*** HOLE CARDS ***
Dealt to 58541d68 
Dealt to 1119892c 
Dealt to 2a55aa6 
Dealt to Hero [9c 9h]
Dealt to 45e460c8 
Dealt to 643372c4 
Hero: raises $0.05 to $0.1
45e460c8: folds
643372c4: folds
58541d68: folds
1119892c: folds
2a55aa6: folds
Uncalled bet ($0.05) returned to Hero
*** SHOWDOWN ***
Hero collected $0.12 from pot
*** SUMMARY ***
Total pot $0.12 | Rake $0 | Jackpot $0 | Bingo $0 | Fortune $0 | Tax $0
Seat 1: 58541d68 (button) folded before Flop (didn't bet)
Seat 2: 1119892c (small blind) folded before Flop
Seat 3: 2a55aa6 (big blind) folded before Flop
Seat 4: Hero collected ($0.12)
Seat 5: 45e460c8 folded before Flop (didn't bet)
Seat 6: 643372c4 folded before Flop (didn't bet)


Poker Hand #RC2094593629: Hold'em No Limit ($0.02/$0.05) - 2023/12/27 21:02:02
Table 'RushAndCash3793327' 6-max Seat #1 is the button
Seat 1: b3b9df8e ($9.03 in chips)
Seat 2: 51c7aec9 ($5.53 in chips)
Seat 3: 2cf89837 ($6.43 in chips)
Seat 4: Hero ($5.84 in chips)
Seat 5: 1e5b0cf6 ($5.98 in chips)
Seat 6: 28565319 ($6.81 in chips)
51c7aec9: posts small blind $0.02
2cf89837: posts big blind $0.05
*** HOLE CARDS ***
Dealt to b3b9df8e 
Dealt to 51c7aec9 
Dealt to 2cf89837 
Dealt to Hero [8d Qc]
Dealt to 1e5b0cf6 
Dealt to 28565319 
Hero: folds
1e5b0cf6: folds
28565319: raises $0.07 to $0.12
b3b9df8e: calls $0.12
51c7aec9: folds
2cf89837: folds
*** FLOP *** [2s Ks 4c]
28565319: bets $0.11
b3b9df8e: calls $0.11
*** TURN *** [2s Ks 4c] [7s]
28565319: checks
b3b9df8e: bets $0.14
28565319: calls $0.14
*** RIVER *** [2s Ks 4c 7s] [As]
28565319: checks
b3b9df8e: bets $0.62
28565319: folds
Uncalled bet ($0.62) returned to b3b9df8e
*** SHOWDOWN ***
b3b9df8e collected $0.77 from pot
*** SUMMARY ***
Total pot $0.81 | Rake $0.04 | Jackpot $0 | Bingo $0 | Fortune $0 | Tax $0
Board [2s Ks 4c 7s As]
Seat 1: b3b9df8e (button) won ($0.77)
Seat 2: 51c7aec9 (small blind) folded before Flop
Seat 3: 2cf89837 (big blind) folded before Flop
Seat 4: Hero folded before Flop (didn't bet)
Seat 5: 1e5b0cf6 folded before Flop (didn't bet)
Seat 6: 28565319 folded on the River


Poker Hand #RC2094593544: Hold'em No Limit ($0.02/$0.05) - 2023/12/27 21:01:58
Table 'RushAndCash3793283' 6-max Seat #1 is the button
Seat 1: cece2bcb ($8.89 in chips)
Seat 2: 78123e35 ($16.79 in chips)
Seat 3: 2c966adf ($8.01 in chips)
Seat 4: b881f476 ($5.07 in chips)
Seat 5: Hero ($5.84 in chips)
Seat 6: 59c6c4f ($7.77 in chips)
78123e35: posts small blind $0.02
2c966adf: posts big blind $0.05
*** HOLE CARDS ***
Dealt to cece2bcb 
Dealt to 78123e35 
Dealt to 2c966adf 
Dealt to b881f476 
Dealt to Hero [3h Jc]
Dealt to 59c6c4f 
b881f476: folds
Hero: folds
59c6c4f: folds
cece2bcb: raises $0.1 to $0.15
78123e35: folds
2c966adf: calls $0.1
*** FLOP *** [Qs 5h 8h]
2c966adf: checks
cece2bcb: bets $0.16
2c966adf: folds
Uncalled bet ($0.16) returned to cece2bcb
*** SHOWDOWN ***
cece2bcb collected $0.31 from pot
*** SUMMARY ***
Total pot $0.32 | Rake $0.01 | Jackpot $0 | Bingo $0 | Fortune $0 | Tax $0
Board [Qs 5h 8h]
Seat 1: cece2bcb (button) won ($0.31)
Seat 2: 78123e35 (small blind) folded before Flop
Seat 3: 2c966adf (big blind) folded on the Flop
Seat 4: b881f476 folded before Flop (didn't bet)
Seat 5: Hero folded before Flop (didn't bet)
Seat 6: 59c6c4f folded before Flop (didn't bet)


Poker Hand #RC2094593399: Hold'em No Limit ($0.02/$0.05) - 2023/12/27 21:01:50
Table 'RushAndCash3793216' 6-max Seat #1 is the button
Seat 1: a4d57c0 ($6.96 in chips)
Seat 2: 6b58deaf ($5 in chips)
Seat 3: Hero ($5.82 in chips)
Seat 4: d7b827bb ($2.68 in chips)
Seat 5: 39992730 ($4.88 in chips)
Seat 6: 4f7c05d4 ($8.98 in chips)
6b58deaf: posts small blind $0.02
Hero: posts big blind $0.05
*** HOLE CARDS ***
Dealt to a4d57c0 
Dealt to 6b58deaf 
Dealt to Hero [Qh 4d]
Dealt to d7b827bb 
Dealt to 39992730 
Dealt to 4f7c05d4 
d7b827bb: folds
39992730: folds
4f7c05d4: folds
a4d57c0: folds
6b58deaf: folds
Uncalled bet ($0.03) returned to Hero
*** SHOWDOWN ***
Hero collected $0.04 from pot
*** SUMMARY ***
Total pot $0.04 | Rake $0 | Jackpot $0 | Bingo $0 | Fortune $0 | Tax $0
Seat 1: a4d57c0 (button) folded before Flop (didn't bet)
Seat 2: 6b58deaf (small blind) folded before Flop
Seat 3: Hero (big blind) collected ($0.04)
Seat 4: d7b827bb folded before Flop (didn't bet)
Seat 5: 39992730 folded before Flop (didn't bet)
Seat 6: 4f7c05d4 folded before Flop (didn't bet)


Poker Hand #RC2094593329: Hold'em No Limit ($0.02/$0.05) - 2023/12/27 21:01:47
Table 'RushAndCash3793182' 6-max Seat #1 is the button
Seat 1: Hero ($5.82 in chips)
Seat 2: bfa824ef ($5.22 in chips)
Seat 3: d69df5a1 ($5.05 in chips)
Seat 4: 3f069be6 ($5.7 in chips)
Seat 5: 6f0b593c ($3.48 in chips)
Seat 6: ff7c9d27 ($5.87 in chips)
bfa824ef: posts small blind $0.02
d69df5a1: posts big blind $0.05
*** HOLE CARDS ***
Dealt to Hero [Td 3h]
Dealt to bfa824ef 
Dealt to d69df5a1 
Dealt to 3f069be6 
Dealt to 6f0b593c 
Dealt to ff7c9d27 
3f069be6: folds
6f0b593c: folds
ff7c9d27: folds
Hero: folds
bfa824ef: folds
Uncalled bet ($0.03) returned to d69df5a1
*** SHOWDOWN ***
d69df5a1 collected $0.04 from pot
*** SUMMARY ***
Total pot $0.04 | Rake $0 | Jackpot $0 | Bingo $0 | Fortune $0 | Tax $0
Seat 1: Hero (button) folded before Flop (didn't bet)
Seat 2: bfa824ef (small blind) folded before Flop
Seat 3: d69df5a1 (big blind) collected ($0.04)
Seat 4: 3f069be6 folded before Flop (didn't bet)
Seat 5: 6f0b593c folded before Flop (didn't bet)
Seat 6: ff7c9d27 folded before Flop (didn't bet)


Poker Hand #RC2094592526: Hold'em No Limit ($0.02/$0.05) - 2023/12/27 21:01:00
Table 'RushAndCash3792772' 6-max Seat #1 is the button
Seat 1: eadcaa5e ($7.21 in chips)
Seat 2: Hero ($5.07 in chips)
Seat 3: 27452f31 ($9.41 in chips)
Seat 4: 10775654 ($5.6 in chips)
Seat 5: 821fa78a ($23.21 in chips)
Seat 6: af89948f ($5 in chips)
Hero: posts small blind $0.02
27452f31: posts big blind $0.05
*** HOLE CARDS ***
Dealt to eadcaa5e 
Dealt to Hero [Jc Jh]
Dealt to 27452f31 
Dealt to 10775654 
Dealt to 821fa78a 
Dealt to af89948f 
10775654: folds
821fa78a: folds
af89948f: raises $0.1 to $0.15
eadcaa5e: folds
Hero: raises $0.35 to $0.5
27452f31: folds
af89948f: calls $0.35
*** FLOP *** [3c Ks 9c]
Hero: bets $0.35
af89948f: calls $0.35
*** TURN *** [3c Ks 9c] [6d]
Hero: checks
af89948f: checks
*** RIVER *** [3c Ks 9c 6d] [3s]
Hero: checks
af89948f: checks
Hero: shows [Jc Jh] (Pair of Jacks and Pair of Treys)
af89948f: shows [Td Tc] (Pair of Tens and Pair of Treys)
*** SHOWDOWN ***
Hero collected $1.6 from pot
*** SUMMARY ***
Total pot $1.75 | Rake $0.08 | Jackpot $0.07 | Bingo $0 | Fortune $0 | Tax $0
Board [3c Ks 9c 6d 3s]
Seat 1: eadcaa5e (button) folded before Flop (didn't bet)
Seat 2: Hero (small blind) showed [Jc Jh] and won ($1.6) with Pair of Jacks and Pair of Treys
Seat 3: 27452f31 (big blind) folded before Flop
Seat 4: 10775654 folded before Flop (didn't bet)
Seat 5: 821fa78a folded before Flop (didn't bet)
Seat 6: af89948f showed [Td Tc] and lost with Pair of Tens and Pair of Treys


Poker Hand #RC2094592259: Hold'em No Limit ($0.02/$0.05) - 2023/12/27 21:00:44
Table 'RushAndCash3792636' 6-max Seat #1 is the button
Seat 1: c5f04825 ($4.55 in chips)
Seat 2: 8668fc09 ($4.03 in chips)
Seat 3: d557ab62 ($14.19 in chips)
Seat 4: d648759 ($13 in chips)
Seat 5: 442f5b0b ($5.82 in chips)
Seat 6: Hero ($5.07 in chips)
8668fc09: posts small blind $0.02
d557ab62: posts big blind $0.05
*** HOLE CARDS ***
Dealt to c5f04825 
Dealt to 8668fc09 
Dealt to d557ab62 
Dealt to d648759 
Dealt to 442f5b0b 
Dealt to Hero [5d 5c]
d648759: folds
442f5b0b: folds
Hero: folds
c5f04825: folds
8668fc09: folds
Uncalled bet ($0.03) returned to d557ab62
*** SHOWDOWN ***
d557ab62 collected $0.04 from pot
*** SUMMARY ***
Total pot $0.04 | Rake $0 | Jackpot $0 | Bingo $0 | Fortune $0 | Tax $0
Seat 1: c5f04825 (button) folded before Flop (didn't bet)
Seat 2: 8668fc09 (small blind) folded before Flop
Seat 3: d557ab62 (big blind) collected ($0.04)
Seat 4: d648759 folded before Flop (didn't bet)
Seat 5: 442f5b0b folded before Flop (didn't bet)
Seat 6: Hero folded before Flop (didn't bet)


Poker Hand #RC2094592198: Hold'em No Limit ($0.02/$0.05) - 2023/12/27 21:00:41
Table 'RushAndCash3792604' 6-max Seat #1 is the button
Seat 1: fc72cc55 ($3.86 in chips)
Seat 2: 17158baf ($1.32 in chips)
Seat 3: 8f3611ed ($15.9 in chips)
Seat 4: b3ddb34b ($4.22 in chips)
Seat 5: Hero ($5.07 in chips)
Seat 6: 4eb17601 ($5 in chips)
17158baf: posts small blind $0.02
8f3611ed: posts big blind $0.05
*** HOLE CARDS ***
Dealt to fc72cc55 
Dealt to 17158baf 
Dealt to 8f3611ed 
Dealt to b3ddb34b 
Dealt to Hero [3h 8h]
Dealt to 4eb17601 
b3ddb34b: folds
Hero: folds
4eb17601: raises $0.07 to $0.12
fc72cc55: folds
17158baf: folds
8f3611ed: folds
Uncalled bet ($0.07) returned to 4eb17601
*** SHOWDOWN ***
4eb17601 collected $0.12 from pot
*** SUMMARY ***
Total pot $0.12 | Rake $0 | Jackpot $0 | Bingo $0 | Fortune $0 | Tax $0
Seat 1: fc72cc55 (button) folded before Flop (didn't bet)
Seat 2: 17158baf (small blind) folded before Flop
Seat 3: 8f3611ed (big blind) folded before Flop
Seat 4: b3ddb34b folded before Flop (didn't bet)
Seat 5: Hero folded before Flop (didn't bet)
Seat 6: 4eb17601 collected ($0.12)


Poker Hand #RC2094592147: Hold'em No Limit ($0.02/$0.05) - 2023/12/27 21:00:37
Table 'RushAndCash3792579' 6-max Seat #1 is the button
Seat 1: 35765f35 ($5.12 in chips)
Seat 2: cb40b530 ($9.51 in chips)
Seat 3: bf66b573 ($5.18 in chips)
Seat 4: cb813d4e ($9.22 in chips)
Seat 5: Hero ($5.07 in chips)
Seat 6: eb30851 ($5 in chips)
cb40b530: posts small blind $0.02
bf66b573: posts big blind $0.05
*** HOLE CARDS ***
Dealt to 35765f35 
Dealt to cb40b530 
Dealt to bf66b573 
Dealt to cb813d4e 
Dealt to Hero [4s Kc]
Dealt to eb30851 
cb813d4e: raises $0.05 to $0.1
Hero: folds
eb30851: folds
35765f35: folds
cb40b530: folds
bf66b573: folds
Uncalled bet ($0.05) returned to cb813d4e
*** SHOWDOWN ***
cb813d4e collected $0.12 from pot
*** SUMMARY ***
Total pot $0.12 | Rake $0 | Jackpot $0 | Bingo $0 | Fortune $0 | Tax $0
Seat 1: 35765f35 (button) folded before Flop (didn't bet)
Seat 2: cb40b530 (small blind) folded before Flop
Seat 3: bf66b573 (big blind) folded before Flop
Seat 4: cb813d4e collected ($0.12)
Seat 5: Hero folded before Flop (didn't bet)
Seat 6: eb30851 folded before Flop (didn't bet)


Poker Hand #RC2094591880: Hold'em No Limit ($0.02/$0.05) - 2023/12/27 21:00:19
Table 'RushAndCash3792440' 6-max Seat #1 is the button
Seat 1: 64413caa ($5 in chips)
Seat 2: Hero ($5.09 in chips)
Seat 3: c805e920 ($2.76 in chips)
Seat 4: ffd6607e ($5.82 in chips)
Seat 5: 77e4d469 ($7.46 in chips)
Seat 6: a4481948 ($14.3 in chips)
Hero: posts small blind $0.02
c805e920: posts big blind $0.05
*** HOLE CARDS ***
Dealt to 64413caa 
Dealt to Hero [3c As]
Dealt to c805e920 
Dealt to ffd6607e 
Dealt to 77e4d469 
Dealt to a4481948 
ffd6607e: folds
77e4d469: folds
a4481948: folds
64413caa: raises $0.05 to $0.1
Hero: folds
c805e920: calls $0.05
*** FLOP *** [Th Kh 6h]
c805e920: checks
64413caa: checks
*** TURN *** [Th Kh 6h] [7h]
c805e920: checks
64413caa: checks
*** RIVER *** [Th Kh 6h 7h] [7c]
c805e920: bets $0.11
64413caa: raises $0.11 to $0.22
c805e920: calls $0.11
64413caa: shows [9c Ah] (Ace High Flush)
c805e920: shows [7d 4d] (Three Sevens)
*** SHOWDOWN ***
64413caa collected $0.63 from pot
*** SUMMARY ***
Total pot $0.66 | Rake $0.03 | Jackpot $0 | Bingo $0 | Fortune $0 | Tax $0
Board [Th Kh 6h 7h 7c]
Seat 1: 64413caa (button) showed [9c Ah] and won ($0.63) with Ace High Flush
Seat 2: Hero (small blind) folded before Flop
Seat 3: c805e920 (big blind) showed [7d 4d] and lost with Three Sevens
Seat 4: ffd6607e folded before Flop (didn't bet)
Seat 5: 77e4d469 folded before Flop (didn't bet)
Seat 6: a4481948 folded before Flop (didn't bet)


Poker Hand #RC2094591818: Hold'em No Limit ($0.02/$0.05) - 2023/12/27 21:00:15
Table 'RushAndCash3792407' 6-max Seat #1 is the button
Seat 1: 31af5dba ($7.96 in chips)
Seat 2: ac692c24 ($5.75 in chips)
Seat 3: Hero ($5.14 in chips)
Seat 4: fa25a909 ($5.18 in chips)
Seat 5: 4e9e17a6 ($5.77 in chips)
Seat 6: d26dbcf ($4.69 in chips)
ac692c24: posts small blind $0.02
Hero: posts big blind $0.05
*** HOLE CARDS ***
Dealt to 31af5dba 
Dealt to ac692c24 
Dealt to Hero [2c Jh]
Dealt to fa25a909 
Dealt to 4e9e17a6 
Dealt to d26dbcf 
fa25a909: folds
4e9e17a6: raises $0.06 to $0.11
d26dbcf: folds
31af5dba: folds
ac692c24: folds
Hero: folds
Uncalled bet ($0.06) returned to 4e9e17a6
*** SHOWDOWN ***
4e9e17a6 collected $0.12 from pot
*** SUMMARY ***
Total pot $0.12 | Rake $0 | Jackpot $0 | Bingo $0 | Fortune $0 | Tax $0
Seat 1: 31af5dba (button) folded before Flop (didn't bet)
Seat 2: ac692c24 (small blind) folded before Flop
Seat 3: Hero (big blind) folded before Flop
Seat 4: fa25a909 folded before Flop (didn't bet)
Seat 5: 4e9e17a6 collected ($0.12)
Seat 6: d26dbcf folded before Flop (didn't bet)


Poker Hand #RC2094591761: Hold'em No Limit ($0.02/$0.05) - 2023/12/27 21:00:11
Table 'RushAndCash3792377' 6-max Seat #1 is the button
Seat 1: Hero ($5.14 in chips)
Seat 2: 10775654 ($5.44 in chips)
Seat 3: 6e01ea81 ($8.37 in chips)
Seat 4: 16744d35 ($6.24 in chips)
Seat 5: 4329ea35 ($2.95 in chips)
Seat 6: 15116960 ($3.14 in chips)
10775654: posts small blind $0.02
6e01ea81: posts big blind $0.05
*** HOLE CARDS ***
Dealt to Hero [Js 4c]
Dealt to 10775654 
Dealt to 6e01ea81 
Dealt to 16744d35 
Dealt to 4329ea35 
Dealt to 15116960 
16744d35: folds
4329ea35: folds
15116960: folds
Hero: folds
10775654: folds
Uncalled bet ($0.03) returned to 6e01ea81
*** SHOWDOWN ***
6e01ea81 collected $0.04 from pot
*** SUMMARY ***
Total pot $0.04 | Rake $0 | Jackpot $0 | Bingo $0 | Fortune $0 | Tax $0
Seat 1: Hero (button) folded before Flop (didn't bet)
Seat 2: 10775654 (small blind) folded before Flop
Seat 3: 6e01ea81 (big blind) collected ($0.04)
Seat 4: 16744d35 folded before Flop (didn't bet)
Seat 5: 4329ea35 folded before Flop (didn't bet)
Seat 6: 15116960 folded before Flop (didn't bet)


Poker Hand #RC2094591700: Hold'em No Limit ($0.02/$0.05) - 2023/12/27 21:00:07
Table 'RushAndCash3792345' 6-max Seat #1 is the button
Seat 1: 51e25143 ($5 in chips)
Seat 2: 64b521e3 ($7.67 in chips)
Seat 3: 5d31ed85 ($5.13 in chips)
Seat 4: e16e04ba ($4.79 in chips)
Seat 5: 593ac210 ($5.51 in chips)
Seat 6: Hero ($5.14 in chips)
64b521e3: posts small blind $0.02
5d31ed85: posts big blind $0.05
*** HOLE CARDS ***
Dealt to 51e25143 
Dealt to 64b521e3 
Dealt to 5d31ed85 
Dealt to e16e04ba 
Dealt to 593ac210 
Dealt to Hero [8c 9h]
e16e04ba: raises $0.08 to $0.13
593ac210: folds
Hero: folds
51e25143: raises $0.29 to $0.42
64b521e3: folds
5d31ed85: folds
e16e04ba: folds
Uncalled bet ($0.29) returned to 51e25143
*** SHOWDOWN ***
51e25143 collected $0.32 from pot
*** SUMMARY ***
Total pot $0.33 | Rake $0.01 | Jackpot $0 | Bingo $0 | Fortune $0 | Tax $0
Seat 1: 51e25143 (button) collected ($0.32)
Seat 2: 64b521e3 (small blind) folded before Flop
Seat 3: 5d31ed85 (big blind) folded before Flop
Seat 4: e16e04ba folded before Flop
Seat 5: 593ac210 folded before Flop (didn't bet)
Seat 6: Hero folded before Flop (didn't bet)


Poker Hand #RC2094591633: Hold'em No Limit ($0.02/$0.05) - 2023/12/27 21:00:04
Table 'RushAndCash3792310' 6-max Seat #1 is the button
Seat 1: aa1c93a9 ($8.98 in chips)
Seat 2: f1876d50 ($12.24 in chips)
Seat 3: 858e0cb4 ($9.42 in chips)
Seat 4: 62f7a9cd ($5.66 in chips)
Seat 5: 119a5dc4 ($2.41 in chips)
Seat 6: Hero ($5.14 in chips)
f1876d50: posts small blind $0.02
858e0cb4: posts big blind $0.05
*** HOLE CARDS ***
Dealt to aa1c93a9 
Dealt to f1876d50 
Dealt to 858e0cb4 
Dealt to 62f7a9cd 
Dealt to 119a5dc4 
Dealt to Hero [6c 7h]
62f7a9cd: raises $0.1 to $0.15
119a5dc4: calls $0.15
Hero: folds
aa1c93a9: folds
f1876d50: folds
858e0cb4: raises $0.4 to $0.55
62f7a9cd: calls $0.4
119a5dc4: calls $0.4
*** FLOP *** [6s Ts 6h]
858e0cb4: bets $0.75
62f7a9cd: folds
119a5dc4: folds
Uncalled bet ($0.75) returned to 858e0cb4
*** SHOWDOWN ***
858e0cb4 collected $1.52 from pot
*** SUMMARY ***
Total pot $1.67 | Rake $0.08 | Jackpot $0.07 | Bingo $0 | Fortune $0 | Tax $0
Board [6s Ts 6h]
Seat 1: aa1c93a9 (button) folded before Flop (didn't bet)
Seat 2: f1876d50 (small blind) folded before Flop
Seat 3: 858e0cb4 (big blind) won ($1.52)
Seat 4: 62f7a9cd folded on the Flop
Seat 5: 119a5dc4 folded on the Flop
Seat 6: Hero folded before Flop (didn't bet)


Poker Hand #RC2094591268: Hold'em No Limit ($0.02/$0.05) - 2023/12/27 20:59:45
Table 'RushAndCash3792126' 6-max Seat #1 is the button
Seat 1: 358d5b9e ($9.2 in chips)
Seat 2: cacf9a73 ($6.81 in chips)
Seat 3: 62f7a9cd ($5.16 in chips)
Seat 4: Hero ($5.14 in chips)
Seat 5: 18e28073 ($5.87 in chips)
Seat 6: a610b903 ($5.07 in chips)
Cash Drop to Pot : total $0.5 
cacf9a73: posts small blind $0.02
62f7a9cd: posts big blind $0.05
*** HOLE CARDS ***
Dealt to 358d5b9e 
Dealt to cacf9a73 
Dealt to 62f7a9cd 
Dealt to Hero [Kc Jd]
Dealt to 18e28073 
Dealt to a610b903 
Hero: folds
18e28073: folds
a610b903: folds
358d5b9e: folds
cacf9a73: folds
Uncalled bet ($0.03) returned to 62f7a9cd
*** SHOWDOWN ***
62f7a9cd collected $0.52 from pot
*** SUMMARY ***
Total pot $0.54 | Rake $0.02 | Jackpot $0 | Bingo $0 | Fortune $0 | Tax $0
Seat 1: 358d5b9e (button) folded before Flop (didn't bet)
Seat 2: cacf9a73 (small blind) folded before Flop
Seat 3: 62f7a9cd (big blind) collected ($0.52)
Seat 4: Hero folded before Flop (didn't bet)
Seat 5: 18e28073 folded before Flop (didn't bet)
Seat 6: a610b903 folded before Flop (didn't bet)


Poker Hand #RC2094591040: Hold'em No Limit ($0.02/$0.05) - 2023/12/27 20:59:34
Table 'RushAndCash3792008' 6-max Seat #1 is the button
Seat 1: Hero ($5.07 in chips)
Seat 2: ed3da34d ($5.41 in chips)
Seat 3: 74b83ffd ($8.47 in chips)
Seat 4: f9dc2aeb ($12.83 in chips)
Seat 5: fcf84949 ($5.6 in chips)
Seat 6: 9c19f0ff ($5.78 in chips)
ed3da34d: posts small blind $0.02
74b83ffd: posts big blind $0.05
*** HOLE CARDS ***
Dealt to Hero [9d Ad]
Dealt to ed3da34d 
Dealt to 74b83ffd 
Dealt to f9dc2aeb 
Dealt to fcf84949 
Dealt to 9c19f0ff 
f9dc2aeb: folds
fcf84949: folds
9c19f0ff: folds
Hero: raises $0.08 to $0.13
ed3da34d: folds
74b83ffd: folds
Uncalled bet ($0.08) returned to Hero
*** SHOWDOWN ***
Hero collected $0.12 from pot
*** SUMMARY ***
Total pot $0.12 | Rake $0 | Jackpot $0 | Bingo $0 | Fortune $0 | Tax $0
Seat 1: Hero (button) collected ($0.12)
Seat 2: ed3da34d (small blind) folded before Flop
Seat 3: 74b83ffd (big blind) folded before Flop
Seat 4: f9dc2aeb folded before Flop (didn't bet)
Seat 5: fcf84949 folded before Flop (didn't bet)
Seat 6: 9c19f0ff folded before Flop (didn't bet)


Poker Hand #RC2094590715: Hold'em No Limit ($0.02/$0.05) - 2023/12/27 20:59:15
Table 'RushAndCash3791840' 6-max Seat #1 is the button
Seat 1: 7a2ef2bb ($5.25 in chips)
Seat 2: Hero ($5.02 in chips)
Seat 3: 904a5708 ($5 in chips)
Seat 4: bfa824ef ($5.16 in chips)
Seat 5: f1452af7 ($14.21 in chips)
Seat 6: cf617ccd ($5.14 in chips)
Hero: posts small blind $0.02
904a5708: posts big blind $0.05
*** HOLE CARDS ***
Dealt to 7a2ef2bb 
Dealt to Hero [2c 3s]
Dealt to 904a5708 
Dealt to bfa824ef 
Dealt to f1452af7 
Dealt to cf617ccd 
bfa824ef: folds
f1452af7: folds
cf617ccd: folds
7a2ef2bb: raises $0.07 to $0.12
Hero: folds
904a5708: folds
Uncalled bet ($0.07) returned to 7a2ef2bb
*** SHOWDOWN ***
7a2ef2bb collected $0.12 from pot
*** SUMMARY ***
Total pot $0.12 | Rake $0 | Jackpot $0 | Bingo $0 | Fortune $0 | Tax $0
Seat 1: 7a2ef2bb (button) collected ($0.12)
Seat 2: Hero (small blind) folded before Flop
Seat 3: 904a5708 (big blind) folded before Flop
Seat 4: bfa824ef folded before Flop (didn't bet)
Seat 5: f1452af7 folded before Flop (didn't bet)
Seat 6: cf617ccd folded before Flop (didn't bet)


Poker Hand #RC2094590651: Hold'em No Limit ($0.02/$0.05) - 2023/12/27 20:59:12
Table 'RushAndCash3791808' 6-max Seat #1 is the button
Seat 1: dc8f15a1 ($9.1 in chips)
Seat 2: 180a21bc ($5.44 in chips)
Seat 3: Hero ($5.07 in chips)
Seat 4: ba4dcf33 ($6.26 in chips)
Seat 5: a4481948 ($14.37 in chips)
Seat 6: 56673495 ($6.82 in chips)
180a21bc: posts small blind $0.02
Hero: posts big blind $0.05
*** HOLE CARDS ***
Dealt to dc8f15a1 
Dealt to 180a21bc 
Dealt to Hero [4d Kh]
Dealt to ba4dcf33 
Dealt to a4481948 
Dealt to 56673495 
ba4dcf33: folds
a4481948: folds
56673495: folds
dc8f15a1: folds
180a21bc: folds
Uncalled bet ($0.03) returned to Hero
*** SHOWDOWN ***
Hero collected $0.04 from pot
*** SUMMARY ***
Total pot $0.04 | Rake $0 | Jackpot $0 | Bingo $0 | Fortune $0 | Tax $0
Seat 1: dc8f15a1 (button) folded before Flop (didn't bet)
Seat 2: 180a21bc (small blind) folded before Flop
Seat 3: Hero (big blind) collected ($0.04)
Seat 4: ba4dcf33 folded before Flop (didn't bet)
Seat 5: a4481948 folded before Flop (didn't bet)
Seat 6: 56673495 folded before Flop (didn't bet)


Poker Hand #RC2094590396: Hold'em No Limit ($0.02/$0.05) - 2023/12/27 20:58:59
Table 'RushAndCash3791688' 6-max Seat #1 is the button
Seat 1: d4705721 ($8.86 in chips)
Seat 2: 3e5e1e70 ($6.1 in chips)
Seat 3: 56617c83 ($5.64 in chips)
Seat 4: 73794eab ($4.51 in chips)
Seat 5: Hero ($5 in chips)
Seat 6: c6f85141 ($3.85 in chips)
3e5e1e70: posts small blind $0.02
56617c83: posts big blind $0.05
*** HOLE CARDS ***
Dealt to d4705721 
Dealt to 3e5e1e70 
Dealt to 56617c83 
Dealt to 73794eab 
Dealt to Hero [Jc Qd]
Dealt to c6f85141 
73794eab: folds
Hero: raises $0.05 to $0.1
c6f85141: folds
d4705721: folds
3e5e1e70: folds
56617c83: folds
Uncalled bet ($0.05) returned to Hero
*** SHOWDOWN ***
Hero collected $0.12 from pot
*** SUMMARY ***
Total pot $0.12 | Rake $0 | Jackpot $0 | Bingo $0 | Fortune $0 | Tax $0
Seat 1: d4705721 (button) folded before Flop (didn't bet)
Seat 2: 3e5e1e70 (small blind) folded before Flop
Seat 3: 56617c83 (big blind) folded before Flop
Seat 4: 73794eab folded before Flop (didn't bet)
Seat 5: Hero collected ($0.12)
Seat 6: c6f85141 folded before Flop (didn't bet)


Poker Hand #RC2094589542: Hold'em No Limit ($0.02/$0.05) - 2023/12/27 20:58:14
Table 'RushAndCash3791270' 6-max Seat #1 is the button
Seat 1: 89b9c786 ($5.68 in chips)
Seat 2: c2dfd0aa ($5 in chips)
Seat 3: 9c953df5 ($2.69 in chips)
Seat 4: 8d34bb34 ($5.24 in chips)
Seat 5: Hero ($5.01 in chips)
Seat 6: e6d316a ($4.1 in chips)
c2dfd0aa: posts small blind $0.02
9c953df5: posts big blind $0.05
*** HOLE CARDS ***
Dealt to 89b9c786 
Dealt to c2dfd0aa 
Dealt to 9c953df5 
Dealt to 8d34bb34 
Dealt to Hero [5h 5c]
Dealt to e6d316a 
8d34bb34: folds
Hero: raises $0.05 to $0.1
e6d316a: folds
89b9c786: folds
c2dfd0aa: folds
9c953df5: raises $0.32 to $0.42
Hero: calls $0.32
*** FLOP *** [9c 9d As]
9c953df5: checks
Hero: bets $0.29
9c953df5: calls $0.29
*** TURN *** [9c 9d As] [Tc]
9c953df5: checks
Hero: checks
*** RIVER *** [9c 9d As Tc] [Ah]
9c953df5: checks
Hero: bets $1.54
9c953df5: calls $1.54
Hero: shows [5h 5c] (Pair of Aces and Pair of Nines)
9c953df5: shows [Jc Js] (Pair of Aces and Pair of Jacks)
*** SHOWDOWN ***
9c953df5 collected $4.3 from pot
*** SUMMARY ***
Total pot $4.52 | Rake $0.15 | Jackpot $0.07 | Bingo $0 | Fortune $0 | Tax $0
Board [9c 9d As Tc Ah]
Seat 1: 89b9c786 (button) folded before Flop (didn't bet)
Seat 2: c2dfd0aa (small blind) folded before Flop
Seat 3: 9c953df5 (big blind) showed [Jc Js] and won ($4.3) with Pair of Aces and Pair of Jacks
Seat 4: 8d34bb34 folded before Flop (didn't bet)
Seat 5: Hero showed [5h 5c] and lost with Pair of Aces and Pair of Nines
Seat 6: e6d316a folded before Flop (didn't bet)


Poker Hand #RC2094589434: Hold'em No Limit ($0.02/$0.05) - 2023/12/27 20:58:08
Table 'RushAndCash3791220' 6-max Seat #1 is the button
Seat 1: 6dc76279 ($10.68 in chips)
Seat 2: fc10e886 ($8.32 in chips)
Seat 3: fd3a237e ($5.26 in chips)
Seat 4: bf66b573 ($5.34 in chips)
Seat 5: Hero ($5.01 in chips)
Seat 6: 9cbfdb9d ($5.09 in chips)
fc10e886: posts small blind $0.02
fd3a237e: posts big blind $0.05
*** HOLE CARDS ***
Dealt to 6dc76279 
Dealt to fc10e886 
Dealt to fd3a237e 
Dealt to bf66b573 
Dealt to Hero [6s 5s]
Dealt to 9cbfdb9d 
bf66b573: folds
Hero: folds
9cbfdb9d: folds
6dc76279: raises $0.08 to $0.13
fc10e886: folds
fd3a237e: calls $0.08
*** FLOP *** [Qs Qc Td]
fd3a237e: checks
6dc76279: bets $0.08
fd3a237e: folds
Uncalled bet ($0.08) returned to 6dc76279
*** SHOWDOWN ***
6dc76279 collected $0.27 from pot
*** SUMMARY ***
Total pot $0.28 | Rake $0.01 | Jackpot $0 | Bingo $0 | Fortune $0 | Tax $0
Board [Qs Qc Td]
Seat 1: 6dc76279 (button) won ($0.27)
Seat 2: fc10e886 (small blind) folded before Flop
Seat 3: fd3a237e (big blind) folded on the Flop
Seat 4: bf66b573 folded before Flop (didn't bet)
Seat 5: Hero folded before Flop (didn't bet)
Seat 6: 9cbfdb9d folded before Flop (didn't bet)


Poker Hand #RC2094589109: Hold'em No Limit ($0.02/$0.05) - 2023/12/27 20:57:52
Table 'RushAndCash3791069' 6-max Seat #1 is the button
Seat 1: 27270be2 ($5.58 in chips)
Seat 2: Hero ($5.03 in chips)
Seat 3: 80c84bc5 ($7.17 in chips)
Seat 4: 3105a0e3 ($5.39 in chips)
Seat 5: 899569f8 ($16.51 in chips)
Seat 6: 1869aa38 ($9.88 in chips)
Hero: posts small blind $0.02
80c84bc5: posts big blind $0.05
*** HOLE CARDS ***
Dealt to 27270be2 
Dealt to Hero [5c 2h]
Dealt to 80c84bc5 
Dealt to 3105a0e3 
Dealt to 899569f8 
Dealt to 1869aa38 
3105a0e3: folds
899569f8: raises $0.07 to $0.12
1869aa38: calls $0.12
27270be2: folds
Hero: folds
80c84bc5: folds
*** FLOP *** [8c 8s Jh]
899569f8: bets $0.11
1869aa38: folds
Uncalled bet ($0.11) returned to 899569f8
*** SHOWDOWN ***
899569f8 collected $0.3 from pot
*** SUMMARY ***
Total pot $0.31 | Rake $0.01 | Jackpot $0 | Bingo $0 | Fortune $0 | Tax $0
Board [8c 8s Jh]
Seat 1: 27270be2 (button) folded before Flop (didn't bet)
Seat 2: Hero (small blind) folded before Flop
Seat 3: 80c84bc5 (big blind) folded before Flop
Seat 4: 3105a0e3 folded before Flop (didn't bet)
Seat 5: 899569f8 won ($0.3)
Seat 6: 1869aa38 folded on the Flop


Poker Hand #RC2094588673: Hold'em No Limit ($0.02/$0.05) - 2023/12/27 20:57:30
Table 'RushAndCash3790851' 6-max Seat #1 is the button
Seat 1: 8bff79df ($5 in chips)
Seat 2: 64515617 ($6.04 in chips)
Seat 3: Hero ($5.08 in chips)
Seat 4: 3993f38 ($4.89 in chips)
Seat 5: 46a86d2c ($5.74 in chips)
Seat 6: d4fb33bd ($7.88 in chips)
64515617: posts small blind $0.02
Hero: posts big blind $0.05
*** HOLE CARDS ***
Dealt to 8bff79df 
Dealt to 64515617 
Dealt to Hero [Jd 4h]
Dealt to 3993f38 
Dealt to 46a86d2c 
Dealt to d4fb33bd 
3993f38: folds
46a86d2c: folds
d4fb33bd: folds
8bff79df: raises $0.08 to $0.13
64515617: folds
Hero: folds
Uncalled bet ($0.08) returned to 8bff79df
*** SHOWDOWN ***
8bff79df collected $0.12 from pot
*** SUMMARY ***
Total pot $0.12 | Rake $0 | Jackpot $0 | Bingo $0 | Fortune $0 | Tax $0
Seat 1: 8bff79df (button) collected ($0.12)
Seat 2: 64515617 (small blind) folded before Flop
Seat 3: Hero (big blind) folded before Flop
Seat 4: 3993f38 folded before Flop (didn't bet)
Seat 5: 46a86d2c folded before Flop (didn't bet)
Seat 6: d4fb33bd folded before Flop (didn't bet)


Poker Hand #RC2094588612: Hold'em No Limit ($0.02/$0.05) - 2023/12/27 20:57:26
Table 'RushAndCash3790819' 6-max Seat #1 is the button
Seat 1: 4997bf7a ($6.07 in chips)
Seat 2: c2f9e0f9 ($5.02 in chips)
Seat 3: 3cf001e6 ($2.98 in chips)
Seat 4: 753710be ($6.85 in chips)
Seat 5: 3528bf25 ($5.37 in chips)
Seat 6: Hero ($5.08 in chips)
c2f9e0f9: posts small blind $0.02
3cf001e6: posts big blind $0.05
*** HOLE CARDS ***
Dealt to 4997bf7a 
Dealt to c2f9e0f9 
Dealt to 3cf001e6 
Dealt to 753710be 
Dealt to 3528bf25 
Dealt to Hero [5s 9c]
753710be: folds
3528bf25: folds
Hero: folds
4997bf7a: folds
c2f9e0f9: raises $0.13 to $0.18
3cf001e6: folds
Uncalled bet ($0.13) returned to c2f9e0f9
*** SHOWDOWN ***
c2f9e0f9 collected $0.1 from pot
*** SUMMARY ***
Total pot $0.1 | Rake $0 | Jackpot $0 | Bingo $0 | Fortune $0 | Tax $0
Seat 1: 4997bf7a (button) folded before Flop (didn't bet)
Seat 2: c2f9e0f9 (small blind) collected ($0.1)
Seat 3: 3cf001e6 (big blind) folded before Flop
Seat 4: 753710be folded before Flop (didn't bet)
Seat 5: 3528bf25 folded before Flop (didn't bet)
Seat 6: Hero folded before Flop (didn't bet)


Poker Hand #RC2094588546: Hold'em No Limit ($0.02/$0.05) - 2023/12/27 20:57:23
Table 'RushAndCash3790786' 6-max Seat #1 is the button
Seat 1: Hero ($5.08 in chips)
Seat 2: 25b550f ($5.07 in chips)
Seat 3: 49d204ad ($4.92 in chips)
Seat 4: 6f0b593c ($4.53 in chips)
Seat 5: 574cd80 ($7.39 in chips)
Seat 6: 442f5b0b ($4.27 in chips)
25b550f: posts small blind $0.02
49d204ad: posts big blind $0.05
*** HOLE CARDS ***
Dealt to Hero [Td 4s]
Dealt to 25b550f 
Dealt to 49d204ad 
Dealt to 6f0b593c 
Dealt to 574cd80 
Dealt to 442f5b0b 
6f0b593c: folds
574cd80: folds
442f5b0b: folds
Hero: folds
25b550f: raises $0.07 to $0.12
49d204ad: folds
Uncalled bet ($0.07) returned to 25b550f
*** SHOWDOWN ***
25b550f collected $0.1 from pot
*** SUMMARY ***
Total pot $0.1 | Rake $0 | Jackpot $0 | Bingo $0 | Fortune $0 | Tax $0
Seat 1: Hero (button) folded before Flop (didn't bet)
Seat 2: 25b550f (small blind) collected ($0.1)
Seat 3: 49d204ad (big blind) folded before Flop
Seat 4: 6f0b593c folded before Flop (didn't bet)
Seat 5: 574cd80 folded before Flop (didn't bet)
Seat 6: 442f5b0b folded before Flop (didn't bet)


Poker Hand #RC2094588471: Hold'em No Limit ($0.02/$0.05) - 2023/12/27 20:57:19
Table 'RushAndCash3790750' 6-max Seat #1 is the button
Seat 1: 81c77fb7 ($5.1 in chips)
Seat 2: 15f0995b ($1.97 in chips)
Seat 3: edb16e47 ($5.41 in chips)
Seat 4: Hero ($5.08 in chips)
Seat 5: 3b56d3ac ($15.22 in chips)
Seat 6: 825f9b92 ($5.18 in chips)
15f0995b: posts small blind $0.02
edb16e47: posts big blind $0.05
*** HOLE CARDS ***
Dealt to 81c77fb7 
Dealt to 15f0995b 
Dealt to edb16e47 
Dealt to Hero [7s 5d]
Dealt to 3b56d3ac 
Dealt to 825f9b92 
Hero: folds
3b56d3ac: folds
825f9b92: raises $0.07 to $0.12
81c77fb7: raises $0.34 to $0.46
15f0995b: folds
edb16e47: calls $0.41
825f9b92: calls $0.34
*** FLOP *** [8s 9c 8d]
edb16e47: checks
825f9b92: checks
81c77fb7: checks
*** TURN *** [8s 9c 8d] [Th]
edb16e47: checks
825f9b92: checks
81c77fb7: checks
*** RIVER *** [8s 9c 8d Th] [7d]
edb16e47: checks
825f9b92: bets $0.7
81c77fb7: folds
edb16e47: folds
Uncalled bet ($0.7) returned to 825f9b92
*** SHOWDOWN ***
825f9b92 collected $1.33 from pot
*** SUMMARY ***
Total pot $1.4 | Rake $0.07 | Jackpot $0 | Bingo $0 | Fortune $0 | Tax $0
Board [8s 9c 8d Th 7d]
Seat 1: 81c77fb7 (button) folded on the River
Seat 2: 15f0995b (small blind) folded before Flop
Seat 3: edb16e47 (big blind) folded on the River
Seat 4: Hero folded before Flop (didn't bet)
Seat 5: 3b56d3ac folded before Flop (didn't bet)
Seat 6: 825f9b92 won ($1.33)


Poker Hand #RC2094588291: Hold'em No Limit ($0.02/$0.05) - 2023/12/27 20:57:10
Table 'RushAndCash3790659' 6-max Seat #1 is the button
Seat 1: c6f85141 ($2.96 in chips)
Seat 2: 3f16f15b ($9.65 in chips)
Seat 3: f9dc2aeb ($12.52 in chips)
Seat 4: 780339c5 ($5 in chips)
Seat 5: Hero ($5.01 in chips)
Seat 6: 69f7ac74 ($8.44 in chips)
3f16f15b: posts small blind $0.02
f9dc2aeb: posts big blind $0.05
*** HOLE CARDS ***
Dealt to c6f85141 
Dealt to 3f16f15b 
Dealt to f9dc2aeb 
Dealt to 780339c5 
Dealt to Hero [5s 6s]
Dealt to 69f7ac74 
780339c5: folds
Hero: raises $0.05 to $0.1
69f7ac74: folds
c6f85141: folds
3f16f15b: folds
f9dc2aeb: folds
Uncalled bet ($0.05) returned to Hero
*** SHOWDOWN ***
Hero collected $0.12 from pot
*** SUMMARY ***
Total pot $0.12 | Rake $0 | Jackpot $0 | Bingo $0 | Fortune $0 | Tax $0
Seat 1: c6f85141 (button) folded before Flop (didn't bet)
Seat 2: 3f16f15b (small blind) folded before Flop
Seat 3: f9dc2aeb (big blind) folded before Flop
Seat 4: 780339c5 folded before Flop (didn't bet)
Seat 5: Hero collected ($0.12)
Seat 6: 69f7ac74 folded before Flop (didn't bet)


Poker Hand #RC2094587930: Hold'em No Limit ($0.02/$0.05) - 2023/12/27 20:56:50
Table 'RushAndCash3790487' 6-max Seat #1 is the button
Seat 1: 28211675 ($5.83 in chips)
Seat 2: Hero ($5.16 in chips)
Seat 3: 1b40644e ($5.23 in chips)
Seat 4: a1d661c3 ($6.05 in chips)
Seat 5: 61fa3766 ($10.04 in chips)
Seat 6: 2b9bea9b ($12.93 in chips)
Hero: posts small blind $0.02
1b40644e: posts big blind $0.05
*** HOLE CARDS ***
Dealt to 28211675 
Dealt to Hero [4d 2d]
Dealt to 1b40644e 
Dealt to a1d661c3 
Dealt to 61fa3766 
Dealt to 2b9bea9b 
a1d661c3: folds
61fa3766: folds
2b9bea9b: folds
28211675: folds
Hero: raises $0.1 to $0.15
1b40644e: calls $0.1
*** FLOP *** [Tc Ad 6h]
Hero: checks
1b40644e: bets $0.09
Hero: folds
Uncalled bet ($0.09) returned to 1b40644e
*** SHOWDOWN ***
1b40644e collected $0.29 from pot
*** SUMMARY ***
Total pot $0.3 | Rake $0.01 | Jackpot $0 | Bingo $0 | Fortune $0 | Tax $0
Board [Tc Ad 6h]
Seat 1: 28211675 (button) folded before Flop (didn't bet)
Seat 2: Hero (small blind) folded on the Flop
Seat 3: 1b40644e (big blind) won ($0.29)
Seat 4: a1d661c3 folded before Flop (didn't bet)
Seat 5: 61fa3766 folded before Flop (didn't bet)
Seat 6: 2b9bea9b folded before Flop (didn't bet)


Poker Hand #RC2094587188: Hold'em No Limit ($0.02/$0.05) - 2023/12/27 20:56:12
Table 'RushAndCash3790127' 6-max Seat #1 is the button
Seat 1: 2b9bea9b ($12.82 in chips)
Seat 2: 74f57a89 ($9.83 in chips)
Seat 3: Hero ($5.26 in chips)
Seat 4: 23defde5 ($9.9 in chips)
Seat 5: 87447fe7 ($5.53 in chips)
Seat 6: 9bd21f84 ($9.39 in chips)
74f57a89: posts small blind $0.02
Hero: posts big blind $0.05
*** HOLE CARDS ***
Dealt to 2b9bea9b 
Dealt to 74f57a89 
Dealt to Hero [3s As]
Dealt to 23defde5 
Dealt to 87447fe7 
Dealt to 9bd21f84 
23defde5: folds
87447fe7: folds
9bd21f84: folds
2b9bea9b: raises $0.05 to $0.1
74f57a89: folds
Hero: calls $0.05
*** FLOP *** [5c 8c 7c]
Hero: checks
2b9bea9b: checks
*** TURN *** [5c 8c 7c] [6s]
Hero: checks
2b9bea9b: checks
*** RIVER *** [5c 8c 7c 6s] [2c]
Hero: checks
2b9bea9b: checks
Hero: shows [3s As] (Ace-High)
2b9bea9b: shows [Ah 4h] (Eights-High Straight)
*** SHOWDOWN ***
2b9bea9b collected $0.21 from pot
*** SUMMARY ***
Total pot $0.22 | Rake $0.01 | Jackpot $0 | Bingo $0 | Fortune $0 | Tax $0
Board [5c 8c 7c 6s 2c]
Seat 1: 2b9bea9b (button) showed [Ah 4h] and won ($0.21) with Eights-High Straight
Seat 2: 74f57a89 (small blind) folded before Flop
Seat 3: Hero (big blind) showed [3s As] and lost with Ace-High
Seat 4: 23defde5 folded before Flop (didn't bet)
Seat 5: 87447fe7 folded before Flop (didn't bet)
Seat 6: 9bd21f84 folded before Flop (didn't bet)


Poker Hand #RC2094587119: Hold'em No Limit ($0.02/$0.05) - 2023/12/27 20:56:09
Table 'RushAndCash3790093' 6-max Seat #1 is the button
Seat 1: Hero ($5.26 in chips)
Seat 2: 8029bbfe ($3.82 in chips)
Seat 3: 7f263f67 ($6.53 in chips)
Seat 4: 27538157 ($10.25 in chips)
Seat 5: 74f57a89 ($9.83 in chips)
Seat 6: 3fe1af06 ($5.28 in chips)
8029bbfe: posts small blind $0.02
7f263f67: posts big blind $0.05
*** HOLE CARDS ***
Dealt to Hero [Jd 8s]
Dealt to 8029bbfe 
Dealt to 7f263f67 
Dealt to 27538157 
Dealt to 74f57a89 
Dealt to 3fe1af06 
27538157: folds
74f57a89: folds
3fe1af06: folds
Hero: folds
8029bbfe: raises $0.15 to $0.2
7f263f67: folds
Uncalled bet ($0.15) returned to 8029bbfe
*** SHOWDOWN ***
8029bbfe collected $0.1 from pot
*** SUMMARY ***
Total pot $0.1 | Rake $0 | Jackpot $0 | Bingo $0 | Fortune $0 | Tax $0
Seat 1: Hero (button) folded before Flop (didn't bet)
Seat 2: 8029bbfe (small blind) collected ($0.1)
Seat 3: 7f263f67 (big blind) folded before Flop
Seat 4: 27538157 folded before Flop (didn't bet)
Seat 5: 74f57a89 folded before Flop (didn't bet)
Seat 6: 3fe1af06 folded before Flop (didn't bet)


Poker Hand #RC2094587049: Hold'em No Limit ($0.02/$0.05) - 2023/12/27 20:56:05
Table 'RushAndCash3790059' 6-max Seat #1 is the button
Seat 1: 76b3c4d0 ($6.77 in chips)
Seat 2: 1b40644e ($5.4 in chips)
Seat 3: 8029bbfe ($3.87 in chips)
Seat 4: Hero ($5.26 in chips)
Seat 5: 2c966adf ($8.68 in chips)
Seat 6: 143dea8e ($5.22 in chips)
1b40644e: posts small blind $0.02
8029bbfe: posts big blind $0.05
*** HOLE CARDS ***
Dealt to 76b3c4d0 
Dealt to 1b40644e 
Dealt to 8029bbfe 
Dealt to Hero [Ts 5s]
Dealt to 2c966adf 
Dealt to 143dea8e 
Hero: folds
2c966adf: folds
143dea8e: folds
76b3c4d0: raises $0.08 to $0.13
1b40644e: folds
8029bbfe: folds
Uncalled bet ($0.08) returned to 76b3c4d0
*** SHOWDOWN ***
76b3c4d0 collected $0.12 from pot
*** SUMMARY ***
Total pot $0.12 | Rake $0 | Jackpot $0 | Bingo $0 | Fortune $0 | Tax $0
Seat 1: 76b3c4d0 (button) collected ($0.12)
Seat 2: 1b40644e (small blind) folded before Flop
Seat 3: 8029bbfe (big blind) folded before Flop
Seat 4: Hero folded before Flop (didn't bet)
Seat 5: 2c966adf folded before Flop (didn't bet)
Seat 6: 143dea8e folded before Flop (didn't bet)


Poker Hand #RC2094586976: Hold'em No Limit ($0.02/$0.05) - 2023/12/27 20:56:01
Table 'RushAndCash3790022' 6-max Seat #1 is the button
Seat 1: 31af5dba ($8.33 in chips)
Seat 2: d25b8471 ($5.75 in chips)
Seat 3: 291ebc32 ($7.02 in chips)
Seat 4: 34e04b3f ($8.84 in chips)
Seat 5: d8026913 ($10.5 in chips)
Seat 6: Hero ($5.26 in chips)
d25b8471: posts small blind $0.02
291ebc32: posts big blind $0.05
*** HOLE CARDS ***
Dealt to 31af5dba 
Dealt to d25b8471 
Dealt to 291ebc32 
Dealt to 34e04b3f 
Dealt to d8026913 
Dealt to Hero [Qh 3h]
34e04b3f: folds
d8026913: folds
Hero: folds
31af5dba: raises $0.05 to $0.1
d25b8471: folds
291ebc32: folds
Uncalled bet ($0.05) returned to 31af5dba
*** SHOWDOWN ***
31af5dba collected $0.12 from pot
*** SUMMARY ***
Total pot $0.12 | Rake $0 | Jackpot $0 | Bingo $0 | Fortune $0 | Tax $0
Seat 1: 31af5dba (button) collected ($0.12)
Seat 2: d25b8471 (small blind) folded before Flop
Seat 3: 291ebc32 (big blind) folded before Flop
Seat 4: 34e04b3f folded before Flop (didn't bet)
Seat 5: d8026913 folded before Flop (didn't bet)
Seat 6: Hero folded before Flop (didn't bet)


Poker Hand #RC2094586909: Hold'em No Limit ($0.02/$0.05) - 2023/12/27 20:55:58
Table 'RushAndCash3789990' 6-max Seat #1 is the button
Seat 1: Hero ($5.26 in chips)
Seat 2: 4f7c05d4 ($8.72 in chips)
Seat 3: 33c99ba6 ($3.26 in chips)
Seat 4: 69a2bf04 ($9.38 in chips)
Seat 5: c2dfd0aa ($5.43 in chips)
Seat 6: 8290eb8e ($5.32 in chips)
4f7c05d4: posts small blind $0.02
33c99ba6: posts big blind $0.05
*** HOLE CARDS ***
Dealt to Hero [6h Qc]
Dealt to 4f7c05d4 
Dealt to 33c99ba6 
Dealt to 69a2bf04 
Dealt to c2dfd0aa 
Dealt to 8290eb8e 
69a2bf04: raises $0.1 to $0.15
c2dfd0aa: calls $0.15
8290eb8e: folds
Hero: folds
4f7c05d4: folds
33c99ba6: folds
*** FLOP *** [5c 8s 2d]
69a2bf04: bets $0.19
c2dfd0aa: folds
Uncalled bet ($0.19) returned to 69a2bf04
*** SHOWDOWN ***
69a2bf04 collected $0.36 from pot
*** SUMMARY ***
Total pot $0.37 | Rake $0.01 | Jackpot $0 | Bingo $0 | Fortune $0 | Tax $0
Board [5c 8s 2d]
Seat 1: Hero (button) folded before Flop (didn't bet)
Seat 2: 4f7c05d4 (small blind) folded before Flop
Seat 3: 33c99ba6 (big blind) folded before Flop
Seat 4: 69a2bf04 won ($0.36)
Seat 5: c2dfd0aa folded on the Flop
Seat 6: 8290eb8e folded before Flop (didn't bet)


Poker Hand #RC2094586626: Hold'em No Limit ($0.02/$0.05) - 2023/12/27 20:55:44
Table 'RushAndCash3789854' 6-max Seat #1 is the button
Seat 1: 5d0bed9d ($14.52 in chips)
Seat 2: Hero ($5.21 in chips)
Seat 3: d34f29de ($7.46 in chips)
Seat 4: 7f263f67 ($6.55 in chips)
Seat 5: d3f29b61 ($3.15 in chips)
Seat 6: 33c99ba6 ($3.28 in chips)
Hero: posts small blind $0.02
d34f29de: posts big blind $0.05
*** HOLE CARDS ***
Dealt to 5d0bed9d 
Dealt to Hero [Jh 3h]
Dealt to d34f29de 
Dealt to 7f263f67 
Dealt to d3f29b61 
Dealt to 33c99ba6 
7f263f67: folds
d3f29b61: folds
33c99ba6: folds
5d0bed9d: folds
Hero: raises $0.1 to $0.15
d34f29de: folds
Uncalled bet ($0.1) returned to Hero
*** SHOWDOWN ***
Hero collected $0.1 from pot
*** SUMMARY ***
Total pot $0.1 | Rake $0 | Jackpot $0 | Bingo $0 | Fortune $0 | Tax $0
Seat 1: 5d0bed9d (button) folded before Flop (didn't bet)
Seat 2: Hero (small blind) collected ($0.1)
Seat 3: d34f29de (big blind) folded before Flop
Seat 4: 7f263f67 folded before Flop (didn't bet)
Seat 5: d3f29b61 folded before Flop (didn't bet)
Seat 6: 33c99ba6 folded before Flop (didn't bet)


Poker Hand #RC2094586565: Hold'em No Limit ($0.02/$0.05) - 2023/12/27 20:55:40
Table 'RushAndCash3789822' 6-max Seat #1 is the button
Seat 1: f5ce1e53 ($5.8 in chips)
Seat 2: df870cc5 ($5.06 in chips)
Seat 3: e89c5c11 ($4.95 in chips)
Seat 4: 12940cb6 ($1.62 in chips)
Seat 5: 11b6f3ba ($13.92 in chips)
Seat 6: Hero ($5.21 in chips)
df870cc5: posts small blind $0.02
e89c5c11: posts big blind $0.05
*** HOLE CARDS ***
Dealt to f5ce1e53 
Dealt to df870cc5 
Dealt to e89c5c11 
Dealt to 12940cb6 
Dealt to 11b6f3ba 
Dealt to Hero [Ac 8d]
12940cb6: folds
11b6f3ba: folds
Hero: folds
f5ce1e53: folds
df870cc5: raises $0.09 to $0.14
e89c5c11: calls $0.09
*** FLOP *** [7s Qs Jd]
df870cc5: bets $0.1
e89c5c11: raises $0.1 to $0.2
df870cc5: folds
Uncalled bet ($0.1) returned to e89c5c11
*** SHOWDOWN ***
e89c5c11 collected $0.46 from pot
*** SUMMARY ***
Total pot $0.48 | Rake $0.02 | Jackpot $0 | Bingo $0 | Fortune $0 | Tax $0
Board [7s Qs Jd]
Seat 1: f5ce1e53 (button) folded before Flop (didn't bet)
Seat 2: df870cc5 (small blind) folded on the Flop
Seat 3: e89c5c11 (big blind) won ($0.46)
Seat 4: 12940cb6 folded before Flop (didn't bet)
Seat 5: 11b6f3ba folded before Flop (didn't bet)
Seat 6: Hero folded before Flop (didn't bet)


Poker Hand #RC2094586497: Hold'em No Limit ($0.02/$0.05) - 2023/12/27 20:55:36
Table 'RushAndCash3789789' 6-max Seat #1 is the button
Seat 1: ffd6607e ($6.12 in chips)
Seat 2: 5ada7abb ($1.39 in chips)
Seat 3: 322117f9 ($5.51 in chips)
Seat 4: b6b2dd8b ($6.82 in chips)
Seat 5: Hero ($5.21 in chips)
Seat 6: a619e8f7 ($5 in chips)
5ada7abb: posts small blind $0.02
322117f9: posts big blind $0.05
*** HOLE CARDS ***
Dealt to ffd6607e 
Dealt to 5ada7abb 
Dealt to 322117f9 
Dealt to b6b2dd8b 
Dealt to Hero [9h 3d]
Dealt to a619e8f7 
b6b2dd8b: folds
Hero: folds
a619e8f7: folds
ffd6607e: raises $0.1 to $0.15
5ada7abb: folds
322117f9: folds
Uncalled bet ($0.1) returned to ffd6607e
*** SHOWDOWN ***
ffd6607e collected $0.12 from pot
*** SUMMARY ***
Total pot $0.12 | Rake $0 | Jackpot $0 | Bingo $0 | Fortune $0 | Tax $0
Seat 1: ffd6607e (button) collected ($0.12)
Seat 2: 5ada7abb (small blind) folded before Flop
Seat 3: 322117f9 (big blind) folded before Flop
Seat 4: b6b2dd8b folded before Flop (didn't bet)
Seat 5: Hero folded before Flop (didn't bet)
Seat 6: a619e8f7 folded before Flop (didn't bet)


Poker Hand #RC2094585836: Hold'em No Limit ($0.02/$0.05) - 2023/12/27 20:55:03
Table 'RushAndCash3789451' 6-max Seat #1 is the button
Seat 1: b6b2dd8b ($6.68 in chips)
Seat 2: b0596725 ($5.13 in chips)
Seat 3: Hero ($5.34 in chips)
Seat 4: b0d5aa2f ($6.06 in chips)
Seat 5: 5a3dc296 ($5.16 in chips)
Seat 6: 6056afb9 ($10.19 in chips)
b0596725: posts small blind $0.02
Hero: posts big blind $0.05
*** HOLE CARDS ***
Dealt to b6b2dd8b 
Dealt to b0596725 
Dealt to Hero [Td Qs]
Dealt to b0d5aa2f 
Dealt to 5a3dc296 
Dealt to 6056afb9 
b0d5aa2f: folds
5a3dc296: folds
6056afb9: folds
b6b2dd8b: raises $0.08 to $0.13
b0596725: folds
Hero: calls $0.08
*** FLOP *** [4s 3c 8h]
Hero: checks
b6b2dd8b: bets $0.21
Hero: folds
Uncalled bet ($0.21) returned to b6b2dd8b
*** SHOWDOWN ***
b6b2dd8b collected $0.27 from pot
*** SUMMARY ***
Total pot $0.28 | Rake $0.01 | Jackpot $0 | Bingo $0 | Fortune $0 | Tax $0
Board [4s 3c 8h]
Seat 1: b6b2dd8b (button) won ($0.27)
Seat 2: b0596725 (small blind) folded before Flop
Seat 3: Hero (big blind) folded on the Flop
Seat 4: b0d5aa2f folded before Flop (didn't bet)
Seat 5: 5a3dc296 folded before Flop (didn't bet)
Seat 6: 6056afb9 folded before Flop (didn't bet)


Poker Hand #RC2094585769: Hold'em No Limit ($0.02/$0.05) - 2023/12/27 20:54:59
Table 'RushAndCash3789420' 6-max Seat #1 is the button
Seat 1: 5c9cda0d ($6.74 in chips)
Seat 2: 4eb827f5 ($5.48 in chips)
Seat 3: 24862006 ($9.31 in chips)
Seat 4: Hero ($5.34 in chips)
Seat 5: 78dd4e29 ($8.29 in chips)
Seat 6: 85217622 ($17.96 in chips)
4eb827f5: posts small blind $0.02
24862006: posts big blind $0.05
*** HOLE CARDS ***
Dealt to 5c9cda0d 
Dealt to 4eb827f5 
Dealt to 24862006 
Dealt to Hero [Ts 4c]
Dealt to 78dd4e29 
Dealt to 85217622 
Hero: folds
78dd4e29: raises $0.05 to $0.1
85217622: folds
5c9cda0d: calls $0.1
4eb827f5: calls $0.08
24862006: calls $0.05
*** FLOP *** [8s Jc Kc]
4eb827f5: checks
24862006: checks
78dd4e29: bets $0.15
5c9cda0d: calls $0.15
4eb827f5: calls $0.15
24862006: folds
*** TURN *** [8s Jc Kc] [4h]
4eb827f5: checks
78dd4e29: checks
5c9cda0d: bets $0.29
4eb827f5: folds
78dd4e29: folds
Uncalled bet ($0.29) returned to 5c9cda0d
*** SHOWDOWN ***
5c9cda0d collected $0.81 from pot
*** SUMMARY ***
Total pot $0.85 | Rake $0.04 | Jackpot $0 | Bingo $0 | Fortune $0 | Tax $0
Board [8s Jc Kc 4h]
Seat 1: 5c9cda0d (button) won ($0.81)
Seat 2: 4eb827f5 (small blind) folded on the Turn
Seat 3: 24862006 (big blind) folded on the Flop
Seat 4: Hero folded before Flop (didn't bet)
Seat 5: 78dd4e29 folded on the Turn
Seat 6: 85217622 folded before Flop (didn't bet)


Poker Hand #RC2094585704: Hold'em No Limit ($0.02/$0.05) - 2023/12/27 20:54:56
Table 'RushAndCash3789387' 6-max Seat #1 is the button
Seat 1: 48b5c4f6 ($12.69 in chips)
Seat 2: 7016f4d3 ($5 in chips)
Seat 3: fd90de27 ($5.07 in chips)
Seat 4: 5a53307e ($7.99 in chips)
Seat 5: Hero ($5.34 in chips)
Seat 6: ae2f927d ($7.18 in chips)
7016f4d3: posts small blind $0.02
fd90de27: posts big blind $0.05
*** HOLE CARDS ***
Dealt to 48b5c4f6 
Dealt to 7016f4d3 
Dealt to fd90de27 
Dealt to 5a53307e 
Dealt to Hero [4d Tc]
Dealt to ae2f927d 
5a53307e: folds
Hero: folds
ae2f927d: folds
48b5c4f6: folds
7016f4d3: raises $0.1 to $0.15
fd90de27: calls $0.1
*** FLOP *** [4h 5s 9s]
7016f4d3: bets $0.2
fd90de27: folds
Uncalled bet ($0.2) returned to 7016f4d3
*** SHOWDOWN ***
7016f4d3 collected $0.29 from pot
*** SUMMARY ***
Total pot $0.3 | Rake $0.01 | Jackpot $0 | Bingo $0 | Fortune $0 | Tax $0
Board [4h 5s 9s]
Seat 1: 48b5c4f6 (button) folded before Flop (didn't bet)
Seat 2: 7016f4d3 (small blind) won ($0.29)
Seat 3: fd90de27 (big blind) folded on the Flop
Seat 4: 5a53307e folded before Flop (didn't bet)
Seat 5: Hero folded before Flop (didn't bet)
Seat 6: ae2f927d folded before Flop (didn't bet)


Poker Hand #RC2094585642: Hold'em No Limit ($0.02/$0.05) - 2023/12/27 20:54:52
Table 'RushAndCash3789356' 6-max Seat #1 is the button
Seat 1: Hero ($5.34 in chips)
Seat 2: 258f5c62 ($5.97 in chips)
Seat 3: 6a8c9633 ($5 in chips)
Seat 4: f8dfc8a2 ($5.7 in chips)
Seat 5: 24862006 ($9.31 in chips)
Seat 6: a8803c53 ($5 in chips)
258f5c62: posts small blind $0.02
6a8c9633: posts big blind $0.05
*** HOLE CARDS ***
Dealt to Hero [7c Js]
Dealt to 258f5c62 
Dealt to 6a8c9633 
Dealt to f8dfc8a2 
Dealt to 24862006 
Dealt to a8803c53 
f8dfc8a2: folds
24862006: folds
a8803c53: raises $0.05 to $0.1
Hero: folds
258f5c62: folds
6a8c9633: calls $0.05
*** FLOP *** [Ts 2d 3h]
6a8c9633: checks
a8803c53: checks
*** TURN *** [Ts 2d 3h] [Qh]
6a8c9633: checks
a8803c53: bets $0.17
6a8c9633: calls $0.17
*** RIVER *** [Ts 2d 3h Qh] [Jd]
6a8c9633: checks
a8803c53: checks
6a8c9633: shows [4c 4h] (Pair of Fours)
a8803c53: shows [Ks 6s] (King-High)
*** SHOWDOWN ***
6a8c9633 collected $0.54 from pot
*** SUMMARY ***
Total pot $0.56 | Rake $0.02 | Jackpot $0 | Bingo $0 | Fortune $0 | Tax $0
Board [Ts 2d 3h Qh Jd]
Seat 1: Hero (button) folded before Flop (didn't bet)
Seat 2: 258f5c62 (small blind) folded before Flop
Seat 3: 6a8c9633 (big blind) showed [4c 4h] and won ($0.54) with Pair of Fours
Seat 4: f8dfc8a2 folded before Flop (didn't bet)
Seat 5: 24862006 folded before Flop (didn't bet)
Seat 6: a8803c53 showed [Ks 6s] and lost with King-High


Poker Hand #RC2094585565: Hold'em No Limit ($0.02/$0.05) - 2023/12/27 20:54:48
Table 'RushAndCash3789318' 6-max Seat #1 is the button
Seat 1: 9cbfdb9d ($5 in chips)
Seat 2: 37675088 ($5.85 in chips)
Seat 3: Hero ($5.39 in chips)
Seat 4: 1b28deb0 ($7.42 in chips)
Seat 5: 643372c4 ($5 in chips)
Seat 6: 474c3748 ($3.07 in chips)
37675088: posts small blind $0.02
Hero: posts big blind $0.05
*** HOLE CARDS ***
Dealt to 9cbfdb9d 
Dealt to 37675088 
Dealt to Hero [9d 5h]
Dealt to 1b28deb0 
Dealt to 643372c4 
Dealt to 474c3748 
1b28deb0: folds
643372c4: folds
474c3748: calls $0.05
9cbfdb9d: folds
37675088: folds
Hero: checks
*** FLOP *** [3d 4h Td]
Hero: checks
474c3748: bets $0.05
Hero: folds
Uncalled bet ($0.05) returned to 474c3748
*** SHOWDOWN ***
474c3748 collected $0.12 from pot
*** SUMMARY ***
Total pot $0.12 | Rake $0 | Jackpot $0 | Bingo $0 | Fortune $0 | Tax $0
Board [3d 4h Td]
Seat 1: 9cbfdb9d (button) folded before Flop (didn't bet)
Seat 2: 37675088 (small blind) folded before Flop
Seat 3: Hero (big blind) folded on the Flop
Seat 4: 1b28deb0 folded before Flop (didn't bet)
Seat 5: 643372c4 folded before Flop (didn't bet)
Seat 6: 474c3748 won ($0.12)


Poker Hand #RC2094585211: Hold'em No Limit ($0.02/$0.05) - 2023/12/27 20:54:30
Table 'RushAndCash3789142' 6-max Seat #1 is the button
Seat 1: 3fb2f460 ($9.25 in chips)
Seat 2: Hero ($5.34 in chips)
Seat 3: 97ef4a9b ($5.4 in chips)
Seat 4: 1b40644e ($5.38 in chips)
Seat 5: a619e8f7 ($5.07 in chips)
Seat 6: e4457efa ($4.96 in chips)
Hero: posts small blind $0.02
97ef4a9b: posts big blind $0.05
*** HOLE CARDS ***
Dealt to 3fb2f460 
Dealt to Hero [Kh 7c]
Dealt to 97ef4a9b 
Dealt to 1b40644e 
Dealt to a619e8f7 
Dealt to e4457efa 
1b40644e: folds
a619e8f7: folds
e4457efa: folds
3fb2f460: folds
Hero: raises $0.1 to $0.15
97ef4a9b: folds
Uncalled bet ($0.1) returned to Hero
*** SHOWDOWN ***
Hero collected $0.1 from pot
*** SUMMARY ***
Total pot $0.1 | Rake $0 | Jackpot $0 | Bingo $0 | Fortune $0 | Tax $0
Seat 1: 3fb2f460 (button) folded before Flop (didn't bet)
Seat 2: Hero (small blind) collected ($0.1)
Seat 3: 97ef4a9b (big blind) folded before Flop
Seat 4: 1b40644e folded before Flop (didn't bet)
Seat 5: a619e8f7 folded before Flop (didn't bet)
Seat 6: e4457efa folded before Flop (didn't bet)


Poker Hand #RC2094585127: Hold'em No Limit ($0.02/$0.05) - 2023/12/27 20:54:27
Table 'RushAndCash3789098' 6-max Seat #1 is the button
Seat 1: 26c09e5f ($6.13 in chips)
Seat 2: a8803c53 ($5.07 in chips)
Seat 3: c7f87cd1 ($5.84 in chips)
Seat 4: c6180e2d ($6.21 in chips)
Seat 5: 1b40644e ($5.38 in chips)
Seat 6: Hero ($5.34 in chips)
a8803c53: posts small blind $0.02
c7f87cd1: posts big blind $0.05
*** HOLE CARDS ***
Dealt to 26c09e5f 
Dealt to a8803c53 
Dealt to c7f87cd1 
Dealt to c6180e2d 
Dealt to 1b40644e 
Dealt to Hero [5s 6d]
c6180e2d: raises $0.05 to $0.1
1b40644e: folds
Hero: folds
26c09e5f: calls $0.1
a8803c53: folds
c7f87cd1: folds
*** FLOP *** [3h Jc 7s]
c6180e2d: bets $0.07
26c09e5f: folds
Uncalled bet ($0.07) returned to c6180e2d
*** SHOWDOWN ***
c6180e2d collected $0.26 from pot
*** SUMMARY ***
Total pot $0.27 | Rake $0.01 | Jackpot $0 | Bingo $0 | Fortune $0 | Tax $0
Board [3h Jc 7s]
Seat 1: 26c09e5f (button) folded on the Flop
Seat 2: a8803c53 (small blind) folded before Flop
Seat 3: c7f87cd1 (big blind) folded before Flop
Seat 4: c6180e2d won ($0.26)
Seat 5: 1b40644e folded before Flop (didn't bet)
Seat 6: Hero folded before Flop (didn't bet)


Poker Hand #RC2094585049: Hold'em No Limit ($0.02/$0.05) - 2023/12/27 20:54:22
Table 'RushAndCash3789056' 6-max Seat #1 is the button
Seat 1: d490469a ($4.09 in chips)
Seat 2: 4811c1cd ($10.2 in chips)
Seat 3: 70d77cad ($13.42 in chips)
Seat 4: 8f72056d ($4.2 in chips)
Seat 5: 135f3775 ($1.75 in chips)
Seat 6: Hero ($5.34 in chips)
4811c1cd: posts small blind $0.02
70d77cad: posts big blind $0.05
*** HOLE CARDS ***
Dealt to d490469a 
Dealt to 4811c1cd 
Dealt to 70d77cad 
Dealt to 8f72056d 
Dealt to 135f3775 
Dealt to Hero [5d Tc]
8f72056d: folds
135f3775: calls $0.05
Hero: folds
d490469a: calls $0.05
4811c1cd: calls $0.03
70d77cad: checks
*** FLOP *** [Js 8s 7s]
4811c1cd: checks
70d77cad: checks
135f3775: bets $0.05
d490469a: calls $0.05
4811c1cd: folds
70d77cad: calls $0.05
*** TURN *** [Js 8s 7s] [2c]
70d77cad: checks
135f3775: bets $0.1
d490469a: calls $0.1
70d77cad: calls $0.1
*** RIVER *** [Js 8s 7s 2c] [Jc]
70d77cad: checks
135f3775: checks
d490469a: bets $0.65
70d77cad: folds
135f3775: calls $0.65
d490469a: shows [9c 9s] (Pair of Jacks and Pair of Nines)
135f3775: shows [Kc Jd] (Three Jacks)
*** SHOWDOWN ***
135f3775 collected $1.79 from pot
*** SUMMARY ***
Total pot $1.95 | Rake $0.09 | Jackpot $0.07 | Bingo $0 | Fortune $0 | Tax $0
Board [Js 8s 7s 2c Jc]
Seat 1: d490469a (button) showed [9c 9s] and lost with Pair of Jacks and Pair of Nines
Seat 2: 4811c1cd (small blind) folded on the Flop
Seat 3: 70d77cad (big blind) folded on the River
Seat 4: 8f72056d folded before Flop (didn't bet)
Seat 5: 135f3775 showed [Kc Jd] and won ($1.79) with Three Jacks
Seat 6: Hero folded before Flop (didn't bet)


Poker Hand #RC2094584973: Hold'em No Limit ($0.02/$0.05) - 2023/12/27 20:54:18
Table 'RushAndCash3789020' 6-max Seat #1 is the button
Seat 1: 4549855 ($11.87 in chips)
Seat 2: bc79e3f1 ($13.77 in chips)
Seat 3: 667ad57f ($3.96 in chips)
Seat 4: a1f8e1e4 ($9.01 in chips)
Seat 5: Hero ($5.34 in chips)
Seat 6: 80c84bc5 ($7.69 in chips)
bc79e3f1: posts small blind $0.02
667ad57f: posts big blind $0.05
*** HOLE CARDS ***
Dealt to 4549855 
Dealt to bc79e3f1 
Dealt to 667ad57f 
Dealt to a1f8e1e4 
Dealt to Hero [8d 4c]
Dealt to 80c84bc5 
a1f8e1e4: folds
Hero: folds
80c84bc5: folds
4549855: raises $0.08 to $0.13
bc79e3f1: folds
667ad57f: folds
Uncalled bet ($0.08) returned to 4549855
*** SHOWDOWN ***
4549855 collected $0.12 from pot
*** SUMMARY ***
Total pot $0.12 | Rake $0 | Jackpot $0 | Bingo $0 | Fortune $0 | Tax $0
Seat 1: 4549855 (button) collected ($0.12)
Seat 2: bc79e3f1 (small blind) folded before Flop
Seat 3: 667ad57f (big blind) folded before Flop
Seat 4: a1f8e1e4 folded before Flop (didn't bet)
Seat 5: Hero folded before Flop (didn't bet)
Seat 6: 80c84bc5 folded before Flop (didn't bet)


Poker Hand #RC2094584885: Hold'em No Limit ($0.02/$0.05) - 2023/12/27 20:54:14
Table 'RushAndCash3788975' 6-max Seat #1 is the button
Seat 1: b2f778b3 ($6.83 in chips)
Seat 2: b9265dd3 ($15.8 in chips)
Seat 3: fa338ba2 ($1.93 in chips)
Seat 4: 5a53307e ($7.92 in chips)
Seat 5: b51cef8d ($7.59 in chips)
Seat 6: Hero ($5.34 in chips)
b9265dd3: posts small blind $0.02
fa338ba2: posts big blind $0.05
*** HOLE CARDS ***
Dealt to b2f778b3 
Dealt to b9265dd3 
Dealt to fa338ba2 
Dealt to 5a53307e 
Dealt to b51cef8d 
Dealt to Hero [3d Th]
5a53307e: folds
b51cef8d: folds
Hero: folds
b2f778b3: raises $0.07 to $0.12
b9265dd3: folds
fa338ba2: folds
Uncalled bet ($0.07) returned to b2f778b3
*** SHOWDOWN ***
b2f778b3 collected $0.12 from pot
*** SUMMARY ***
Total pot $0.12 | Rake $0 | Jackpot $0 | Bingo $0 | Fortune $0 | Tax $0
Seat 1: b2f778b3 (button) collected ($0.12)
Seat 2: b9265dd3 (small blind) folded before Flop
Seat 3: fa338ba2 (big blind) folded before Flop
Seat 4: 5a53307e folded before Flop (didn't bet)
Seat 5: b51cef8d folded before Flop (didn't bet)
Seat 6: Hero folded before Flop (didn't bet)


Poker Hand #RC2094574087: Hold'em No Limit ($0.02/$0.05) - 2023/12/27 20:53:33
Table 'RushAndCash3788566' 6-max Seat #1 is the button
Seat 1: Hero ($5.17 in chips)
Seat 2: 821fa78a ($23.06 in chips)
Seat 3: 8bff79df ($5 in chips)
Seat 4: 5a53307e ($8.03 in chips)
Seat 5: c21bdf1b ($5 in chips)
Seat 6: 5204a1fe ($7.89 in chips)
821fa78a: posts small blind $0.02
8bff79df: posts big blind $0.05
*** HOLE CARDS ***
Dealt to Hero [Qc Jc]
Dealt to 821fa78a 
Dealt to 8bff79df 
Dealt to 5a53307e 
Dealt to c21bdf1b 
Dealt to 5204a1fe 
5a53307e: raises $0.06 to $0.11
c21bdf1b: folds
5204a1fe: folds
Hero: calls $0.11
821fa78a: folds
8bff79df: folds
*** FLOP *** [6s 9h 4s]
5a53307e: checks
Hero: checks
*** TURN *** [6s 9h 4s] [Qh]
5a53307e: checks
Hero: checks
*** RIVER *** [6s 9h 4s Qh] [7d]
5a53307e: checks
Hero: bets $0.15
5a53307e: folds
Uncalled bet ($0.15) returned to Hero
*** SHOWDOWN ***
Hero collected $0.28 from pot
*** SUMMARY ***
Total pot $0.29 | Rake $0.01 | Jackpot $0 | Bingo $0 | Fortune $0 | Tax $0
Board [6s 9h 4s Qh 7d]
Seat 1: Hero (button) won ($0.28)
Seat 2: 821fa78a (small blind) folded before Flop
Seat 3: 8bff79df (big blind) folded before Flop
Seat 4: 5a53307e folded on the River
Seat 5: c21bdf1b folded before Flop (didn't bet)
Seat 6: 5204a1fe folded before Flop (didn't bet)


Poker Hand #RC2094573511: Hold'em No Limit ($0.02/$0.05) - 2023/12/27 20:53:04
Table 'RushAndCash3788269' 6-max Seat #1 is the button
Seat 1: 821fa78a ($23.19 in chips)
Seat 2: Hero ($5 in chips)
Seat 3: dd4d7f96 ($5.93 in chips)
Seat 4: 961c5f19 ($34.11 in chips)
Seat 5: c5f04825 ($5 in chips)
Seat 6: 8767c87b ($6.58 in chips)
Hero: posts small blind $0.02
dd4d7f96: posts big blind $0.05
*** HOLE CARDS ***
Dealt to 821fa78a 
Dealt to Hero [Ts Ah]
Dealt to dd4d7f96 
Dealt to 961c5f19 
Dealt to c5f04825 
Dealt to 8767c87b 
961c5f19: folds
c5f04825: folds
8767c87b: folds
821fa78a: raises $0.08 to $0.13
Hero: calls $0.11
dd4d7f96: folds
*** FLOP *** [As Th 4h]
Hero: bets $0.1
821fa78a: folds
Uncalled bet ($0.1) returned to Hero
*** SHOWDOWN ***
Hero collected $0.3 from pot
*** SUMMARY ***
Total pot $0.31 | Rake $0.01 | Jackpot $0 | Bingo $0 | Fortune $0 | Tax $0
Board [As Th 4h]
Seat 1: 821fa78a (button) folded on the Flop
Seat 2: Hero (small blind) won ($0.3)
Seat 3: dd4d7f96 (big blind) folded before Flop
Seat 4: 961c5f19 folded before Flop (didn't bet)
Seat 5: c5f04825 folded before Flop (didn't bet)
Seat 6: 8767c87b folded before Flop (didn't bet)


Poker Hand #RC2094573287: Hold'em No Limit ($0.02/$0.05) - 2023/12/27 20:52:52
Table 'RushAndCash3788155' 6-max Seat #1 is the button
Seat 1: 20a42622 ($4.88 in chips)
Seat 2: 50c89abb ($7.32 in chips)
Seat 3: Hero ($5.02 in chips)
Seat 4: 7016f4d3 ($5.15 in chips)
Seat 5: b3ddb34b ($4.93 in chips)
Seat 6: f1876d50 ($11.3 in chips)
50c89abb: posts small blind $0.02
Hero: posts big blind $0.05
*** HOLE CARDS ***
Dealt to 20a42622 
Dealt to 50c89abb 
Dealt to Hero [6h 4c]
Dealt to 7016f4d3 
Dealt to b3ddb34b 
Dealt to f1876d50 
7016f4d3: raises $0.1 to $0.15
b3ddb34b: folds
f1876d50: folds
20a42622: folds
50c89abb: folds
Hero: folds
Uncalled bet ($0.1) returned to 7016f4d3
*** SHOWDOWN ***
7016f4d3 collected $0.12 from pot
*** SUMMARY ***
Total pot $0.12 | Rake $0 | Jackpot $0 | Bingo $0 | Fortune $0 | Tax $0
Seat 1: 20a42622 (button) folded before Flop (didn't bet)
Seat 2: 50c89abb (small blind) folded before Flop
Seat 3: Hero (big blind) folded before Flop
Seat 4: 7016f4d3 collected ($0.12)
Seat 5: b3ddb34b folded before Flop (didn't bet)
Seat 6: f1876d50 folded before Flop (didn't bet)


Poker Hand #RC2094573215: Hold'em No Limit ($0.02/$0.05) - 2023/12/27 20:52:49
Table 'RushAndCash3788122' 6-max Seat #1 is the button
Seat 1: 81c77fb7 ($4.98 in chips)
Seat 2: a5b192e7 ($5.05 in chips)
Seat 3: ff18f1e2 ($7.81 in chips)
Seat 4: Hero ($5.02 in chips)
Seat 5: 9f9d2491 ($5 in chips)
Seat 6: 39740130 ($4.9 in chips)
a5b192e7: posts small blind $0.02
ff18f1e2: posts big blind $0.05
*** HOLE CARDS ***
Dealt to 81c77fb7 
Dealt to a5b192e7 
Dealt to ff18f1e2 
Dealt to Hero [3s Kc]
Dealt to 9f9d2491 
Dealt to 39740130 
Hero: folds
9f9d2491: folds
39740130: folds
81c77fb7: raises $0.08 to $0.13
a5b192e7: folds
ff18f1e2: folds
Uncalled bet ($0.08) returned to 81c77fb7
*** SHOWDOWN ***
81c77fb7 collected $0.12 from pot
*** SUMMARY ***
Total pot $0.12 | Rake $0 | Jackpot $0 | Bingo $0 | Fortune $0 | Tax $0
Seat 1: 81c77fb7 (button) collected ($0.12)
Seat 2: a5b192e7 (small blind) folded before Flop
Seat 3: ff18f1e2 (big blind) folded before Flop
Seat 4: Hero folded before Flop (didn't bet)
Seat 5: 9f9d2491 folded before Flop (didn't bet)
Seat 6: 39740130 folded before Flop (didn't bet)


Poker Hand #RC2094573143: Hold'em No Limit ($0.02/$0.05) - 2023/12/27 20:52:45
Table 'RushAndCash3788085' 6-max Seat #1 is the button
Seat 1: fb5b1ccc ($12.43 in chips)
Seat 2: ba4dcf33 ($6.67 in chips)
Seat 3: 6b422a3f ($9 in chips)
Seat 4: Hero ($5.02 in chips)
Seat 5: 587c9b8e ($8.23 in chips)
Seat 6: 37675088 ($5.03 in chips)
ba4dcf33: posts small blind $0.02
6b422a3f: posts big blind $0.05
*** HOLE CARDS ***
Dealt to fb5b1ccc 
Dealt to ba4dcf33 
Dealt to 6b422a3f 
Dealt to Hero [4s 7h]
Dealt to 587c9b8e 
Dealt to 37675088 
Hero: folds
587c9b8e: folds
37675088: folds
fb5b1ccc: raises $0.1 to $0.15
ba4dcf33: folds
6b422a3f: raises $0.5 to $0.65
fb5b1ccc: calls $0.5
*** FLOP *** [Ad 4h 5d]
6b422a3f: bets $0.32
fb5b1ccc: folds
Uncalled bet ($0.32) returned to 6b422a3f
*** SHOWDOWN ***
6b422a3f collected $1.26 from pot
*** SUMMARY ***
Total pot $1.32 | Rake $0.06 | Jackpot $0 | Bingo $0 | Fortune $0 | Tax $0
Board [Ad 4h 5d]
Seat 1: fb5b1ccc (button) folded on the Flop
Seat 2: ba4dcf33 (small blind) folded before Flop
Seat 3: 6b422a3f (big blind) won ($1.26)
Seat 4: Hero folded before Flop (didn't bet)
Seat 5: 587c9b8e folded before Flop (didn't bet)
Seat 6: 37675088 folded before Flop (didn't bet)


Poker Hand #RC2094573072: Hold'em No Limit ($0.02/$0.05) - 2023/12/27 20:52:42
Table 'RushAndCash3788051' 6-max Seat #1 is the button
Seat 1: Hero ($5.02 in chips)
Seat 2: 2a55aa6 ($5.89 in chips)
Seat 3: 9808a737 ($6.59 in chips)
Seat 4: 6b422a3f ($9 in chips)
Seat 5: 28f6306d ($5.11 in chips)
Seat 6: 159bec7c ($5.07 in chips)
2a55aa6: posts small blind $0.02
9808a737: posts big blind $0.05
*** HOLE CARDS ***
Dealt to Hero [3d 4c]
Dealt to 2a55aa6 
Dealt to 9808a737 
Dealt to 6b422a3f 
Dealt to 28f6306d 
Dealt to 159bec7c 
6b422a3f: folds
28f6306d: folds
159bec7c: folds
Hero: folds
2a55aa6: folds
Uncalled bet ($0.03) returned to 9808a737
*** SHOWDOWN ***
9808a737 collected $0.04 from pot
*** SUMMARY ***
Total pot $0.04 | Rake $0 | Jackpot $0 | Bingo $0 | Fortune $0 | Tax $0
Seat 1: Hero (button) folded before Flop (didn't bet)
Seat 2: 2a55aa6 (small blind) folded before Flop
Seat 3: 9808a737 (big blind) collected ($0.04)
Seat 4: 6b422a3f folded before Flop (didn't bet)
Seat 5: 28f6306d folded before Flop (didn't bet)
Seat 6: 159bec7c folded before Flop (didn't bet)


Poker Hand #RC2094572875: Hold'em No Limit ($0.02/$0.05) - 2023/12/27 20:52:32
Table 'RushAndCash3787957' 6-max Seat #1 is the button
Seat 1: a2949445 ($5.07 in chips)
Seat 2: ff7c9d27 ($5.25 in chips)
Seat 3: Hero ($5 in chips)
Seat 4: dd198d66 ($24.14 in chips)
Seat 5: 8290eb8e ($5.94 in chips)
Seat 6: 3993f38 ($4.76 in chips)
ff7c9d27: posts small blind $0.02
Hero: posts big blind $0.05
*** HOLE CARDS ***
Dealt to a2949445 
Dealt to ff7c9d27 
Dealt to Hero [Kc 8s]
Dealt to dd198d66 
Dealt to 8290eb8e 
Dealt to 3993f38 
dd198d66: folds
8290eb8e: folds
3993f38: folds
a2949445: folds
ff7c9d27: folds
Uncalled bet ($0.03) returned to Hero
*** SHOWDOWN ***
Hero collected $0.04 from pot
*** SUMMARY ***
Total pot $0.04 | Rake $0 | Jackpot $0 | Bingo $0 | Fortune $0 | Tax $0
Seat 1: a2949445 (button) folded before Flop (didn't bet)
Seat 2: ff7c9d27 (small blind) folded before Flop
Seat 3: Hero (big blind) collected ($0.04)
Seat 4: dd198d66 folded before Flop (didn't bet)
Seat 5: 8290eb8e folded before Flop (didn't bet)
Seat 6: 3993f38 folded before Flop (didn't bet)


Poker Hand #RC2094572628: Hold'em No Limit ($0.02/$0.05) - 2023/12/27 20:52:20
Table 'RushAndCash3787839' 6-max Seat #1 is the button
Seat 1: 9c19f0ff ($5.07 in chips)
Seat 2: Hero ($5.01 in chips)
Seat 3: 31af5dba ($9.86 in chips)
Seat 4: fb9a94b2 ($6.44 in chips)
Seat 5: 57afc08f ($6.18 in chips)
Seat 6: 77e4d469 ($9.11 in chips)
Hero: posts small blind $0.02
31af5dba: posts big blind $0.05
*** HOLE CARDS ***
Dealt to 9c19f0ff 
Dealt to Hero [3s Jc]
Dealt to 31af5dba 
Dealt to fb9a94b2 
Dealt to 57afc08f 
Dealt to 77e4d469 
fb9a94b2: folds
57afc08f: folds
77e4d469: raises $0.07 to $0.12
9c19f0ff: folds
Hero: folds
31af5dba: calls $0.07
*** FLOP *** [8c Qs 7s]
31af5dba: checks
77e4d469: bets $0.09
31af5dba: calls $0.09
*** TURN *** [8c Qs 7s] [Qh]
31af5dba: checks
77e4d469: bets $0.17
31af5dba: folds
Uncalled bet ($0.17) returned to 77e4d469
*** SHOWDOWN ***
77e4d469 collected $0.42 from pot
*** SUMMARY ***
Total pot $0.44 | Rake $0.02 | Jackpot $0 | Bingo $0 | Fortune $0 | Tax $0
Board [8c Qs 7s Qh]
Seat 1: 9c19f0ff (button) folded before Flop (didn't bet)
Seat 2: Hero (small blind) folded before Flop
Seat 3: 31af5dba (big blind) folded on the Turn
Seat 4: fb9a94b2 folded before Flop (didn't bet)
Seat 5: 57afc08f folded before Flop (didn't bet)
Seat 6: 77e4d469 won ($0.42)


Poker Hand #RC2094572551: Hold'em No Limit ($0.02/$0.05) - 2023/12/27 20:52:16
Table 'RushAndCash3787801' 6-max Seat #1 is the button
Seat 1: 6969a957 ($10.04 in chips)
Seat 2: ad2892fb ($5.91 in chips)
Seat 3: d675546e ($5 in chips)
Seat 4: 5d31ed85 ($5.18 in chips)
Seat 5: 6b258923 ($5 in chips)
Seat 6: Hero ($5.01 in chips)
ad2892fb: posts small blind $0.02
d675546e: posts big blind $0.05
*** HOLE CARDS ***
Dealt to 6969a957 
Dealt to ad2892fb 
Dealt to d675546e 
Dealt to 5d31ed85 
Dealt to 6b258923 
Dealt to Hero [Tc 4h]
5d31ed85: raises $0.05 to $0.1
6b258923: folds
Hero: folds
6969a957: folds
ad2892fb: folds
d675546e: folds
Uncalled bet ($0.05) returned to 5d31ed85
*** SHOWDOWN ***
5d31ed85 collected $0.12 from pot
*** SUMMARY ***
Total pot $0.12 | Rake $0 | Jackpot $0 | Bingo $0 | Fortune $0 | Tax $0
Seat 1: 6969a957 (button) folded before Flop (didn't bet)
Seat 2: ad2892fb (small blind) folded before Flop
Seat 3: d675546e (big blind) folded before Flop
Seat 4: 5d31ed85 collected ($0.12)
Seat 5: 6b258923 folded before Flop (didn't bet)
Seat 6: Hero folded before Flop (didn't bet)


Poker Hand #RC2094572477: Hold'em No Limit ($0.02/$0.05) - 2023/12/27 20:52:12
Table 'RushAndCash3787764' 6-max Seat #1 is the button
Seat 1: 129d5d42 ($5.48 in chips)
Seat 2: a5f9505c ($5.74 in chips)
Seat 3: 59789e86 ($5 in chips)
Seat 4: Hero ($5.01 in chips)
Seat 5: c5958bb7 ($9.67 in chips)
Seat 6: d2511a5c ($5.05 in chips)
a5f9505c: posts small blind $0.02
59789e86: posts big blind $0.05
*** HOLE CARDS ***
Dealt to 129d5d42 
Dealt to a5f9505c 
Dealt to 59789e86 
Dealt to Hero [9s 8d]
Dealt to c5958bb7 
Dealt to d2511a5c 
Hero: folds
c5958bb7: folds
d2511a5c: folds
129d5d42: folds
a5f9505c: folds
Uncalled bet ($0.03) returned to 59789e86
*** SHOWDOWN ***
59789e86 collected $0.04 from pot
*** SUMMARY ***
Total pot $0.04 | Rake $0 | Jackpot $0 | Bingo $0 | Fortune $0 | Tax $0
Seat 1: 129d5d42 (button) folded before Flop (didn't bet)
Seat 2: a5f9505c (small blind) folded before Flop
Seat 3: 59789e86 (big blind) collected ($0.04)
Seat 4: Hero folded before Flop (didn't bet)
Seat 5: c5958bb7 folded before Flop (didn't bet)
Seat 6: d2511a5c folded before Flop (didn't bet)


Poker Hand #RC2094572316: Hold'em No Limit ($0.02/$0.05) - 2023/12/27 20:52:04
Table 'RushAndCash3787687' 6-max Seat #1 is the button
Seat 1: 69f7ac74 ($7.12 in chips)
Seat 2: f040953 ($6.18 in chips)
Seat 3: d557ab62 ($13.72 in chips)
Seat 4: b8c06739 ($7.38 in chips)
Seat 5: 51c7aec9 ($5.41 in chips)
Seat 6: Hero ($5.01 in chips)
f040953: posts small blind $0.02
d557ab62: posts big blind $0.05
*** HOLE CARDS ***
Dealt to 69f7ac74 
Dealt to f040953 
Dealt to d557ab62 
Dealt to b8c06739 
Dealt to 51c7aec9 
Dealt to Hero [Jd Tc]
b8c06739: calls $0.05
51c7aec9: folds
Hero: folds
69f7ac74: raises $0.2 to $0.25
f040953: folds
d557ab62: folds
b8c06739: folds
Uncalled bet ($0.2) returned to 69f7ac74
*** SHOWDOWN ***
69f7ac74 collected $0.17 from pot
*** SUMMARY ***
Total pot $0.17 | Rake $0 | Jackpot $0 | Bingo $0 | Fortune $0 | Tax $0
Seat 1: 69f7ac74 (button) collected ($0.17)
Seat 2: f040953 (small blind) folded before Flop
Seat 3: d557ab62 (big blind) folded before Flop
Seat 4: b8c06739 folded before Flop
Seat 5: 51c7aec9 folded before Flop (didn't bet)
Seat 6: Hero folded before Flop (didn't bet)


Poker Hand #RC2094572213: Hold'em No Limit ($0.02/$0.05) - 2023/12/27 20:51:59
Table 'RushAndCash3787638' 6-max Seat #1 is the button
Seat 1: Hero ($5.01 in chips)
Seat 2: 61737da3 ($9.07 in chips)
Seat 3: b1d3cfa9 ($5.07 in chips)
Seat 4: f4aa5f06 ($5.19 in chips)
Seat 5: 1b99ba34 ($10.3 in chips)
Seat 6: b963e604 ($8 in chips)
61737da3: posts small blind $0.02
b1d3cfa9: posts big blind $0.05
*** HOLE CARDS ***
Dealt to Hero [9s 2d]
Dealt to 61737da3 
Dealt to b1d3cfa9 
Dealt to f4aa5f06 
Dealt to 1b99ba34 
Dealt to b963e604 
f4aa5f06: folds
1b99ba34: raises $0.08 to $0.13
b963e604: folds
Hero: folds
61737da3: folds
b1d3cfa9: folds
Uncalled bet ($0.08) returned to 1b99ba34
*** SHOWDOWN ***
1b99ba34 collected $0.12 from pot
*** SUMMARY ***
Total pot $0.12 | Rake $0 | Jackpot $0 | Bingo $0 | Fortune $0 | Tax $0
Seat 1: Hero (button) folded before Flop (didn't bet)
Seat 2: 61737da3 (small blind) folded before Flop
Seat 3: b1d3cfa9 (big blind) folded before Flop
Seat 4: f4aa5f06 folded before Flop (didn't bet)
Seat 5: 1b99ba34 collected ($0.12)
Seat 6: b963e604 folded before Flop (didn't bet)


Poker Hand #RC2094572072: Hold'em No Limit ($0.02/$0.05) - 2023/12/27 20:51:51
Table 'RushAndCash3787571' 6-max Seat #1 is the button
Seat 1: 31af5dba ($9.88 in chips)
Seat 2: Hero ($5.03 in chips)
Seat 3: 61737da3 ($9.12 in chips)
Seat 4: f060f8ed ($5.69 in chips)
Seat 5: 643c6b26 ($5.66 in chips)
Seat 6: ac6f6432 ($4.98 in chips)
Hero: posts small blind $0.02
61737da3: posts big blind $0.05
*** HOLE CARDS ***
Dealt to 31af5dba 
Dealt to Hero [Js 7s]
Dealt to 61737da3 
Dealt to f060f8ed 
Dealt to 643c6b26 
Dealt to ac6f6432 
f060f8ed: raises $0.1 to $0.15
643c6b26: folds
ac6f6432: folds
31af5dba: folds
Hero: folds
61737da3: folds
Uncalled bet ($0.1) returned to f060f8ed
*** SHOWDOWN ***
f060f8ed collected $0.12 from pot
*** SUMMARY ***
Total pot $0.12 | Rake $0 | Jackpot $0 | Bingo $0 | Fortune $0 | Tax $0
Seat 1: 31af5dba (button) folded before Flop (didn't bet)
Seat 2: Hero (small blind) folded before Flop
Seat 3: 61737da3 (big blind) folded before Flop
Seat 4: f060f8ed collected ($0.12)
Seat 5: 643c6b26 folded before Flop (didn't bet)
Seat 6: ac6f6432 folded before Flop (didn't bet)


Poker Hand #RC2094571343: Hold'em No Limit ($0.02/$0.05) - 2023/12/27 20:51:14
Table 'RushAndCash3787227' 6-max Seat #1 is the button
Seat 1: 8c9da424 ($5 in chips)
Seat 2: 5bffa8a1 ($1.8 in chips)
Seat 3: Hero ($5.13 in chips)
Seat 4: 61737da3 ($9.01 in chips)
Seat 5: e8717a11 ($8.3 in chips)
Seat 6: 7aad2653 ($6.41 in chips)
5bffa8a1: posts small blind $0.02
Hero: posts big blind $0.05
*** HOLE CARDS ***
Dealt to 8c9da424 
Dealt to 5bffa8a1 
Dealt to Hero [2h Kh]
Dealt to 61737da3 
Dealt to e8717a11 
Dealt to 7aad2653 
61737da3: raises $0.05 to $0.1
e8717a11: folds
7aad2653: folds
8c9da424: folds
5bffa8a1: folds
Hero: calls $0.05
*** FLOP *** [Ah Js Th]
Hero: checks
61737da3: checks
*** TURN *** [Ah Js Th] [Jc]
Hero: checks
61737da3: checks
*** RIVER *** [Ah Js Th Jc] [9d]
Hero: checks
61737da3: bets $0.11
Hero: folds
Uncalled bet ($0.11) returned to 61737da3
*** SHOWDOWN ***
61737da3 collected $0.21 from pot
*** SUMMARY ***
Total pot $0.22 | Rake $0.01 | Jackpot $0 | Bingo $0 | Fortune $0 | Tax $0
Board [Ah Js Th Jc 9d]
Seat 1: 8c9da424 (button) folded before Flop (didn't bet)
Seat 2: 5bffa8a1 (small blind) folded before Flop
Seat 3: Hero (big blind) folded on the River
Seat 4: 61737da3 won ($0.21)
Seat 5: e8717a11 folded before Flop (didn't bet)
Seat 6: 7aad2653 folded before Flop (didn't bet)


Poker Hand #RC2094571034: Hold'em No Limit ($0.02/$0.05) - 2023/12/27 20:50:58
Table 'RushAndCash3787073' 6-max Seat #1 is the button
Seat 1: ec730470 ($1.04 in chips)
Seat 2: 3f587bf6 ($5.21 in chips)
Seat 3: 70d77cad ($13.14 in chips)
Seat 4: e8717a11 ($8.35 in chips)
Seat 5: a9a5ee49 ($4.98 in chips)
Seat 6: Hero ($5.06 in chips)
3f587bf6: posts small blind $0.02
70d77cad: posts big blind $0.05
*** HOLE CARDS ***
Dealt to ec730470 
Dealt to 3f587bf6 
Dealt to 70d77cad 
Dealt to e8717a11 
Dealt to a9a5ee49 
Dealt to Hero [As Ac]
e8717a11: folds
a9a5ee49: folds
Hero: raises $0.05 to $0.1
ec730470: folds
3f587bf6: folds
70d77cad: folds
Uncalled bet ($0.05) returned to Hero
*** SHOWDOWN ***
Hero collected $0.12 from pot
*** SUMMARY ***
Total pot $0.12 | Rake $0 | Jackpot $0 | Bingo $0 | Fortune $0 | Tax $0
Seat 1: ec730470 (button) folded before Flop (didn't bet)
Seat 2: 3f587bf6 (small blind) folded before Flop
Seat 3: 70d77cad (big blind) folded before Flop
Seat 4: e8717a11 folded before Flop (didn't bet)
Seat 5: a9a5ee49 folded before Flop (didn't bet)
Seat 6: Hero collected ($0.12)


Poker Hand #RC2094570201: Hold'em No Limit ($0.02/$0.05) - 2023/12/27 20:50:15
Table 'RushAndCash3786651' 6-max Seat #1 is the button
Seat 1: 6611a058 ($5.34 in chips)
Seat 2: e8717a11 ($7.13 in chips)
Seat 3: 19c84b8b ($6.12 in chips)
Seat 4: e9d4b33a ($5.08 in chips)
Seat 5: Hero ($5.16 in chips)
Seat 6: d5b942bb ($11.36 in chips)
Cash Drop to Pot : total $0.5 
e8717a11: posts small blind $0.02
19c84b8b: posts big blind $0.05
*** HOLE CARDS ***
Dealt to 6611a058 
Dealt to e8717a11 
Dealt to 19c84b8b 
Dealt to e9d4b33a 
Dealt to Hero [Jc Qh]
Dealt to d5b942bb 
e9d4b33a: folds
Hero: raises $0.05 to $0.1
d5b942bb: calls $0.1
6611a058: folds
e8717a11: raises $0.64 to $0.74
19c84b8b: folds
Hero: folds
d5b942bb: calls $0.64
*** FLOP *** [5s Js 9h]
e8717a11: bets $1.07
d5b942bb: folds
Uncalled bet ($1.07) returned to e8717a11
d5b942bb: shows [Qd]
*** SHOWDOWN ***
e8717a11 collected $1.96 from pot
*** SUMMARY ***
Total pot $2.13 | Rake $0.1 | Jackpot $0.07 | Bingo $0 | Fortune $0 | Tax $0
Board [5s Js 9h]
Seat 1: 6611a058 (button) folded before Flop (didn't bet)
Seat 2: e8717a11 (small blind) won ($1.96)
Seat 3: 19c84b8b (big blind) folded before Flop
Seat 4: e9d4b33a folded before Flop (didn't bet)
Seat 5: Hero folded before Flop
Seat 6: d5b942bb folded on the Flop


Poker Hand #RC2094570124: Hold'em No Limit ($0.02/$0.05) - 2023/12/27 20:50:11
Table 'RushAndCash3786613' 6-max Seat #1 is the button
Seat 1: 1869aa38 ($10.02 in chips)
Seat 2: 24e24cc3 ($5.81 in chips)
Seat 3: 3ed5343b ($11.2 in chips)
Seat 4: e34cd626 ($5 in chips)
Seat 5: Hero ($5.16 in chips)
Seat 6: 858e0cb4 ($10.38 in chips)
24e24cc3: posts small blind $0.02
3ed5343b: posts big blind $0.05
*** HOLE CARDS ***
Dealt to 1869aa38 
Dealt to 24e24cc3 
Dealt to 3ed5343b 
Dealt to e34cd626 
Dealt to Hero [8c 5c]
Dealt to 858e0cb4 
e34cd626: folds
Hero: folds
858e0cb4: folds
1869aa38: raises $0.06 to $0.11
24e24cc3: folds
3ed5343b: folds
Uncalled bet ($0.06) returned to 1869aa38
*** SHOWDOWN ***
1869aa38 collected $0.12 from pot
*** SUMMARY ***
Total pot $0.12 | Rake $0 | Jackpot $0 | Bingo $0 | Fortune $0 | Tax $0
Seat 1: 1869aa38 (button) collected ($0.12)
Seat 2: 24e24cc3 (small blind) folded before Flop
Seat 3: 3ed5343b (big blind) folded before Flop
Seat 4: e34cd626 folded before Flop (didn't bet)
Seat 5: Hero folded before Flop (didn't bet)
Seat 6: 858e0cb4 folded before Flop (didn't bet)


Poker Hand #RC2094570047: Hold'em No Limit ($0.02/$0.05) - 2023/12/27 20:50:07
Table 'RushAndCash3786577' 6-max Seat #1 is the button
Seat 1: Hero ($5.16 in chips)
Seat 2: b7dc02f3 ($5.13 in chips)
Seat 3: 5a53307e ($7.3 in chips)
Seat 4: 9cbfdb9d ($5.16 in chips)
Seat 5: 322117f9 ($4.62 in chips)
Seat 6: f28a72d ($6.02 in chips)
b7dc02f3: posts small blind $0.02
5a53307e: posts big blind $0.05
*** HOLE CARDS ***
Dealt to Hero [2s 5s]
Dealt to b7dc02f3 
Dealt to 5a53307e 
Dealt to 9cbfdb9d 
Dealt to 322117f9 
Dealt to f28a72d 
9cbfdb9d: raises $0.05 to $0.1
322117f9: folds
f28a72d: folds
Hero: folds
b7dc02f3: folds
5a53307e: calls $0.05
*** FLOP *** [7s Ac Kd]
5a53307e: checks
9cbfdb9d: bets $0.05
5a53307e: calls $0.05
*** TURN *** [7s Ac Kd] [9h]
5a53307e: checks
9cbfdb9d: bets $0.21
5a53307e: raises $0.81 to $1.02
9cbfdb9d: calls $0.81
*** RIVER *** [7s Ac Kd 9h] [8s]
5a53307e: checks
9cbfdb9d: checks
5a53307e: shows [Kc Ah] (Pair of Aces and Pair of Kings)
9cbfdb9d: shows [Js As] (Pair of Aces)
*** SHOWDOWN ***
5a53307e collected $2.18 from pot
*** SUMMARY ***
Total pot $2.36 | Rake $0.11 | Jackpot $0.07 | Bingo $0 | Fortune $0 | Tax $0
Board [7s Ac Kd 9h 8s]
Seat 1: Hero (button) folded before Flop (didn't bet)
Seat 2: b7dc02f3 (small blind) folded before Flop
Seat 3: 5a53307e (big blind) showed [Kc Ah] and won ($2.18) with Pair of Aces and Pair of Kings
Seat 4: 9cbfdb9d showed [Js As] and lost with Pair of Aces
Seat 5: 322117f9 folded before Flop (didn't bet)
Seat 6: f28a72d folded before Flop (didn't bet)


Poker Hand #RC2094569590: Hold'em No Limit ($0.02/$0.05) - 2023/12/27 20:49:44
Table 'RushAndCash3786343' 6-max Seat #1 is the button
Seat 1: 7f0a9119 ($5.14 in chips)
Seat 2: Hero ($5.11 in chips)
Seat 3: c7f87cd1 ($6.67 in chips)
Seat 4: 29b89750 ($5.07 in chips)
Seat 5: ceac0f18 ($5.96 in chips)
Seat 6: bcc21958 ($5.83 in chips)
Hero: posts small blind $0.02
c7f87cd1: posts big blind $0.05
*** HOLE CARDS ***
Dealt to 7f0a9119 
Dealt to Hero [Ac Js]
Dealt to c7f87cd1 
Dealt to 29b89750 
Dealt to ceac0f18 
Dealt to bcc21958 
29b89750: folds
ceac0f18: folds
bcc21958: folds
7f0a9119: folds
Hero: raises $0.1 to $0.15
c7f87cd1: folds
Uncalled bet ($0.1) returned to Hero
*** SHOWDOWN ***
Hero collected $0.1 from pot
*** SUMMARY ***
Total pot $0.1 | Rake $0 | Jackpot $0 | Bingo $0 | Fortune $0 | Tax $0
Seat 1: 7f0a9119 (button) folded before Flop (didn't bet)
Seat 2: Hero (small blind) collected ($0.1)
Seat 3: c7f87cd1 (big blind) folded before Flop
Seat 4: 29b89750 folded before Flop (didn't bet)
Seat 5: ceac0f18 folded before Flop (didn't bet)
Seat 6: bcc21958 folded before Flop (didn't bet)


Poker Hand #RC2094569309: Hold'em No Limit ($0.02/$0.05) - 2023/12/27 20:49:29
Table 'RushAndCash3786203' 6-max Seat #1 is the button
Seat 1: ffd6607e ($6.36 in chips)
Seat 2: 1119892c ($5.76 in chips)
Seat 3: Hero ($5.16 in chips)
Seat 4: 2d958896 ($6.15 in chips)
Seat 5: 1853e4f7 ($9.27 in chips)
Seat 6: f9dc2aeb ($12.78 in chips)
1119892c: posts small blind $0.02
Hero: posts big blind $0.05
*** HOLE CARDS ***
Dealt to ffd6607e 
Dealt to 1119892c 
Dealt to Hero [6d 4c]
Dealt to 2d958896 
Dealt to 1853e4f7 
Dealt to f9dc2aeb 
2d958896: folds
1853e4f7: folds
f9dc2aeb: raises $0.1 to $0.15
ffd6607e: folds
1119892c: calls $0.13
Hero: folds
*** FLOP *** [3h Ad 8h]
1119892c: bets $0.18
f9dc2aeb: raises $0.54 to $0.72
1119892c: folds
Uncalled bet ($0.54) returned to f9dc2aeb
*** SHOWDOWN ***
f9dc2aeb collected $0.68 from pot
*** SUMMARY ***
Total pot $0.71 | Rake $0.03 | Jackpot $0 | Bingo $0 | Fortune $0 | Tax $0
Board [3h Ad 8h]
Seat 1: ffd6607e (button) folded before Flop (didn't bet)
Seat 2: 1119892c (small blind) folded on the Flop
Seat 3: Hero (big blind) folded before Flop
Seat 4: 2d958896 folded before Flop (didn't bet)
Seat 5: 1853e4f7 folded before Flop (didn't bet)
Seat 6: f9dc2aeb won ($0.68)


Poker Hand #RC2094569245: Hold'em No Limit ($0.02/$0.05) - 2023/12/27 20:49:25
Table 'RushAndCash3786171' 6-max Seat #1 is the button
Seat 1: 9ed383ac ($6.27 in chips)
Seat 2: bfa824ef ($4.55 in chips)
Seat 3: 43c14bfa ($5.46 in chips)
Seat 4: Hero ($5.16 in chips)
Seat 5: 48dc9f88 ($5.78 in chips)
Seat 6: b4e485a2 ($5.74 in chips)
bfa824ef: posts small blind $0.02
43c14bfa: posts big blind $0.05
*** HOLE CARDS ***
Dealt to 9ed383ac 
Dealt to bfa824ef 
Dealt to 43c14bfa 
Dealt to Hero [Qh 5d]
Dealt to 48dc9f88 
Dealt to b4e485a2 
Hero: folds
48dc9f88: folds
b4e485a2: raises $0.05 to $0.1
9ed383ac: folds
bfa824ef: folds
43c14bfa: folds
Uncalled bet ($0.05) returned to b4e485a2
*** SHOWDOWN ***
b4e485a2 collected $0.12 from pot
*** SUMMARY ***
Total pot $0.12 | Rake $0 | Jackpot $0 | Bingo $0 | Fortune $0 | Tax $0
Seat 1: 9ed383ac (button) folded before Flop (didn't bet)
Seat 2: bfa824ef (small blind) folded before Flop
Seat 3: 43c14bfa (big blind) folded before Flop
Seat 4: Hero folded before Flop (didn't bet)
Seat 5: 48dc9f88 folded before Flop (didn't bet)
Seat 6: b4e485a2 collected ($0.12)


Poker Hand #RC2094569172: Hold'em No Limit ($0.02/$0.05) - 2023/12/27 20:49:21
Table 'RushAndCash3786136' 6-max Seat #1 is the button
Seat 1: 97279311 ($8.24 in chips)
Seat 2: 466c629d ($6 in chips)
Seat 3: 4873e51e ($5.39 in chips)
Seat 4: 46a86d2c ($4.99 in chips)
Seat 5: 244d3655 ($5.03 in chips)
Seat 6: Hero ($5.16 in chips)
466c629d: posts small blind $0.02
4873e51e: posts big blind $0.05
*** HOLE CARDS ***
Dealt to 97279311 
Dealt to 466c629d 
Dealt to 4873e51e 
Dealt to 46a86d2c 
Dealt to 244d3655 
Dealt to Hero [Ks 9h]
46a86d2c: folds
244d3655: folds
Hero: folds
97279311: folds
466c629d: folds
Uncalled bet ($0.03) returned to 4873e51e
*** SHOWDOWN ***
4873e51e collected $0.04 from pot
*** SUMMARY ***
Total pot $0.04 | Rake $0 | Jackpot $0 | Bingo $0 | Fortune $0 | Tax $0
Seat 1: 97279311 (button) folded before Flop (didn't bet)
Seat 2: 466c629d (small blind) folded before Flop
Seat 3: 4873e51e (big blind) collected ($0.04)
Seat 4: 46a86d2c folded before Flop (didn't bet)
Seat 5: 244d3655 folded before Flop (didn't bet)
Seat 6: Hero folded before Flop (didn't bet)


Poker Hand #RC2094569104: Hold'em No Limit ($0.02/$0.05) - 2023/12/27 20:49:18
Table 'RushAndCash3786103' 6-max Seat #1 is the button
Seat 1: 1a4c9fe5 ($6.76 in chips)
Seat 2: 9669342c ($5.49 in chips)
Seat 3: cbc529ce ($5.6 in chips)
Seat 4: 46a86d2c ($4.99 in chips)
Seat 5: Hero ($5.16 in chips)
Seat 6: a64665aa ($10.67 in chips)
9669342c: posts small blind $0.02
cbc529ce: posts big blind $0.05
*** HOLE CARDS ***
Dealt to 1a4c9fe5 
Dealt to 9669342c 
Dealt to cbc529ce 
Dealt to 46a86d2c 
Dealt to Hero [5h 7d]
Dealt to a64665aa 
46a86d2c: folds
Hero: folds
a64665aa: folds
1a4c9fe5: folds
9669342c: raises $0.08 to $0.13
cbc529ce: raises $0.32 to $0.45
9669342c: folds
Uncalled bet ($0.32) returned to cbc529ce
*** SHOWDOWN ***
cbc529ce collected $0.25 from pot
*** SUMMARY ***
Total pot $0.26 | Rake $0.01 | Jackpot $0 | Bingo $0 | Fortune $0 | Tax $0
Seat 1: 1a4c9fe5 (button) folded before Flop (didn't bet)
Seat 2: 9669342c (small blind) folded before Flop
Seat 3: cbc529ce (big blind) collected ($0.25)
Seat 4: 46a86d2c folded before Flop (didn't bet)
Seat 5: Hero folded before Flop (didn't bet)
Seat 6: a64665aa folded before Flop (didn't bet)


Poker Hand #RC2094569030: Hold'em No Limit ($0.02/$0.05) - 2023/12/27 20:49:14
Table 'RushAndCash3786067' 6-max Seat #1 is the button
Seat 1: 3df02c76 ($9.95 in chips)
Seat 2: fe92596e ($7.63 in chips)
Seat 3: cbc9fff5 ($8.01 in chips)
Seat 4: a0724968 ($5.08 in chips)
Seat 5: Hero ($5.16 in chips)
Seat 6: 46a86d2c ($4.99 in chips)
fe92596e: posts small blind $0.02
cbc9fff5: posts big blind $0.05
*** HOLE CARDS ***
Dealt to 3df02c76 
Dealt to fe92596e 
Dealt to cbc9fff5 
Dealt to a0724968 
Dealt to Hero [As 7c]
Dealt to 46a86d2c 
a0724968: folds
Hero: folds
46a86d2c: folds
3df02c76: raises $0.05 to $0.1
fe92596e: folds
cbc9fff5: calls $0.05
*** FLOP *** [Ac 5d 7h]
cbc9fff5: checks
3df02c76: bets $0.08
cbc9fff5: folds
Uncalled bet ($0.08) returned to 3df02c76
*** SHOWDOWN ***
3df02c76 collected $0.21 from pot
*** SUMMARY ***
Total pot $0.22 | Rake $0.01 | Jackpot $0 | Bingo $0 | Fortune $0 | Tax $0
Board [Ac 5d 7h]
Seat 1: 3df02c76 (button) won ($0.21)
Seat 2: fe92596e (small blind) folded before Flop
Seat 3: cbc9fff5 (big blind) folded on the Flop
Seat 4: a0724968 folded before Flop (didn't bet)
Seat 5: Hero folded before Flop (didn't bet)
Seat 6: 46a86d2c folded before Flop (didn't bet)


Poker Hand #RC2094568940: Hold'em No Limit ($0.02/$0.05) - 2023/12/27 20:49:10
Table 'RushAndCash3786021' 6-max Seat #1 is the button
Seat 1: Hero ($5.16 in chips)
Seat 2: 6056afb9 ($7.82 in chips)
Seat 3: be200c6 ($6.78 in chips)
Seat 4: 57c77a71 ($4.95 in chips)
Seat 5: 210220d0 ($5.46 in chips)
Seat 6: dc67b46e ($2.22 in chips)
6056afb9: posts small blind $0.02
be200c6: posts big blind $0.05
*** HOLE CARDS ***
Dealt to Hero [2c 7d]
Dealt to 6056afb9 
Dealt to be200c6 
Dealt to 57c77a71 
Dealt to 210220d0 
Dealt to dc67b46e 
57c77a71: raises $0.1 to $0.15
210220d0: folds
dc67b46e: folds
Hero: folds
6056afb9: calls $0.13
be200c6: folds
*** FLOP *** [Jh 6d 6c]
6056afb9: checks
57c77a71: checks
*** TURN *** [Jh 6d 6c] [9s]
6056afb9: bets $0.18
57c77a71: folds
Uncalled bet ($0.18) returned to 6056afb9
*** SHOWDOWN ***
6056afb9 collected $0.34 from pot
*** SUMMARY ***
Total pot $0.35 | Rake $0.01 | Jackpot $0 | Bingo $0 | Fortune $0 | Tax $0
Board [Jh 6d 6c 9s]
Seat 1: Hero (button) folded before Flop (didn't bet)
Seat 2: 6056afb9 (small blind) won ($0.34)
Seat 3: be200c6 (big blind) folded before Flop
Seat 4: 57c77a71 folded on the Turn
Seat 5: 210220d0 folded before Flop (didn't bet)
Seat 6: dc67b46e folded before Flop (didn't bet)


Poker Hand #RC2094568767: Hold'em No Limit ($0.02/$0.05) - 2023/12/27 20:49:01
Table 'RushAndCash3785935' 6-max Seat #1 is the button
Seat 1: d34f29de ($7.43 in chips)
Seat 2: 1184109 ($4.76 in chips)
Seat 3: Hero ($5.21 in chips)
Seat 4: 7016f4d3 ($5.16 in chips)
Seat 5: eb7aacac ($0.87 in chips)
Seat 6: e6a5ebc1 ($16.2 in chips)
1184109: posts small blind $0.02
Hero: posts big blind $0.05
*** HOLE CARDS ***
Dealt to d34f29de 
Dealt to 1184109 
Dealt to Hero [8c 6d]
Dealt to 7016f4d3 
Dealt to eb7aacac 
Dealt to e6a5ebc1 
7016f4d3: folds
eb7aacac: folds
e6a5ebc1: folds
d34f29de: folds
1184109: raises $0.08 to $0.13
Hero: folds
Uncalled bet ($0.08) returned to 1184109
*** SHOWDOWN ***
1184109 collected $0.1 from pot
*** SUMMARY ***
Total pot $0.1 | Rake $0 | Jackpot $0 | Bingo $0 | Fortune $0 | Tax $0
Seat 1: d34f29de (button) folded before Flop (didn't bet)
Seat 2: 1184109 (small blind) collected ($0.1)
Seat 3: Hero (big blind) folded before Flop
Seat 4: 7016f4d3 folded before Flop (didn't bet)
Seat 5: eb7aacac folded before Flop (didn't bet)
Seat 6: e6a5ebc1 folded before Flop (didn't bet)


Poker Hand #RC2094568208: Hold'em No Limit ($0.02/$0.05) - 2023/12/27 20:48:32
Table 'RushAndCash3785660' 6-max Seat #1 is the button
Seat 1: d96cb66b ($4.93 in chips)
Seat 2: Hero ($5.07 in chips)
Seat 3: 1184109 ($4.91 in chips)
Seat 4: d4fb33bd ($7.59 in chips)
Seat 5: 3680c535 ($3.56 in chips)
Seat 6: 25b550f ($5.07 in chips)
Hero: posts small blind $0.02
1184109: posts big blind $0.05
*** HOLE CARDS ***
Dealt to d96cb66b 
Dealt to Hero [Js Td]
Dealt to 1184109 
Dealt to d4fb33bd 
Dealt to 3680c535 
Dealt to 25b550f 
d4fb33bd: folds
3680c535: folds
25b550f: folds
d96cb66b: folds
Hero: raises $0.1 to $0.15
1184109: calls $0.1
*** FLOP *** [7c 4c 4d]
Hero: checks
1184109: checks
*** TURN *** [7c 4c 4d] [4s]
Hero: checks
1184109: checks
*** RIVER *** [7c 4c 4d 4s] [Th]
Hero: checks
1184109: checks
Hero: shows [Js Td] (Fours Full over Tens)
1184109: shows [9s As] (Three Fours)
*** SHOWDOWN ***
Hero collected $0.29 from pot
*** SUMMARY ***
Total pot $0.3 | Rake $0.01 | Jackpot $0 | Bingo $0 | Fortune $0 | Tax $0
Board [7c 4c 4d 4s Th]
Seat 1: d96cb66b (button) folded before Flop (didn't bet)
Seat 2: Hero (small blind) showed [Js Td] and won ($0.29) with Fours Full over Tens
Seat 3: 1184109 (big blind) showed [9s As] and lost with Three Fours
Seat 4: d4fb33bd folded before Flop (didn't bet)
Seat 5: 3680c535 folded before Flop (didn't bet)
Seat 6: 25b550f folded before Flop (didn't bet)


Poker Hand #RC2094568143: Hold'em No Limit ($0.02/$0.05) - 2023/12/27 20:48:28
Table 'RushAndCash3785627' 6-max Seat #1 is the button
Seat 1: 99904b5f ($4.47 in chips)
Seat 2: 129d5d42 ($5 in chips)
Seat 3: cda25e6a ($5.83 in chips)
Seat 4: 1184109 ($4.91 in chips)
Seat 5: 3b9dc5ff ($6.01 in chips)
Seat 6: Hero ($5.07 in chips)
129d5d42: posts small blind $0.02
cda25e6a: posts big blind $0.05
*** HOLE CARDS ***
Dealt to 99904b5f 
Dealt to 129d5d42 
Dealt to cda25e6a 
Dealt to 1184109 
Dealt to 3b9dc5ff 
Dealt to Hero [8c Kh]
1184109: folds
3b9dc5ff: folds
Hero: folds
99904b5f: raises $0.07 to $0.12
129d5d42: folds
cda25e6a: calls $0.07
*** FLOP *** [Kc 3h Jd]
cda25e6a: checks
99904b5f: bets $0.13
cda25e6a: calls $0.13
*** TURN *** [Kc 3h Jd] [Ac]
cda25e6a: checks
99904b5f: bets $0.36
cda25e6a: raises $0.94 to $1.3
99904b5f: calls $0.94
*** RIVER *** [Kc 3h Jd Ac] [9h]
cda25e6a: bets $4.28 and is all-in
99904b5f: calls $2.92 and is all-in
Uncalled bet ($1.36) returned to cda25e6a
cda25e6a: shows [Ts Qs] (Aces-High Straight)
99904b5f: shows [Ad Ah] (Three Aces)
*** SHOWDOWN ***
cda25e6a collected $8.74 from pot
*** SUMMARY ***
Total pot $8.96 | Rake $0.15 | Jackpot $0.07 | Bingo $0 | Fortune $0 | Tax $0
Board [Kc 3h Jd Ac 9h]
Seat 1: 99904b5f (button) showed [Ad Ah] and lost with Three Aces
Seat 2: 129d5d42 (small blind) folded before Flop
Seat 3: cda25e6a (big blind) showed [Ts Qs] and won ($8.74) with Aces-High Straight
Seat 4: 1184109 folded before Flop (didn't bet)
Seat 5: 3b9dc5ff folded before Flop (didn't bet)
Seat 6: Hero folded before Flop (didn't bet)


Poker Hand #RC2094568074: Hold'em No Limit ($0.02/$0.05) - 2023/12/27 20:48:25
Table 'RushAndCash3785592' 6-max Seat #1 is the button
Seat 1: 802b86d ($5.64 in chips)
Seat 2: 3b9a22be ($17.36 in chips)
Seat 3: bcc21958 ($5.74 in chips)
Seat 4: Hero ($5.07 in chips)
Seat 5: 510af08c ($5 in chips)
Seat 6: 50421fa7 ($7.94 in chips)
3b9a22be: posts small blind $0.02
bcc21958: posts big blind $0.05
*** HOLE CARDS ***
Dealt to 802b86d 
Dealt to 3b9a22be 
Dealt to bcc21958 
Dealt to Hero [3d Qc]
Dealt to 510af08c 
Dealt to 50421fa7 
Hero: folds
510af08c: folds
50421fa7: raises $0.06 to $0.11
802b86d: folds
3b9a22be: folds
bcc21958: folds
Uncalled bet ($0.06) returned to 50421fa7
*** SHOWDOWN ***
50421fa7 collected $0.12 from pot
*** SUMMARY ***
Total pot $0.12 | Rake $0 | Jackpot $0 | Bingo $0 | Fortune $0 | Tax $0
Seat 1: 802b86d (button) folded before Flop (didn't bet)
Seat 2: 3b9a22be (small blind) folded before Flop
Seat 3: bcc21958 (big blind) folded before Flop
Seat 4: Hero folded before Flop (didn't bet)
Seat 5: 510af08c folded before Flop (didn't bet)
Seat 6: 50421fa7 collected ($0.12)


Poker Hand #RC2094568007: Hold'em No Limit ($0.02/$0.05) - 2023/12/27 20:48:21
Table 'RushAndCash3785561' 6-max Seat #1 is the button
Seat 1: 8ab1dee2 ($1.63 in chips)
Seat 2: 87acde28 ($9.59 in chips)
Seat 3: 7f61e43e ($4.04 in chips)
Seat 4: 510af08c ($5 in chips)
Seat 5: Hero ($5.07 in chips)
Seat 6: 9870903 ($5.75 in chips)
87acde28: posts small blind $0.02
7f61e43e: posts big blind $0.05
*** HOLE CARDS ***
Dealt to 8ab1dee2 
Dealt to 87acde28 
Dealt to 7f61e43e 
Dealt to 510af08c 
Dealt to Hero [8s Qd]
Dealt to 9870903 
510af08c: folds
Hero: folds
9870903: folds
8ab1dee2: raises $0.1 to $0.15
87acde28: calls $0.13
7f61e43e: folds
*** FLOP *** [Ah 2s 2c]
87acde28: checks
8ab1dee2: bets $0.18
87acde28: folds
Uncalled bet ($0.18) returned to 8ab1dee2
*** SHOWDOWN ***
8ab1dee2 collected $0.34 from pot
*** SUMMARY ***
Total pot $0.35 | Rake $0.01 | Jackpot $0 | Bingo $0 | Fortune $0 | Tax $0
Board [Ah 2s 2c]
Seat 1: 8ab1dee2 (button) won ($0.34)
Seat 2: 87acde28 (small blind) folded on the Flop
Seat 3: 7f61e43e (big blind) folded before Flop
Seat 4: 510af08c folded before Flop (didn't bet)
Seat 5: Hero folded before Flop (didn't bet)
Seat 6: 9870903 folded before Flop (didn't bet)


Poker Hand #RC2094567941: Hold'em No Limit ($0.02/$0.05) - 2023/12/27 20:48:18
Table 'RushAndCash3785528' 6-max Seat #1 is the button
Seat 1: Hero ($5.07 in chips)
Seat 2: 8bfed688 ($44.14 in chips)
Seat 3: dd426674 ($4.3 in chips)
Seat 4: eab8c69b ($3.73 in chips)
Seat 5: 314d6258 ($10.46 in chips)
Seat 6: 2e75303d ($6.89 in chips)
8bfed688: posts small blind $0.02
dd426674: posts big blind $0.05
*** HOLE CARDS ***
Dealt to Hero [5d 3h]
Dealt to 8bfed688 
Dealt to dd426674 
Dealt to eab8c69b 
Dealt to 314d6258 
Dealt to 2e75303d 
eab8c69b: folds
314d6258: folds
2e75303d: raises $0.07 to $0.12
Hero: folds
8bfed688: calls $0.1
dd426674: folds
*** FLOP *** [8h Qs 7d]
8bfed688: checks
2e75303d: bets $0.1
8bfed688: calls $0.1
*** TURN *** [8h Qs 7d] [6h]
8bfed688: bets $0.26
2e75303d: folds
Uncalled bet ($0.26) returned to 8bfed688
*** SHOWDOWN ***
8bfed688 collected $0.47 from pot
*** SUMMARY ***
Total pot $0.49 | Rake $0.02 | Jackpot $0 | Bingo $0 | Fortune $0 | Tax $0
Board [8h Qs 7d 6h]
Seat 1: Hero (button) folded before Flop (didn't bet)
Seat 2: 8bfed688 (small blind) won ($0.47)
Seat 3: dd426674 (big blind) folded before Flop
Seat 4: eab8c69b folded before Flop (didn't bet)
Seat 5: 314d6258 folded before Flop (didn't bet)
Seat 6: 2e75303d folded on the Turn


Poker Hand #RC2094567730: Hold'em No Limit ($0.02/$0.05) - 2023/12/27 20:48:08
Table 'RushAndCash3785424' 6-max Seat #1 is the button
Seat 1: 25b550f ($5.07 in chips)
Seat 2: 80c84bc5 ($5.75 in chips)
Seat 3: Hero ($5.05 in chips)
Seat 4: 8484bf09 ($5.06 in chips)
Seat 5: cfa33b6a ($6.91 in chips)
Seat 6: 7d4336a2 ($6.25 in chips)
80c84bc5: posts small blind $0.02
Hero: posts big blind $0.05
*** HOLE CARDS ***
Dealt to 25b550f 
Dealt to 80c84bc5 
Dealt to Hero [7d 9d]
Dealt to 8484bf09 
Dealt to cfa33b6a 
Dealt to 7d4336a2 
8484bf09: folds
cfa33b6a: folds
7d4336a2: folds
25b550f: folds
80c84bc5: folds
Uncalled bet ($0.03) returned to Hero
*** SHOWDOWN ***
Hero collected $0.04 from pot
*** SUMMARY ***
Total pot $0.04 | Rake $0 | Jackpot $0 | Bingo $0 | Fortune $0 | Tax $0
Seat 1: 25b550f (button) folded before Flop (didn't bet)
Seat 2: 80c84bc5 (small blind) folded before Flop
Seat 3: Hero (big blind) collected ($0.04)
Seat 4: 8484bf09 folded before Flop (didn't bet)
Seat 5: cfa33b6a folded before Flop (didn't bet)
Seat 6: 7d4336a2 folded before Flop (didn't bet)


Poker Hand #RC2094567650: Hold'em No Limit ($0.02/$0.05) - 2023/12/27 20:48:04
Table 'RushAndCash3785385' 6-max Seat #1 is the button
Seat 1: 574cd80 ($5.96 in chips)
Seat 2: Hero ($5.07 in chips)
Seat 3: 3fb2f460 ($9.18 in chips)
Seat 4: 8667e5eb ($5.55 in chips)
Seat 5: bb25585d ($8.27 in chips)
Seat 6: 1184109 ($4.98 in chips)
Hero: posts small blind $0.02
3fb2f460: posts big blind $0.05
*** HOLE CARDS ***
Dealt to 574cd80 
Dealt to Hero [8s Kd]
Dealt to 3fb2f460 
Dealt to 8667e5eb 
Dealt to bb25585d 
Dealt to 1184109 
8667e5eb: folds
bb25585d: folds
1184109: folds
574cd80: folds
Hero: folds
Uncalled bet ($0.03) returned to 3fb2f460
*** SHOWDOWN ***
3fb2f460 collected $0.04 from pot
*** SUMMARY ***
Total pot $0.04 | Rake $0 | Jackpot $0 | Bingo $0 | Fortune $0 | Tax $0
Seat 1: 574cd80 (button) folded before Flop (didn't bet)
Seat 2: Hero (small blind) folded before Flop
Seat 3: 3fb2f460 (big blind) collected ($0.04)
Seat 4: 8667e5eb folded before Flop (didn't bet)
Seat 5: bb25585d folded before Flop (didn't bet)
Seat 6: 1184109 folded before Flop (didn't bet)


Poker Hand #RC2094567580: Hold'em No Limit ($0.02/$0.05) - 2023/12/27 20:48:00
Table 'RushAndCash3785349' 6-max Seat #1 is the button
Seat 1: c095b8c8 ($5 in chips)
Seat 2: 5b68a27 ($12.11 in chips)
Seat 3: c7169508 ($5.25 in chips)
Seat 4: bb25585d ($8.27 in chips)
Seat 5: Hero ($5.07 in chips)
Seat 6: 1184109 ($4.98 in chips)
5b68a27: posts small blind $0.02
c7169508: posts big blind $0.05
*** HOLE CARDS ***
Dealt to c095b8c8 
Dealt to 5b68a27 
Dealt to c7169508 
Dealt to bb25585d 
Dealt to Hero [5s 3h]
Dealt to 1184109 
bb25585d: folds
Hero: folds
1184109: folds
c095b8c8: folds
5b68a27: folds
Uncalled bet ($0.03) returned to c7169508
*** SHOWDOWN ***
c7169508 collected $0.04 from pot
*** SUMMARY ***
Total pot $0.04 | Rake $0 | Jackpot $0 | Bingo $0 | Fortune $0 | Tax $0
Seat 1: c095b8c8 (button) folded before Flop (didn't bet)
Seat 2: 5b68a27 (small blind) folded before Flop
Seat 3: c7169508 (big blind) collected ($0.04)
Seat 4: bb25585d folded before Flop (didn't bet)
Seat 5: Hero folded before Flop (didn't bet)
Seat 6: 1184109 folded before Flop (didn't bet)


Poker Hand #RC2094567503: Hold'em No Limit ($0.02/$0.05) - 2023/12/27 20:47:56
Table 'RushAndCash3785311' 6-max Seat #1 is the button
Seat 1: fff0502d ($7.91 in chips)
Seat 2: e6a3a3d7 ($4.03 in chips)
Seat 3: c1b5ed1d ($5 in chips)
Seat 4: 17519f2f ($6.22 in chips)
Seat 5: 420321cd ($5.12 in chips)
Seat 6: Hero ($5.07 in chips)
e6a3a3d7: posts small blind $0.02
c1b5ed1d: posts big blind $0.05
*** HOLE CARDS ***
Dealt to fff0502d 
Dealt to e6a3a3d7 
Dealt to c1b5ed1d 
Dealt to 17519f2f 
Dealt to 420321cd 
Dealt to Hero [2h 9h]
17519f2f: raises $0.05 to $0.1
420321cd: folds
Hero: folds
fff0502d: raises $0.21 to $0.31
e6a3a3d7: folds
c1b5ed1d: folds
17519f2f: calls $0.21
*** FLOP *** [Ks Th Ts]
17519f2f: checks
fff0502d: checks
*** TURN *** [Ks Th Ts] [3s]
17519f2f: checks
fff0502d: checks
*** RIVER *** [Ks Th Ts 3s] [2s]
17519f2f: bets $0.69
fff0502d: folds
Uncalled bet ($0.69) returned to 17519f2f
*** SHOWDOWN ***
17519f2f collected $0.66 from pot
*** SUMMARY ***
Total pot $0.69 | Rake $0.03 | Jackpot $0 | Bingo $0 | Fortune $0 | Tax $0
Board [Ks Th Ts 3s 2s]
Seat 1: fff0502d (button) folded on the River
Seat 2: e6a3a3d7 (small blind) folded before Flop
Seat 3: c1b5ed1d (big blind) folded before Flop
Seat 4: 17519f2f won ($0.66)
Seat 5: 420321cd folded before Flop (didn't bet)
Seat 6: Hero folded before Flop (didn't bet)


Poker Hand #RC2094567437: Hold'em No Limit ($0.02/$0.05) - 2023/12/27 20:47:53
Table 'RushAndCash3785276' 6-max Seat #1 is the button
Seat 1: 6056afb9 ($5.9 in chips)
Seat 2: 1d87709e ($5 in chips)
Seat 3: 3528bf25 ($10.67 in chips)
Seat 4: Hero ($5.07 in chips)
Seat 5: 3d9d1147 ($8.36 in chips)
Seat 6: fc10e886 ($7.15 in chips)
1d87709e: posts small blind $0.02
3528bf25: posts big blind $0.05
*** HOLE CARDS ***
Dealt to 6056afb9 
Dealt to 1d87709e 
Dealt to 3528bf25 
Dealt to Hero [Js 4c]
Dealt to 3d9d1147 
Dealt to fc10e886 
Hero: folds
3d9d1147: raises $0.06 to $0.11
fc10e886: folds
6056afb9: raises $0.29 to $0.4
1d87709e: folds
3528bf25: folds
3d9d1147: raises $0.6 to $1
6056afb9: calls $0.6
*** FLOP *** [Jc 5c 3d]
3d9d1147: bets $1
6056afb9: calls $1
*** TURN *** [Jc 5c 3d] [Jh]
3d9d1147: checks
6056afb9: bets $0.64
3d9d1147: folds
Uncalled bet ($0.64) returned to 6056afb9
*** SHOWDOWN ***
6056afb9 collected $3.85 from pot
*** SUMMARY ***
Total pot $4.07 | Rake $0.15 | Jackpot $0.07 | Bingo $0 | Fortune $0 | Tax $0
Board [Jc 5c 3d Jh]
Seat 1: 6056afb9 (button) won ($3.85)
Seat 2: 1d87709e (small blind) folded before Flop
Seat 3: 3528bf25 (big blind) folded before Flop
Seat 4: Hero folded before Flop (didn't bet)
Seat 5: 3d9d1147 folded on the Turn
Seat 6: fc10e886 folded before Flop (didn't bet)


Poker Hand #RC2094567378: Hold'em No Limit ($0.02/$0.05) - 2023/12/27 20:47:49
Table 'RushAndCash3785246' 6-max Seat #1 is the button
Seat 1: c5f04825 ($6.03 in chips)
Seat 2: 420321cd ($5.14 in chips)
Seat 3: Hero ($5.12 in chips)
Seat 4: 5f2626e3 ($7.2 in chips)
Seat 5: 532e6a06 ($5.26 in chips)
Seat 6: 589cc4e2 ($5.99 in chips)
420321cd: posts small blind $0.02
Hero: posts big blind $0.05
*** HOLE CARDS ***
Dealt to c5f04825 
Dealt to 420321cd 
Dealt to Hero [Kd 3c]
Dealt to 5f2626e3 
Dealt to 532e6a06 
Dealt to 589cc4e2 
5f2626e3: folds
532e6a06: folds
589cc4e2: folds
c5f04825: raises $0.07 to $0.12
420321cd: folds
Hero: folds
Uncalled bet ($0.07) returned to c5f04825
*** SHOWDOWN ***
c5f04825 collected $0.12 from pot
*** SUMMARY ***
Total pot $0.12 | Rake $0 | Jackpot $0 | Bingo $0 | Fortune $0 | Tax $0
Seat 1: c5f04825 (button) collected ($0.12)
Seat 2: 420321cd (small blind) folded before Flop
Seat 3: Hero (big blind) folded before Flop
Seat 4: 5f2626e3 folded before Flop (didn't bet)
Seat 5: 532e6a06 folded before Flop (didn't bet)
Seat 6: 589cc4e2 folded before Flop (didn't bet)


Poker Hand #RC2094567304: Hold'em No Limit ($0.02/$0.05) - 2023/12/27 20:47:46
Table 'RushAndCash3785208' 6-max Seat #1 is the button
Seat 1: Hero ($5.12 in chips)
Seat 2: 3b56d3ac ($15.41 in chips)
Seat 3: 7f0a9119 ($5 in chips)
Seat 4: ed3da34d ($9.48 in chips)
Seat 5: 2c93ed10 ($4.9 in chips)
Seat 6: 456ee5d4 ($5 in chips)
3b56d3ac: posts small blind $0.02
7f0a9119: posts big blind $0.05
*** HOLE CARDS ***
Dealt to Hero [Td 8h]
Dealt to 3b56d3ac 
Dealt to 7f0a9119 
Dealt to ed3da34d 
Dealt to 2c93ed10 
Dealt to 456ee5d4 
ed3da34d: raises $0.06 to $0.11
2c93ed10: folds
456ee5d4: folds
Hero: folds
3b56d3ac: folds
7f0a9119: folds
Uncalled bet ($0.06) returned to ed3da34d
*** SHOWDOWN ***
ed3da34d collected $0.12 from pot
*** SUMMARY ***
Total pot $0.12 | Rake $0 | Jackpot $0 | Bingo $0 | Fortune $0 | Tax $0
Seat 1: Hero (button) folded before Flop (didn't bet)
Seat 2: 3b56d3ac (small blind) folded before Flop
Seat 3: 7f0a9119 (big blind) folded before Flop
Seat 4: ed3da34d collected ($0.12)
Seat 5: 2c93ed10 folded before Flop (didn't bet)
Seat 6: 456ee5d4 folded before Flop (didn't bet)


Poker Hand #RC2094567030: Hold'em No Limit ($0.02/$0.05) - 2023/12/27 20:47:31
Table 'RushAndCash3785066' 6-max Seat #1 is the button
Seat 1: a17264f8 ($5 in chips)
Seat 2: Hero ($5.07 in chips)
Seat 3: e10a687f ($5.06 in chips)
Seat 4: aa4556e2 ($5 in chips)
Seat 5: fa57e767 ($4.92 in chips)
Seat 6: b59abcaa ($8.7 in chips)
Hero: posts small blind $0.02
e10a687f: posts big blind $0.05
*** HOLE CARDS ***
Dealt to a17264f8 
Dealt to Hero [2h 9h]
Dealt to e10a687f 
Dealt to aa4556e2 
Dealt to fa57e767 
Dealt to b59abcaa 
aa4556e2: folds
fa57e767: folds
b59abcaa: folds
a17264f8: folds
Hero: raises $0.1 to $0.15
e10a687f: folds
Uncalled bet ($0.1) returned to Hero
*** SHOWDOWN ***
Hero collected $0.1 from pot
*** SUMMARY ***
Total pot $0.1 | Rake $0 | Jackpot $0 | Bingo $0 | Fortune $0 | Tax $0
Seat 1: a17264f8 (button) folded before Flop (didn't bet)
Seat 2: Hero (small blind) collected ($0.1)
Seat 3: e10a687f (big blind) folded before Flop
Seat 4: aa4556e2 folded before Flop (didn't bet)
Seat 5: fa57e767 folded before Flop (didn't bet)
Seat 6: b59abcaa folded before Flop (didn't bet)


Poker Hand #RC2094566622: Hold'em No Limit ($0.02/$0.05) - 2023/12/27 20:47:10
Table 'RushAndCash3784869' 6-max Seat #1 is the button
Seat 1: 3528bf25 ($10.62 in chips)
Seat 2: 4f7c05d4 ($8.91 in chips)
Seat 3: d2511a5c ($5.05 in chips)
Seat 4: d4705721 ($14.84 in chips)
Seat 5: Hero ($5 in chips)
Seat 6: c5f04825 ($6.18 in chips)
4f7c05d4: posts small blind $0.02
d2511a5c: posts big blind $0.05
*** HOLE CARDS ***
Dealt to 3528bf25 
Dealt to 4f7c05d4 
Dealt to d2511a5c 
Dealt to d4705721 
Dealt to Hero [4c Ac]
Dealt to c5f04825 
d4705721: folds
Hero: raises $0.05 to $0.1
c5f04825: folds
3528bf25: folds
4f7c05d4: folds
d2511a5c: folds
Uncalled bet ($0.05) returned to Hero
*** SHOWDOWN ***
Hero collected $0.12 from pot
*** SUMMARY ***
Total pot $0.12 | Rake $0 | Jackpot $0 | Bingo $0 | Fortune $0 | Tax $0
Seat 1: 3528bf25 (button) folded before Flop (didn't bet)
Seat 2: 4f7c05d4 (small blind) folded before Flop
Seat 3: d2511a5c (big blind) folded before Flop
Seat 4: d4705721 folded before Flop (didn't bet)
Seat 5: Hero collected ($0.12)
Seat 6: c5f04825 folded before Flop (didn't bet)


Poker Hand #RC2094566493: Hold'em No Limit ($0.02/$0.05) - 2023/12/27 20:47:04
Table 'RushAndCash3784805' 6-max Seat #1 is the button
Seat 1: 28211675 ($6.03 in chips)
Seat 2: fff0502d ($7.02 in chips)
Seat 3: 761f719f ($5.39 in chips)
Seat 4: a1f8e1e4 ($9.1 in chips)
Seat 5: e281a5f3 ($5.66 in chips)
Seat 6: Hero ($5 in chips)
fff0502d: posts small blind $0.02
761f719f: posts big blind $0.05
*** HOLE CARDS ***
Dealt to 28211675 
Dealt to fff0502d 
Dealt to 761f719f 
Dealt to a1f8e1e4 
Dealt to e281a5f3 
Dealt to Hero [5h 6h]
a1f8e1e4: raises $0.08 to $0.13
e281a5f3: folds
Hero: folds
28211675: folds
fff0502d: folds
761f719f: calls $0.08
*** FLOP *** [4h Jd 7s]
761f719f: checks
a1f8e1e4: bets $0.09
761f719f: raises $0.35 to $0.44
a1f8e1e4: folds
Uncalled bet ($0.35) returned to 761f719f
*** SHOWDOWN ***
761f719f collected $0.44 from pot
*** SUMMARY ***
Total pot $0.46 | Rake $0.02 | Jackpot $0 | Bingo $0 | Fortune $0 | Tax $0
Board [4h Jd 7s]
Seat 1: 28211675 (button) folded before Flop (didn't bet)
Seat 2: fff0502d (small blind) folded before Flop
Seat 3: 761f719f (big blind) won ($0.44)
Seat 4: a1f8e1e4 folded on the Flop
Seat 5: e281a5f3 folded before Flop (didn't bet)
Seat 6: Hero folded before Flop (didn't bet)


Poker Hand #RC2094566406: Hold'em No Limit ($0.02/$0.05) - 2023/12/27 20:46:59
Table 'RushAndCash3784763' 6-max Seat #1 is the button
Seat 1: 3f587bf6 ($5.08 in chips)
Seat 2: c1b5ed1d ($5 in chips)
Seat 3: 8667e5eb ($5.81 in chips)
Seat 4: 4c9af569 ($5.54 in chips)
Seat 5: Hero ($5 in chips)
Seat 6: e72137e2 ($20.69 in chips)
c1b5ed1d: posts small blind $0.02
8667e5eb: posts big blind $0.05
*** HOLE CARDS ***
Dealt to 3f587bf6 
Dealt to c1b5ed1d 
Dealt to 8667e5eb 
Dealt to 4c9af569 
Dealt to Hero [2c 8s]
Dealt to e72137e2 
4c9af569: folds
Hero: folds
e72137e2: raises $0.07 to $0.12
3f587bf6: folds
c1b5ed1d: folds
8667e5eb: folds
Uncalled bet ($0.07) returned to e72137e2
*** SHOWDOWN ***
e72137e2 collected $0.12 from pot
*** SUMMARY ***
Total pot $0.12 | Rake $0 | Jackpot $0 | Bingo $0 | Fortune $0 | Tax $0
Seat 1: 3f587bf6 (button) folded before Flop (didn't bet)
Seat 2: c1b5ed1d (small blind) folded before Flop
Seat 3: 8667e5eb (big blind) folded before Flop
Seat 4: 4c9af569 folded before Flop (didn't bet)
Seat 5: Hero folded before Flop (didn't bet)
Seat 6: e72137e2 collected ($0.12)


Poker Hand #RC2094566070: Hold'em No Limit ($0.02/$0.05) - 2023/12/27 20:46:41
Table 'RushAndCash3784608' 6-max Seat #1 is the button
Seat 1: 5ed4d2e1 ($5.14 in chips)
Seat 2: e8fe78c2 ($2.28 in chips)
Seat 3: Hero ($5 in chips)
Seat 4: 22b66a8b ($5.49 in chips)
Seat 5: 57a55ea2 ($4.52 in chips)
Seat 6: 59c6c4f ($7.11 in chips)
e8fe78c2: posts small blind $0.02
Hero: posts big blind $0.05
*** HOLE CARDS ***
Dealt to 5ed4d2e1 
Dealt to e8fe78c2 
Dealt to Hero [Kc 3c]
Dealt to 22b66a8b 
Dealt to 57a55ea2 
Dealt to 59c6c4f 
22b66a8b: folds
57a55ea2: folds
59c6c4f: folds
5ed4d2e1: raises $0.08 to $0.13
e8fe78c2: calls $0.11
Hero: calls $0.08
*** FLOP *** [2s Jc 4d]
e8fe78c2: checks
Hero: checks
5ed4d2e1: bets $0.13
e8fe78c2: calls $0.13
Hero: folds
*** TURN *** [2s Jc 4d] [Qs]
e8fe78c2: checks
5ed4d2e1: bets $0.33
e8fe78c2: folds
Uncalled bet ($0.33) returned to 5ed4d2e1
*** SHOWDOWN ***
5ed4d2e1 collected $0.62 from pot
*** SUMMARY ***
Total pot $0.65 | Rake $0.03 | Jackpot $0 | Bingo $0 | Fortune $0 | Tax $0
Board [2s Jc 4d Qs]
Seat 1: 5ed4d2e1 (button) won ($0.62)
Seat 2: e8fe78c2 (small blind) folded on the Turn
Seat 3: Hero (big blind) folded on the Flop
Seat 4: 22b66a8b folded before Flop (didn't bet)
Seat 5: 57a55ea2 folded before Flop (didn't bet)
Seat 6: 59c6c4f folded before Flop (didn't bet)


Poker Hand #RC2094565623: Hold'em No Limit ($0.02/$0.05) - 2023/12/27 20:46:17
Table 'RushAndCash3784383' 6-max Seat #1 is the button
Seat 1: e0424c3 ($8.48 in chips)
Seat 2: Hero ($5 in chips)
Seat 3: 3680c535 ($3.31 in chips)
Seat 4: 62f7a9cd ($6.42 in chips)
Seat 5: 41604d8e ($5.01 in chips)
Seat 6: 869cd4a ($5.16 in chips)
Hero: posts small blind $0.02
3680c535: posts big blind $0.05
*** HOLE CARDS ***
Dealt to e0424c3 
Dealt to Hero [Js Th]
Dealt to 3680c535 
Dealt to 62f7a9cd 
Dealt to 41604d8e 
Dealt to 869cd4a 
62f7a9cd: raises $0.09 to $0.14
41604d8e: folds
869cd4a: folds
e0424c3: folds
Hero: folds
3680c535: folds
Uncalled bet ($0.09) returned to 62f7a9cd
*** SHOWDOWN ***
62f7a9cd collected $0.12 from pot
*** SUMMARY ***
Total pot $0.12 | Rake $0 | Jackpot $0 | Bingo $0 | Fortune $0 | Tax $0
Seat 1: e0424c3 (button) folded before Flop (didn't bet)
Seat 2: Hero (small blind) folded before Flop
Seat 3: 3680c535 (big blind) folded before Flop
Seat 4: 62f7a9cd collected ($0.12)
Seat 5: 41604d8e folded before Flop (didn't bet)
Seat 6: 869cd4a folded before Flop (didn't bet)


Poker Hand #RC2094565553: Hold'em No Limit ($0.02/$0.05) - 2023/12/27 20:46:14
Table 'RushAndCash3784347' 6-max Seat #1 is the button
Seat 1: Hero ($5 in chips)
Seat 2: e00a45ef ($7.49 in chips)
Seat 3: 357aea4 ($6.35 in chips)
Seat 4: 8cf9c8e1 ($5 in chips)
Seat 5: 35663588 ($3.62 in chips)
Seat 6: 916f8512 ($13.15 in chips)
e00a45ef: posts small blind $0.02
357aea4: posts big blind $0.05
*** HOLE CARDS ***
Dealt to Hero [5h Jc]
Dealt to e00a45ef 
Dealt to 357aea4 
Dealt to 8cf9c8e1 
Dealt to 35663588 
Dealt to 916f8512 
8cf9c8e1: folds
35663588: folds
916f8512: folds
Hero: folds
e00a45ef: folds
Uncalled bet ($0.03) returned to 357aea4
*** SHOWDOWN ***
357aea4 collected $0.04 from pot
*** SUMMARY ***
Total pot $0.04 | Rake $0 | Jackpot $0 | Bingo $0 | Fortune $0 | Tax $0
Seat 1: Hero (button) folded before Flop (didn't bet)
Seat 2: e00a45ef (small blind) folded before Flop
Seat 3: 357aea4 (big blind) collected ($0.04)
Seat 4: 8cf9c8e1 folded before Flop (didn't bet)
Seat 5: 35663588 folded before Flop (didn't bet)
Seat 6: 916f8512 folded before Flop (didn't bet)


Poker Hand #RC2094565493: Hold'em No Limit ($0.02/$0.05) - 2023/12/27 20:46:10
Table 'RushAndCash3784318' 6-max Seat #1 is the button
Seat 1: fd515659 ($5.79 in chips)
Seat 2: 35663588 ($3.64 in chips)
Seat 3: bcc21958 ($5.67 in chips)
Seat 4: fb9a94b2 ($8.29 in chips)
Seat 5: 1f04ac3b ($14.68 in chips)
Seat 6: Hero ($5 in chips)
35663588: posts small blind $0.02
bcc21958: posts big blind $0.05
*** HOLE CARDS ***
Dealt to fd515659 
Dealt to 35663588 
Dealt to bcc21958 
Dealt to fb9a94b2 
Dealt to 1f04ac3b 
Dealt to Hero [6s Tc]
fb9a94b2: folds
1f04ac3b: folds
Hero: folds
fd515659: folds
35663588: folds
Uncalled bet ($0.03) returned to bcc21958
*** SHOWDOWN ***
bcc21958 collected $0.04 from pot
*** SUMMARY ***
Total pot $0.04 | Rake $0 | Jackpot $0 | Bingo $0 | Fortune $0 | Tax $0
Seat 1: fd515659 (button) folded before Flop (didn't bet)
Seat 2: 35663588 (small blind) folded before Flop
Seat 3: bcc21958 (big blind) collected ($0.04)
Seat 4: fb9a94b2 folded before Flop (didn't bet)
Seat 5: 1f04ac3b folded before Flop (didn't bet)
Seat 6: Hero folded before Flop (didn't bet)


Poker Hand #RC2094565422: Hold'em No Limit ($0.02/$0.05) - 2023/12/27 20:46:06
Table 'RushAndCash3784284' 6-max Seat #1 is the button
Seat 1: 5edbcb03 ($6.16 in chips)
Seat 2: 6cc107ff ($3.15 in chips)
Seat 3: de8bf76e ($7.24 in chips)
Seat 4: d2357699 ($6.46 in chips)
Seat 5: Hero ($5 in chips)
Seat 6: fb9a94b2 ($8.29 in chips)
6cc107ff: posts small blind $0.02
de8bf76e: posts big blind $0.05
*** HOLE CARDS ***
Dealt to 5edbcb03 
Dealt to 6cc107ff 
Dealt to de8bf76e 
Dealt to d2357699 
Dealt to Hero [6c 2d]
Dealt to fb9a94b2 
d2357699: folds
Hero: folds
fb9a94b2: folds
5edbcb03: folds
6cc107ff: folds
Uncalled bet ($0.03) returned to de8bf76e
*** SHOWDOWN ***
de8bf76e collected $0.04 from pot
*** SUMMARY ***
Total pot $0.04 | Rake $0 | Jackpot $0 | Bingo $0 | Fortune $0 | Tax $0
Seat 1: 5edbcb03 (button) folded before Flop (didn't bet)
Seat 2: 6cc107ff (small blind) folded before Flop
Seat 3: de8bf76e (big blind) collected ($0.04)
Seat 4: d2357699 folded before Flop (didn't bet)
Seat 5: Hero folded before Flop (didn't bet)
Seat 6: fb9a94b2 folded before Flop (didn't bet)


Poker Hand #RC2094565296: Hold'em No Limit ($0.02/$0.05) - 2023/12/27 20:46:00
Table 'RushAndCash3784219' 6-max Seat #1 is the button
Seat 1: Hero ($5 in chips)
Seat 2: 17f1fc5b ($4.71 in chips)
Seat 3: 5a03a4c1 ($30.79 in chips)
Seat 4: dae4b43e ($13.09 in chips)
Seat 5: 5443ae1f ($4.99 in chips)
Seat 6: 1119892c ($5.82 in chips)
17f1fc5b: posts small blind $0.02
5a03a4c1: posts big blind $0.05
*** HOLE CARDS ***
Dealt to Hero [2s 5c]
Dealt to 17f1fc5b 
Dealt to 5a03a4c1 
Dealt to dae4b43e 
Dealt to 5443ae1f 
Dealt to 1119892c 
dae4b43e: folds
5443ae1f: folds
1119892c: folds
Hero: folds
17f1fc5b: raises $0.1 to $0.15
5a03a4c1: folds
Uncalled bet ($0.1) returned to 17f1fc5b
*** SHOWDOWN ***
17f1fc5b collected $0.1 from pot
*** SUMMARY ***
Total pot $0.1 | Rake $0 | Jackpot $0 | Bingo $0 | Fortune $0 | Tax $0
Seat 1: Hero (button) folded before Flop (didn't bet)
Seat 2: 17f1fc5b (small blind) collected ($0.1)
Seat 3: 5a03a4c1 (big blind) folded before Flop
Seat 4: dae4b43e folded before Flop (didn't bet)
Seat 5: 5443ae1f folded before Flop (didn't bet)
Seat 6: 1119892c folded before Flop (didn't bet)


Poker Hand #RC2094565003: Hold'em No Limit ($0.02/$0.05) - 2023/12/27 20:45:44
Table 'RushAndCash3784072' 6-max Seat #1 is the button
Seat 1: d2511a5c ($5 in chips)
Seat 2: f241e5a8 ($5.28 in chips)
Seat 3: Hero ($5.05 in chips)
Seat 4: a7dc6581 ($9.24 in chips)
Seat 5: 5d0bed9d ($14.83 in chips)
Seat 6: e00a45ef ($7.4 in chips)
f241e5a8: posts small blind $0.02
Hero: posts big blind $0.05
*** HOLE CARDS ***
Dealt to d2511a5c 
Dealt to f241e5a8 
Dealt to Hero [2h Qs]
Dealt to a7dc6581 
Dealt to 5d0bed9d 
Dealt to e00a45ef 
a7dc6581: folds
5d0bed9d: folds
e00a45ef: raises $0.06 to $0.11
d2511a5c: folds
f241e5a8: folds
Hero: folds
Uncalled bet ($0.06) returned to e00a45ef
*** SHOWDOWN ***
e00a45ef collected $0.12 from pot
*** SUMMARY ***
Total pot $0.12 | Rake $0 | Jackpot $0 | Bingo $0 | Fortune $0 | Tax $0
Seat 1: d2511a5c (button) folded before Flop (didn't bet)
Seat 2: f241e5a8 (small blind) folded before Flop
Seat 3: Hero (big blind) folded before Flop
Seat 4: a7dc6581 folded before Flop (didn't bet)
Seat 5: 5d0bed9d folded before Flop (didn't bet)
Seat 6: e00a45ef collected ($0.12)


Poker Hand #RC2094564804: Hold'em No Limit ($0.02/$0.05) - 2023/12/27 20:45:33
Table 'RushAndCash3783973' 6-max Seat #1 is the button
Seat 1: 2302028 ($5.55 in chips)
Seat 2: Hero ($5 in chips)
Seat 3: c61fe96c ($4.4 in chips)
Seat 4: 3ad362c2 ($6.76 in chips)
Seat 5: 159bec7c ($5.23 in chips)
Seat 6: 4145b204 ($6.19 in chips)
Hero: posts small blind $0.02
c61fe96c: posts big blind $0.05
*** HOLE CARDS ***
Dealt to 2302028 
Dealt to Hero [9c Kh]
Dealt to c61fe96c 
Dealt to 3ad362c2 
Dealt to 159bec7c 
Dealt to 4145b204 
3ad362c2: folds
159bec7c: folds
4145b204: folds
2302028: folds
Hero: raises $0.1 to $0.15
c61fe96c: folds
Uncalled bet ($0.1) returned to Hero
*** SHOWDOWN ***
Hero collected $0.1 from pot
*** SUMMARY ***
Total pot $0.1 | Rake $0 | Jackpot $0 | Bingo $0 | Fortune $0 | Tax $0
Seat 1: 2302028 (button) folded before Flop (didn't bet)
Seat 2: Hero (small blind) collected ($0.1)
Seat 3: c61fe96c (big blind) folded before Flop
Seat 4: 3ad362c2 folded before Flop (didn't bet)
Seat 5: 159bec7c folded before Flop (didn't bet)
Seat 6: 4145b204 folded before Flop (didn't bet)


Poker Hand #RC2094554694: Hold'em No Limit ($0.02/$0.05) - 2023/12/27 20:45:27
Table 'RushAndCash3783920' 6-max Seat #1 is the button
Seat 1: 4549855 ($6.6 in chips)
Seat 2: 51e41955 ($9.33 in chips)
Seat 3: eb5602d2 ($7.41 in chips)
Seat 4: 3f16f15b ($10.02 in chips)
Seat 5: Hero ($5 in chips)
Seat 6: b7180d42 ($12.04 in chips)
51e41955: posts small blind $0.02
eb5602d2: posts big blind $0.05
*** HOLE CARDS ***
Dealt to 4549855 
Dealt to 51e41955 
Dealt to eb5602d2 
Dealt to 3f16f15b 
Dealt to Hero [9h 8c]
Dealt to b7180d42 
3f16f15b: folds
Hero: folds
b7180d42: folds
4549855: raises $0.08 to $0.13
51e41955: folds
eb5602d2: calls $0.08
*** FLOP *** [8h 4d 6h]
eb5602d2: checks
4549855: checks
*** TURN *** [8h 4d 6h] [8s]
eb5602d2: bets $0.1
4549855: calls $0.1
*** RIVER *** [8h 4d 6h 8s] [Kc]
eb5602d2: checks
4549855: checks
eb5602d2: shows [7d Ah] (Pair of Eights)
4549855: shows [Jd Jh] (Pair of Jacks and Pair of Eights)
*** SHOWDOWN ***
4549855 collected $0.46 from pot
*** SUMMARY ***
Total pot $0.48 | Rake $0.02 | Jackpot $0 | Bingo $0 | Fortune $0 | Tax $0
Board [8h 4d 6h 8s Kc]
Seat 1: 4549855 (button) showed [Jd Jh] and won ($0.46) with Pair of Jacks and Pair of Eights
Seat 2: 51e41955 (small blind) folded before Flop
Seat 3: eb5602d2 (big blind) showed [7d Ah] and lost with Pair of Eights
Seat 4: 3f16f15b folded before Flop (didn't bet)
Seat 5: Hero folded before Flop (didn't bet)
Seat 6: b7180d42 folded before Flop (didn't bet)


Poker Hand #RC2094554621: Hold'em No Limit ($0.02/$0.05) - 2023/12/27 20:45:24
Table 'RushAndCash3783883' 6-max Seat #1 is the button
Seat 1: 10775654 ($5.07 in chips)
Seat 2: 5443ae1f ($6.01 in chips)
Seat 3: 2b96aed ($13.04 in chips)
Seat 4: Hero ($5 in chips)
Seat 5: eb5ad4e9 ($5 in chips)
Seat 6: 67b7a6aa ($8.49 in chips)
5443ae1f: posts small blind $0.02
2b96aed: posts big blind $0.05
*** HOLE CARDS ***
Dealt to 10775654 
Dealt to 5443ae1f 
Dealt to 2b96aed 
Dealt to Hero [5d 9h]
Dealt to eb5ad4e9 
Dealt to 67b7a6aa 
Hero: folds
eb5ad4e9: folds
67b7a6aa: folds
10775654: raises $0.07 to $0.12
5443ae1f: raises $0.15 to $0.27
2b96aed: folds
10775654: calls $0.15
*** FLOP *** [4c 8h 2c]
5443ae1f: bets $0.2
10775654: calls $0.2
*** TURN *** [4c 8h 2c] [4d]
5443ae1f: bets $0.5
10775654: calls $0.5
*** RIVER *** [4c 8h 2c 4d] [3h]
5443ae1f: checks
10775654: checks
5443ae1f: shows [Kh Qh] (Pair of Fours)
10775654: shows [Kc 8c] (Pair of Eights and Pair of Fours)
*** SHOWDOWN ***
10775654 collected $1.83 from pot
*** SUMMARY ***
Total pot $1.99 | Rake $0.09 | Jackpot $0.07 | Bingo $0 | Fortune $0 | Tax $0
Board [4c 8h 2c 4d 3h]
Seat 1: 10775654 (button) showed [Kc 8c] and won ($1.83) with Pair of Eights and Pair of Fours
Seat 2: 5443ae1f (small blind) showed [Kh Qh] and lost with Pair of Fours
Seat 3: 2b96aed (big blind) folded before Flop
Seat 4: Hero folded before Flop (didn't bet)
Seat 5: eb5ad4e9 folded before Flop (didn't bet)
Seat 6: 67b7a6aa folded before Flop (didn't bet)


Poker Hand #RC2094554561: Hold'em No Limit ($0.02/$0.05) - 2023/12/27 20:45:20
Table 'RushAndCash3783853' 6-max Seat #1 is the button
Seat 1: fd515659 ($5.77 in chips)
Seat 2: 739d395f ($5 in chips)
Seat 3: f2893c22 ($4.44 in chips)
Seat 4: 29d3e277 ($6.74 in chips)
Seat 5: ea506754 ($3.88 in chips)
Seat 6: Hero ($5 in chips)
739d395f: posts small blind $0.02
f2893c22: posts big blind $0.05
*** HOLE CARDS ***
Dealt to fd515659 
Dealt to 739d395f 
Dealt to f2893c22 
Dealt to 29d3e277 
Dealt to ea506754 
Dealt to Hero [Qd 2c]
29d3e277: folds
ea506754: folds
Hero: folds
fd515659: folds
739d395f: folds
Uncalled bet ($0.03) returned to f2893c22
*** SHOWDOWN ***
f2893c22 collected $0.04 from pot
*** SUMMARY ***
Total pot $0.04 | Rake $0 | Jackpot $0 | Bingo $0 | Fortune $0 | Tax $0
Seat 1: fd515659 (button) folded before Flop (didn't bet)
Seat 2: 739d395f (small blind) folded before Flop
Seat 3: f2893c22 (big blind) collected ($0.04)
Seat 4: 29d3e277 folded before Flop (didn't bet)
Seat 5: ea506754 folded before Flop (didn't bet)
Seat 6: Hero folded before Flop (didn't bet)


Poker Hand #RC2094554195: Hold'em No Limit ($0.02/$0.05) - 2023/12/27 20:45:01
Table 'RushAndCash3783672' 6-max Seat #1 is the button
Seat 1: ce2f9ee ($5.27 in chips)
Seat 2: f41f5dcd ($9.1 in chips)
Seat 3: 2b96aed ($13.09 in chips)
Seat 4: 51e41955 ($9.31 in chips)
Seat 5: Hero ($5 in chips)
Seat 6: cbc529ce ($5.62 in chips)
f41f5dcd: posts small blind $0.02
2b96aed: posts big blind $0.05
*** HOLE CARDS ***
Dealt to ce2f9ee 
Dealt to f41f5dcd 
Dealt to 2b96aed 
Dealt to 51e41955 
Dealt to Hero [Qh 7h]
Dealt to cbc529ce 
51e41955: folds
Hero: raises $0.05 to $0.1
cbc529ce: folds
ce2f9ee: folds
f41f5dcd: raises $0.13 to $0.23
2b96aed: folds
Hero: folds
Uncalled bet ($0.13) returned to f41f5dcd
*** SHOWDOWN ***
f41f5dcd collected $0.24 from pot
*** SUMMARY ***
Total pot $0.25 | Rake $0.01 | Jackpot $0 | Bingo $0 | Fortune $0 | Tax $0
Seat 1: ce2f9ee (button) folded before Flop (didn't bet)
Seat 2: f41f5dcd (small blind) collected ($0.24)
Seat 3: 2b96aed (big blind) folded before Flop
Seat 4: 51e41955 folded before Flop (didn't bet)
Seat 5: Hero folded before Flop
Seat 6: cbc529ce folded before Flop (didn't bet)


Poker Hand #RC2094554100: Hold'em No Limit ($0.02/$0.05) - 2023/12/27 20:44:55
Table 'RushAndCash3783625' 6-max Seat #1 is the button
Seat 1: Hero ($5 in chips)
Seat 2: c0b04742 ($4.88 in chips)
Seat 3: 6b68cc57 ($5.27 in chips)
Seat 4: afa53af1 ($6.62 in chips)
Seat 5: d34f29de ($7.73 in chips)
Seat 6: cdc632af ($3.64 in chips)
c0b04742: posts small blind $0.02
6b68cc57: posts big blind $0.05
*** HOLE CARDS ***
Dealt to Hero [2h As]
Dealt to c0b04742 
Dealt to 6b68cc57 
Dealt to afa53af1 
Dealt to d34f29de 
Dealt to cdc632af 
afa53af1: folds
d34f29de: raises $0.1 to $0.15
cdc632af: folds
Hero: folds
c0b04742: folds
6b68cc57: calls $0.1
*** FLOP *** [6c Jc 2d]
6b68cc57: checks
d34f29de: bets $0.2
6b68cc57: folds
Uncalled bet ($0.2) returned to d34f29de
*** SHOWDOWN ***
d34f29de collected $0.31 from pot
*** SUMMARY ***
Total pot $0.32 | Rake $0.01 | Jackpot $0 | Bingo $0 | Fortune $0 | Tax $0
Board [6c Jc 2d]
Seat 1: Hero (button) folded before Flop (didn't bet)
Seat 2: c0b04742 (small blind) folded before Flop
Seat 3: 6b68cc57 (big blind) folded on the Flop
Seat 4: afa53af1 folded before Flop (didn't bet)
Seat 5: d34f29de won ($0.31)
Seat 6: cdc632af folded before Flop (didn't bet)


Poker Hand #RC2094553864: Hold'em No Limit ($0.02/$0.05) - 2023/12/27 20:44:44
Table 'RushAndCash3783504' 6-max Seat #1 is the button
Seat 1: 4b6a7b7 ($4.87 in chips)
Seat 2: Hero ($5.02 in chips)
Seat 3: dc8f15a1 ($9.2 in chips)
Seat 4: a532460f ($5.83 in chips)
Seat 5: d0764f0f ($5.11 in chips)
Seat 6: d3f29b61 ($3.18 in chips)
Hero: posts small blind $0.02
dc8f15a1: posts big blind $0.05
*** HOLE CARDS ***
Dealt to 4b6a7b7 
Dealt to Hero [5s 4h]
Dealt to dc8f15a1 
Dealt to a532460f 
Dealt to d0764f0f 
Dealt to d3f29b61 
a532460f: folds
d0764f0f: folds
d3f29b61: folds
4b6a7b7: folds
Hero: folds
Uncalled bet ($0.03) returned to dc8f15a1
*** SHOWDOWN ***
dc8f15a1 collected $0.04 from pot
*** SUMMARY ***
Total pot $0.04 | Rake $0 | Jackpot $0 | Bingo $0 | Fortune $0 | Tax $0
Seat 1: 4b6a7b7 (button) folded before Flop (didn't bet)
Seat 2: Hero (small blind) folded before Flop
Seat 3: dc8f15a1 (big blind) collected ($0.04)
Seat 4: a532460f folded before Flop (didn't bet)
Seat 5: d0764f0f folded before Flop (didn't bet)
Seat 6: d3f29b61 folded before Flop (didn't bet)


Poker Hand #RC2094553640: Hold'em No Limit ($0.02/$0.05) - 2023/12/27 20:44:33
Table 'RushAndCash3783393' 6-max Seat #1 is the button
Seat 1: e8717a11 ($7.37 in chips)
Seat 2: fb9a94b2 ($7.73 in chips)
Seat 3: Hero ($5 in chips)
Seat 4: 5507970f ($4.65 in chips)
Seat 5: 8f7d1c8f ($5.68 in chips)
Seat 6: b7180d42 ($12.18 in chips)
fb9a94b2: posts small blind $0.02
Hero: posts big blind $0.05
*** HOLE CARDS ***
Dealt to e8717a11 
Dealt to fb9a94b2 
Dealt to Hero [7c 8c]
Dealt to 5507970f 
Dealt to 8f7d1c8f 
Dealt to b7180d42 
5507970f: folds
8f7d1c8f: folds
b7180d42: folds
e8717a11: folds
fb9a94b2: folds
Uncalled bet ($0.03) returned to Hero
*** SHOWDOWN ***
Hero collected $0.04 from pot
*** SUMMARY ***
Total pot $0.04 | Rake $0 | Jackpot $0 | Bingo $0 | Fortune $0 | Tax $0
Seat 1: e8717a11 (button) folded before Flop (didn't bet)
Seat 2: fb9a94b2 (small blind) folded before Flop
Seat 3: Hero (big blind) collected ($0.04)
Seat 4: 5507970f folded before Flop (didn't bet)
Seat 5: 8f7d1c8f folded before Flop (didn't bet)
Seat 6: b7180d42 folded before Flop (didn't bet)


