Poker Hand #RC2078483600: Hold'em No Limit ($0.02/$0.05) - 2023/12/22 21:24:40
Table 'RushAndCash787112' 6-max Seat #1 is the button
Seat 1: aed2a4dc ($3.6 in chips)
Seat 2: Hero ($6.59 in chips)
Seat 3: 6e872e9c ($19.22 in chips)
Seat 4: cf6f5635 ($5.79 in chips)
Seat 5: 587c07c3 ($5.25 in chips)
Seat 6: 32dfaf2b ($6.78 in chips)
Hero: posts small blind $0.02
6e872e9c: posts big blind $0.05
*** HOLE CARDS ***
Dealt to aed2a4dc 
Dealt to Hero [8h Th]
Dealt to 6e872e9c 
Dealt to cf6f5635 
Dealt to 587c07c3 
Dealt to 32dfaf2b 
cf6f5635: folds
587c07c3: raises $0.08 to $0.13
32dfaf2b: calls $0.13
aed2a4dc: folds
Hero: folds
6e872e9c: calls $0.08
*** FLOP *** [2d 6d 8d]
6e872e9c: checks
587c07c3: checks
32dfaf2b: bets $0.22
6e872e9c: calls $0.22
587c07c3: folds
*** TURN *** [2d 6d 8d] [7h]
6e872e9c: checks
32dfaf2b: checks
*** RIVER *** [2d 6d 8d 7h] [3c]
6e872e9c: bets $0.43
32dfaf2b: folds
Uncalled bet ($0.43) returned to 6e872e9c
*** SHOWDOWN ***
6e872e9c collected $0.81 from pot
*** SUMMARY ***
Total pot $0.85 | Rake $0.04 | Jackpot $0 | Bingo $0 | Fortune $0 | Tax $0
Board [2d 6d 8d 7h 3c]
Seat 1: aed2a4dc (button) folded before Flop (didn't bet)
Seat 2: Hero (small blind) folded before Flop
Seat 3: 6e872e9c (big blind) won ($0.81)
Seat 4: cf6f5635 folded before Flop (didn't bet)
Seat 5: 587c07c3 folded on the Flop
Seat 6: 32dfaf2b folded on the River


Poker Hand #RC2078483455: Hold'em No Limit ($0.02/$0.05) - 2023/12/22 21:24:32
Table 'RushAndCash787042' 6-max Seat #1 is the button
Seat 1: 3df6f82d ($2.94 in chips)
Seat 2: 29b0f5be ($5.6 in chips)
Seat 3: Hero ($6.57 in chips)
Seat 4: 1fff7a0a ($8.57 in chips)
Seat 5: 9dcfc86d ($3.99 in chips)
Seat 6: 75daa184 ($11.21 in chips)
29b0f5be: posts small blind $0.02
Hero: posts big blind $0.05
*** HOLE CARDS ***
Dealt to 3df6f82d 
Dealt to 29b0f5be 
Dealt to Hero [Js 3d]
Dealt to 1fff7a0a 
Dealt to 9dcfc86d 
Dealt to 75daa184 
1fff7a0a: folds
9dcfc86d: folds
75daa184: folds
3df6f82d: folds
29b0f5be: folds
Uncalled bet ($0.03) returned to Hero
*** SHOWDOWN ***
Hero collected $0.04 from pot
*** SUMMARY ***
Total pot $0.04 | Rake $0 | Jackpot $0 | Bingo $0 | Fortune $0 | Tax $0
Seat 1: 3df6f82d (button) folded before Flop (didn't bet)
Seat 2: 29b0f5be (small blind) folded before Flop
Seat 3: Hero (big blind) collected ($0.04)
Seat 4: 1fff7a0a folded before Flop (didn't bet)
Seat 5: 9dcfc86d folded before Flop (didn't bet)
Seat 6: 75daa184 folded before Flop (didn't bet)


Poker Hand #RC2078483386: Hold'em No Limit ($0.02/$0.05) - 2023/12/22 21:24:28
Table 'RushAndCash787010' 6-max Seat #1 is the button
Seat 1: 38eafb19 ($5 in chips)
Seat 2: eeb37e34 ($7.93 in chips)
Seat 3: 82e9c1ba ($13.69 in chips)
Seat 4: 1b93f683 ($5.74 in chips)
Seat 5: ff6f425f ($10.87 in chips)
Seat 6: Hero ($6.57 in chips)
eeb37e34: posts small blind $0.02
82e9c1ba: posts big blind $0.05
*** HOLE CARDS ***
Dealt to 38eafb19 
Dealt to eeb37e34 
Dealt to 82e9c1ba 
Dealt to 1b93f683 
Dealt to ff6f425f 
Dealt to Hero [9s Ac]
1b93f683: folds
ff6f425f: raises $0.05 to $0.1
Hero: folds
38eafb19: folds
eeb37e34: folds
82e9c1ba: raises $0.33 to $0.43
ff6f425f: calls $0.33
*** FLOP *** [5d 3s Ts]
82e9c1ba: bets $0.58
ff6f425f: calls $0.58
*** TURN *** [5d 3s Ts] [Ah]
82e9c1ba: bets $0.68
ff6f425f: raises $0.77 to $1.45
82e9c1ba: calls $0.77
*** RIVER *** [5d 3s Ts Ah] [3c]
82e9c1ba: checks
ff6f425f: bets $2.8
82e9c1ba: calls $2.8
ff6f425f: shows [Jh Jd] (Pair of Jacks and Pair of Treys)
82e9c1ba: shows [Kd Ad] (Pair of Aces and Pair of Treys)
*** SHOWDOWN ***
82e9c1ba collected $10.32 from pot
*** SUMMARY ***
Total pot $10.54 | Rake $0.15 | Jackpot $0.07 | Bingo $0 | Fortune $0 | Tax $0
Board [5d 3s Ts Ah 3c]
Seat 1: 38eafb19 (button) folded before Flop (didn't bet)
Seat 2: eeb37e34 (small blind) folded before Flop
Seat 3: 82e9c1ba (big blind) showed [Kd Ad] and won ($10.32) with Pair of Aces and Pair of Treys
Seat 4: 1b93f683 folded before Flop (didn't bet)
Seat 5: ff6f425f showed [Jh Jd] and lost with Pair of Jacks and Pair of Treys
Seat 6: Hero folded before Flop (didn't bet)


Poker Hand #RC2078482901: Hold'em No Limit ($0.02/$0.05) - 2023/12/22 21:24:00
Table 'RushAndCash786785' 6-max Seat #1 is the button
Seat 1: 1fc1f571 ($13.58 in chips)
Seat 2: 22818fb2 ($5 in chips)
Seat 3: Hero ($6.67 in chips)
Seat 4: c18ede1f ($6.08 in chips)
Seat 5: f804ce50 ($14.43 in chips)
Seat 6: 4a4c34d3 ($4.79 in chips)
22818fb2: posts small blind $0.02
Hero: posts big blind $0.05
*** HOLE CARDS ***
Dealt to 1fc1f571 
Dealt to 22818fb2 
Dealt to Hero [7d As]
Dealt to c18ede1f 
Dealt to f804ce50 
Dealt to 4a4c34d3 
c18ede1f: folds
f804ce50: folds
4a4c34d3: raises $0.05 to $0.1
1fc1f571: folds
22818fb2: folds
Hero: calls $0.05
*** FLOP *** [4s Td 3c]
Hero: checks
4a4c34d3: bets $0.11
Hero: folds
Uncalled bet ($0.11) returned to 4a4c34d3
*** SHOWDOWN ***
4a4c34d3 collected $0.21 from pot
*** SUMMARY ***
Total pot $0.22 | Rake $0.01 | Jackpot $0 | Bingo $0 | Fortune $0 | Tax $0
Board [4s Td 3c]
Seat 1: 1fc1f571 (button) folded before Flop (didn't bet)
Seat 2: 22818fb2 (small blind) folded before Flop
Seat 3: Hero (big blind) folded on the Flop
Seat 4: c18ede1f folded before Flop (didn't bet)
Seat 5: f804ce50 folded before Flop (didn't bet)
Seat 6: 4a4c34d3 won ($0.21)


Poker Hand #RC2078482837: Hold'em No Limit ($0.02/$0.05) - 2023/12/22 21:23:56
Table 'RushAndCash786756' 6-max Seat #1 is the button
Seat 1: 6bf9020c ($5.12 in chips)
Seat 2: 3a35e9f5 ($19.23 in chips)
Seat 3: 11ec2bb2 ($7.12 in chips)
Seat 4: Hero ($6.67 in chips)
Seat 5: 3d292096 ($8.72 in chips)
Seat 6: 4aa2dd0a ($6.05 in chips)
3a35e9f5: posts small blind $0.02
11ec2bb2: posts big blind $0.05
*** HOLE CARDS ***
Dealt to 6bf9020c 
Dealt to 3a35e9f5 
Dealt to 11ec2bb2 
Dealt to Hero [7s 5s]
Dealt to 3d292096 
Dealt to 4aa2dd0a 
Hero: folds
3d292096: raises $0.08 to $0.13
4aa2dd0a: calls $0.13
6bf9020c: folds
3a35e9f5: folds
11ec2bb2: folds
*** FLOP *** [8d 4s 6d]
3d292096: checks
4aa2dd0a: bets $0.18
3d292096: folds
Uncalled bet ($0.18) returned to 4aa2dd0a
*** SHOWDOWN ***
4aa2dd0a collected $0.32 from pot
*** SUMMARY ***
Total pot $0.33 | Rake $0.01 | Jackpot $0 | Bingo $0 | Fortune $0 | Tax $0
Board [8d 4s 6d]
Seat 1: 6bf9020c (button) folded before Flop (didn't bet)
Seat 2: 3a35e9f5 (small blind) folded before Flop
Seat 3: 11ec2bb2 (big blind) folded before Flop
Seat 4: Hero folded before Flop (didn't bet)
Seat 5: 3d292096 folded on the Flop
Seat 6: 4aa2dd0a won ($0.32)


Poker Hand #RC2078482739: Hold'em No Limit ($0.02/$0.05) - 2023/12/22 21:23:51
Table 'RushAndCash786710' 6-max Seat #1 is the button
Seat 1: 610bd7fc ($11.11 in chips)
Seat 2: ff5dd678 ($2.34 in chips)
Seat 3: 3a26c05c ($6.28 in chips)
Seat 4: 23800d75 ($5.21 in chips)
Seat 5: 53d2996c ($13.67 in chips)
Seat 6: Hero ($6.67 in chips)
ff5dd678: posts small blind $0.02
3a26c05c: posts big blind $0.05
*** HOLE CARDS ***
Dealt to 610bd7fc 
Dealt to ff5dd678 
Dealt to 3a26c05c 
Dealt to 23800d75 
Dealt to 53d2996c 
Dealt to Hero [9s 7s]
23800d75: folds
53d2996c: raises $0.08 to $0.13
Hero: folds
610bd7fc: folds
ff5dd678: folds
3a26c05c: calls $0.08
*** FLOP *** [6s 5h Ac]
3a26c05c: checks
53d2996c: bets $0.14
3a26c05c: calls $0.14
*** TURN *** [6s 5h Ac] [8c]
3a26c05c: checks
53d2996c: bets $0.44
3a26c05c: calls $0.44
*** RIVER *** [6s 5h Ac 8c] [4h]
3a26c05c: checks
53d2996c: checks
3a26c05c: shows [Ah Qd] (Pair of Aces)
53d2996c: shows [Jc As] (Pair of Aces)
*** SHOWDOWN ***
3a26c05c collected $1.37 from pot
*** SUMMARY ***
Total pot $1.44 | Rake $0.07 | Jackpot $0 | Bingo $0 | Fortune $0 | Tax $0
Board [6s 5h Ac 8c 4h]
Seat 1: 610bd7fc (button) folded before Flop (didn't bet)
Seat 2: ff5dd678 (small blind) folded before Flop
Seat 3: 3a26c05c (big blind) showed [Ah Qd] and won ($1.37) with Pair of Aces
Seat 4: 23800d75 folded before Flop (didn't bet)
Seat 5: 53d2996c showed [Jc As] and lost with Pair of Aces
Seat 6: Hero folded before Flop (didn't bet)


Poker Hand #RC2078482677: Hold'em No Limit ($0.02/$0.05) - 2023/12/22 21:23:47
Table 'RushAndCash786679' 6-max Seat #1 is the button
Seat 1: 5d317abf ($8.36 in chips)
Seat 2: Hero ($6.69 in chips)
Seat 3: 1ab06c8f ($5.12 in chips)
Seat 4: 25941725 ($4.52 in chips)
Seat 5: 395dbfbb ($5.91 in chips)
Seat 6: 3a9b3c34 ($3.42 in chips)
Hero: posts small blind $0.02
1ab06c8f: posts big blind $0.05
*** HOLE CARDS ***
Dealt to 5d317abf 
Dealt to Hero [7h 4s]
Dealt to 1ab06c8f 
Dealt to 25941725 
Dealt to 395dbfbb 
Dealt to 3a9b3c34 
25941725: folds
395dbfbb: folds
3a9b3c34: folds
5d317abf: raises $0.08 to $0.13
Hero: folds
1ab06c8f: folds
Uncalled bet ($0.08) returned to 5d317abf
*** SHOWDOWN ***
5d317abf collected $0.12 from pot
*** SUMMARY ***
Total pot $0.12 | Rake $0 | Jackpot $0 | Bingo $0 | Fortune $0 | Tax $0
Seat 1: 5d317abf (button) collected ($0.12)
Seat 2: Hero (small blind) folded before Flop
Seat 3: 1ab06c8f (big blind) folded before Flop
Seat 4: 25941725 folded before Flop (didn't bet)
Seat 5: 395dbfbb folded before Flop (didn't bet)
Seat 6: 3a9b3c34 folded before Flop (didn't bet)


Poker Hand #RC2078482619: Hold'em No Limit ($0.02/$0.05) - 2023/12/22 21:23:43
Table 'RushAndCash786649' 6-max Seat #1 is the button
Seat 1: a3926d8e ($4.91 in chips)
Seat 2: 954d1f7b ($5 in chips)
Seat 3: edac6d16 ($5 in chips)
Seat 4: d74d8525 ($5.86 in chips)
Seat 5: Hero ($6.69 in chips)
Seat 6: d32741ba ($9.11 in chips)
954d1f7b: posts small blind $0.02
edac6d16: posts big blind $0.05
*** HOLE CARDS ***
Dealt to a3926d8e 
Dealt to 954d1f7b 
Dealt to edac6d16 
Dealt to d74d8525 
Dealt to Hero [Ah 4s]
Dealt to d32741ba 
d74d8525: folds
Hero: folds
d32741ba: folds
a3926d8e: folds
954d1f7b: folds
Uncalled bet ($0.03) returned to edac6d16
*** SHOWDOWN ***
edac6d16 collected $0.04 from pot
*** SUMMARY ***
Total pot $0.04 | Rake $0 | Jackpot $0 | Bingo $0 | Fortune $0 | Tax $0
Seat 1: a3926d8e (button) folded before Flop (didn't bet)
Seat 2: 954d1f7b (small blind) folded before Flop
Seat 3: edac6d16 (big blind) collected ($0.04)
Seat 4: d74d8525 folded before Flop (didn't bet)
Seat 5: Hero folded before Flop (didn't bet)
Seat 6: d32741ba folded before Flop (didn't bet)


Poker Hand #RC2078482564: Hold'em No Limit ($0.02/$0.05) - 2023/12/22 21:23:40
Table 'RushAndCash786622' 6-max Seat #1 is the button
Seat 1: Hero ($6.69 in chips)
Seat 2: 257cb6ea ($5 in chips)
Seat 3: 6e872e9c ($19.49 in chips)
Seat 4: edb6154b ($6.14 in chips)
Seat 5: bc26f2e1 ($5.07 in chips)
Seat 6: 622d6af4 ($20.38 in chips)
257cb6ea: posts small blind $0.02
6e872e9c: posts big blind $0.05
*** HOLE CARDS ***
Dealt to Hero [Kh 7s]
Dealt to 257cb6ea 
Dealt to 6e872e9c 
Dealt to edb6154b 
Dealt to bc26f2e1 
Dealt to 622d6af4 
edb6154b: folds
bc26f2e1: folds
622d6af4: folds
Hero: folds
257cb6ea: raises $0.1 to $0.15
6e872e9c: calls $0.1
*** FLOP *** [5s 3h Qc]
257cb6ea: checks
6e872e9c: bets $0.1
257cb6ea: raises $0.25 to $0.35
6e872e9c: folds
Uncalled bet ($0.25) returned to 257cb6ea
*** SHOWDOWN ***
257cb6ea collected $0.48 from pot
*** SUMMARY ***
Total pot $0.5 | Rake $0.02 | Jackpot $0 | Bingo $0 | Fortune $0 | Tax $0
Board [5s 3h Qc]
Seat 1: Hero (button) folded before Flop (didn't bet)
Seat 2: 257cb6ea (small blind) won ($0.48)
Seat 3: 6e872e9c (big blind) folded on the Flop
Seat 4: edb6154b folded before Flop (didn't bet)
Seat 5: bc26f2e1 folded before Flop (didn't bet)
Seat 6: 622d6af4 folded before Flop (didn't bet)


Poker Hand #RC2078482434: Hold'em No Limit ($0.02/$0.05) - 2023/12/22 21:23:33
Table 'RushAndCash786562' 6-max Seat #1 is the button
Seat 1: 317ccf77 ($1.6 in chips)
Seat 2: 2dd9a65 ($4.84 in chips)
Seat 3: a2edfbd1 ($2.7 in chips)
Seat 4: c71b7029 ($8.52 in chips)
Seat 5: 1fff7a0a ($8.38 in chips)
Seat 6: Hero ($6.69 in chips)
2dd9a65: posts small blind $0.02
a2edfbd1: posts big blind $0.05
*** HOLE CARDS ***
Dealt to 317ccf77 
Dealt to 2dd9a65 
Dealt to a2edfbd1 
Dealt to c71b7029 
Dealt to 1fff7a0a 
Dealt to Hero [Kd 9d]
c71b7029: folds
1fff7a0a: raises $0.08 to $0.13
Hero: folds
317ccf77: calls $0.13
2dd9a65: folds
a2edfbd1: folds
*** FLOP *** [4h Qs 4s]
1fff7a0a: bets $0.11
317ccf77: folds
Uncalled bet ($0.11) returned to 1fff7a0a
*** SHOWDOWN ***
1fff7a0a collected $0.32 from pot
*** SUMMARY ***
Total pot $0.33 | Rake $0.01 | Jackpot $0 | Bingo $0 | Fortune $0 | Tax $0
Board [4h Qs 4s]
Seat 1: 317ccf77 (button) folded on the Flop
Seat 2: 2dd9a65 (small blind) folded before Flop
Seat 3: a2edfbd1 (big blind) folded before Flop
Seat 4: c71b7029 folded before Flop (didn't bet)
Seat 5: 1fff7a0a won ($0.32)
Seat 6: Hero folded before Flop (didn't bet)


Poker Hand #RC2078481826: Hold'em No Limit ($0.02/$0.05) - 2023/12/22 21:22:57
Table 'RushAndCash786285' 6-max Seat #1 is the button
Seat 1: b01c40bf ($18.41 in chips)
Seat 2: 317ccf77 ($1.91 in chips)
Seat 3: 44231a0a ($13.25 in chips)
Seat 4: Hero ($7 in chips)
Seat 5: 5a299033 ($5.14 in chips)
Seat 6: a2edfbd1 ($2.07 in chips)
317ccf77: posts small blind $0.02
44231a0a: posts big blind $0.05
*** HOLE CARDS ***
Dealt to b01c40bf 
Dealt to 317ccf77 
Dealt to 44231a0a 
Dealt to Hero [9h 9s]
Dealt to 5a299033 
Dealt to a2edfbd1 
Hero: raises $0.05 to $0.1
5a299033: folds
a2edfbd1: raises $0.21 to $0.31
b01c40bf: folds
317ccf77: calls $0.29
44231a0a: folds
Hero: calls $0.21
*** FLOP *** [Qc 6d Ts]
317ccf77: checks
Hero: checks
a2edfbd1: bets $0.49
317ccf77: folds
Hero: folds
Uncalled bet ($0.49) returned to a2edfbd1
*** SHOWDOWN ***
a2edfbd1 collected $0.94 from pot
*** SUMMARY ***
Total pot $0.98 | Rake $0.04 | Jackpot $0 | Bingo $0 | Fortune $0 | Tax $0
Board [Qc 6d Ts]
Seat 1: b01c40bf (button) folded before Flop (didn't bet)
Seat 2: 317ccf77 (small blind) folded on the Flop
Seat 3: 44231a0a (big blind) folded before Flop
Seat 4: Hero folded on the Flop
Seat 5: 5a299033 folded before Flop (didn't bet)
Seat 6: a2edfbd1 won ($0.94)


Poker Hand #RC2078481746: Hold'em No Limit ($0.02/$0.05) - 2023/12/22 21:22:52
Table 'RushAndCash786245' 6-max Seat #1 is the button
Seat 1: 933d69ee ($7.99 in chips)
Seat 2: 84dda8d8 ($3.51 in chips)
Seat 3: 1be6b9fd ($9.14 in chips)
Seat 4: 4e44d49f ($11.39 in chips)
Seat 5: Hero ($7 in chips)
Seat 6: f9c6a467 ($21.33 in chips)
84dda8d8: posts small blind $0.02
1be6b9fd: posts big blind $0.05
*** HOLE CARDS ***
Dealt to 933d69ee 
Dealt to 84dda8d8 
Dealt to 1be6b9fd 
Dealt to 4e44d49f 
Dealt to Hero [5s 6d]
Dealt to f9c6a467 
4e44d49f: folds
Hero: folds
f9c6a467: raises $0.07 to $0.12
933d69ee: folds
84dda8d8: folds
1be6b9fd: calls $0.07
*** FLOP *** [4s 4h 8s]
1be6b9fd: checks
f9c6a467: bets $0.1
1be6b9fd: raises $0.25 to $0.35
f9c6a467: calls $0.25
*** TURN *** [4s 4h 8s] [Qs]
1be6b9fd: bets $0.51
f9c6a467: calls $0.51
*** RIVER *** [4s 4h 8s Qs] [Th]
1be6b9fd: checks
f9c6a467: checks
1be6b9fd: shows [Ts Ad] (Pair of Tens and Pair of Fours)
f9c6a467: shows [Kc 4c] (Three Fours)
*** SHOWDOWN ***
f9c6a467 collected $1.82 from pot
*** SUMMARY ***
Total pot $1.98 | Rake $0.09 | Jackpot $0.07 | Bingo $0 | Fortune $0 | Tax $0
Board [4s 4h 8s Qs Th]
Seat 1: 933d69ee (button) folded before Flop (didn't bet)
Seat 2: 84dda8d8 (small blind) folded before Flop
Seat 3: 1be6b9fd (big blind) showed [Ts Ad] and lost with Pair of Tens and Pair of Fours
Seat 4: 4e44d49f folded before Flop (didn't bet)
Seat 5: Hero folded before Flop (didn't bet)
Seat 6: f9c6a467 showed [Kc 4c] and won ($1.82) with Three Fours


Poker Hand #RC2078481605: Hold'em No Limit ($0.02/$0.05) - 2023/12/22 21:22:44
Table 'RushAndCash786176' 6-max Seat #1 is the button
Seat 1: 4d43d419 ($7.65 in chips)
Seat 2: c2881b52 ($10.69 in chips)
Seat 3: Hero ($7.05 in chips)
Seat 4: a1dfe2ad ($9.59 in chips)
Seat 5: e1380a89 ($6.37 in chips)
Seat 6: f9e151ff ($11.44 in chips)
c2881b52: posts small blind $0.02
Hero: posts big blind $0.05
*** HOLE CARDS ***
Dealt to 4d43d419 
Dealt to c2881b52 
Dealt to Hero [9d Th]
Dealt to a1dfe2ad 
Dealt to e1380a89 
Dealt to f9e151ff 
a1dfe2ad: raises $0.05 to $0.1
e1380a89: folds
f9e151ff: folds
4d43d419: folds
c2881b52: folds
Hero: folds
Uncalled bet ($0.05) returned to a1dfe2ad
*** SHOWDOWN ***
a1dfe2ad collected $0.12 from pot
*** SUMMARY ***
Total pot $0.12 | Rake $0 | Jackpot $0 | Bingo $0 | Fortune $0 | Tax $0
Seat 1: 4d43d419 (button) folded before Flop (didn't bet)
Seat 2: c2881b52 (small blind) folded before Flop
Seat 3: Hero (big blind) folded before Flop
Seat 4: a1dfe2ad collected ($0.12)
Seat 5: e1380a89 folded before Flop (didn't bet)
Seat 6: f9e151ff folded before Flop (didn't bet)


Poker Hand #RC2078481536: Hold'em No Limit ($0.02/$0.05) - 2023/12/22 21:22:40
Table 'RushAndCash786144' 6-max Seat #1 is the button
Seat 1: Hero ($7.05 in chips)
Seat 2: 67d4b163 ($10.93 in chips)
Seat 3: 54daf47b ($9.69 in chips)
Seat 4: 58e5ab76 ($9.81 in chips)
Seat 5: 886872c9 ($5.39 in chips)
Seat 6: 294d35ce ($14.2 in chips)
67d4b163: posts small blind $0.02
54daf47b: posts big blind $0.05
*** HOLE CARDS ***
Dealt to Hero [5d Jc]
Dealt to 67d4b163 
Dealt to 54daf47b 
Dealt to 58e5ab76 
Dealt to 886872c9 
Dealt to 294d35ce 
58e5ab76: folds
886872c9: folds
294d35ce: raises $0.08 to $0.13
Hero: folds
67d4b163: folds
54daf47b: folds
Uncalled bet ($0.08) returned to 294d35ce
*** SHOWDOWN ***
294d35ce collected $0.12 from pot
*** SUMMARY ***
Total pot $0.12 | Rake $0 | Jackpot $0 | Bingo $0 | Fortune $0 | Tax $0
Seat 1: Hero (button) folded before Flop (didn't bet)
Seat 2: 67d4b163 (small blind) folded before Flop
Seat 3: 54daf47b (big blind) folded before Flop
Seat 4: 58e5ab76 folded before Flop (didn't bet)
Seat 5: 886872c9 folded before Flop (didn't bet)
Seat 6: 294d35ce collected ($0.12)


Poker Hand #RC2078481476: Hold'em No Limit ($0.02/$0.05) - 2023/12/22 21:22:36
Table 'RushAndCash786117' 6-max Seat #1 is the button
Seat 1: 55f8abbc ($6.05 in chips)
Seat 2: f7d66c7 ($5.1 in chips)
Seat 3: c9faf803 ($13.88 in chips)
Seat 4: Hero ($7.05 in chips)
Seat 5: 73c8f8b5 ($5 in chips)
Seat 6: bc26f2e1 ($5 in chips)
f7d66c7: posts small blind $0.02
c9faf803: posts big blind $0.05
*** HOLE CARDS ***
Dealt to 55f8abbc 
Dealt to f7d66c7 
Dealt to c9faf803 
Dealt to Hero [7h 4s]
Dealt to 73c8f8b5 
Dealt to bc26f2e1 
Hero: folds
73c8f8b5: folds
bc26f2e1: folds
55f8abbc: raises $0.08 to $0.13
f7d66c7: raises $0.24 to $0.37
c9faf803: folds
55f8abbc: calls $0.24
*** FLOP *** [2h Jd Tc]
f7d66c7: bets $0.6
55f8abbc: calls $0.6
*** TURN *** [2h Jd Tc] [Kh]
f7d66c7: checks
55f8abbc: bets $1.04
f7d66c7: calls $1.04
*** RIVER *** [2h Jd Tc Kh] [8c]
f7d66c7: checks
55f8abbc: checks
f7d66c7: shows [9c 9h] (Pair of Nines)
55f8abbc: shows [Js As] (Pair of Jacks)
*** SHOWDOWN ***
55f8abbc collected $3.85 from pot
*** SUMMARY ***
Total pot $4.07 | Rake $0.15 | Jackpot $0.07 | Bingo $0 | Fortune $0 | Tax $0
Board [2h Jd Tc Kh 8c]
Seat 1: 55f8abbc (button) showed [Js As] and won ($3.85) with Pair of Jacks
Seat 2: f7d66c7 (small blind) showed [9c 9h] and lost with Pair of Nines
Seat 3: c9faf803 (big blind) folded before Flop
Seat 4: Hero folded before Flop (didn't bet)
Seat 5: 73c8f8b5 folded before Flop (didn't bet)
Seat 6: bc26f2e1 folded before Flop (didn't bet)


Poker Hand #RC2078481406: Hold'em No Limit ($0.02/$0.05) - 2023/12/22 21:22:33
Table 'RushAndCash786084' 6-max Seat #1 is the button
Seat 1: f9c6a467 ($21.33 in chips)
Seat 2: 7203c376 ($5 in chips)
Seat 3: 89a27c2 ($4.7 in chips)
Seat 4: 45bb3f0f ($5.26 in chips)
Seat 5: 11811683 ($5.49 in chips)
Seat 6: Hero ($7.05 in chips)
7203c376: posts small blind $0.02
89a27c2: posts big blind $0.05
*** HOLE CARDS ***
Dealt to f9c6a467 
Dealt to 7203c376 
Dealt to 89a27c2 
Dealt to 45bb3f0f 
Dealt to 11811683 
Dealt to Hero [Kh 5s]
45bb3f0f: folds
11811683: raises $0.1 to $0.15
Hero: folds
f9c6a467: folds
7203c376: folds
89a27c2: folds
Uncalled bet ($0.1) returned to 11811683
*** SHOWDOWN ***
11811683 collected $0.12 from pot
*** SUMMARY ***
Total pot $0.12 | Rake $0 | Jackpot $0 | Bingo $0 | Fortune $0 | Tax $0
Seat 1: f9c6a467 (button) folded before Flop (didn't bet)
Seat 2: 7203c376 (small blind) folded before Flop
Seat 3: 89a27c2 (big blind) folded before Flop
Seat 4: 45bb3f0f folded before Flop (didn't bet)
Seat 5: 11811683 collected ($0.12)
Seat 6: Hero folded before Flop (didn't bet)


Poker Hand #RC2078481318: Hold'em No Limit ($0.02/$0.05) - 2023/12/22 21:22:27
Table 'RushAndCash786042' 6-max Seat #1 is the button
Seat 1: 23800d75 ($5.33 in chips)
Seat 2: 40c4a4f ($9.86 in chips)
Seat 3: c320c189 ($8.7 in chips)
Seat 4: 93d5c821 ($5.89 in chips)
Seat 5: Hero ($7.05 in chips)
Seat 6: 98124327 ($5 in chips)
40c4a4f: posts small blind $0.02
c320c189: posts big blind $0.05
*** HOLE CARDS ***
Dealt to 23800d75 
Dealt to 40c4a4f 
Dealt to c320c189 
Dealt to 93d5c821 
Dealt to Hero [6c Qh]
Dealt to 98124327 
93d5c821: folds
Hero: folds
98124327: raises $0.05 to $0.1
23800d75: folds
40c4a4f: calls $0.08
c320c189: folds
*** FLOP *** [9c Ac 7d]
40c4a4f: checks
98124327: bets $0.08
40c4a4f: folds
Uncalled bet ($0.08) returned to 98124327
*** SHOWDOWN ***
98124327 collected $0.24 from pot
*** SUMMARY ***
Total pot $0.25 | Rake $0.01 | Jackpot $0 | Bingo $0 | Fortune $0 | Tax $0
Board [9c Ac 7d]
Seat 1: 23800d75 (button) folded before Flop (didn't bet)
Seat 2: 40c4a4f (small blind) folded on the Flop
Seat 3: c320c189 (big blind) folded before Flop
Seat 4: 93d5c821 folded before Flop (didn't bet)
Seat 5: Hero folded before Flop (didn't bet)
Seat 6: 98124327 won ($0.24)


Poker Hand #RC2078481077: Hold'em No Limit ($0.02/$0.05) - 2023/12/22 21:22:14
Table 'RushAndCash785923' 6-max Seat #1 is the button
Seat 1: 7d137087 ($6.44 in chips)
Seat 2: Hero ($7.07 in chips)
Seat 3: a61e93fb ($11.27 in chips)
Seat 4: 2861b620 ($4.52 in chips)
Seat 5: bc118b95 ($5.87 in chips)
Seat 6: 4a4c34d3 ($5.68 in chips)
Hero: posts small blind $0.02
a61e93fb: posts big blind $0.05
*** HOLE CARDS ***
Dealt to 7d137087 
Dealt to Hero [2d 9c]
Dealt to a61e93fb 
Dealt to 2861b620 
Dealt to bc118b95 
Dealt to 4a4c34d3 
2861b620: folds
bc118b95: folds
4a4c34d3: folds
7d137087: folds
Hero: folds
Uncalled bet ($0.03) returned to a61e93fb
*** SHOWDOWN ***
a61e93fb collected $0.04 from pot
*** SUMMARY ***
Total pot $0.04 | Rake $0 | Jackpot $0 | Bingo $0 | Fortune $0 | Tax $0
Seat 1: 7d137087 (button) folded before Flop (didn't bet)
Seat 2: Hero (small blind) folded before Flop
Seat 3: a61e93fb (big blind) collected ($0.04)
Seat 4: 2861b620 folded before Flop (didn't bet)
Seat 5: bc118b95 folded before Flop (didn't bet)
Seat 6: 4a4c34d3 folded before Flop (didn't bet)


Poker Hand #RC2078480935: Hold'em No Limit ($0.02/$0.05) - 2023/12/22 21:22:06
Table 'RushAndCash785849' 6-max Seat #1 is the button
Seat 1: e69446ee ($8.68 in chips)
Seat 2: c6bf1d22 ($6.43 in chips)
Seat 3: Hero ($7.12 in chips)
Seat 4: 53d2996c ($13.96 in chips)
Seat 5: c0a415e7 ($4.65 in chips)
Seat 6: d3ab8cb0 ($5 in chips)
c6bf1d22: posts small blind $0.02
Hero: posts big blind $0.05
*** HOLE CARDS ***
Dealt to e69446ee 
Dealt to c6bf1d22 
Dealt to Hero [5c 8c]
Dealt to 53d2996c 
Dealt to c0a415e7 
Dealt to d3ab8cb0 
53d2996c: folds
c0a415e7: folds
d3ab8cb0: raises $0.05 to $0.1
e69446ee: folds
c6bf1d22: folds
Hero: folds
Uncalled bet ($0.05) returned to d3ab8cb0
*** SHOWDOWN ***
d3ab8cb0 collected $0.12 from pot
*** SUMMARY ***
Total pot $0.12 | Rake $0 | Jackpot $0 | Bingo $0 | Fortune $0 | Tax $0
Seat 1: e69446ee (button) folded before Flop (didn't bet)
Seat 2: c6bf1d22 (small blind) folded before Flop
Seat 3: Hero (big blind) folded before Flop
Seat 4: 53d2996c folded before Flop (didn't bet)
Seat 5: c0a415e7 folded before Flop (didn't bet)
Seat 6: d3ab8cb0 collected ($0.12)


Poker Hand #RC2078480879: Hold'em No Limit ($0.02/$0.05) - 2023/12/22 21:22:02
Table 'RushAndCash785821' 6-max Seat #1 is the button
Seat 1: Hero ($7.12 in chips)
Seat 2: 2823eab6 ($3.32 in chips)
Seat 3: 73c8f8b5 ($5.06 in chips)
Seat 4: 7e84e7dc ($14.53 in chips)
Seat 5: c8389234 ($10.4 in chips)
Seat 6: c71b7029 ($8.68 in chips)
2823eab6: posts small blind $0.02
73c8f8b5: posts big blind $0.05
*** HOLE CARDS ***
Dealt to Hero [Kd 4s]
Dealt to 2823eab6 
Dealt to 73c8f8b5 
Dealt to 7e84e7dc 
Dealt to c8389234 
Dealt to c71b7029 
7e84e7dc: folds
c8389234: raises $0.1 to $0.15
c71b7029: folds
Hero: folds
2823eab6: folds
73c8f8b5: folds
Uncalled bet ($0.1) returned to c8389234
*** SHOWDOWN ***
c8389234 collected $0.12 from pot
*** SUMMARY ***
Total pot $0.12 | Rake $0 | Jackpot $0 | Bingo $0 | Fortune $0 | Tax $0
Seat 1: Hero (button) folded before Flop (didn't bet)
Seat 2: 2823eab6 (small blind) folded before Flop
Seat 3: 73c8f8b5 (big blind) folded before Flop
Seat 4: 7e84e7dc folded before Flop (didn't bet)
Seat 5: c8389234 collected ($0.12)
Seat 6: c71b7029 folded before Flop (didn't bet)


Poker Hand #RC2078480751: Hold'em No Limit ($0.02/$0.05) - 2023/12/22 21:21:54
Table 'RushAndCash785753' 6-max Seat #1 is the button
Seat 1: ca4d7d81 ($7.34 in chips)
Seat 2: Hero ($7.14 in chips)
Seat 3: 463feb61 ($9.83 in chips)
Seat 4: e0b16ddc ($5.25 in chips)
Seat 5: f88f8e87 ($5 in chips)
Seat 6: 3c03eb6e ($6.99 in chips)
Hero: posts small blind $0.02
463feb61: posts big blind $0.05
*** HOLE CARDS ***
Dealt to ca4d7d81 
Dealt to Hero [7s Kd]
Dealt to 463feb61 
Dealt to e0b16ddc 
Dealt to f88f8e87 
Dealt to 3c03eb6e 
e0b16ddc: folds
f88f8e87: raises $0.05 to $0.1
3c03eb6e: folds
ca4d7d81: calls $0.1
Hero: folds
463feb61: folds
*** FLOP *** [9c Tc 5h]
f88f8e87: checks
ca4d7d81: bets $0.22
f88f8e87: folds
Uncalled bet ($0.22) returned to ca4d7d81
*** SHOWDOWN ***
ca4d7d81 collected $0.26 from pot
*** SUMMARY ***
Total pot $0.27 | Rake $0.01 | Jackpot $0 | Bingo $0 | Fortune $0 | Tax $0
Board [9c Tc 5h]
Seat 1: ca4d7d81 (button) won ($0.26)
Seat 2: Hero (small blind) folded before Flop
Seat 3: 463feb61 (big blind) folded before Flop
Seat 4: e0b16ddc folded before Flop (didn't bet)
Seat 5: f88f8e87 folded on the Flop
Seat 6: 3c03eb6e folded before Flop (didn't bet)


Poker Hand #RC2078480690: Hold'em No Limit ($0.02/$0.05) - 2023/12/22 21:21:50
Table 'RushAndCash785723' 6-max Seat #1 is the button
Seat 1: ef1573b1 ($5.51 in chips)
Seat 2: f43dd94b ($5.21 in chips)
Seat 3: acefe839 ($17.97 in chips)
Seat 4: c71b7029 ($8.68 in chips)
Seat 5: 97e7da6 ($6.04 in chips)
Seat 6: Hero ($7.14 in chips)
f43dd94b: posts small blind $0.02
acefe839: posts big blind $0.05
*** HOLE CARDS ***
Dealt to ef1573b1 
Dealt to f43dd94b 
Dealt to acefe839 
Dealt to c71b7029 
Dealt to 97e7da6 
Dealt to Hero [3d 9h]
c71b7029: folds
97e7da6: folds
Hero: folds
ef1573b1: folds
f43dd94b: folds
Uncalled bet ($0.03) returned to acefe839
*** SHOWDOWN ***
acefe839 collected $0.04 from pot
*** SUMMARY ***
Total pot $0.04 | Rake $0 | Jackpot $0 | Bingo $0 | Fortune $0 | Tax $0
Seat 1: ef1573b1 (button) folded before Flop (didn't bet)
Seat 2: f43dd94b (small blind) folded before Flop
Seat 3: acefe839 (big blind) collected ($0.04)
Seat 4: c71b7029 folded before Flop (didn't bet)
Seat 5: 97e7da6 folded before Flop (didn't bet)
Seat 6: Hero folded before Flop (didn't bet)


Poker Hand #RC2078480608: Hold'em No Limit ($0.02/$0.05) - 2023/12/22 21:21:45
Table 'RushAndCash785685' 6-max Seat #1 is the button
Seat 1: 463feb61 ($9.76 in chips)
Seat 2: c8f603a8 ($3.96 in chips)
Seat 3: 91937678 ($6.09 in chips)
Seat 4: 6029883b ($5.93 in chips)
Seat 5: d56f57b9 ($10.22 in chips)
Seat 6: Hero ($7.14 in chips)
c8f603a8: posts small blind $0.02
91937678: posts big blind $0.05
*** HOLE CARDS ***
Dealt to 463feb61 
Dealt to c8f603a8 
Dealt to 91937678 
Dealt to 6029883b 
Dealt to d56f57b9 
Dealt to Hero [2c Ah]
6029883b: folds
d56f57b9: folds
Hero: folds
463feb61: raises $0.1 to $0.15
c8f603a8: folds
91937678: folds
Uncalled bet ($0.1) returned to 463feb61
*** SHOWDOWN ***
463feb61 collected $0.12 from pot
*** SUMMARY ***
Total pot $0.12 | Rake $0 | Jackpot $0 | Bingo $0 | Fortune $0 | Tax $0
Seat 1: 463feb61 (button) collected ($0.12)
Seat 2: c8f603a8 (small blind) folded before Flop
Seat 3: 91937678 (big blind) folded before Flop
Seat 4: 6029883b folded before Flop (didn't bet)
Seat 5: d56f57b9 folded before Flop (didn't bet)
Seat 6: Hero folded before Flop (didn't bet)


Poker Hand #RC2078480406: Hold'em No Limit ($0.02/$0.05) - 2023/12/22 21:21:34
Table 'RushAndCash785594' 6-max Seat #1 is the button
Seat 1: 89a27c2 ($4.79 in chips)
Seat 2: Hero ($7.16 in chips)
Seat 3: b2b4173f ($3.13 in chips)
Seat 4: 6c94c615 ($5 in chips)
Seat 5: 5b2bf61b ($5.36 in chips)
Seat 6: 610bd7fc ($10.95 in chips)
Hero: posts small blind $0.02
b2b4173f: posts big blind $0.05
*** HOLE CARDS ***
Dealt to 89a27c2 
Dealt to Hero [Jc Ks]
Dealt to b2b4173f 
Dealt to 6c94c615 
Dealt to 5b2bf61b 
Dealt to 610bd7fc 
6c94c615: raises $0.08 to $0.13
5b2bf61b: folds
610bd7fc: folds
89a27c2: folds
Hero: folds
b2b4173f: calls $0.08
*** FLOP *** [Ts 2c Kh]
b2b4173f: checks
6c94c615: bets $0.1
b2b4173f: folds
Uncalled bet ($0.1) returned to 6c94c615
*** SHOWDOWN ***
6c94c615 collected $0.27 from pot
*** SUMMARY ***
Total pot $0.28 | Rake $0.01 | Jackpot $0 | Bingo $0 | Fortune $0 | Tax $0
Board [Ts 2c Kh]
Seat 1: 89a27c2 (button) folded before Flop (didn't bet)
Seat 2: Hero (small blind) folded before Flop
Seat 3: b2b4173f (big blind) folded on the Flop
Seat 4: 6c94c615 won ($0.27)
Seat 5: 5b2bf61b folded before Flop (didn't bet)
Seat 6: 610bd7fc folded before Flop (didn't bet)


Poker Hand #RC2078480003: Hold'em No Limit ($0.02/$0.05) - 2023/12/22 21:21:12
Table 'RushAndCash785408' 6-max Seat #1 is the button
Seat 1: 81f9a1e6 ($17.75 in chips)
Seat 2: 9af3794b ($5 in chips)
Seat 3: Hero ($6.75 in chips)
Seat 4: cdd2600a ($0.43 in chips)
Seat 5: 6484c2 ($5 in chips)
Seat 6: 8ad5eb6 ($5.4 in chips)
9af3794b: posts small blind $0.02
Hero: posts big blind $0.05
*** HOLE CARDS ***
Dealt to 81f9a1e6 
Dealt to 9af3794b 
Dealt to Hero [Jh Jd]
Dealt to cdd2600a 
Dealt to 6484c2 
Dealt to 8ad5eb6 
cdd2600a: raises $0.38 to $0.43 and is all-in
6484c2: folds
8ad5eb6: folds
81f9a1e6: folds
9af3794b: folds
Hero: calls $0.38
cdd2600a: shows [Qs 5s]
Hero: shows [Jh Jd]
*** FLOP *** [9s 5h 9d]
*** TURN *** [9s 5h 9d] [4s]
*** RIVER *** [9s 5h 9d 4s] [6c]
*** SHOWDOWN ***
Hero collected $0.84 from pot
*** SUMMARY ***
Total pot $0.88 | Rake $0.04 | Jackpot $0 | Bingo $0 | Fortune $0 | Tax $0
Board [9s 5h 9d 4s 6c]
Seat 1: 81f9a1e6 (button) folded before Flop (didn't bet)
Seat 2: 9af3794b (small blind) folded before Flop
Seat 3: Hero (big blind) showed [Jh Jd] and won ($0.84) with Pair of Jacks and Pair of Nines
Seat 4: cdd2600a showed [Qs 5s] and lost with Pair of Nines and Pair of Fives
Seat 5: 6484c2 folded before Flop (didn't bet)
Seat 6: 8ad5eb6 folded before Flop (didn't bet)


Poker Hand #RC2078479642: Hold'em No Limit ($0.02/$0.05) - 2023/12/22 21:20:51
Table 'RushAndCash785241' 6-max Seat #1 is the button
Seat 1: Hero ($6.88 in chips)
Seat 2: 52749f9e ($5 in chips)
Seat 3: 27517d94 ($7.15 in chips)
Seat 4: 11612373 ($13.46 in chips)
Seat 5: 78c7aa39 ($5.19 in chips)
Seat 6: 11676b65 ($5.12 in chips)
52749f9e: posts small blind $0.02
27517d94: posts big blind $0.05
*** HOLE CARDS ***
Dealt to Hero [Jd As]
Dealt to 52749f9e 
Dealt to 27517d94 
Dealt to 11612373 
Dealt to 78c7aa39 
Dealt to 11676b65 
11612373: folds
78c7aa39: folds
11676b65: folds
Hero: raises $0.08 to $0.13
52749f9e: raises $0.37 to $0.5
27517d94: folds
Hero: folds
Uncalled bet ($0.37) returned to 52749f9e
*** SHOWDOWN ***
52749f9e collected $0.3 from pot
*** SUMMARY ***
Total pot $0.31 | Rake $0.01 | Jackpot $0 | Bingo $0 | Fortune $0 | Tax $0
Seat 1: Hero (button) folded before Flop
Seat 2: 52749f9e (small blind) collected ($0.3)
Seat 3: 27517d94 (big blind) folded before Flop
Seat 4: 11612373 folded before Flop (didn't bet)
Seat 5: 78c7aa39 folded before Flop (didn't bet)
Seat 6: 11676b65 folded before Flop (didn't bet)


Poker Hand #RC2078479585: Hold'em No Limit ($0.02/$0.05) - 2023/12/22 21:20:48
Table 'RushAndCash785213' 6-max Seat #1 is the button
Seat 1: 697fb04a ($46.95 in chips)
Seat 2: ab5dffec ($7.34 in chips)
Seat 3: cbfe1acc ($7.76 in chips)
Seat 4: fc09aaf ($1.85 in chips)
Seat 5: 177da66b ($5.89 in chips)
Seat 6: Hero ($6.88 in chips)
ab5dffec: posts small blind $0.02
cbfe1acc: posts big blind $0.05
*** HOLE CARDS ***
Dealt to 697fb04a 
Dealt to ab5dffec 
Dealt to cbfe1acc 
Dealt to fc09aaf 
Dealt to 177da66b 
Dealt to Hero [9c Js]
fc09aaf: folds
177da66b: raises $0.08 to $0.13
Hero: folds
697fb04a: folds
ab5dffec: folds
cbfe1acc: folds
Uncalled bet ($0.08) returned to 177da66b
*** SHOWDOWN ***
177da66b collected $0.12 from pot
*** SUMMARY ***
Total pot $0.12 | Rake $0 | Jackpot $0 | Bingo $0 | Fortune $0 | Tax $0
Seat 1: 697fb04a (button) folded before Flop (didn't bet)
Seat 2: ab5dffec (small blind) folded before Flop
Seat 3: cbfe1acc (big blind) folded before Flop
Seat 4: fc09aaf folded before Flop (didn't bet)
Seat 5: 177da66b collected ($0.12)
Seat 6: Hero folded before Flop (didn't bet)


Poker Hand #RC2078479512: Hold'em No Limit ($0.02/$0.05) - 2023/12/22 21:20:44
Table 'RushAndCash785180' 6-max Seat #1 is the button
Seat 1: 998574b7 ($5 in chips)
Seat 2: 3288926 ($9.88 in chips)
Seat 3: 2e44f78e ($13.53 in chips)
Seat 4: Hero ($6.88 in chips)
Seat 5: 548ecbec ($6.41 in chips)
Seat 6: 3e2e2010 ($7.08 in chips)
3288926: posts small blind $0.02
2e44f78e: posts big blind $0.05
*** HOLE CARDS ***
Dealt to 998574b7 
Dealt to 3288926 
Dealt to 2e44f78e 
Dealt to Hero [8d 4d]
Dealt to 548ecbec 
Dealt to 3e2e2010 
Hero: folds
548ecbec: raises $0.08 to $0.13
3e2e2010: raises $0.27 to $0.4
998574b7: folds
3288926: folds
2e44f78e: folds
548ecbec: folds
Uncalled bet ($0.27) returned to 3e2e2010
*** SHOWDOWN ***
3e2e2010 collected $0.32 from pot
*** SUMMARY ***
Total pot $0.33 | Rake $0.01 | Jackpot $0 | Bingo $0 | Fortune $0 | Tax $0
Seat 1: 998574b7 (button) folded before Flop (didn't bet)
Seat 2: 3288926 (small blind) folded before Flop
Seat 3: 2e44f78e (big blind) folded before Flop
Seat 4: Hero folded before Flop (didn't bet)
Seat 5: 548ecbec folded before Flop
Seat 6: 3e2e2010 collected ($0.32)


Poker Hand #RC2078479085: Hold'em No Limit ($0.02/$0.05) - 2023/12/22 21:20:18
Table 'RushAndCash784971' 6-max Seat #1 is the button
Seat 1: ddbe951e ($9.91 in chips)
Seat 2: 98124327 ($5.02 in chips)
Seat 3: Hero ($7 in chips)
Seat 4: 2c867a7e ($13.79 in chips)
Seat 5: d6d8d23b ($6.62 in chips)
Seat 6: e7562cd9 ($5 in chips)
98124327: posts small blind $0.02
Hero: posts big blind $0.05
*** HOLE CARDS ***
Dealt to ddbe951e 
Dealt to 98124327 
Dealt to Hero [Jd Ks]
Dealt to 2c867a7e 
Dealt to d6d8d23b 
Dealt to e7562cd9 
2c867a7e: folds
d6d8d23b: folds
e7562cd9: folds
ddbe951e: folds
98124327: raises $0.07 to $0.12
Hero: calls $0.07
*** FLOP *** [Ac 7h 5s]
98124327: bets $0.08
Hero: folds
Uncalled bet ($0.08) returned to 98124327
*** SHOWDOWN ***
98124327 collected $0.23 from pot
*** SUMMARY ***
Total pot $0.24 | Rake $0.01 | Jackpot $0 | Bingo $0 | Fortune $0 | Tax $0
Board [Ac 7h 5s]
Seat 1: ddbe951e (button) folded before Flop (didn't bet)
Seat 2: 98124327 (small blind) won ($0.23)
Seat 3: Hero (big blind) folded on the Flop
Seat 4: 2c867a7e folded before Flop (didn't bet)
Seat 5: d6d8d23b folded before Flop (didn't bet)
Seat 6: e7562cd9 folded before Flop (didn't bet)


Poker Hand #RC2078478444: Hold'em No Limit ($0.02/$0.05) - 2023/12/22 21:19:40
Table 'RushAndCash784658' 6-max Seat #1 is the button
Seat 1: a2edfbd1 ($2.22 in chips)
Seat 2: Hero ($7.02 in chips)
Seat 3: bd4a4d17 ($18.76 in chips)
Seat 4: fba7efa6 ($9.06 in chips)
Seat 5: 9fd86997 ($21.13 in chips)
Seat 6: 8aaa95a5 ($4.49 in chips)
Hero: posts small blind $0.02
bd4a4d17: posts big blind $0.05
*** HOLE CARDS ***
Dealt to a2edfbd1 
Dealt to Hero [Jd 6c]
Dealt to bd4a4d17 
Dealt to fba7efa6 
Dealt to 9fd86997 
Dealt to 8aaa95a5 
fba7efa6: folds
9fd86997: folds
8aaa95a5: folds
a2edfbd1: folds
Hero: folds
Uncalled bet ($0.03) returned to bd4a4d17
*** SHOWDOWN ***
bd4a4d17 collected $0.04 from pot
*** SUMMARY ***
Total pot $0.04 | Rake $0 | Jackpot $0 | Bingo $0 | Fortune $0 | Tax $0
Seat 1: a2edfbd1 (button) folded before Flop (didn't bet)
Seat 2: Hero (small blind) folded before Flop
Seat 3: bd4a4d17 (big blind) collected ($0.04)
Seat 4: fba7efa6 folded before Flop (didn't bet)
Seat 5: 9fd86997 folded before Flop (didn't bet)
Seat 6: 8aaa95a5 folded before Flop (didn't bet)


Poker Hand #RC2078477929: Hold'em No Limit ($0.02/$0.05) - 2023/12/22 21:19:11
Table 'RushAndCash784418' 6-max Seat #1 is the button
Seat 1: 59c7f4b1 ($6.74 in chips)
Seat 2: 3b613695 ($8.51 in chips)
Seat 3: 42b297d3 ($2.24 in chips)
Seat 4: 72f7386e ($12.16 in chips)
Seat 5: Hero ($6.95 in chips)
Seat 6: 11612373 ($13.76 in chips)
3b613695: posts small blind $0.02
42b297d3: posts big blind $0.05
*** HOLE CARDS ***
Dealt to 59c7f4b1 
Dealt to 3b613695 
Dealt to 42b297d3 
Dealt to 72f7386e 
Dealt to Hero [Jd Jc]
Dealt to 11612373 
72f7386e: folds
Hero: raises $0.05 to $0.1
11612373: folds
59c7f4b1: folds
3b613695: folds
42b297d3: folds
Uncalled bet ($0.05) returned to Hero
*** SHOWDOWN ***
Hero collected $0.12 from pot
*** SUMMARY ***
Total pot $0.12 | Rake $0 | Jackpot $0 | Bingo $0 | Fortune $0 | Tax $0
Seat 1: 59c7f4b1 (button) folded before Flop (didn't bet)
Seat 2: 3b613695 (small blind) folded before Flop
Seat 3: 42b297d3 (big blind) folded before Flop
Seat 4: 72f7386e folded before Flop (didn't bet)
Seat 5: Hero collected ($0.12)
Seat 6: 11612373 folded before Flop (didn't bet)


Poker Hand #RC2078477848: Hold'em No Limit ($0.02/$0.05) - 2023/12/22 21:19:06
Table 'RushAndCash784380' 6-max Seat #1 is the button
Seat 1: 8e4ad426 ($5 in chips)
Seat 2: ac89ef05 ($8.7 in chips)
Seat 3: 6524c228 ($5.28 in chips)
Seat 4: cea6060f ($5.23 in chips)
Seat 5: 317ccf77 ($3.16 in chips)
Seat 6: Hero ($6.95 in chips)
ac89ef05: posts small blind $0.02
6524c228: posts big blind $0.05
*** HOLE CARDS ***
Dealt to 8e4ad426 
Dealt to ac89ef05 
Dealt to 6524c228 
Dealt to cea6060f 
Dealt to 317ccf77 
Dealt to Hero [2s 7s]
cea6060f: folds
317ccf77: folds
Hero: folds
8e4ad426: folds
ac89ef05: raises $0.1 to $0.15
6524c228: calls $0.1
*** FLOP *** [Jh 5c 9h]
ac89ef05: bets $0.11
6524c228: calls $0.11
*** TURN *** [Jh 5c 9h] [4c]
ac89ef05: checks
6524c228: checks
*** RIVER *** [Jh 5c 9h 4c] [Ac]
ac89ef05: bets $0.1
6524c228: calls $0.1
ac89ef05: shows [3c 3h] (Pair of Treys)
6524c228: shows [5d Kc] (Pair of Fives)
*** SHOWDOWN ***
6524c228 collected $0.69 from pot
*** SUMMARY ***
Total pot $0.72 | Rake $0.03 | Jackpot $0 | Bingo $0 | Fortune $0 | Tax $0
Board [Jh 5c 9h 4c Ac]
Seat 1: 8e4ad426 (button) folded before Flop (didn't bet)
Seat 2: ac89ef05 (small blind) showed [3c 3h] and lost with Pair of Treys
Seat 3: 6524c228 (big blind) showed [5d Kc] and won ($0.69) with Pair of Fives
Seat 4: cea6060f folded before Flop (didn't bet)
Seat 5: 317ccf77 folded before Flop (didn't bet)
Seat 6: Hero folded before Flop (didn't bet)


Poker Hand #RC2078477786: Hold'em No Limit ($0.02/$0.05) - 2023/12/22 21:19:02
Table 'RushAndCash784348' 6-max Seat #1 is the button
Seat 1: adc999b ($13.94 in chips)
Seat 2: 81f9a1e6 ($16.6 in chips)
Seat 3: 8f6f063c ($7.58 in chips)
Seat 4: f9adeea ($5.02 in chips)
Seat 5: 93990934 ($8.52 in chips)
Seat 6: Hero ($6.95 in chips)
81f9a1e6: posts small blind $0.02
8f6f063c: posts big blind $0.05
*** HOLE CARDS ***
Dealt to adc999b 
Dealt to 81f9a1e6 
Dealt to 8f6f063c 
Dealt to f9adeea 
Dealt to 93990934 
Dealt to Hero [9d 6s]
f9adeea: folds
93990934: raises $0.1 to $0.15
Hero: folds
adc999b: raises $0.25 to $0.4
81f9a1e6: folds
8f6f063c: folds
93990934: folds
Uncalled bet ($0.25) returned to adc999b
*** SHOWDOWN ***
adc999b collected $0.36 from pot
*** SUMMARY ***
Total pot $0.37 | Rake $0.01 | Jackpot $0 | Bingo $0 | Fortune $0 | Tax $0
Seat 1: adc999b (button) collected ($0.36)
Seat 2: 81f9a1e6 (small blind) folded before Flop
Seat 3: 8f6f063c (big blind) folded before Flop
Seat 4: f9adeea folded before Flop (didn't bet)
Seat 5: 93990934 folded before Flop
Seat 6: Hero folded before Flop (didn't bet)


Poker Hand #RC2078477685: Hold'em No Limit ($0.02/$0.05) - 2023/12/22 21:18:56
Table 'RushAndCash784297' 6-max Seat #1 is the button
Seat 1: Hero ($6.95 in chips)
Seat 2: 983d74a ($7.8 in chips)
Seat 3: d2739eda ($2.53 in chips)
Seat 4: 680eb0e1 ($10.46 in chips)
Seat 5: 4dab75d6 ($4.93 in chips)
Seat 6: 517da49 ($6.29 in chips)
983d74a: posts small blind $0.02
d2739eda: posts big blind $0.05
*** HOLE CARDS ***
Dealt to Hero [4c Kd]
Dealt to 983d74a 
Dealt to d2739eda 
Dealt to 680eb0e1 
Dealt to 4dab75d6 
Dealt to 517da49 
680eb0e1: folds
4dab75d6: folds
517da49: raises $0.07 to $0.12
Hero: folds
983d74a: folds
d2739eda: calls $0.07
*** FLOP *** [6c Ac 5s]
d2739eda: checks
517da49: checks
*** TURN *** [6c Ac 5s] [3d]
d2739eda: checks
517da49: bets $0.12
d2739eda: folds
Uncalled bet ($0.12) returned to 517da49
*** SHOWDOWN ***
517da49 collected $0.25 from pot
*** SUMMARY ***
Total pot $0.26 | Rake $0.01 | Jackpot $0 | Bingo $0 | Fortune $0 | Tax $0
Board [6c Ac 5s 3d]
Seat 1: Hero (button) folded before Flop (didn't bet)
Seat 2: 983d74a (small blind) folded before Flop
Seat 3: d2739eda (big blind) folded on the Turn
Seat 4: 680eb0e1 folded before Flop (didn't bet)
Seat 5: 4dab75d6 folded before Flop (didn't bet)
Seat 6: 517da49 won ($0.25)


Poker Hand #RC2078477604: Hold'em No Limit ($0.02/$0.05) - 2023/12/22 21:18:51
Table 'RushAndCash784257' 6-max Seat #1 is the button
Seat 1: 81f9a1e6 ($16.53 in chips)
Seat 2: Hero ($6.97 in chips)
Seat 3: 7c10f852 ($23.93 in chips)
Seat 4: b1e42a90 ($5.67 in chips)
Seat 5: cd339031 ($5 in chips)
Seat 6: c2881b52 ($12.29 in chips)
Hero: posts small blind $0.02
7c10f852: posts big blind $0.05
*** HOLE CARDS ***
Dealt to 81f9a1e6 
Dealt to Hero [2c 6s]
Dealt to 7c10f852 
Dealt to b1e42a90 
Dealt to cd339031 
Dealt to c2881b52 
b1e42a90: folds
cd339031: folds
c2881b52: folds
81f9a1e6: raises $0.06 to $0.11
Hero: folds
7c10f852: folds
Uncalled bet ($0.06) returned to 81f9a1e6
*** SHOWDOWN ***
81f9a1e6 collected $0.12 from pot
*** SUMMARY ***
Total pot $0.12 | Rake $0 | Jackpot $0 | Bingo $0 | Fortune $0 | Tax $0
Seat 1: 81f9a1e6 (button) collected ($0.12)
Seat 2: Hero (small blind) folded before Flop
Seat 3: 7c10f852 (big blind) folded before Flop
Seat 4: b1e42a90 folded before Flop (didn't bet)
Seat 5: cd339031 folded before Flop (didn't bet)
Seat 6: c2881b52 folded before Flop (didn't bet)


Poker Hand #RC2078477544: Hold'em No Limit ($0.02/$0.05) - 2023/12/22 21:18:47
Table 'RushAndCash784225' 6-max Seat #1 is the button
Seat 1: cb9a7609 ($5 in chips)
Seat 2: 1ab06c8f ($5.18 in chips)
Seat 3: 7b2861ec ($9.89 in chips)
Seat 4: 9af3794b ($5.38 in chips)
Seat 5: 2f89a0 ($5.37 in chips)
Seat 6: Hero ($6.97 in chips)
1ab06c8f: posts small blind $0.02
7b2861ec: posts big blind $0.05
*** HOLE CARDS ***
Dealt to cb9a7609 
Dealt to 1ab06c8f 
Dealt to 7b2861ec 
Dealt to 9af3794b 
Dealt to 2f89a0 
Dealt to Hero [4h 7h]
9af3794b: folds
2f89a0: folds
Hero: folds
cb9a7609: raises $0.08 to $0.13
1ab06c8f: folds
7b2861ec: folds
Uncalled bet ($0.08) returned to cb9a7609
*** SHOWDOWN ***
cb9a7609 collected $0.12 from pot
*** SUMMARY ***
Total pot $0.12 | Rake $0 | Jackpot $0 | Bingo $0 | Fortune $0 | Tax $0
Seat 1: cb9a7609 (button) collected ($0.12)
Seat 2: 1ab06c8f (small blind) folded before Flop
Seat 3: 7b2861ec (big blind) folded before Flop
Seat 4: 9af3794b folded before Flop (didn't bet)
Seat 5: 2f89a0 folded before Flop (didn't bet)
Seat 6: Hero folded before Flop (didn't bet)


Poker Hand #RC2078477403: Hold'em No Limit ($0.02/$0.05) - 2023/12/22 21:18:40
Table 'RushAndCash784154' 6-max Seat #1 is the button
Seat 1: 801c157f ($22.92 in chips)
Seat 2: b19c761e ($2.4 in chips)
Seat 3: de3b84bb ($25.43 in chips)
Seat 4: Hero ($6.97 in chips)
Seat 5: 5f6686b6 ($2.52 in chips)
Seat 6: dc7cff29 ($5.64 in chips)
b19c761e: posts small blind $0.02
de3b84bb: posts big blind $0.05
*** HOLE CARDS ***
Dealt to 801c157f 
Dealt to b19c761e 
Dealt to de3b84bb 
Dealt to Hero [3h 4c]
Dealt to 5f6686b6 
Dealt to dc7cff29 
Hero: folds
5f6686b6: folds
dc7cff29: folds
801c157f: raises $0.05 to $0.1
b19c761e: calls $0.08
de3b84bb: calls $0.05
*** FLOP *** [5d Ac 6s]
b19c761e: checks
de3b84bb: checks
801c157f: checks
*** TURN *** [5d Ac 6s] [6h]
b19c761e: checks
de3b84bb: checks
801c157f: checks
*** RIVER *** [5d Ac 6s 6h] [2d]
b19c761e: checks
de3b84bb: bets $0.23
801c157f: folds
b19c761e: folds
Uncalled bet ($0.23) returned to de3b84bb
de3b84bb: shows [3c Ts] (Pair of Sixes)
*** SHOWDOWN ***
de3b84bb collected $0.29 from pot
*** SUMMARY ***
Total pot $0.3 | Rake $0.01 | Jackpot $0 | Bingo $0 | Fortune $0 | Tax $0
Board [5d Ac 6s 6h 2d]
Seat 1: 801c157f (button) folded on the River
Seat 2: b19c761e (small blind) folded on the River
Seat 3: de3b84bb (big blind) showed [3c Ts] and won ($0.29)
Seat 4: Hero folded before Flop (didn't bet)
Seat 5: 5f6686b6 folded before Flop (didn't bet)
Seat 6: dc7cff29 folded before Flop (didn't bet)


Poker Hand #RC2078477315: Hold'em No Limit ($0.02/$0.05) - 2023/12/22 21:18:35
Table 'RushAndCash784109' 6-max Seat #1 is the button
Seat 1: 3b87467 ($7.57 in chips)
Seat 2: 610bd7fc ($11.32 in chips)
Seat 3: Hero ($7.02 in chips)
Seat 4: cb9a7609 ($5 in chips)
Seat 5: c0d3508b ($5.2 in chips)
Seat 6: 983d74a ($7.78 in chips)
610bd7fc: posts small blind $0.02
Hero: posts big blind $0.05
*** HOLE CARDS ***
Dealt to 3b87467 
Dealt to 610bd7fc 
Dealt to Hero [Qs 7c]
Dealt to cb9a7609 
Dealt to c0d3508b 
Dealt to 983d74a 
cb9a7609: folds
c0d3508b: raises $0.1 to $0.15
983d74a: folds
3b87467: folds
610bd7fc: folds
Hero: folds
Uncalled bet ($0.1) returned to c0d3508b
*** SHOWDOWN ***
c0d3508b collected $0.12 from pot
*** SUMMARY ***
Total pot $0.12 | Rake $0 | Jackpot $0 | Bingo $0 | Fortune $0 | Tax $0
Seat 1: 3b87467 (button) folded before Flop (didn't bet)
Seat 2: 610bd7fc (small blind) folded before Flop
Seat 3: Hero (big blind) folded before Flop
Seat 4: cb9a7609 folded before Flop (didn't bet)
Seat 5: c0d3508b collected ($0.12)
Seat 6: 983d74a folded before Flop (didn't bet)


Poker Hand #RC2078477124: Hold'em No Limit ($0.02/$0.05) - 2023/12/22 21:18:24
Table 'RushAndCash784009' 6-max Seat #1 is the button
Seat 1: Hero ($7.02 in chips)
Seat 2: 913692c3 ($6.15 in chips)
Seat 3: ad963d07 ($5.27 in chips)
Seat 4: 59846dec ($6.73 in chips)
Seat 5: f2f8c789 ($19.32 in chips)
Seat 6: 174ad468 ($5.5 in chips)
913692c3: posts small blind $0.02
ad963d07: posts big blind $0.05
*** HOLE CARDS ***
Dealt to Hero [Js 6s]
Dealt to 913692c3 
Dealt to ad963d07 
Dealt to 59846dec 
Dealt to f2f8c789 
Dealt to 174ad468 
59846dec: folds
f2f8c789: folds
174ad468: folds
Hero: folds
913692c3: folds
Uncalled bet ($0.03) returned to ad963d07
*** SHOWDOWN ***
ad963d07 collected $0.04 from pot
*** SUMMARY ***
Total pot $0.04 | Rake $0 | Jackpot $0 | Bingo $0 | Fortune $0 | Tax $0
Seat 1: Hero (button) folded before Flop (didn't bet)
Seat 2: 913692c3 (small blind) folded before Flop
Seat 3: ad963d07 (big blind) collected ($0.04)
Seat 4: 59846dec folded before Flop (didn't bet)
Seat 5: f2f8c789 folded before Flop (didn't bet)
Seat 6: 174ad468 folded before Flop (didn't bet)


Poker Hand #RC2078476976: Hold'em No Limit ($0.02/$0.05) - 2023/12/22 21:18:15
Table 'RushAndCash783935' 6-max Seat #1 is the button
Seat 1: 869465ff ($14.88 in chips)
Seat 2: Hero ($7.04 in chips)
Seat 3: b18917a1 ($5 in chips)
Seat 4: 6bd97a49 ($17.18 in chips)
Seat 5: d51e5ac3 ($5.27 in chips)
Seat 6: ffe24a9e ($5 in chips)
Hero: posts small blind $0.02
b18917a1: posts big blind $0.05
*** HOLE CARDS ***
Dealt to 869465ff 
Dealt to Hero [Ac 4d]
Dealt to b18917a1 
Dealt to 6bd97a49 
Dealt to d51e5ac3 
Dealt to ffe24a9e 
6bd97a49: folds
d51e5ac3: folds
ffe24a9e: raises $0.05 to $0.1
869465ff: folds
Hero: folds
b18917a1: folds
Uncalled bet ($0.05) returned to ffe24a9e
*** SHOWDOWN ***
ffe24a9e collected $0.12 from pot
*** SUMMARY ***
Total pot $0.12 | Rake $0 | Jackpot $0 | Bingo $0 | Fortune $0 | Tax $0
Seat 1: 869465ff (button) folded before Flop (didn't bet)
Seat 2: Hero (small blind) folded before Flop
Seat 3: b18917a1 (big blind) folded before Flop
Seat 4: 6bd97a49 folded before Flop (didn't bet)
Seat 5: d51e5ac3 folded before Flop (didn't bet)
Seat 6: ffe24a9e collected ($0.12)


Poker Hand #RC2078476912: Hold'em No Limit ($0.02/$0.05) - 2023/12/22 21:18:11
Table 'RushAndCash783904' 6-max Seat #1 is the button
Seat 1: 39e048a4 ($5.57 in chips)
Seat 2: 4aa2dd0a ($6.01 in chips)
Seat 3: 58864a6e ($20.14 in chips)
Seat 4: 4ab8a557 ($8.82 in chips)
Seat 5: Hero ($7.04 in chips)
Seat 6: 29e18081 ($5.53 in chips)
4aa2dd0a: posts small blind $0.02
58864a6e: posts big blind $0.05
*** HOLE CARDS ***
Dealt to 39e048a4 
Dealt to 4aa2dd0a 
Dealt to 58864a6e 
Dealt to 4ab8a557 
Dealt to Hero [2s 7h]
Dealt to 29e18081 
4ab8a557: folds
Hero: folds
29e18081: raises $0.07 to $0.12
39e048a4: folds
4aa2dd0a: calls $0.1
58864a6e: raises $0.58 to $0.7
29e18081: folds
4aa2dd0a: folds
Uncalled bet ($0.58) returned to 58864a6e
*** SHOWDOWN ***
58864a6e collected $0.35 from pot
*** SUMMARY ***
Total pot $0.36 | Rake $0.01 | Jackpot $0 | Bingo $0 | Fortune $0 | Tax $0
Seat 1: 39e048a4 (button) folded before Flop (didn't bet)
Seat 2: 4aa2dd0a (small blind) folded before Flop
Seat 3: 58864a6e (big blind) collected ($0.35)
Seat 4: 4ab8a557 folded before Flop (didn't bet)
Seat 5: Hero folded before Flop (didn't bet)
Seat 6: 29e18081 folded before Flop


Poker Hand #RC2078476381: Hold'em No Limit ($0.02/$0.05) - 2023/12/22 21:17:41
Table 'RushAndCash783650' 6-max Seat #1 is the button
Seat 1: Hero ($7.17 in chips)
Seat 2: 9674377d ($1.75 in chips)
Seat 3: 4aa2dd0a ($5.87 in chips)
Seat 4: ffe24a9e ($5 in chips)
Seat 5: dce31b8a ($6.04 in chips)
Seat 6: 6c75362e ($6.12 in chips)
9674377d: posts small blind $0.02
4aa2dd0a: posts big blind $0.05
*** HOLE CARDS ***
Dealt to Hero [Kh Td]
Dealt to 9674377d 
Dealt to 4aa2dd0a 
Dealt to ffe24a9e 
Dealt to dce31b8a 
Dealt to 6c75362e 
ffe24a9e: folds
dce31b8a: folds
6c75362e: folds
Hero: raises $0.08 to $0.13
9674377d: folds
4aa2dd0a: raises $0.42 to $0.55
Hero: folds
Uncalled bet ($0.42) returned to 4aa2dd0a
*** SHOWDOWN ***
4aa2dd0a collected $0.27 from pot
*** SUMMARY ***
Total pot $0.28 | Rake $0.01 | Jackpot $0 | Bingo $0 | Fortune $0 | Tax $0
Seat 1: Hero (button) folded before Flop
Seat 2: 9674377d (small blind) folded before Flop
Seat 3: 4aa2dd0a (big blind) collected ($0.27)
Seat 4: ffe24a9e folded before Flop (didn't bet)
Seat 5: dce31b8a folded before Flop (didn't bet)
Seat 6: 6c75362e folded before Flop (didn't bet)


Poker Hand #RC2078476245: Hold'em No Limit ($0.02/$0.05) - 2023/12/22 21:17:33
Table 'RushAndCash783587' 6-max Seat #1 is the button
Seat 1: 2880461b ($5.09 in chips)
Seat 2: 2ece180e ($5.79 in chips)
Seat 3: 74c8019d ($2.79 in chips)
Seat 4: 20a136d7 ($5.39 in chips)
Seat 5: 29a59401 ($1.32 in chips)
Seat 6: Hero ($7.17 in chips)
2ece180e: posts small blind $0.02
74c8019d: posts big blind $0.05
*** HOLE CARDS ***
Dealt to 2880461b 
Dealt to 2ece180e 
Dealt to 74c8019d 
Dealt to 20a136d7 
Dealt to 29a59401 
Dealt to Hero [5d 4s]
20a136d7: folds
29a59401: folds
Hero: folds
2880461b: folds
2ece180e: folds
Uncalled bet ($0.03) returned to 74c8019d
*** SHOWDOWN ***
74c8019d collected $0.04 from pot
*** SUMMARY ***
Total pot $0.04 | Rake $0 | Jackpot $0 | Bingo $0 | Fortune $0 | Tax $0
Seat 1: 2880461b (button) folded before Flop (didn't bet)
Seat 2: 2ece180e (small blind) folded before Flop
Seat 3: 74c8019d (big blind) collected ($0.04)
Seat 4: 20a136d7 folded before Flop (didn't bet)
Seat 5: 29a59401 folded before Flop (didn't bet)
Seat 6: Hero folded before Flop (didn't bet)


Poker Hand #RC2078476181: Hold'em No Limit ($0.02/$0.05) - 2023/12/22 21:17:30
Table 'RushAndCash783554' 6-max Seat #1 is the button
Seat 1: 9d480ff ($5.04 in chips)
Seat 2: 835e8518 ($5 in chips)
Seat 3: Hero ($7.22 in chips)
Seat 4: 5f87768d ($5 in chips)
Seat 5: f88f8e87 ($5 in chips)
Seat 6: 110b939f ($5.16 in chips)
835e8518: posts small blind $0.02
Hero: posts big blind $0.05
*** HOLE CARDS ***
Dealt to 9d480ff 
Dealt to 835e8518 
Dealt to Hero [Kh 2c]
Dealt to 5f87768d 
Dealt to f88f8e87 
Dealt to 110b939f 
5f87768d: folds
f88f8e87: folds
110b939f: folds
9d480ff: raises $0.05 to $0.1
835e8518: folds
Hero: folds
Uncalled bet ($0.05) returned to 9d480ff
*** SHOWDOWN ***
9d480ff collected $0.12 from pot
*** SUMMARY ***
Total pot $0.12 | Rake $0 | Jackpot $0 | Bingo $0 | Fortune $0 | Tax $0
Seat 1: 9d480ff (button) collected ($0.12)
Seat 2: 835e8518 (small blind) folded before Flop
Seat 3: Hero (big blind) folded before Flop
Seat 4: 5f87768d folded before Flop (didn't bet)
Seat 5: f88f8e87 folded before Flop (didn't bet)
Seat 6: 110b939f folded before Flop (didn't bet)


Poker Hand #RC2078476085: Hold'em No Limit ($0.02/$0.05) - 2023/12/22 21:17:24
Table 'RushAndCash783506' 6-max Seat #1 is the button
Seat 1: 6ffefba2 ($5 in chips)
Seat 2: 2e44f78e ($14.07 in chips)
Seat 3: 4d8d4585 ($5.19 in chips)
Seat 4: 6bd97a49 ($17.18 in chips)
Seat 5: 9674377d ($1.8 in chips)
Seat 6: Hero ($7.22 in chips)
2e44f78e: posts small blind $0.02
4d8d4585: posts big blind $0.05
*** HOLE CARDS ***
Dealt to 6ffefba2 
Dealt to 2e44f78e 
Dealt to 4d8d4585 
Dealt to 6bd97a49 
Dealt to 9674377d 
Dealt to Hero [3h 4h]
6bd97a49: raises $0.05 to $0.1
9674377d: folds
Hero: folds
6ffefba2: folds
2e44f78e: folds
4d8d4585: folds
Uncalled bet ($0.05) returned to 6bd97a49
*** SHOWDOWN ***
6bd97a49 collected $0.12 from pot
*** SUMMARY ***
Total pot $0.12 | Rake $0 | Jackpot $0 | Bingo $0 | Fortune $0 | Tax $0
Seat 1: 6ffefba2 (button) folded before Flop (didn't bet)
Seat 2: 2e44f78e (small blind) folded before Flop
Seat 3: 4d8d4585 (big blind) folded before Flop
Seat 4: 6bd97a49 collected ($0.12)
Seat 5: 9674377d folded before Flop (didn't bet)
Seat 6: Hero folded before Flop (didn't bet)


Poker Hand #RC2078476024: Hold'em No Limit ($0.02/$0.05) - 2023/12/22 21:17:20
Table 'RushAndCash783478' 6-max Seat #1 is the button
Seat 1: a2031208 ($6.88 in chips)
Seat 2: 373bc096 ($5 in chips)
Seat 3: 73c8f8b5 ($5 in chips)
Seat 4: 84d4f92c ($5 in chips)
Seat 5: 3da5ed9c ($4.65 in chips)
Seat 6: Hero ($7.22 in chips)
373bc096: posts small blind $0.02
73c8f8b5: posts big blind $0.05
*** HOLE CARDS ***
Dealt to a2031208 
Dealt to 373bc096 
Dealt to 73c8f8b5 
Dealt to 84d4f92c 
Dealt to 3da5ed9c 
Dealt to Hero [2d 5s]
84d4f92c: folds
3da5ed9c: folds
Hero: folds
a2031208: raises $0.06 to $0.11
373bc096: folds
73c8f8b5: folds
Uncalled bet ($0.06) returned to a2031208
*** SHOWDOWN ***
a2031208 collected $0.12 from pot
*** SUMMARY ***
Total pot $0.12 | Rake $0 | Jackpot $0 | Bingo $0 | Fortune $0 | Tax $0
Seat 1: a2031208 (button) collected ($0.12)
Seat 2: 373bc096 (small blind) folded before Flop
Seat 3: 73c8f8b5 (big blind) folded before Flop
Seat 4: 84d4f92c folded before Flop (didn't bet)
Seat 5: 3da5ed9c folded before Flop (didn't bet)
Seat 6: Hero folded before Flop (didn't bet)


Poker Hand #RC2078475963: Hold'em No Limit ($0.02/$0.05) - 2023/12/22 21:17:17
Table 'RushAndCash783449' 6-max Seat #1 is the button
Seat 1: 7f067c94 ($42.21 in chips)
Seat 2: eb944e6 ($5.94 in chips)
Seat 3: 2880461b ($5.07 in chips)
Seat 4: Hero ($7.22 in chips)
Seat 5: d52ccee4 ($9.2 in chips)
Seat 6: b5259737 ($14.86 in chips)
eb944e6: posts small blind $0.02
2880461b: posts big blind $0.05
*** HOLE CARDS ***
Dealt to 7f067c94 
Dealt to eb944e6 
Dealt to 2880461b 
Dealt to Hero [8d 5s]
Dealt to d52ccee4 
Dealt to b5259737 
Hero: folds
d52ccee4: folds
b5259737: folds
7f067c94: folds
eb944e6: folds
Uncalled bet ($0.03) returned to 2880461b
*** SHOWDOWN ***
2880461b collected $0.04 from pot
*** SUMMARY ***
Total pot $0.04 | Rake $0 | Jackpot $0 | Bingo $0 | Fortune $0 | Tax $0
Seat 1: 7f067c94 (button) folded before Flop (didn't bet)
Seat 2: eb944e6 (small blind) folded before Flop
Seat 3: 2880461b (big blind) collected ($0.04)
Seat 4: Hero folded before Flop (didn't bet)
Seat 5: d52ccee4 folded before Flop (didn't bet)
Seat 6: b5259737 folded before Flop (didn't bet)


Poker Hand #RC2078475423: Hold'em No Limit ($0.02/$0.05) - 2023/12/22 21:16:46
Table 'RushAndCash783184' 6-max Seat #1 is the button
Seat 1: de3b84bb ($25.17 in chips)
Seat 2: 3a26c05c ($5.07 in chips)
Seat 3: 886872c9 ($4.93 in chips)
Seat 4: Hero ($7.06 in chips)
Seat 5: 9d480ff ($5.48 in chips)
Seat 6: 5da5ce8d ($18.48 in chips)
3a26c05c: posts small blind $0.02
886872c9: posts big blind $0.05
*** HOLE CARDS ***
Dealt to de3b84bb 
Dealt to 3a26c05c 
Dealt to 886872c9 
Dealt to Hero [5s 5c]
Dealt to 9d480ff 
Dealt to 5da5ce8d 
Hero: raises $0.05 to $0.1
9d480ff: folds
5da5ce8d: folds
de3b84bb: calls $0.1
3a26c05c: folds
886872c9: folds
*** FLOP *** [8s 3h 3d]
Hero: checks
de3b84bb: checks
*** TURN *** [8s 3h 3d] [As]
Hero: checks
de3b84bb: checks
*** RIVER *** [8s 3h 3d As] [Ts]
Hero: bets $0.1
de3b84bb: folds
Uncalled bet ($0.1) returned to Hero
*** SHOWDOWN ***
Hero collected $0.26 from pot
*** SUMMARY ***
Total pot $0.27 | Rake $0.01 | Jackpot $0 | Bingo $0 | Fortune $0 | Tax $0
Board [8s 3h 3d As Ts]
Seat 1: de3b84bb (button) folded on the River
Seat 2: 3a26c05c (small blind) folded before Flop
Seat 3: 886872c9 (big blind) folded before Flop
Seat 4: Hero won ($0.26)
Seat 5: 9d480ff folded before Flop (didn't bet)
Seat 6: 5da5ce8d folded before Flop (didn't bet)


Poker Hand #RC2078474985: Hold'em No Limit ($0.02/$0.05) - 2023/12/22 21:16:20
Table 'RushAndCash782966' 6-max Seat #1 is the button
Seat 1: f920d981 ($7.12 in chips)
Seat 2: 4c699d7 ($1.99 in chips)
Seat 3: ff05f2b3 ($2.5 in chips)
Seat 4: a4441de9 ($6.5 in chips)
Seat 5: 7732abf7 ($25.29 in chips)
Seat 6: Hero ($7.16 in chips)
4c699d7: posts small blind $0.02
ff05f2b3: posts big blind $0.05
*** HOLE CARDS ***
Dealt to f920d981 
Dealt to 4c699d7 
Dealt to ff05f2b3 
Dealt to a4441de9 
Dealt to 7732abf7 
Dealt to Hero [Ad Jc]
a4441de9: folds
7732abf7: folds
Hero: raises $0.05 to $0.1
f920d981: folds
4c699d7: calls $0.08
ff05f2b3: raises $0.24 to $0.34
Hero: folds
4c699d7: calls $0.24
*** FLOP *** [7c Td Js]
4c699d7: checks
ff05f2b3: checks
*** TURN *** [7c Td Js] [7s]
4c699d7: checks
ff05f2b3: bets $0.88
4c699d7: calls $0.88
*** RIVER *** [7c Td Js 7s] [7d]
4c699d7: checks
ff05f2b3: checks
4c699d7: shows [9c Kc] (Three Sevens)
ff05f2b3: shows [As 4s] (Three Sevens)
*** SHOWDOWN ***
ff05f2b3 collected $2.35 from pot
*** SUMMARY ***
Total pot $2.54 | Rake $0.12 | Jackpot $0.07 | Bingo $0 | Fortune $0 | Tax $0
Board [7c Td Js 7s 7d]
Seat 1: f920d981 (button) folded before Flop (didn't bet)
Seat 2: 4c699d7 (small blind) showed [9c Kc] and lost with Three Sevens
Seat 3: ff05f2b3 (big blind) showed [As 4s] and won ($2.35) with Three Sevens
Seat 4: a4441de9 folded before Flop (didn't bet)
Seat 5: 7732abf7 folded before Flop (didn't bet)
Seat 6: Hero folded before Flop


Poker Hand #RC2078474928: Hold'em No Limit ($0.02/$0.05) - 2023/12/22 21:16:16
Table 'RushAndCash782937' 6-max Seat #1 is the button
Seat 1: c0d3508b ($5.23 in chips)
Seat 2: 59a39874 ($13.06 in chips)
Seat 3: Hero ($7.21 in chips)
Seat 4: 67d4b163 ($14.86 in chips)
Seat 5: 821f3bc7 ($6.3 in chips)
Seat 6: f03c68f3 ($8.65 in chips)
59a39874: posts small blind $0.02
Hero: posts big blind $0.05
*** HOLE CARDS ***
Dealt to c0d3508b 
Dealt to 59a39874 
Dealt to Hero [4s 5d]
Dealt to 67d4b163 
Dealt to 821f3bc7 
Dealt to f03c68f3 
67d4b163: folds
821f3bc7: folds
f03c68f3: folds
c0d3508b: folds
59a39874: raises $0.1 to $0.15
Hero: folds
Uncalled bet ($0.1) returned to 59a39874
*** SHOWDOWN ***
59a39874 collected $0.1 from pot
*** SUMMARY ***
Total pot $0.1 | Rake $0 | Jackpot $0 | Bingo $0 | Fortune $0 | Tax $0
Seat 1: c0d3508b (button) folded before Flop (didn't bet)
Seat 2: 59a39874 (small blind) collected ($0.1)
Seat 3: Hero (big blind) folded before Flop
Seat 4: 67d4b163 folded before Flop (didn't bet)
Seat 5: 821f3bc7 folded before Flop (didn't bet)
Seat 6: f03c68f3 folded before Flop (didn't bet)


Poker Hand #RC2078474766: Hold'em No Limit ($0.02/$0.05) - 2023/12/22 21:16:07
Table 'RushAndCash782857' 6-max Seat #1 is the button
Seat 1: Hero ($7.14 in chips)
Seat 2: 18f0f05c ($9.51 in chips)
Seat 3: 2c2cc68d ($12.57 in chips)
Seat 4: 54daf47b ($8.88 in chips)
Seat 5: 67d4b163 ($14.86 in chips)
Seat 6: 92b246ad ($9.5 in chips)
18f0f05c: posts small blind $0.02
2c2cc68d: posts big blind $0.05
*** HOLE CARDS ***
Dealt to Hero [Kh 8h]
Dealt to 18f0f05c 
Dealt to 2c2cc68d 
Dealt to 54daf47b 
Dealt to 67d4b163 
Dealt to 92b246ad 
54daf47b: folds
67d4b163: folds
92b246ad: folds
Hero: raises $0.08 to $0.13
18f0f05c: folds
2c2cc68d: folds
Uncalled bet ($0.08) returned to Hero
*** SHOWDOWN ***
Hero collected $0.12 from pot
*** SUMMARY ***
Total pot $0.12 | Rake $0 | Jackpot $0 | Bingo $0 | Fortune $0 | Tax $0
Seat 1: Hero (button) collected ($0.12)
Seat 2: 18f0f05c (small blind) folded before Flop
Seat 3: 2c2cc68d (big blind) folded before Flop
Seat 4: 54daf47b folded before Flop (didn't bet)
Seat 5: 67d4b163 folded before Flop (didn't bet)
Seat 6: 92b246ad folded before Flop (didn't bet)


Poker Hand #RC2078454688: Hold'em No Limit ($0.02/$0.05) - 2023/12/22 21:16:02
Table 'RushAndCash782819' 6-max Seat #1 is the button
Seat 1: dc851cb6 ($5.77 in chips)
Seat 2: 8014c02 ($22.84 in chips)
Seat 3: fdc2d3ba ($15.27 in chips)
Seat 4: 2e20f1d7 ($5 in chips)
Seat 5: Hero ($7.14 in chips)
Seat 6: ad963d07 ($5 in chips)
8014c02: posts small blind $0.02
fdc2d3ba: posts big blind $0.05
*** HOLE CARDS ***
Dealt to dc851cb6 
Dealt to 8014c02 
Dealt to fdc2d3ba 
Dealt to 2e20f1d7 
Dealt to Hero [7d 9s]
Dealt to ad963d07 
2e20f1d7: folds
Hero: folds
ad963d07: folds
dc851cb6: folds
8014c02: folds
Uncalled bet ($0.03) returned to fdc2d3ba
*** SHOWDOWN ***
fdc2d3ba collected $0.04 from pot
*** SUMMARY ***
Total pot $0.04 | Rake $0 | Jackpot $0 | Bingo $0 | Fortune $0 | Tax $0
Seat 1: dc851cb6 (button) folded before Flop (didn't bet)
Seat 2: 8014c02 (small blind) folded before Flop
Seat 3: fdc2d3ba (big blind) collected ($0.04)
Seat 4: 2e20f1d7 folded before Flop (didn't bet)
Seat 5: Hero folded before Flop (didn't bet)
Seat 6: ad963d07 folded before Flop (didn't bet)


Poker Hand #RC2078454622: Hold'em No Limit ($0.02/$0.05) - 2023/12/22 21:15:59
Table 'RushAndCash782787' 6-max Seat #1 is the button
Seat 1: 47fd8156 ($5.05 in chips)
Seat 2: Hero ($7.16 in chips)
Seat 3: 5d626479 ($3.41 in chips)
Seat 4: 5e4a0558 ($4.93 in chips)
Seat 5: 3ac82985 ($2.16 in chips)
Seat 6: 2a4364bc ($9.45 in chips)
Hero: posts small blind $0.02
5d626479: posts big blind $0.05
*** HOLE CARDS ***
Dealt to 47fd8156 
Dealt to Hero [5c 3d]
Dealt to 5d626479 
Dealt to 5e4a0558 
Dealt to 3ac82985 
Dealt to 2a4364bc 
5e4a0558: folds
3ac82985: folds
2a4364bc: folds
47fd8156: raises $0.05 to $0.1
Hero: folds
5d626479: calls $0.05
*** FLOP *** [7d Qc 4s]
5d626479: checks
47fd8156: bets $0.11
5d626479: calls $0.11
*** TURN *** [7d Qc 4s] [Kc]
5d626479: checks
47fd8156: checks
*** RIVER *** [7d Qc 4s Kc] [5s]
5d626479: checks
47fd8156: checks
5d626479: shows [Ah 7c] (Pair of Sevens)
47fd8156: shows [As 6c] (Ace-High)
*** SHOWDOWN ***
5d626479 collected $0.42 from pot
*** SUMMARY ***
Total pot $0.44 | Rake $0.02 | Jackpot $0 | Bingo $0 | Fortune $0 | Tax $0
Board [7d Qc 4s Kc 5s]
Seat 1: 47fd8156 (button) showed [As 6c] and lost with Ace-High
Seat 2: Hero (small blind) folded before Flop
Seat 3: 5d626479 (big blind) showed [Ah 7c] and won ($0.42) with Pair of Sevens
Seat 4: 5e4a0558 folded before Flop (didn't bet)
Seat 5: 3ac82985 folded before Flop (didn't bet)
Seat 6: 2a4364bc folded before Flop (didn't bet)


Poker Hand #RC2078454561: Hold'em No Limit ($0.02/$0.05) - 2023/12/22 21:15:55
Table 'RushAndCash782757' 6-max Seat #1 is the button
Seat 1: f920d981 ($7.14 in chips)
Seat 2: 5f11c3da ($17.23 in chips)
Seat 3: 4dab75d6 ($4.96 in chips)
Seat 4: 6f165a6d ($1.92 in chips)
Seat 5: 9f9a5f9d ($5.15 in chips)
Seat 6: Hero ($7.16 in chips)
5f11c3da: posts small blind $0.02
4dab75d6: posts big blind $0.05
*** HOLE CARDS ***
Dealt to f920d981 
Dealt to 5f11c3da 
Dealt to 4dab75d6 
Dealt to 6f165a6d 
Dealt to 9f9a5f9d 
Dealt to Hero [4d 2h]
6f165a6d: calls $0.05
9f9a5f9d: raises $0.15 to $0.2
Hero: folds
f920d981: folds
5f11c3da: folds
4dab75d6: folds
6f165a6d: calls $0.15
*** FLOP *** [4c Tc 4s]
6f165a6d: checks
9f9a5f9d: bets $0.2
6f165a6d: folds
Uncalled bet ($0.2) returned to 9f9a5f9d
*** SHOWDOWN ***
9f9a5f9d collected $0.45 from pot
*** SUMMARY ***
Total pot $0.47 | Rake $0.02 | Jackpot $0 | Bingo $0 | Fortune $0 | Tax $0
Board [4c Tc 4s]
Seat 1: f920d981 (button) folded before Flop (didn't bet)
Seat 2: 5f11c3da (small blind) folded before Flop
Seat 3: 4dab75d6 (big blind) folded before Flop
Seat 4: 6f165a6d folded on the Flop
Seat 5: 9f9a5f9d won ($0.45)
Seat 6: Hero folded before Flop (didn't bet)


Poker Hand #RC2078454458: Hold'em No Limit ($0.02/$0.05) - 2023/12/22 21:15:49
Table 'RushAndCash782709' 6-max Seat #1 is the button
Seat 1: cdd2600a ($2.31 in chips)
Seat 2: 605ca6ae ($10.44 in chips)
Seat 3: 27517d94 ($7.57 in chips)
Seat 4: d6c4e270 ($2.19 in chips)
Seat 5: 16ecd29a ($9.26 in chips)
Seat 6: Hero ($7.16 in chips)
605ca6ae: posts small blind $0.02
27517d94: posts big blind $0.05
*** HOLE CARDS ***
Dealt to cdd2600a 
Dealt to 605ca6ae 
Dealt to 27517d94 
Dealt to d6c4e270 
Dealt to 16ecd29a 
Dealt to Hero [7d Js]
d6c4e270: raises $0.05 to $0.1
16ecd29a: folds
Hero: folds
cdd2600a: folds
605ca6ae: folds
27517d94: folds
Uncalled bet ($0.05) returned to d6c4e270
*** SHOWDOWN ***
d6c4e270 collected $0.12 from pot
*** SUMMARY ***
Total pot $0.12 | Rake $0 | Jackpot $0 | Bingo $0 | Fortune $0 | Tax $0
Seat 1: cdd2600a (button) folded before Flop (didn't bet)
Seat 2: 605ca6ae (small blind) folded before Flop
Seat 3: 27517d94 (big blind) folded before Flop
Seat 4: d6c4e270 collected ($0.12)
Seat 5: 16ecd29a folded before Flop (didn't bet)
Seat 6: Hero folded before Flop (didn't bet)


Poker Hand #RC2078454352: Hold'em No Limit ($0.02/$0.05) - 2023/12/22 21:15:43
Table 'RushAndCash782656' 6-max Seat #1 is the button
Seat 1: bdb78d67 ($5.16 in chips)
Seat 2: 72f7386e ($13.03 in chips)
Seat 3: Hero ($7.21 in chips)
Seat 4: d0442df9 ($9.79 in chips)
Seat 5: 59ad445d ($6.34 in chips)
Seat 6: 1adb19a8 ($3.31 in chips)
72f7386e: posts small blind $0.02
Hero: posts big blind $0.05
*** HOLE CARDS ***
Dealt to bdb78d67 
Dealt to 72f7386e 
Dealt to Hero [2h 6d]
Dealt to d0442df9 
Dealt to 59ad445d 
Dealt to 1adb19a8 
d0442df9: raises $0.1 to $0.15
59ad445d: folds
1adb19a8: folds
bdb78d67: calls $0.15
72f7386e: folds
Hero: folds
*** FLOP *** [8c 4d Kd]
d0442df9: checks
bdb78d67: bets $0.15
d0442df9: calls $0.15
*** TURN *** [8c 4d Kd] [9h]
d0442df9: checks
bdb78d67: bets $0.4
d0442df9: raises $0.74 to $1.14
bdb78d67: calls $0.74
*** RIVER *** [8c 4d Kd 9h] [5c]
d0442df9: checks
bdb78d67: checks
d0442df9: shows [Ac 4h] (Pair of Fours)
bdb78d67: shows [8d Td] (Pair of Eights)
*** SHOWDOWN ***
bdb78d67 collected $2.74 from pot
*** SUMMARY ***
Total pot $2.95 | Rake $0.14 | Jackpot $0.07 | Bingo $0 | Fortune $0 | Tax $0
Board [8c 4d Kd 9h 5c]
Seat 1: bdb78d67 (button) showed [8d Td] and won ($2.74) with Pair of Eights
Seat 2: 72f7386e (small blind) folded before Flop
Seat 3: Hero (big blind) folded before Flop
Seat 4: d0442df9 showed [Ac 4h] and lost with Pair of Fours
Seat 5: 59ad445d folded before Flop (didn't bet)
Seat 6: 1adb19a8 folded before Flop (didn't bet)


Poker Hand #RC2078454212: Hold'em No Limit ($0.02/$0.05) - 2023/12/22 21:15:34
Table 'RushAndCash782590' 6-max Seat #1 is the button
Seat 1: d59fc4d ($7 in chips)
Seat 2: Hero ($7.23 in chips)
Seat 3: 30a2950b ($7.4 in chips)
Seat 4: 34ce5e3 ($5 in chips)
Seat 5: b976716a ($16.31 in chips)
Seat 6: 32dfaf2b ($7.24 in chips)
Hero: posts small blind $0.02
30a2950b: posts big blind $0.05
*** HOLE CARDS ***
Dealt to d59fc4d 
Dealt to Hero [7h Qs]
Dealt to 30a2950b 
Dealt to 34ce5e3 
Dealt to b976716a 
Dealt to 32dfaf2b 
34ce5e3: folds
b976716a: folds
32dfaf2b: raises $0.05 to $0.1
d59fc4d: folds
Hero: folds
30a2950b: folds
Uncalled bet ($0.05) returned to 32dfaf2b
*** SHOWDOWN ***
32dfaf2b collected $0.12 from pot
*** SUMMARY ***
Total pot $0.12 | Rake $0 | Jackpot $0 | Bingo $0 | Fortune $0 | Tax $0
Seat 1: d59fc4d (button) folded before Flop (didn't bet)
Seat 2: Hero (small blind) folded before Flop
Seat 3: 30a2950b (big blind) folded before Flop
Seat 4: 34ce5e3 folded before Flop (didn't bet)
Seat 5: b976716a folded before Flop (didn't bet)
Seat 6: 32dfaf2b collected ($0.12)


Poker Hand #RC2078454050: Hold'em No Limit ($0.02/$0.05) - 2023/12/22 21:15:24
Table 'RushAndCash782512' 6-max Seat #1 is the button
Seat 1: Hero ($7.16 in chips)
Seat 2: a4441de9 ($6.36 in chips)
Seat 3: 311eeba4 ($6.95 in chips)
Seat 4: abd6fe91 ($5.21 in chips)
Seat 5: 459d0f5c ($5 in chips)
Seat 6: 1db9c453 ($5.93 in chips)
a4441de9: posts small blind $0.02
311eeba4: posts big blind $0.05
*** HOLE CARDS ***
Dealt to Hero [8s Js]
Dealt to a4441de9 
Dealt to 311eeba4 
Dealt to abd6fe91 
Dealt to 459d0f5c 
Dealt to 1db9c453 
abd6fe91: folds
459d0f5c: folds
1db9c453: folds
Hero: raises $0.08 to $0.13
a4441de9: folds
311eeba4: folds
Uncalled bet ($0.08) returned to Hero
*** SHOWDOWN ***
Hero collected $0.12 from pot
*** SUMMARY ***
Total pot $0.12 | Rake $0 | Jackpot $0 | Bingo $0 | Fortune $0 | Tax $0
Seat 1: Hero (button) collected ($0.12)
Seat 2: a4441de9 (small blind) folded before Flop
Seat 3: 311eeba4 (big blind) folded before Flop
Seat 4: abd6fe91 folded before Flop (didn't bet)
Seat 5: 459d0f5c folded before Flop (didn't bet)
Seat 6: 1db9c453 folded before Flop (didn't bet)


Poker Hand #RC2078453981: Hold'em No Limit ($0.02/$0.05) - 2023/12/22 21:15:21
Table 'RushAndCash782480' 6-max Seat #1 is the button
Seat 1: b6052383 ($4.83 in chips)
Seat 2: f19577e3 ($5.06 in chips)
Seat 3: fcc5325d ($5.09 in chips)
Seat 4: Hero ($7.09 in chips)
Seat 5: 4b60b73d ($5.49 in chips)
Seat 6: 29c7b0d2 ($5 in chips)
f19577e3: posts small blind $0.02
fcc5325d: posts big blind $0.05
*** HOLE CARDS ***
Dealt to b6052383 
Dealt to f19577e3 
Dealt to fcc5325d 
Dealt to Hero [Td 8h]
Dealt to 4b60b73d 
Dealt to 29c7b0d2 
Hero: folds
4b60b73d: folds
29c7b0d2: raises $0.07 to $0.12
b6052383: folds
f19577e3: folds
fcc5325d: folds
Uncalled bet ($0.07) returned to 29c7b0d2
*** SHOWDOWN ***
29c7b0d2 collected $0.12 from pot
*** SUMMARY ***
Total pot $0.12 | Rake $0 | Jackpot $0 | Bingo $0 | Fortune $0 | Tax $0
Seat 1: b6052383 (button) folded before Flop (didn't bet)
Seat 2: f19577e3 (small blind) folded before Flop
Seat 3: fcc5325d (big blind) folded before Flop
Seat 4: Hero folded before Flop (didn't bet)
Seat 5: 4b60b73d folded before Flop (didn't bet)
Seat 6: 29c7b0d2 collected ($0.12)


Poker Hand #RC2078453897: Hold'em No Limit ($0.02/$0.05) - 2023/12/22 21:15:16
Table 'RushAndCash782440' 6-max Seat #1 is the button
Seat 1: d03e1a8e ($7.64 in chips)
Seat 2: 34ce5e3 ($5 in chips)
Seat 3: Hero ($7.14 in chips)
Seat 4: d71ab80c ($7.43 in chips)
Seat 5: ebeb62f7 ($4.81 in chips)
Seat 6: ff769430 ($7.16 in chips)
34ce5e3: posts small blind $0.02
Hero: posts big blind $0.05
*** HOLE CARDS ***
Dealt to d03e1a8e 
Dealt to 34ce5e3 
Dealt to Hero [4s 6c]
Dealt to d71ab80c 
Dealt to ebeb62f7 
Dealt to ff769430 
d71ab80c: folds
ebeb62f7: folds
ff769430: folds
d03e1a8e: folds
34ce5e3: folds
Uncalled bet ($0.03) returned to Hero
*** SHOWDOWN ***
Hero collected $0.04 from pot
*** SUMMARY ***
Total pot $0.04 | Rake $0 | Jackpot $0 | Bingo $0 | Fortune $0 | Tax $0
Seat 1: d03e1a8e (button) folded before Flop (didn't bet)
Seat 2: 34ce5e3 (small blind) folded before Flop
Seat 3: Hero (big blind) collected ($0.04)
Seat 4: d71ab80c folded before Flop (didn't bet)
Seat 5: ebeb62f7 folded before Flop (didn't bet)
Seat 6: ff769430 folded before Flop (didn't bet)


Poker Hand #RC2078453840: Hold'em No Limit ($0.02/$0.05) - 2023/12/22 21:15:12
Table 'RushAndCash782412' 6-max Seat #1 is the button
Seat 1: Hero ($7.14 in chips)
Seat 2: 6bf9020c ($5.16 in chips)
Seat 3: 17be45ec ($6.43 in chips)
Seat 4: 6e3c9195 ($6.74 in chips)
Seat 5: 53442c3b ($10.85 in chips)
Seat 6: 29e18081 ($5.16 in chips)
6bf9020c: posts small blind $0.02
17be45ec: posts big blind $0.05
*** HOLE CARDS ***
Dealt to Hero [Ks 7h]
Dealt to 6bf9020c 
Dealt to 17be45ec 
Dealt to 6e3c9195 
Dealt to 53442c3b 
Dealt to 29e18081 
6e3c9195: folds
53442c3b: folds
29e18081: folds
Hero: folds
6bf9020c: folds
Uncalled bet ($0.03) returned to 17be45ec
*** SHOWDOWN ***
17be45ec collected $0.04 from pot
*** SUMMARY ***
Total pot $0.04 | Rake $0 | Jackpot $0 | Bingo $0 | Fortune $0 | Tax $0
Seat 1: Hero (button) folded before Flop (didn't bet)
Seat 2: 6bf9020c (small blind) folded before Flop
Seat 3: 17be45ec (big blind) collected ($0.04)
Seat 4: 6e3c9195 folded before Flop (didn't bet)
Seat 5: 53442c3b folded before Flop (didn't bet)
Seat 6: 29e18081 folded before Flop (didn't bet)


Poker Hand #RC2078453716: Hold'em No Limit ($0.02/$0.05) - 2023/12/22 21:15:05
Table 'RushAndCash782352' 6-max Seat #1 is the button
Seat 1: 9aad1596 ($7.07 in chips)
Seat 2: Hero ($7.16 in chips)
Seat 3: 4b46876e ($4.13 in chips)
Seat 4: c9dcc850 ($7.96 in chips)
Seat 5: 84d4f92c ($5 in chips)
Seat 6: eeb37e34 ($8.28 in chips)
Hero: posts small blind $0.02
4b46876e: posts big blind $0.05
*** HOLE CARDS ***
Dealt to 9aad1596 
Dealt to Hero [6s 5d]
Dealt to 4b46876e 
Dealt to c9dcc850 
Dealt to 84d4f92c 
Dealt to eeb37e34 
c9dcc850: folds
84d4f92c: folds
eeb37e34: raises $0.08 to $0.13
9aad1596: folds
Hero: folds
4b46876e: folds
Uncalled bet ($0.08) returned to eeb37e34
*** SHOWDOWN ***
eeb37e34 collected $0.12 from pot
*** SUMMARY ***
Total pot $0.12 | Rake $0 | Jackpot $0 | Bingo $0 | Fortune $0 | Tax $0
Seat 1: 9aad1596 (button) folded before Flop (didn't bet)
Seat 2: Hero (small blind) folded before Flop
Seat 3: 4b46876e (big blind) folded before Flop
Seat 4: c9dcc850 folded before Flop (didn't bet)
Seat 5: 84d4f92c folded before Flop (didn't bet)
Seat 6: eeb37e34 collected ($0.12)


Poker Hand #RC2078452990: Hold'em No Limit ($0.02/$0.05) - 2023/12/22 21:14:23
Table 'RushAndCash782016' 6-max Seat #1 is the button
Seat 1: 4b46876e ($4.28 in chips)
Seat 2: 580b42af ($5 in chips)
Seat 3: b8e0eed ($5 in chips)
Seat 4: Hero ($6.72 in chips)
Seat 5: 4c0d7324 ($5 in chips)
Seat 6: dbf99aff ($5.11 in chips)
580b42af: posts small blind $0.02
b8e0eed: posts big blind $0.05
*** HOLE CARDS ***
Dealt to 4b46876e 
Dealt to 580b42af 
Dealt to b8e0eed 
Dealt to Hero [7c 7s]
Dealt to 4c0d7324 
Dealt to dbf99aff 
Hero: raises $0.05 to $0.1
4c0d7324: folds
dbf99aff: folds
4b46876e: calls $0.1
580b42af: folds
b8e0eed: calls $0.05
*** FLOP *** [Ah 7d 7h]
b8e0eed: checks
Hero: checks
4b46876e: checks
*** TURN *** [Ah 7d 7h] [5h]
b8e0eed: bets $0.05
Hero: calls $0.05
4b46876e: calls $0.05
*** RIVER *** [Ah 7d 7h 5h] [Qs]
b8e0eed: checks
Hero: bets $0.16
4b46876e: folds
b8e0eed: calls $0.16
Hero: shows [7c 7s] (Four Sevens)
b8e0eed: shows [Ad Jc] (Pair of Aces and Pair of Sevens)
*** SHOWDOWN ***
Hero collected $0.75 from pot
*** SUMMARY ***
Total pot $0.79 | Rake $0.04 | Jackpot $0 | Bingo $0 | Fortune $0 | Tax $0
Board [Ah 7d 7h 5h Qs]
Seat 1: 4b46876e (button) folded on the River
Seat 2: 580b42af (small blind) folded before Flop
Seat 3: b8e0eed (big blind) showed [Ad Jc] and lost with Pair of Aces and Pair of Sevens
Seat 4: Hero showed [7c 7s] and won ($0.75) with Four Sevens
Seat 5: 4c0d7324 folded before Flop (didn't bet)
Seat 6: dbf99aff folded before Flop (didn't bet)


Poker Hand #RC2078452909: Hold'em No Limit ($0.02/$0.05) - 2023/12/22 21:14:19
Table 'RushAndCash781975' 6-max Seat #1 is the button
Seat 1: 6f5406fb ($5.09 in chips)
Seat 2: 90b129bf ($7.56 in chips)
Seat 3: 96eff031 ($1.36 in chips)
Seat 4: ad142c24 ($11.6 in chips)
Seat 5: Hero ($6.72 in chips)
Seat 6: db5367a6 ($9.94 in chips)
90b129bf: posts small blind $0.02
96eff031: posts big blind $0.05
*** HOLE CARDS ***
Dealt to 6f5406fb 
Dealt to 90b129bf 
Dealt to 96eff031 
Dealt to ad142c24 
Dealt to Hero [4s 9s]
Dealt to db5367a6 
ad142c24: raises $0.06 to $0.11
Hero: folds
db5367a6: raises $0.15 to $0.26
6f5406fb: folds
90b129bf: folds
96eff031: folds
ad142c24: calls $0.15
*** FLOP *** [Jc Kh 6s]
ad142c24: checks
db5367a6: bets $0.3
ad142c24: calls $0.3
*** TURN *** [Jc Kh 6s] [3c]
ad142c24: checks
db5367a6: bets $0.6
ad142c24: folds
Uncalled bet ($0.6) returned to db5367a6
*** SHOWDOWN ***
db5367a6 collected $1.13 from pot
*** SUMMARY ***
Total pot $1.19 | Rake $0.06 | Jackpot $0 | Bingo $0 | Fortune $0 | Tax $0
Board [Jc Kh 6s 3c]
Seat 1: 6f5406fb (button) folded before Flop (didn't bet)
Seat 2: 90b129bf (small blind) folded before Flop
Seat 3: 96eff031 (big blind) folded before Flop
Seat 4: ad142c24 folded on the Turn
Seat 5: Hero folded before Flop (didn't bet)
Seat 6: db5367a6 won ($1.13)


Poker Hand #RC2078452829: Hold'em No Limit ($0.02/$0.05) - 2023/12/22 21:14:14
Table 'RushAndCash781937' 6-max Seat #1 is the button
Seat 1: e5b5763b ($6.58 in chips)
Seat 2: 879060f7 ($16.95 in chips)
Seat 3: bc118b95 ($5.16 in chips)
Seat 4: aa6d4c49 ($15.81 in chips)
Seat 5: Hero ($6.72 in chips)
Seat 6: 8f240b5e ($4.27 in chips)
879060f7: posts small blind $0.02
bc118b95: posts big blind $0.05
*** HOLE CARDS ***
Dealt to e5b5763b 
Dealt to 879060f7 
Dealt to bc118b95 
Dealt to aa6d4c49 
Dealt to Hero [9c 6h]
Dealt to 8f240b5e 
aa6d4c49: folds
Hero: folds
8f240b5e: folds
e5b5763b: folds
879060f7: folds
Uncalled bet ($0.03) returned to bc118b95
*** SHOWDOWN ***
bc118b95 collected $0.04 from pot
*** SUMMARY ***
Total pot $0.04 | Rake $0 | Jackpot $0 | Bingo $0 | Fortune $0 | Tax $0
Seat 1: e5b5763b (button) folded before Flop (didn't bet)
Seat 2: 879060f7 (small blind) folded before Flop
Seat 3: bc118b95 (big blind) collected ($0.04)
Seat 4: aa6d4c49 folded before Flop (didn't bet)
Seat 5: Hero folded before Flop (didn't bet)
Seat 6: 8f240b5e folded before Flop (didn't bet)


Poker Hand #RC2078452762: Hold'em No Limit ($0.02/$0.05) - 2023/12/22 21:14:10
Table 'RushAndCash781905' 6-max Seat #1 is the button
Seat 1: Hero ($6.72 in chips)
Seat 2: 463feb61 ($4.31 in chips)
Seat 3: 7c19951 ($5.63 in chips)
Seat 4: 13f0dad9 ($13.79 in chips)
Seat 5: 7451ad28 ($9.7 in chips)
Seat 6: 1d1c20e8 ($5.76 in chips)
463feb61: posts small blind $0.02
7c19951: posts big blind $0.05
*** HOLE CARDS ***
Dealt to Hero [Ks 7d]
Dealt to 463feb61 
Dealt to 7c19951 
Dealt to 13f0dad9 
Dealt to 7451ad28 
Dealt to 1d1c20e8 
13f0dad9: folds
7451ad28: folds
1d1c20e8: raises $0.06 to $0.11
Hero: folds
463feb61: folds
7c19951: folds
Uncalled bet ($0.06) returned to 1d1c20e8
*** SHOWDOWN ***
1d1c20e8 collected $0.12 from pot
*** SUMMARY ***
Total pot $0.12 | Rake $0 | Jackpot $0 | Bingo $0 | Fortune $0 | Tax $0
Seat 1: Hero (button) folded before Flop (didn't bet)
Seat 2: 463feb61 (small blind) folded before Flop
Seat 3: 7c19951 (big blind) folded before Flop
Seat 4: 13f0dad9 folded before Flop (didn't bet)
Seat 5: 7451ad28 folded before Flop (didn't bet)
Seat 6: 1d1c20e8 collected ($0.12)


Poker Hand #RC2078452706: Hold'em No Limit ($0.02/$0.05) - 2023/12/22 21:14:07
Table 'RushAndCash781878' 6-max Seat #1 is the button
Seat 1: 8aaa95a5 ($3.94 in chips)
Seat 2: Hero ($6.74 in chips)
Seat 3: 19915c5a ($5 in chips)
Seat 4: 2057ccaa ($5.31 in chips)
Seat 5: c2881b52 ($12.26 in chips)
Seat 6: e7dae1d3 ($5.21 in chips)
Hero: posts small blind $0.02
19915c5a: posts big blind $0.05
*** HOLE CARDS ***
Dealt to 8aaa95a5 
Dealt to Hero [3c Js]
Dealt to 19915c5a 
Dealt to 2057ccaa 
Dealt to c2881b52 
Dealt to e7dae1d3 
2057ccaa: raises $0.05 to $0.1
c2881b52: folds
e7dae1d3: folds
8aaa95a5: folds
Hero: folds
19915c5a: folds
Uncalled bet ($0.05) returned to 2057ccaa
*** SHOWDOWN ***
2057ccaa collected $0.12 from pot
*** SUMMARY ***
Total pot $0.12 | Rake $0 | Jackpot $0 | Bingo $0 | Fortune $0 | Tax $0
Seat 1: 8aaa95a5 (button) folded before Flop (didn't bet)
Seat 2: Hero (small blind) folded before Flop
Seat 3: 19915c5a (big blind) folded before Flop
Seat 4: 2057ccaa collected ($0.12)
Seat 5: c2881b52 folded before Flop (didn't bet)
Seat 6: e7dae1d3 folded before Flop (didn't bet)


Poker Hand #RC2078452595: Hold'em No Limit ($0.02/$0.05) - 2023/12/22 21:14:01
Table 'RushAndCash781822' 6-max Seat #1 is the button
Seat 1: eadbd152 ($4.11 in chips)
Seat 2: 9aad1596 ($6.49 in chips)
Seat 3: Hero ($6.79 in chips)
Seat 4: 1f9b16cf ($5.3 in chips)
Seat 5: b18917a1 ($5.02 in chips)
Seat 6: 21196b97 ($8.71 in chips)
9aad1596: posts small blind $0.02
Hero: posts big blind $0.05
*** HOLE CARDS ***
Dealt to eadbd152 
Dealt to 9aad1596 
Dealt to Hero [7s 3h]
Dealt to 1f9b16cf 
Dealt to b18917a1 
Dealt to 21196b97 
1f9b16cf: folds
b18917a1: raises $0.06 to $0.11
21196b97: folds
eadbd152: folds
9aad1596: folds
Hero: folds
Uncalled bet ($0.06) returned to b18917a1
*** SHOWDOWN ***
b18917a1 collected $0.12 from pot
*** SUMMARY ***
Total pot $0.12 | Rake $0 | Jackpot $0 | Bingo $0 | Fortune $0 | Tax $0
Seat 1: eadbd152 (button) folded before Flop (didn't bet)
Seat 2: 9aad1596 (small blind) folded before Flop
Seat 3: Hero (big blind) folded before Flop
Seat 4: 1f9b16cf folded before Flop (didn't bet)
Seat 5: b18917a1 collected ($0.12)
Seat 6: 21196b97 folded before Flop (didn't bet)


Poker Hand #RC2078452524: Hold'em No Limit ($0.02/$0.05) - 2023/12/22 21:13:57
Table 'RushAndCash781789' 6-max Seat #1 is the button
Seat 1: 9926d81a ($5.12 in chips)
Seat 2: f3501d52 ($5 in chips)
Seat 3: 494d7c43 ($6 in chips)
Seat 4: 21196b97 ($8.71 in chips)
Seat 5: Hero ($6.79 in chips)
Seat 6: 23d318c4 ($5 in chips)
f3501d52: posts small blind $0.02
494d7c43: posts big blind $0.05
*** HOLE CARDS ***
Dealt to 9926d81a 
Dealt to f3501d52 
Dealt to 494d7c43 
Dealt to 21196b97 
Dealt to Hero [Qh 3h]
Dealt to 23d318c4 
21196b97: folds
Hero: folds
23d318c4: folds
9926d81a: folds
f3501d52: folds
Uncalled bet ($0.03) returned to 494d7c43
*** SHOWDOWN ***
494d7c43 collected $0.04 from pot
*** SUMMARY ***
Total pot $0.04 | Rake $0 | Jackpot $0 | Bingo $0 | Fortune $0 | Tax $0
Seat 1: 9926d81a (button) folded before Flop (didn't bet)
Seat 2: f3501d52 (small blind) folded before Flop
Seat 3: 494d7c43 (big blind) collected ($0.04)
Seat 4: 21196b97 folded before Flop (didn't bet)
Seat 5: Hero folded before Flop (didn't bet)
Seat 6: 23d318c4 folded before Flop (didn't bet)


Poker Hand #RC2078452464: Hold'em No Limit ($0.02/$0.05) - 2023/12/22 21:13:54
Table 'RushAndCash781761' 6-max Seat #1 is the button
Seat 1: 3721b8cb ($6.62 in chips)
Seat 2: 74c8019d ($3.77 in chips)
Seat 3: c7be9492 ($5.09 in chips)
Seat 4: Hero ($6.79 in chips)
Seat 5: 1cfe329a ($10.75 in chips)
Seat 6: f677406 ($6.8 in chips)
74c8019d: posts small blind $0.02
c7be9492: posts big blind $0.05
*** HOLE CARDS ***
Dealt to 3721b8cb 
Dealt to 74c8019d 
Dealt to c7be9492 
Dealt to Hero [4c Qc]
Dealt to 1cfe329a 
Dealt to f677406 
Hero: folds
1cfe329a: raises $0.08 to $0.13
f677406: folds
3721b8cb: folds
74c8019d: folds
c7be9492: folds
Uncalled bet ($0.08) returned to 1cfe329a
*** SHOWDOWN ***
1cfe329a collected $0.12 from pot
*** SUMMARY ***
Total pot $0.12 | Rake $0 | Jackpot $0 | Bingo $0 | Fortune $0 | Tax $0
Seat 1: 3721b8cb (button) folded before Flop (didn't bet)
Seat 2: 74c8019d (small blind) folded before Flop
Seat 3: c7be9492 (big blind) folded before Flop
Seat 4: Hero folded before Flop (didn't bet)
Seat 5: 1cfe329a collected ($0.12)
Seat 6: f677406 folded before Flop (didn't bet)


Poker Hand #RC2078452381: Hold'em No Limit ($0.02/$0.05) - 2023/12/22 21:13:49
Table 'RushAndCash781721' 6-max Seat #1 is the button
Seat 1: 5d626479 ($4.35 in chips)
Seat 2: 3d929f9f ($6.29 in chips)
Seat 3: 1259a422 ($6.04 in chips)
Seat 4: dad35107 ($18.75 in chips)
Seat 5: Hero ($6.79 in chips)
Seat 6: 271c38e0 ($5.73 in chips)
3d929f9f: posts small blind $0.02
1259a422: posts big blind $0.05
*** HOLE CARDS ***
Dealt to 5d626479 
Dealt to 3d929f9f 
Dealt to 1259a422 
Dealt to dad35107 
Dealt to Hero [4c 6h]
Dealt to 271c38e0 
dad35107: raises $0.07 to $0.12
Hero: folds
271c38e0: folds
5d626479: folds
3d929f9f: calls $0.1
1259a422: folds
*** FLOP *** [Jc 3h 2h]
3d929f9f: checks
dad35107: bets $0.15
3d929f9f: raises $0.3 to $0.45
dad35107: raises $0.6 to $1.05
3d929f9f: raises $5.12 to $6.17 and is all-in
dad35107: folds
Uncalled bet ($5.12) returned to 3d929f9f
*** SHOWDOWN ***
3d929f9f collected $2.21 from pot
*** SUMMARY ***
Total pot $2.39 | Rake $0.11 | Jackpot $0.07 | Bingo $0 | Fortune $0 | Tax $0
Board [Jc 3h 2h]
Seat 1: 5d626479 (button) folded before Flop (didn't bet)
Seat 2: 3d929f9f (small blind) won ($2.21)
Seat 3: 1259a422 (big blind) folded before Flop
Seat 4: dad35107 folded on the Flop
Seat 5: Hero folded before Flop (didn't bet)
Seat 6: 271c38e0 folded before Flop (didn't bet)


Poker Hand #RC2078451801: Hold'em No Limit ($0.02/$0.05) - 2023/12/22 21:13:15
Table 'RushAndCash781435' 6-max Seat #1 is the button
Seat 1: 879060f7 ($16.88 in chips)
Seat 2: d7f451d5 ($10.46 in chips)
Seat 3: Hero ($6.12 in chips)
Seat 4: 29a59401 ($2.5 in chips)
Seat 5: 5d626479 ($4.86 in chips)
Seat 6: 5b8f96c1 ($3.71 in chips)
d7f451d5: posts small blind $0.02
Hero: posts big blind $0.05
*** HOLE CARDS ***
Dealt to 879060f7 
Dealt to d7f451d5 
Dealt to Hero [Td Qd]
Dealt to 29a59401 
Dealt to 5d626479 
Dealt to 5b8f96c1 
29a59401: raises $0.15 to $0.2
5d626479: calls $0.2
5b8f96c1: folds
879060f7: folds
d7f451d5: folds
Hero: calls $0.15
*** FLOP *** [Js Qs 2c]
Hero: checks
29a59401: checks
5d626479: checks
*** TURN *** [Js Qs 2c] [5h]
Hero: checks
29a59401: checks
5d626479: checks
*** RIVER *** [Js Qs 2c 5h] [2h]
Hero: bets $0.31
29a59401: folds
5d626479: calls $0.31
Hero: shows [Td Qd] (Pair of Queens and Pair of Twos)
5d626479: shows [As Th] (Pair of Twos)
*** SHOWDOWN ***
Hero collected $1.18 from pot
*** SUMMARY ***
Total pot $1.24 | Rake $0.06 | Jackpot $0 | Bingo $0 | Fortune $0 | Tax $0
Board [Js Qs 2c 5h 2h]
Seat 1: 879060f7 (button) folded before Flop (didn't bet)
Seat 2: d7f451d5 (small blind) folded before Flop
Seat 3: Hero (big blind) showed [Td Qd] and won ($1.18) with Pair of Queens and Pair of Twos
Seat 4: 29a59401 folded on the River
Seat 5: 5d626479 showed [As Th] and lost with Pair of Twos
Seat 6: 5b8f96c1 folded before Flop (didn't bet)


Poker Hand #RC2078451598: Hold'em No Limit ($0.02/$0.05) - 2023/12/22 21:13:03
Table 'RushAndCash781338' 6-max Seat #1 is the button
Seat 1: 7c950e30 ($9.45 in chips)
Seat 2: 5945e592 ($4.65 in chips)
Seat 3: 3dbf95c1 ($8.75 in chips)
Seat 4: 9450adf7 ($8.62 in chips)
Seat 5: 29c7b0d2 ($5.19 in chips)
Seat 6: Hero ($6.12 in chips)
5945e592: posts small blind $0.02
3dbf95c1: posts big blind $0.05
*** HOLE CARDS ***
Dealt to 7c950e30 
Dealt to 5945e592 
Dealt to 3dbf95c1 
Dealt to 9450adf7 
Dealt to 29c7b0d2 
Dealt to Hero [8h Qh]
9450adf7: folds
29c7b0d2: folds
Hero: folds
7c950e30: folds
5945e592: folds
Uncalled bet ($0.03) returned to 3dbf95c1
*** SHOWDOWN ***
3dbf95c1 collected $0.04 from pot
*** SUMMARY ***
Total pot $0.04 | Rake $0 | Jackpot $0 | Bingo $0 | Fortune $0 | Tax $0
Seat 1: 7c950e30 (button) folded before Flop (didn't bet)
Seat 2: 5945e592 (small blind) folded before Flop
Seat 3: 3dbf95c1 (big blind) collected ($0.04)
Seat 4: 9450adf7 folded before Flop (didn't bet)
Seat 5: 29c7b0d2 folded before Flop (didn't bet)
Seat 6: Hero folded before Flop (didn't bet)


Poker Hand #RC2078451489: Hold'em No Limit ($0.02/$0.05) - 2023/12/22 21:12:57
Table 'RushAndCash781285' 6-max Seat #1 is the button
Seat 1: 67d4b163 ($13.15 in chips)
Seat 2: Hero ($6.14 in chips)
Seat 3: 5ba9a692 ($6.77 in chips)
Seat 4: 610bd7fc ($10.89 in chips)
Seat 5: 90b129bf ($6.83 in chips)
Seat 6: ff5dd678 ($1.95 in chips)
Hero: posts small blind $0.02
5ba9a692: posts big blind $0.05
*** HOLE CARDS ***
Dealt to 67d4b163 
Dealt to Hero [7s Kc]
Dealt to 5ba9a692 
Dealt to 610bd7fc 
Dealt to 90b129bf 
Dealt to ff5dd678 
610bd7fc: folds
90b129bf: folds
ff5dd678: calls $0.05
67d4b163: folds
Hero: folds
5ba9a692: checks
*** FLOP *** [Kd Ks Ac]
5ba9a692: checks
ff5dd678: checks
*** TURN *** [Kd Ks Ac] [Jc]
5ba9a692: checks
ff5dd678: checks
*** RIVER *** [Kd Ks Ac Jc] [4h]
5ba9a692: checks
ff5dd678: bets $0.05
5ba9a692: folds
Uncalled bet ($0.05) returned to ff5dd678
*** SHOWDOWN ***
ff5dd678 collected $0.12 from pot
*** SUMMARY ***
Total pot $0.12 | Rake $0 | Jackpot $0 | Bingo $0 | Fortune $0 | Tax $0
Board [Kd Ks Ac Jc 4h]
Seat 1: 67d4b163 (button) folded before Flop (didn't bet)
Seat 2: Hero (small blind) folded before Flop
Seat 3: 5ba9a692 (big blind) folded on the River
Seat 4: 610bd7fc folded before Flop (didn't bet)
Seat 5: 90b129bf folded before Flop (didn't bet)
Seat 6: ff5dd678 won ($0.12)


Poker Hand #RC2078451270: Hold'em No Limit ($0.02/$0.05) - 2023/12/22 21:12:43
Table 'RushAndCash781184' 6-max Seat #1 is the button
Seat 1: Hero ($6.07 in chips)
Seat 2: 67d4b163 ($13.22 in chips)
Seat 3: eb944e6 ($6.22 in chips)
Seat 4: 18f9cb34 ($6.32 in chips)
Seat 5: 6d3488f1 ($3.54 in chips)
Seat 6: 59846dec ($2.62 in chips)
67d4b163: posts small blind $0.02
eb944e6: posts big blind $0.05
*** HOLE CARDS ***
Dealt to Hero [Tc Ac]
Dealt to 67d4b163 
Dealt to eb944e6 
Dealt to 18f9cb34 
Dealt to 6d3488f1 
Dealt to 59846dec 
18f9cb34: folds
6d3488f1: folds
59846dec: folds
Hero: raises $0.08 to $0.13
67d4b163: folds
eb944e6: folds
Uncalled bet ($0.08) returned to Hero
*** SHOWDOWN ***
Hero collected $0.12 from pot
*** SUMMARY ***
Total pot $0.12 | Rake $0 | Jackpot $0 | Bingo $0 | Fortune $0 | Tax $0
Seat 1: Hero (button) collected ($0.12)
Seat 2: 67d4b163 (small blind) folded before Flop
Seat 3: eb944e6 (big blind) folded before Flop
Seat 4: 18f9cb34 folded before Flop (didn't bet)
Seat 5: 6d3488f1 folded before Flop (didn't bet)
Seat 6: 59846dec folded before Flop (didn't bet)


Poker Hand #RC2078451202: Hold'em No Limit ($0.02/$0.05) - 2023/12/22 21:12:39
Table 'RushAndCash781152' 6-max Seat #1 is the button
Seat 1: cabfa413 ($5.04 in chips)
Seat 2: 8e0f056d ($7.87 in chips)
Seat 3: 72f7386e ($10.72 in chips)
Seat 4: Hero ($6.07 in chips)
Seat 5: fdc2d3ba ($12.99 in chips)
Seat 6: 8d15f06b ($11.93 in chips)
8e0f056d: posts small blind $0.02
72f7386e: posts big blind $0.05
*** HOLE CARDS ***
Dealt to cabfa413 
Dealt to 8e0f056d 
Dealt to 72f7386e 
Dealt to Hero [Jc Kh]
Dealt to fdc2d3ba 
Dealt to 8d15f06b 
Hero: folds
fdc2d3ba: folds
8d15f06b: folds
cabfa413: folds
8e0f056d: raises $0.05 to $0.1
72f7386e: folds
Uncalled bet ($0.05) returned to 8e0f056d
*** SHOWDOWN ***
8e0f056d collected $0.1 from pot
*** SUMMARY ***
Total pot $0.1 | Rake $0 | Jackpot $0 | Bingo $0 | Fortune $0 | Tax $0
Seat 1: cabfa413 (button) folded before Flop (didn't bet)
Seat 2: 8e0f056d (small blind) collected ($0.1)
Seat 3: 72f7386e (big blind) folded before Flop
Seat 4: Hero folded before Flop (didn't bet)
Seat 5: fdc2d3ba folded before Flop (didn't bet)
Seat 6: 8d15f06b folded before Flop (didn't bet)


Poker Hand #RC2078450963: Hold'em No Limit ($0.02/$0.05) - 2023/12/22 21:12:25
Table 'RushAndCash781041' 6-max Seat #1 is the button
Seat 1: f03c68f3 ($8 in chips)
Seat 2: 52749f9e ($6.32 in chips)
Seat 3: cf6f5635 ($7.45 in chips)
Seat 4: c8389234 ($12.45 in chips)
Seat 5: Hero ($6 in chips)
Seat 6: d32741ba ($10.61 in chips)
52749f9e: posts small blind $0.02
cf6f5635: posts big blind $0.05
*** HOLE CARDS ***
Dealt to f03c68f3 
Dealt to 52749f9e 
Dealt to cf6f5635 
Dealt to c8389234 
Dealt to Hero [As Ah]
Dealt to d32741ba 
c8389234: folds
Hero: raises $0.05 to $0.1
d32741ba: folds
f03c68f3: folds
52749f9e: folds
cf6f5635: folds
Uncalled bet ($0.05) returned to Hero
*** SHOWDOWN ***
Hero collected $0.12 from pot
*** SUMMARY ***
Total pot $0.12 | Rake $0 | Jackpot $0 | Bingo $0 | Fortune $0 | Tax $0
Seat 1: f03c68f3 (button) folded before Flop (didn't bet)
Seat 2: 52749f9e (small blind) folded before Flop
Seat 3: cf6f5635 (big blind) folded before Flop
Seat 4: c8389234 folded before Flop (didn't bet)
Seat 5: Hero collected ($0.12)
Seat 6: d32741ba folded before Flop (didn't bet)


Poker Hand #RC2078450899: Hold'em No Limit ($0.02/$0.05) - 2023/12/22 21:12:21
Table 'RushAndCash781013' 6-max Seat #1 is the button
Seat 1: b74b84be ($3.29 in chips)
Seat 2: 780442c9 ($5.88 in chips)
Seat 3: 9796250f ($3.68 in chips)
Seat 4: Hero ($6 in chips)
Seat 5: f6f7aa18 ($5.14 in chips)
Seat 6: c6bf1d22 ($7.74 in chips)
780442c9: posts small blind $0.02
9796250f: posts big blind $0.05
*** HOLE CARDS ***
Dealt to b74b84be 
Dealt to 780442c9 
Dealt to 9796250f 
Dealt to Hero [9s 3d]
Dealt to f6f7aa18 
Dealt to c6bf1d22 
Hero: folds
f6f7aa18: raises $0.08 to $0.13
c6bf1d22: folds
b74b84be: folds
780442c9: folds
9796250f: calls $0.08
*** FLOP *** [Th 8c 9c]
9796250f: checks
f6f7aa18: bets $0.14
9796250f: folds
Uncalled bet ($0.14) returned to f6f7aa18
*** SHOWDOWN ***
f6f7aa18 collected $0.27 from pot
*** SUMMARY ***
Total pot $0.28 | Rake $0.01 | Jackpot $0 | Bingo $0 | Fortune $0 | Tax $0
Board [Th 8c 9c]
Seat 1: b74b84be (button) folded before Flop (didn't bet)
Seat 2: 780442c9 (small blind) folded before Flop
Seat 3: 9796250f (big blind) folded on the Flop
Seat 4: Hero folded before Flop (didn't bet)
Seat 5: f6f7aa18 won ($0.27)
Seat 6: c6bf1d22 folded before Flop (didn't bet)


Poker Hand #RC2078450835: Hold'em No Limit ($0.02/$0.05) - 2023/12/22 21:12:18
Table 'RushAndCash780984' 6-max Seat #1 is the button
Seat 1: 3cf310b ($5.57 in chips)
Seat 2: Hero ($6.02 in chips)
Seat 3: a9db0c00 ($14.89 in chips)
Seat 4: 4a2f512 ($2.08 in chips)
Seat 5: 7c19951 ($5.59 in chips)
Seat 6: 7ddba90d ($4.03 in chips)
Hero: posts small blind $0.02
a9db0c00: posts big blind $0.05
*** HOLE CARDS ***
Dealt to 3cf310b 
Dealt to Hero [Kc 2s]
Dealt to a9db0c00 
Dealt to 4a2f512 
Dealt to 7c19951 
Dealt to 7ddba90d 
4a2f512: raises $0.06 to $0.11
7c19951: folds
7ddba90d: folds
3cf310b: folds
Hero: folds
a9db0c00: folds
Uncalled bet ($0.06) returned to 4a2f512
*** SHOWDOWN ***
4a2f512 collected $0.12 from pot
*** SUMMARY ***
Total pot $0.12 | Rake $0 | Jackpot $0 | Bingo $0 | Fortune $0 | Tax $0
Seat 1: 3cf310b (button) folded before Flop (didn't bet)
Seat 2: Hero (small blind) folded before Flop
Seat 3: a9db0c00 (big blind) folded before Flop
Seat 4: 4a2f512 collected ($0.12)
Seat 5: 7c19951 folded before Flop (didn't bet)
Seat 6: 7ddba90d folded before Flop (didn't bet)


Poker Hand #RC2078450637: Hold'em No Limit ($0.02/$0.05) - 2023/12/22 21:12:07
Table 'RushAndCash780896' 6-max Seat #1 is the button
Seat 1: 6e3c9195 ($6.15 in chips)
Seat 2: 7c19951 ($5.54 in chips)
Seat 3: Hero ($6 in chips)
Seat 4: 97e7da6 ($5 in chips)
Seat 5: ceb10c49 ($6.18 in chips)
Seat 6: 5261fe21 ($5 in chips)
7c19951: posts small blind $0.02
Hero: posts big blind $0.05
*** HOLE CARDS ***
Dealt to 6e3c9195 
Dealt to 7c19951 
Dealt to Hero [Jd Ad]
Dealt to 97e7da6 
Dealt to ceb10c49 
Dealt to 5261fe21 
97e7da6: folds
ceb10c49: folds
5261fe21: folds
6e3c9195: folds
7c19951: folds
Uncalled bet ($0.03) returned to Hero
*** SHOWDOWN ***
Hero collected $0.04 from pot
*** SUMMARY ***
Total pot $0.04 | Rake $0 | Jackpot $0 | Bingo $0 | Fortune $0 | Tax $0
Seat 1: 6e3c9195 (button) folded before Flop (didn't bet)
Seat 2: 7c19951 (small blind) folded before Flop
Seat 3: Hero (big blind) collected ($0.04)
Seat 4: 97e7da6 folded before Flop (didn't bet)
Seat 5: ceb10c49 folded before Flop (didn't bet)
Seat 6: 5261fe21 folded before Flop (didn't bet)


Poker Hand #RC2078450573: Hold'em No Limit ($0.02/$0.05) - 2023/12/22 21:12:03
Table 'RushAndCash780865' 6-max Seat #1 is the button
Seat 1: Hero ($6 in chips)
Seat 2: 3c028e9 ($5.64 in chips)
Seat 3: 6b8a648f ($5.53 in chips)
Seat 4: 81ecaac5 ($5.86 in chips)
Seat 5: 59ef18cb ($2.69 in chips)
Seat 6: ad142c24 ($12.38 in chips)
3c028e9: posts small blind $0.02
6b8a648f: posts big blind $0.05
*** HOLE CARDS ***
Dealt to Hero [3s Kc]
Dealt to 3c028e9 
Dealt to 6b8a648f 
Dealt to 81ecaac5 
Dealt to 59ef18cb 
Dealt to ad142c24 
81ecaac5: folds
59ef18cb: raises $0.08 to $0.13
ad142c24: folds
Hero: folds
3c028e9: folds
6b8a648f: folds
Uncalled bet ($0.08) returned to 59ef18cb
*** SHOWDOWN ***
59ef18cb collected $0.12 from pot
*** SUMMARY ***
Total pot $0.12 | Rake $0 | Jackpot $0 | Bingo $0 | Fortune $0 | Tax $0
Seat 1: Hero (button) folded before Flop (didn't bet)
Seat 2: 3c028e9 (small blind) folded before Flop
Seat 3: 6b8a648f (big blind) folded before Flop
Seat 4: 81ecaac5 folded before Flop (didn't bet)
Seat 5: 59ef18cb collected ($0.12)
Seat 6: ad142c24 folded before Flop (didn't bet)


Poker Hand #RC2078450477: Hold'em No Limit ($0.02/$0.05) - 2023/12/22 21:11:58
Table 'RushAndCash780819' 6-max Seat #1 is the button
Seat 1: 49374b34 ($5.3 in chips)
Seat 2: e44205f6 ($5.6 in chips)
Seat 3: 7c19951 ($5.59 in chips)
Seat 4: Hero ($6 in chips)
Seat 5: b8103a2d ($10.07 in chips)
Seat 6: 71871718 ($2.31 in chips)
e44205f6: posts small blind $0.02
7c19951: posts big blind $0.05
*** HOLE CARDS ***
Dealt to 49374b34 
Dealt to e44205f6 
Dealt to 7c19951 
Dealt to Hero [8h 6s]
Dealt to b8103a2d 
Dealt to 71871718 
Hero: folds
b8103a2d: folds
71871718: folds
49374b34: folds
e44205f6: folds
Uncalled bet ($0.03) returned to 7c19951
*** SHOWDOWN ***
7c19951 collected $0.04 from pot
*** SUMMARY ***
Total pot $0.04 | Rake $0 | Jackpot $0 | Bingo $0 | Fortune $0 | Tax $0
Seat 1: 49374b34 (button) folded before Flop (didn't bet)
Seat 2: e44205f6 (small blind) folded before Flop
Seat 3: 7c19951 (big blind) collected ($0.04)
Seat 4: Hero folded before Flop (didn't bet)
Seat 5: b8103a2d folded before Flop (didn't bet)
Seat 6: 71871718 folded before Flop (didn't bet)


Poker Hand #RC2078450421: Hold'em No Limit ($0.02/$0.05) - 2023/12/22 21:11:54
Table 'RushAndCash780793' 6-max Seat #1 is the button
Seat 1: 2be5624e ($5.26 in chips)
Seat 2: b8103a2d ($10.09 in chips)
Seat 3: 75daa184 ($8.65 in chips)
Seat 4: 9b2d2337 ($18.96 in chips)
Seat 5: Hero ($6 in chips)
Seat 6: ff6f425f ($12.24 in chips)
b8103a2d: posts small blind $0.02
75daa184: posts big blind $0.05
*** HOLE CARDS ***
Dealt to 2be5624e 
Dealt to b8103a2d 
Dealt to 75daa184 
Dealt to 9b2d2337 
Dealt to Hero [9h 5d]
Dealt to ff6f425f 
9b2d2337: folds
Hero: folds
ff6f425f: folds
2be5624e: raises $0.08 to $0.13
b8103a2d: folds
75daa184: calls $0.08
*** FLOP *** [As Kc Th]
75daa184: checks
2be5624e: bets $0.21
75daa184: calls $0.21
*** TURN *** [As Kc Th] [Ah]
75daa184: checks
2be5624e: checks
*** RIVER *** [As Kc Th Ah] [Ts]
75daa184: bets $0.8
2be5624e: raises $4.12 to $4.92 and is all-in
75daa184: calls $4.12
2be5624e: shows [5s Ac] (Aces Full over Tens)
75daa184: shows [Ad 7d] (Aces Full over Tens)
*** SHOWDOWN ***
75daa184 collected $5.17 from pot
2be5624e collected $5.16 from pot
*** SUMMARY ***
Total pot $10.54 | Rake $0.14 | Jackpot $0.07 | Bingo $0 | Fortune $0 | Tax $0
Board [As Kc Th Ah Ts]
Seat 1: 2be5624e (button) showed [5s Ac] and won ($5.16) with Aces Full over Tens
Seat 2: b8103a2d (small blind) folded before Flop
Seat 3: 75daa184 (big blind) showed [Ad 7d] and won ($5.17) with Aces Full over Tens
Seat 4: 9b2d2337 folded before Flop (didn't bet)
Seat 5: Hero folded before Flop (didn't bet)
Seat 6: ff6f425f folded before Flop (didn't bet)


Poker Hand #RC2078450191: Hold'em No Limit ($0.02/$0.05) - 2023/12/22 21:11:41
Table 'RushAndCash780679' 6-max Seat #1 is the button
Seat 1: c7b7c566 ($6.64 in chips)
Seat 2: f71b25e9 ($5.53 in chips)
Seat 3: 2f89a0 ($5 in chips)
Seat 4: 6a594ce8 ($5.07 in chips)
Seat 5: Hero ($5.93 in chips)
Seat 6: 9b0ec3a ($12.56 in chips)
f71b25e9: posts small blind $0.02
2f89a0: posts big blind $0.05
*** HOLE CARDS ***
Dealt to c7b7c566 
Dealt to f71b25e9 
Dealt to 2f89a0 
Dealt to 6a594ce8 
Dealt to Hero [Ks Ad]
Dealt to 9b0ec3a 
6a594ce8: folds
Hero: raises $0.05 to $0.1
9b0ec3a: folds
c7b7c566: folds
f71b25e9: folds
2f89a0: folds
Uncalled bet ($0.05) returned to Hero
*** SHOWDOWN ***
Hero collected $0.12 from pot
*** SUMMARY ***
Total pot $0.12 | Rake $0 | Jackpot $0 | Bingo $0 | Fortune $0 | Tax $0
Seat 1: c7b7c566 (button) folded before Flop (didn't bet)
Seat 2: f71b25e9 (small blind) folded before Flop
Seat 3: 2f89a0 (big blind) folded before Flop
Seat 4: 6a594ce8 folded before Flop (didn't bet)
Seat 5: Hero collected ($0.12)
Seat 6: 9b0ec3a folded before Flop (didn't bet)


Poker Hand #RC2078450101: Hold'em No Limit ($0.02/$0.05) - 2023/12/22 21:11:36
Table 'RushAndCash780633' 6-max Seat #1 is the button
Seat 1: f9c6a467 ($20.61 in chips)
Seat 2: 801c157f ($14.73 in chips)
Seat 3: Hero ($5.98 in chips)
Seat 4: 8e0f056d ($8.04 in chips)
Seat 5: b95e9d10 ($5.16 in chips)
Seat 6: 604bace8 ($3.18 in chips)
801c157f: posts small blind $0.02
Hero: posts big blind $0.05
*** HOLE CARDS ***
Dealt to f9c6a467 
Dealt to 801c157f 
Dealt to Hero [7s Qh]
Dealt to 8e0f056d 
Dealt to b95e9d10 
Dealt to 604bace8 
8e0f056d: folds
b95e9d10: raises $0.05 to $0.1
604bace8: folds
f9c6a467: folds
801c157f: folds
Hero: folds
Uncalled bet ($0.05) returned to b95e9d10
*** SHOWDOWN ***
b95e9d10 collected $0.12 from pot
*** SUMMARY ***
Total pot $0.12 | Rake $0 | Jackpot $0 | Bingo $0 | Fortune $0 | Tax $0
Seat 1: f9c6a467 (button) folded before Flop (didn't bet)
Seat 2: 801c157f (small blind) folded before Flop
Seat 3: Hero (big blind) folded before Flop
Seat 4: 8e0f056d folded before Flop (didn't bet)
Seat 5: b95e9d10 collected ($0.12)
Seat 6: 604bace8 folded before Flop (didn't bet)


Poker Hand #RC2078450036: Hold'em No Limit ($0.02/$0.05) - 2023/12/22 21:11:32
Table 'RushAndCash780602' 6-max Seat #1 is the button
Seat 1: 58864a6e ($20.8 in chips)
Seat 2: Hero ($6 in chips)
Seat 3: a602a3b0 ($8.86 in chips)
Seat 4: 18f0f05c ($10.6 in chips)
Seat 5: 3e455537 ($4.68 in chips)
Seat 6: 6bf9020c ($5.08 in chips)
Hero: posts small blind $0.02
a602a3b0: posts big blind $0.05
*** HOLE CARDS ***
Dealt to 58864a6e 
Dealt to Hero [3s Jc]
Dealt to a602a3b0 
Dealt to 18f0f05c 
Dealt to 3e455537 
Dealt to 6bf9020c 
18f0f05c: raises $0.06 to $0.11
3e455537: folds
6bf9020c: folds
58864a6e: folds
Hero: folds
a602a3b0: folds
Uncalled bet ($0.06) returned to 18f0f05c
*** SHOWDOWN ***
18f0f05c collected $0.12 from pot
*** SUMMARY ***
Total pot $0.12 | Rake $0 | Jackpot $0 | Bingo $0 | Fortune $0 | Tax $0
Seat 1: 58864a6e (button) folded before Flop (didn't bet)
Seat 2: Hero (small blind) folded before Flop
Seat 3: a602a3b0 (big blind) folded before Flop
Seat 4: 18f0f05c collected ($0.12)
Seat 5: 3e455537 folded before Flop (didn't bet)
Seat 6: 6bf9020c folded before Flop (didn't bet)


Poker Hand #RC2078449985: Hold'em No Limit ($0.02/$0.05) - 2023/12/22 21:11:29
Table 'RushAndCash780578' 6-max Seat #1 is the button
Seat 1: d71ab80c ($7.3 in chips)
Seat 2: d42ee966 ($7.12 in chips)
Seat 3: 2df55086 ($7.5 in chips)
Seat 4: b95e9d10 ($5.16 in chips)
Seat 5: Hero ($6 in chips)
Seat 6: 9aad1596 ($7.38 in chips)
d42ee966: posts small blind $0.02
2df55086: posts big blind $0.05
*** HOLE CARDS ***
Dealt to d71ab80c 
Dealt to d42ee966 
Dealt to 2df55086 
Dealt to b95e9d10 
Dealt to Hero [Qs 3s]
Dealt to 9aad1596 
b95e9d10: folds
Hero: folds
9aad1596: folds
d71ab80c: raises $0.05 to $0.1
d42ee966: folds
2df55086: folds
Uncalled bet ($0.05) returned to d71ab80c
*** SHOWDOWN ***
d71ab80c collected $0.12 from pot
*** SUMMARY ***
Total pot $0.12 | Rake $0 | Jackpot $0 | Bingo $0 | Fortune $0 | Tax $0
Seat 1: d71ab80c (button) collected ($0.12)
Seat 2: d42ee966 (small blind) folded before Flop
Seat 3: 2df55086 (big blind) folded before Flop
Seat 4: b95e9d10 folded before Flop (didn't bet)
Seat 5: Hero folded before Flop (didn't bet)
Seat 6: 9aad1596 folded before Flop (didn't bet)


Poker Hand #RC2078449812: Hold'em No Limit ($0.02/$0.05) - 2023/12/22 21:11:19
Table 'RushAndCash780499' 6-max Seat #1 is the button
Seat 1: 567a37c4 ($5.33 in chips)
Seat 2: a87d0af2 ($4.34 in chips)
Seat 3: dc7cff29 ($5.98 in chips)
Seat 4: 2c2cc68d ($12.13 in chips)
Seat 5: Hero ($5.93 in chips)
Seat 6: 1be6b9fd ($10.07 in chips)
a87d0af2: posts small blind $0.02
dc7cff29: posts big blind $0.05
*** HOLE CARDS ***
Dealt to 567a37c4 
Dealt to a87d0af2 
Dealt to dc7cff29 
Dealt to 2c2cc68d 
Dealt to Hero [Jh Ad]
Dealt to 1be6b9fd 
2c2cc68d: folds
Hero: raises $0.05 to $0.1
1be6b9fd: folds
567a37c4: folds
a87d0af2: folds
dc7cff29: folds
Uncalled bet ($0.05) returned to Hero
*** SHOWDOWN ***
Hero collected $0.12 from pot
*** SUMMARY ***
Total pot $0.12 | Rake $0 | Jackpot $0 | Bingo $0 | Fortune $0 | Tax $0
Seat 1: 567a37c4 (button) folded before Flop (didn't bet)
Seat 2: a87d0af2 (small blind) folded before Flop
Seat 3: dc7cff29 (big blind) folded before Flop
Seat 4: 2c2cc68d folded before Flop (didn't bet)
Seat 5: Hero collected ($0.12)
Seat 6: 1be6b9fd folded before Flop (didn't bet)


Poker Hand #RC2078449759: Hold'em No Limit ($0.02/$0.05) - 2023/12/22 21:11:15
Table 'RushAndCash780476' 6-max Seat #1 is the button
Seat 1: Hero ($5.93 in chips)
Seat 2: 999944fc ($6.2 in chips)
Seat 3: 7ab29bd ($5.42 in chips)
Seat 4: cb16bb03 ($5 in chips)
Seat 5: 1e3d103d ($5.38 in chips)
Seat 6: f0337111 ($7.57 in chips)
999944fc: posts small blind $0.02
7ab29bd: posts big blind $0.05
*** HOLE CARDS ***
Dealt to Hero [8c 5d]
Dealt to 999944fc 
Dealt to 7ab29bd 
Dealt to cb16bb03 
Dealt to 1e3d103d 
Dealt to f0337111 
cb16bb03: folds
1e3d103d: raises $0.05 to $0.1
f0337111: folds
Hero: folds
999944fc: folds
7ab29bd: calls $0.05
*** FLOP *** [Ah Qs 4d]
7ab29bd: checks
1e3d103d: bets $0.1
7ab29bd: folds
Uncalled bet ($0.1) returned to 1e3d103d
*** SHOWDOWN ***
1e3d103d collected $0.21 from pot
*** SUMMARY ***
Total pot $0.22 | Rake $0.01 | Jackpot $0 | Bingo $0 | Fortune $0 | Tax $0
Board [Ah Qs 4d]
Seat 1: Hero (button) folded before Flop (didn't bet)
Seat 2: 999944fc (small blind) folded before Flop
Seat 3: 7ab29bd (big blind) folded on the Flop
Seat 4: cb16bb03 folded before Flop (didn't bet)
Seat 5: 1e3d103d won ($0.21)
Seat 6: f0337111 folded before Flop (didn't bet)


Poker Hand #RC2078449407: Hold'em No Limit ($0.02/$0.05) - 2023/12/22 21:10:54
Table 'RushAndCash780313' 6-max Seat #1 is the button
Seat 1: b8103a2d ($10.33 in chips)
Seat 2: Hero ($6.03 in chips)
Seat 3: 8acef960 ($3.04 in chips)
Seat 4: 6029883b ($5 in chips)
Seat 5: 1be6b9fd ($9.93 in chips)
Seat 6: 9450adf7 ($8.39 in chips)
Hero: posts small blind $0.02
8acef960: posts big blind $0.05
*** HOLE CARDS ***
Dealt to b8103a2d 
Dealt to Hero [8h Kh]
Dealt to 8acef960 
Dealt to 6029883b 
Dealt to 1be6b9fd 
Dealt to 9450adf7 
6029883b: folds
1be6b9fd: raises $0.05 to $0.1
9450adf7: folds
b8103a2d: folds
Hero: calls $0.08
8acef960: folds
*** FLOP *** [Jd 4d 2h]
Hero: checks
1be6b9fd: bets $0.14
Hero: folds
Uncalled bet ($0.14) returned to 1be6b9fd
*** SHOWDOWN ***
1be6b9fd collected $0.24 from pot
*** SUMMARY ***
Total pot $0.25 | Rake $0.01 | Jackpot $0 | Bingo $0 | Fortune $0 | Tax $0
Board [Jd 4d 2h]
Seat 1: b8103a2d (button) folded before Flop (didn't bet)
Seat 2: Hero (small blind) folded on the Flop
Seat 3: 8acef960 (big blind) folded before Flop
Seat 4: 6029883b folded before Flop (didn't bet)
Seat 5: 1be6b9fd won ($0.24)
Seat 6: 9450adf7 folded before Flop (didn't bet)


Poker Hand #RC2078449345: Hold'em No Limit ($0.02/$0.05) - 2023/12/22 21:10:50
Table 'RushAndCash780285' 6-max Seat #1 is the button
Seat 1: a0ef5108 ($4.89 in chips)
Seat 2: 59ad445d ($7.42 in chips)
Seat 3: 3c028e9 ($5.76 in chips)
Seat 4: Hero ($6.03 in chips)
Seat 5: 5861f243 ($5.64 in chips)
Seat 6: 1e7880dc ($13.4 in chips)
59ad445d: posts small blind $0.02
3c028e9: posts big blind $0.05
*** HOLE CARDS ***
Dealt to a0ef5108 
Dealt to 59ad445d 
Dealt to 3c028e9 
Dealt to Hero [Kc Ts]
Dealt to 5861f243 
Dealt to 1e7880dc 
Hero: folds
5861f243: folds
1e7880dc: raises $0.05 to $0.1
a0ef5108: folds
59ad445d: folds
3c028e9: folds
Uncalled bet ($0.05) returned to 1e7880dc
*** SHOWDOWN ***
1e7880dc collected $0.12 from pot
*** SUMMARY ***
Total pot $0.12 | Rake $0 | Jackpot $0 | Bingo $0 | Fortune $0 | Tax $0
Seat 1: a0ef5108 (button) folded before Flop (didn't bet)
Seat 2: 59ad445d (small blind) folded before Flop
Seat 3: 3c028e9 (big blind) folded before Flop
Seat 4: Hero folded before Flop (didn't bet)
Seat 5: 5861f243 folded before Flop (didn't bet)
Seat 6: 1e7880dc collected ($0.12)


Poker Hand #RC2078448689: Hold'em No Limit ($0.02/$0.05) - 2023/12/22 21:10:10
Table 'RushAndCash779961' 6-max Seat #1 is the button
Seat 1: c0d3508b ($2.11 in chips)
Seat 2: a0ef5108 ($4.26 in chips)
Seat 3: Hero ($6.73 in chips)
Seat 4: e03be8c0 ($5.63 in chips)
Seat 5: 90511c4f ($5 in chips)
Seat 6: 311eeba4 ($5.94 in chips)
a0ef5108: posts small blind $0.02
Hero: posts big blind $0.05
*** HOLE CARDS ***
Dealt to c0d3508b 
Dealt to a0ef5108 
Dealt to Hero [Td Jd]
Dealt to e03be8c0 
Dealt to 90511c4f 
Dealt to 311eeba4 
e03be8c0: folds
90511c4f: folds
311eeba4: folds
c0d3508b: folds
a0ef5108: raises $0.1 to $0.15
Hero: calls $0.1
*** FLOP *** [Kd 7s Kc]
a0ef5108: bets $0.1
Hero: calls $0.1
*** TURN *** [Kd 7s Kc] [9d]
a0ef5108: bets $0.17
Hero: calls $0.17
*** RIVER *** [Kd 7s Kc 9d] [3s]
a0ef5108: checks
Hero: bets $0.28
a0ef5108: calls $0.28
Hero: shows [Td Jd] (Pair of Kings)
a0ef5108: shows [Qd As] (Pair of Kings)
*** SHOWDOWN ***
a0ef5108 collected $1.33 from pot
*** SUMMARY ***
Total pot $1.4 | Rake $0.07 | Jackpot $0 | Bingo $0 | Fortune $0 | Tax $0
Board [Kd 7s Kc 9d 3s]
Seat 1: c0d3508b (button) folded before Flop (didn't bet)
Seat 2: a0ef5108 (small blind) showed [Qd As] and won ($1.33) with Pair of Kings
Seat 3: Hero (big blind) showed [Td Jd] and lost with Pair of Kings
Seat 4: e03be8c0 folded before Flop (didn't bet)
Seat 5: 90511c4f folded before Flop (didn't bet)
Seat 6: 311eeba4 folded before Flop (didn't bet)


Poker Hand #RC2078448618: Hold'em No Limit ($0.02/$0.05) - 2023/12/22 21:10:06
Table 'RushAndCash779926' 6-max Seat #1 is the button
Seat 1: 1c8d5419 ($8.37 in chips)
Seat 2: d59fc4d ($7.57 in chips)
Seat 3: 740989e3 ($5 in chips)
Seat 4: Hero ($6.73 in chips)
Seat 5: ee1f67f7 ($9.71 in chips)
Seat 6: ec033a10 ($5.12 in chips)
d59fc4d: posts small blind $0.02
740989e3: posts big blind $0.05
*** HOLE CARDS ***
Dealt to 1c8d5419 
Dealt to d59fc4d 
Dealt to 740989e3 
Dealt to Hero [6c Tc]
Dealt to ee1f67f7 
Dealt to ec033a10 
Hero: folds
ee1f67f7: folds
ec033a10: folds
1c8d5419: raises $0.08 to $0.13
d59fc4d: folds
740989e3: calls $0.08
*** FLOP *** [2c 3d 6h]
740989e3: checks
1c8d5419: checks
*** TURN *** [2c 3d 6h] [Qc]
740989e3: checks
1c8d5419: checks
*** RIVER *** [2c 3d 6h Qc] [Jd]
740989e3: bets $0.4
1c8d5419: folds
Uncalled bet ($0.4) returned to 740989e3
*** SHOWDOWN ***
740989e3 collected $0.27 from pot
*** SUMMARY ***
Total pot $0.28 | Rake $0.01 | Jackpot $0 | Bingo $0 | Fortune $0 | Tax $0
Board [2c 3d 6h Qc Jd]
Seat 1: 1c8d5419 (button) folded on the River
Seat 2: d59fc4d (small blind) folded before Flop
Seat 3: 740989e3 (big blind) won ($0.27)
Seat 4: Hero folded before Flop (didn't bet)
Seat 5: ee1f67f7 folded before Flop (didn't bet)
Seat 6: ec033a10 folded before Flop (didn't bet)


Poker Hand #RC2078448561: Hold'em No Limit ($0.02/$0.05) - 2023/12/22 21:10:03
Table 'RushAndCash779900' 6-max Seat #1 is the button
Seat 1: b6036b95 ($5.75 in chips)
Seat 2: c344ad4c ($5.14 in chips)
Seat 3: 6502f27b ($5.68 in chips)
Seat 4: Hero ($6.73 in chips)
Seat 5: cb16bb03 ($5.2 in chips)
Seat 6: 1e4a5551 ($1.94 in chips)
c344ad4c: posts small blind $0.02
6502f27b: posts big blind $0.05
*** HOLE CARDS ***
Dealt to b6036b95 
Dealt to c344ad4c 
Dealt to 6502f27b 
Dealt to Hero [2h Qd]
Dealt to cb16bb03 
Dealt to 1e4a5551 
Hero: folds
cb16bb03: raises $0.08 to $0.13
1e4a5551: folds
b6036b95: folds
c344ad4c: raises $0.31 to $0.44
6502f27b: folds
cb16bb03: folds
Uncalled bet ($0.31) returned to c344ad4c
*** SHOWDOWN ***
c344ad4c collected $0.3 from pot
*** SUMMARY ***
Total pot $0.31 | Rake $0.01 | Jackpot $0 | Bingo $0 | Fortune $0 | Tax $0
Seat 1: b6036b95 (button) folded before Flop (didn't bet)
Seat 2: c344ad4c (small blind) collected ($0.3)
Seat 3: 6502f27b (big blind) folded before Flop
Seat 4: Hero folded before Flop (didn't bet)
Seat 5: cb16bb03 folded before Flop
Seat 6: 1e4a5551 folded before Flop (didn't bet)


Poker Hand #RC2078448469: Hold'em No Limit ($0.02/$0.05) - 2023/12/22 21:09:58
Table 'RushAndCash779860' 6-max Seat #1 is the button
Seat 1: Hero ($6.73 in chips)
Seat 2: 3928912e ($5.07 in chips)
Seat 3: 177da66b ($4.76 in chips)
Seat 4: 2057ccaa ($5.14 in chips)
Seat 5: 3c03eb6e ($7.48 in chips)
Seat 6: 1db9c453 ($5.46 in chips)
3928912e: posts small blind $0.02
177da66b: posts big blind $0.05
*** HOLE CARDS ***
Dealt to Hero [9c Js]
Dealt to 3928912e 
Dealt to 177da66b 
Dealt to 2057ccaa 
Dealt to 3c03eb6e 
Dealt to 1db9c453 
2057ccaa: folds
3c03eb6e: raises $0.06 to $0.11
1db9c453: folds
Hero: folds
3928912e: folds
177da66b: folds
Uncalled bet ($0.06) returned to 3c03eb6e
*** SHOWDOWN ***
3c03eb6e collected $0.12 from pot
*** SUMMARY ***
Total pot $0.12 | Rake $0 | Jackpot $0 | Bingo $0 | Fortune $0 | Tax $0
Seat 1: Hero (button) folded before Flop (didn't bet)
Seat 2: 3928912e (small blind) folded before Flop
Seat 3: 177da66b (big blind) folded before Flop
Seat 4: 2057ccaa folded before Flop (didn't bet)
Seat 5: 3c03eb6e collected ($0.12)
Seat 6: 1db9c453 folded before Flop (didn't bet)


Poker Hand #RC2078448381: Hold'em No Limit ($0.02/$0.05) - 2023/12/22 21:09:53
Table 'RushAndCash779819' 6-max Seat #1 is the button
Seat 1: a0ef5108 ($4.21 in chips)
Seat 2: Hero ($6.75 in chips)
Seat 3: 3034205c ($5.17 in chips)
Seat 4: 985b2ecb ($3.9 in chips)
Seat 5: 7157dd36 ($9.58 in chips)
Seat 6: 697fb04a ($46.63 in chips)
Hero: posts small blind $0.02
3034205c: posts big blind $0.05
*** HOLE CARDS ***
Dealt to a0ef5108 
Dealt to Hero [8h 5s]
Dealt to 3034205c 
Dealt to 985b2ecb 
Dealt to 7157dd36 
Dealt to 697fb04a 
985b2ecb: folds
7157dd36: folds
697fb04a: folds
a0ef5108: folds
Hero: folds
Uncalled bet ($0.03) returned to 3034205c
*** SHOWDOWN ***
3034205c collected $0.04 from pot
*** SUMMARY ***
Total pot $0.04 | Rake $0 | Jackpot $0 | Bingo $0 | Fortune $0 | Tax $0
Seat 1: a0ef5108 (button) folded before Flop (didn't bet)
Seat 2: Hero (small blind) folded before Flop
Seat 3: 3034205c (big blind) collected ($0.04)
Seat 4: 985b2ecb folded before Flop (didn't bet)
Seat 5: 7157dd36 folded before Flop (didn't bet)
Seat 6: 697fb04a folded before Flop (didn't bet)


Poker Hand #RC2078448187: Hold'em No Limit ($0.02/$0.05) - 2023/12/22 21:09:42
Table 'RushAndCash779729' 6-max Seat #1 is the button
Seat 1: fdc2d3ba ($14.05 in chips)
Seat 2: 2ec85018 ($2.19 in chips)
Seat 3: Hero ($6.8 in chips)
Seat 4: 879060f7 ($17.22 in chips)
Seat 5: 96eff031 ($1.65 in chips)
Seat 6: 3cf310b ($5.52 in chips)
2ec85018: posts small blind $0.02
Hero: posts big blind $0.05
*** HOLE CARDS ***
Dealt to fdc2d3ba 
Dealt to 2ec85018 
Dealt to Hero [9h Qs]
Dealt to 879060f7 
Dealt to 96eff031 
Dealt to 3cf310b 
879060f7: folds
96eff031: raises $0.08 to $0.13
3cf310b: folds
fdc2d3ba: folds
2ec85018: folds
Hero: folds
Uncalled bet ($0.08) returned to 96eff031
*** SHOWDOWN ***
96eff031 collected $0.12 from pot
*** SUMMARY ***
Total pot $0.12 | Rake $0 | Jackpot $0 | Bingo $0 | Fortune $0 | Tax $0
Seat 1: fdc2d3ba (button) folded before Flop (didn't bet)
Seat 2: 2ec85018 (small blind) folded before Flop
Seat 3: Hero (big blind) folded before Flop
Seat 4: 879060f7 folded before Flop (didn't bet)
Seat 5: 96eff031 collected ($0.12)
Seat 6: 3cf310b folded before Flop (didn't bet)


Poker Hand #RC2078447563: Hold'em No Limit ($0.02/$0.05) - 2023/12/22 21:09:06
Table 'RushAndCash779442' 6-max Seat #1 is the button
Seat 1: 2ec85018 ($3.08 in chips)
Seat 2: 859547f3 ($5.8 in chips)
Seat 3: b6614f46 ($4.47 in chips)
Seat 4: Hero ($5.99 in chips)
Seat 5: 271c38e0 ($6.02 in chips)
Seat 6: 561e5b01 ($5.16 in chips)
859547f3: posts small blind $0.02
b6614f46: posts big blind $0.05
*** HOLE CARDS ***
Dealt to 2ec85018 
Dealt to 859547f3 
Dealt to b6614f46 
Dealt to Hero [Ah Ac]
Dealt to 271c38e0 
Dealt to 561e5b01 
Hero: raises $0.05 to $0.1
271c38e0: folds
561e5b01: folds
2ec85018: calls $0.1
859547f3: folds
b6614f46: folds
*** FLOP *** [4s 6s 5c]
Hero: bets $0.14
2ec85018: calls $0.14
*** TURN *** [4s 6s 5c] [8h]
Hero: bets $0.28
2ec85018: calls $0.28
*** RIVER *** [4s 6s 5c 8h] [Kc]
Hero: bets $0.37
2ec85018: calls $0.37
Hero: shows [Ah Ac] (Pair of Aces)
2ec85018: shows [3s 3d] (Pair of Treys)
*** SHOWDOWN ***
Hero collected $1.7 from pot
*** SUMMARY ***
Total pot $1.85 | Rake $0.08 | Jackpot $0.07 | Bingo $0 | Fortune $0 | Tax $0
Board [4s 6s 5c 8h Kc]
Seat 1: 2ec85018 (button) showed [3s 3d] and lost with Pair of Treys
Seat 2: 859547f3 (small blind) folded before Flop
Seat 3: b6614f46 (big blind) folded before Flop
Seat 4: Hero showed [Ah Ac] and won ($1.7) with Pair of Aces
Seat 5: 271c38e0 folded before Flop (didn't bet)
Seat 6: 561e5b01 folded before Flop (didn't bet)


Poker Hand #RC2078447498: Hold'em No Limit ($0.02/$0.05) - 2023/12/22 21:09:02
Table 'RushAndCash779409' 6-max Seat #1 is the button
Seat 1: 8b0c9357 ($4.93 in chips)
Seat 2: e6188be4 ($4.29 in chips)
Seat 3: b3e85c60 ($13.53 in chips)
Seat 4: Hero ($5.99 in chips)
Seat 5: e929859b ($3.75 in chips)
Seat 6: 517da49 ($5.61 in chips)
e6188be4: posts small blind $0.02
b3e85c60: posts big blind $0.05
*** HOLE CARDS ***
Dealt to 8b0c9357 
Dealt to e6188be4 
Dealt to b3e85c60 
Dealt to Hero [3d Ah]
Dealt to e929859b 
Dealt to 517da49 
Hero: folds
e929859b: raises $0.08 to $0.13
517da49: raises $0.3 to $0.43
8b0c9357: folds
e6188be4: folds
b3e85c60: folds
e929859b: calls $0.3
*** FLOP *** [3s 6s 6c]
e929859b: checks
517da49: bets $0.48
e929859b: calls $0.48
*** TURN *** [3s 6s 6c] [5h]
e929859b: checks
517da49: checks
*** RIVER *** [3s 6s 6c 5h] [Ks]
e929859b: checks
517da49: checks
e929859b: shows [Jh Js] (Pair of Jacks and Pair of Sixes)
517da49: shows [Kh Tc] (Pair of Kings and Pair of Sixes)
*** SHOWDOWN ***
517da49 collected $1.73 from pot
*** SUMMARY ***
Total pot $1.89 | Rake $0.09 | Jackpot $0.07 | Bingo $0 | Fortune $0 | Tax $0
Board [3s 6s 6c 5h Ks]
Seat 1: 8b0c9357 (button) folded before Flop (didn't bet)
Seat 2: e6188be4 (small blind) folded before Flop
Seat 3: b3e85c60 (big blind) folded before Flop
Seat 4: Hero folded before Flop (didn't bet)
Seat 5: e929859b showed [Jh Js] and lost with Pair of Jacks and Pair of Sixes
Seat 6: 517da49 showed [Kh Tc] and won ($1.73) with Pair of Kings and Pair of Sixes


Poker Hand #RC2078447259: Hold'em No Limit ($0.02/$0.05) - 2023/12/22 21:08:49
Table 'RushAndCash779298' 6-max Seat #1 is the button
Seat 1: Hero ($5.99 in chips)
Seat 2: f03c68f3 ($7.5 in chips)
Seat 3: 7c19951 ($7.52 in chips)
Seat 4: f5ffb37c ($5.86 in chips)
Seat 5: cea6060f ($5.82 in chips)
Seat 6: 8eb71456 ($10.62 in chips)
f03c68f3: posts small blind $0.02
7c19951: posts big blind $0.05
*** HOLE CARDS ***
Dealt to Hero [5h Kh]
Dealt to f03c68f3 
Dealt to 7c19951 
Dealt to f5ffb37c 
Dealt to cea6060f 
Dealt to 8eb71456 
f5ffb37c: folds
cea6060f: raises $0.05 to $0.1
8eb71456: folds
Hero: folds
f03c68f3: folds
7c19951: folds
Uncalled bet ($0.05) returned to cea6060f
*** SHOWDOWN ***
cea6060f collected $0.12 from pot
*** SUMMARY ***
Total pot $0.12 | Rake $0 | Jackpot $0 | Bingo $0 | Fortune $0 | Tax $0
Seat 1: Hero (button) folded before Flop (didn't bet)
Seat 2: f03c68f3 (small blind) folded before Flop
Seat 3: 7c19951 (big blind) folded before Flop
Seat 4: f5ffb37c folded before Flop (didn't bet)
Seat 5: cea6060f collected ($0.12)
Seat 6: 8eb71456 folded before Flop (didn't bet)


Poker Hand #RC2078447174: Hold'em No Limit ($0.02/$0.05) - 2023/12/22 21:08:44
Table 'RushAndCash779256' 6-max Seat #1 is the button
Seat 1: 459d0f5c ($5 in chips)
Seat 2: f3b8bc9d ($12.11 in chips)
Seat 3: e519a9e8 ($16.58 in chips)
Seat 4: 4d8d4585 ($5.19 in chips)
Seat 5: Hero ($5.99 in chips)
Seat 6: af92dfc8 ($5.67 in chips)
f3b8bc9d: posts small blind $0.02
e519a9e8: posts big blind $0.05
*** HOLE CARDS ***
Dealt to 459d0f5c 
Dealt to f3b8bc9d 
Dealt to e519a9e8 
Dealt to 4d8d4585 
Dealt to Hero [3s 7h]
Dealt to af92dfc8 
4d8d4585: folds
Hero: folds
af92dfc8: folds
459d0f5c: folds
f3b8bc9d: raises $0.1 to $0.15
e519a9e8: folds
Uncalled bet ($0.1) returned to f3b8bc9d
*** SHOWDOWN ***
f3b8bc9d collected $0.1 from pot
*** SUMMARY ***
Total pot $0.1 | Rake $0 | Jackpot $0 | Bingo $0 | Fortune $0 | Tax $0
Seat 1: 459d0f5c (button) folded before Flop (didn't bet)
Seat 2: f3b8bc9d (small blind) collected ($0.1)
Seat 3: e519a9e8 (big blind) folded before Flop
Seat 4: 4d8d4585 folded before Flop (didn't bet)
Seat 5: Hero folded before Flop (didn't bet)
Seat 6: af92dfc8 folded before Flop (didn't bet)


Poker Hand #RC2078446934: Hold'em No Limit ($0.02/$0.05) - 2023/12/22 21:08:30
Table 'RushAndCash779131' 6-max Seat #1 is the button
Seat 1: 6bd97a49 ($13.73 in chips)
Seat 2: 1205c2ed ($5.64 in chips)
Seat 3: Hero ($6.04 in chips)
Seat 4: f751acea ($5.47 in chips)
Seat 5: 8f1c60bf ($8.21 in chips)
Seat 6: b8e0eed ($5.07 in chips)
1205c2ed: posts small blind $0.02
Hero: posts big blind $0.05
*** HOLE CARDS ***
Dealt to 6bd97a49 
Dealt to 1205c2ed 
Dealt to Hero [3s 6s]
Dealt to f751acea 
Dealt to 8f1c60bf 
Dealt to b8e0eed 
f751acea: calls $0.05
8f1c60bf: folds
b8e0eed: folds
6bd97a49: calls $0.05
1205c2ed: raises $0.05 to $0.1
Hero: folds
f751acea: calls $0.05
6bd97a49: calls $0.05
*** FLOP *** [Ts Kc Qd]
1205c2ed: checks
f751acea: checks
6bd97a49: checks
*** TURN *** [Ts Kc Qd] [4h]
1205c2ed: bets $0.09
f751acea: calls $0.09
6bd97a49: calls $0.09
*** RIVER *** [Ts Kc Qd 4h] [8c]
1205c2ed: bets $0.5
f751acea: calls $0.5
6bd97a49: folds
1205c2ed: shows [5h 5s] (Pair of Fives)
f751acea: shows [Kd Jh] (Pair of Kings)
*** SHOWDOWN ***
f751acea collected $1.48 from pot
*** SUMMARY ***
Total pot $1.62 | Rake $0.07 | Jackpot $0.07 | Bingo $0 | Fortune $0 | Tax $0
Board [Ts Kc Qd 4h 8c]
Seat 1: 6bd97a49 (button) folded on the River
Seat 2: 1205c2ed (small blind) showed [5h 5s] and lost with Pair of Fives
Seat 3: Hero (big blind) folded before Flop
Seat 4: f751acea showed [Kd Jh] and won ($1.48) with Pair of Kings
Seat 5: 8f1c60bf folded before Flop (didn't bet)
Seat 6: b8e0eed folded before Flop (didn't bet)


Poker Hand #RC2078446821: Hold'em No Limit ($0.02/$0.05) - 2023/12/22 21:08:23
Table 'RushAndCash779078' 6-max Seat #1 is the button
Seat 1: 801c157f ($14.79 in chips)
Seat 2: 2a270879 ($4.88 in chips)
Seat 3: 4fedcb8f ($7.3 in chips)
Seat 4: 688f0ff0 ($5.29 in chips)
Seat 5: Hero ($6.04 in chips)
Seat 6: 5ccb7b69 ($4.32 in chips)
2a270879: posts small blind $0.02
4fedcb8f: posts big blind $0.05
*** HOLE CARDS ***
Dealt to 801c157f 
Dealt to 2a270879 
Dealt to 4fedcb8f 
Dealt to 688f0ff0 
Dealt to Hero [5c 4c]
Dealt to 5ccb7b69 
688f0ff0: folds
Hero: folds
5ccb7b69: folds
801c157f: folds
2a270879: folds
Uncalled bet ($0.03) returned to 4fedcb8f
*** SHOWDOWN ***
4fedcb8f collected $0.04 from pot
*** SUMMARY ***
Total pot $0.04 | Rake $0 | Jackpot $0 | Bingo $0 | Fortune $0 | Tax $0
Seat 1: 801c157f (button) folded before Flop (didn't bet)
Seat 2: 2a270879 (small blind) folded before Flop
Seat 3: 4fedcb8f (big blind) collected ($0.04)
Seat 4: 688f0ff0 folded before Flop (didn't bet)
Seat 5: Hero folded before Flop (didn't bet)
Seat 6: 5ccb7b69 folded before Flop (didn't bet)


Poker Hand #RC2078446763: Hold'em No Limit ($0.02/$0.05) - 2023/12/22 21:08:20
Table 'RushAndCash779050' 6-max Seat #1 is the button
Seat 1: 2b810e8b ($5.07 in chips)
Seat 2: 2df55086 ($7.11 in chips)
Seat 3: 4a2f512 ($1.63 in chips)
Seat 4: Hero ($6.04 in chips)
Seat 5: 3cf310b ($5.52 in chips)
Seat 6: d59fc4d ($6.33 in chips)
2df55086: posts small blind $0.02
4a2f512: posts big blind $0.05
*** HOLE CARDS ***
Dealt to 2b810e8b 
Dealt to 2df55086 
Dealt to 4a2f512 
Dealt to Hero [Js 3d]
Dealt to 3cf310b 
Dealt to d59fc4d 
Hero: folds
3cf310b: folds
d59fc4d: raises $0.08 to $0.13
2b810e8b: folds
2df55086: folds
4a2f512: folds
Uncalled bet ($0.08) returned to d59fc4d
*** SHOWDOWN ***
d59fc4d collected $0.12 from pot
*** SUMMARY ***
Total pot $0.12 | Rake $0 | Jackpot $0 | Bingo $0 | Fortune $0 | Tax $0
Seat 1: 2b810e8b (button) folded before Flop (didn't bet)
Seat 2: 2df55086 (small blind) folded before Flop
Seat 3: 4a2f512 (big blind) folded before Flop
Seat 4: Hero folded before Flop (didn't bet)
Seat 5: 3cf310b folded before Flop (didn't bet)
Seat 6: d59fc4d collected ($0.12)


Poker Hand #RC2078446703: Hold'em No Limit ($0.02/$0.05) - 2023/12/22 21:08:16
Table 'RushAndCash779020' 6-max Seat #1 is the button
Seat 1: 875f34a0 ($9.62 in chips)
Seat 2: Hero ($6.06 in chips)
Seat 3: b6036b95 ($5.66 in chips)
Seat 4: 5b035bcb ($3.14 in chips)
Seat 5: 2c867a7e ($11.88 in chips)
Seat 6: 561e5b01 ($5.28 in chips)
Hero: posts small blind $0.02
b6036b95: posts big blind $0.05
*** HOLE CARDS ***
Dealt to 875f34a0 
Dealt to Hero [4c 3d]
Dealt to b6036b95 
Dealt to 5b035bcb 
Dealt to 2c867a7e 
Dealt to 561e5b01 
5b035bcb: folds
2c867a7e: folds
561e5b01: folds
875f34a0: raises $0.05 to $0.1
Hero: folds
b6036b95: folds
Uncalled bet ($0.05) returned to 875f34a0
*** SHOWDOWN ***
875f34a0 collected $0.12 from pot
*** SUMMARY ***
Total pot $0.12 | Rake $0 | Jackpot $0 | Bingo $0 | Fortune $0 | Tax $0
Seat 1: 875f34a0 (button) collected ($0.12)
Seat 2: Hero (small blind) folded before Flop
Seat 3: b6036b95 (big blind) folded before Flop
Seat 4: 5b035bcb folded before Flop (didn't bet)
Seat 5: 2c867a7e folded before Flop (didn't bet)
Seat 6: 561e5b01 folded before Flop (didn't bet)


Poker Hand #RC2078446627: Hold'em No Limit ($0.02/$0.05) - 2023/12/22 21:08:12
Table 'RushAndCash778982' 6-max Seat #1 is the button
Seat 1: 9b819678 ($2.1 in chips)
Seat 2: 42b297d3 ($4.96 in chips)
Seat 3: 5fea4bbc ($12.85 in chips)
Seat 4: e6188be4 ($4.35 in chips)
Seat 5: 561e5b01 ($5.28 in chips)
Seat 6: Hero ($6.06 in chips)
42b297d3: posts small blind $0.02
5fea4bbc: posts big blind $0.05
*** HOLE CARDS ***
Dealt to 9b819678 
Dealt to 42b297d3 
Dealt to 5fea4bbc 
Dealt to e6188be4 
Dealt to 561e5b01 
Dealt to Hero [5s Qd]
e6188be4: folds
561e5b01: folds
Hero: folds
9b819678: calls $0.05
42b297d3: calls $0.03
5fea4bbc: checks
*** FLOP *** [4d Jd 3c]
42b297d3: checks
5fea4bbc: checks
9b819678: bets $0.08
42b297d3: folds
5fea4bbc: folds
Uncalled bet ($0.08) returned to 9b819678
42b297d3: shows [6c]
*** SHOWDOWN ***
9b819678 collected $0.15 from pot
*** SUMMARY ***
Total pot $0.15 | Rake $0 | Jackpot $0 | Bingo $0 | Fortune $0 | Tax $0
Board [4d Jd 3c]
Seat 1: 9b819678 (button) won ($0.15)
Seat 2: 42b297d3 (small blind) folded on the Flop
Seat 3: 5fea4bbc (big blind) folded on the Flop
Seat 4: e6188be4 folded before Flop (didn't bet)
Seat 5: 561e5b01 folded before Flop (didn't bet)
Seat 6: Hero folded before Flop (didn't bet)


Poker Hand #RC2078445946: Hold'em No Limit ($0.02/$0.05) - 2023/12/22 21:07:35
Table 'RushAndCash778649' 6-max Seat #1 is the button
Seat 1: Hero ($5.4 in chips)
Seat 2: 567a37c4 ($5.33 in chips)
Seat 3: 59ad445d ($3.91 in chips)
Seat 4: b8e0eed ($5 in chips)
Seat 5: 96eff031 ($1.86 in chips)
Seat 6: 9b819678 ($2.83 in chips)
567a37c4: posts small blind $0.02
59ad445d: posts big blind $0.05
*** HOLE CARDS ***
Dealt to Hero [Qc As]
Dealt to 567a37c4 
Dealt to 59ad445d 
Dealt to b8e0eed 
Dealt to 96eff031 
Dealt to 9b819678 
b8e0eed: folds
96eff031: folds
9b819678: calls $0.05
Hero: raises $0.17 to $0.22
567a37c4: folds
59ad445d: folds
9b819678: calls $0.17
*** FLOP *** [4s Jc 6d]
9b819678: checks
Hero: checks
*** TURN *** [4s Jc 6d] [5s]
9b819678: bets $0.17
Hero: calls $0.17
*** RIVER *** [4s Jc 6d 5s] [Qh]
9b819678: checks
Hero: bets $0.34
9b819678: calls $0.34
Hero: shows [Qc As] (Pair of Queens)
9b819678: shows [3h 5h] (Pair of Fives)
*** SHOWDOWN ***
Hero collected $1.39 from pot
*** SUMMARY ***
Total pot $1.53 | Rake $0.07 | Jackpot $0.07 | Bingo $0 | Fortune $0 | Tax $0
Board [4s Jc 6d 5s Qh]
Seat 1: Hero (button) showed [Qc As] and won ($1.39) with Pair of Queens
Seat 2: 567a37c4 (small blind) folded before Flop
Seat 3: 59ad445d (big blind) folded before Flop
Seat 4: b8e0eed folded before Flop (didn't bet)
Seat 5: 96eff031 folded before Flop (didn't bet)
Seat 6: 9b819678 showed [3h 5h] and lost with Pair of Fives


Poker Hand #RC2078445574: Hold'em No Limit ($0.02/$0.05) - 2023/12/22 21:07:13
Table 'RushAndCash778483' 6-max Seat #1 is the button
Seat 1: 9b819678 ($2.93 in chips)
Seat 2: 9796250f ($5.15 in chips)
Seat 3: 52f74b76 ($6.15 in chips)
Seat 4: 49374b34 ($5.94 in chips)
Seat 5: Hero ($5.17 in chips)
Seat 6: b8d8e3a7 ($6.11 in chips)
9796250f: posts small blind $0.02
52f74b76: posts big blind $0.05
*** HOLE CARDS ***
Dealt to 9b819678 
Dealt to 9796250f 
Dealt to 52f74b76 
Dealt to 49374b34 
Dealt to Hero [Ah 5h]
Dealt to b8d8e3a7 
49374b34: folds
Hero: raises $0.05 to $0.1
b8d8e3a7: folds
9b819678: calls $0.1
9796250f: folds
52f74b76: folds
*** FLOP *** [9d Qs 6h]
Hero: bets $0.14
9b819678: folds
Uncalled bet ($0.14) returned to Hero
*** SHOWDOWN ***
Hero collected $0.26 from pot
*** SUMMARY ***
Total pot $0.27 | Rake $0.01 | Jackpot $0 | Bingo $0 | Fortune $0 | Tax $0
Board [9d Qs 6h]
Seat 1: 9b819678 (button) folded on the Flop
Seat 2: 9796250f (small blind) folded before Flop
Seat 3: 52f74b76 (big blind) folded before Flop
Seat 4: 49374b34 folded before Flop (didn't bet)
Seat 5: Hero won ($0.26)
Seat 6: b8d8e3a7 folded before Flop (didn't bet)


Poker Hand #RC2078445509: Hold'em No Limit ($0.02/$0.05) - 2023/12/22 21:07:09
Table 'RushAndCash778456' 6-max Seat #1 is the button
Seat 1: 622d6af4 ($11.57 in chips)
Seat 2: 329a3fca ($2.12 in chips)
Seat 3: Hero ($5.22 in chips)
Seat 4: 52f74b76 ($6.15 in chips)
Seat 5: d59fc4d ($5.81 in chips)
Seat 6: f3b8bc9d ($12.37 in chips)
329a3fca: posts small blind $0.02
Hero: posts big blind $0.05
*** HOLE CARDS ***
Dealt to 622d6af4 
Dealt to 329a3fca 
Dealt to Hero [7s 3d]
Dealt to 52f74b76 
Dealt to d59fc4d 
Dealt to f3b8bc9d 
52f74b76: folds
d59fc4d: folds
f3b8bc9d: folds
622d6af4: folds
329a3fca: folds
Uncalled bet ($0.03) returned to Hero
*** SHOWDOWN ***
Hero collected $0.04 from pot
*** SUMMARY ***
Total pot $0.04 | Rake $0 | Jackpot $0 | Bingo $0 | Fortune $0 | Tax $0
Seat 1: 622d6af4 (button) folded before Flop (didn't bet)
Seat 2: 329a3fca (small blind) folded before Flop
Seat 3: Hero (big blind) collected ($0.04)
Seat 4: 52f74b76 folded before Flop (didn't bet)
Seat 5: d59fc4d folded before Flop (didn't bet)
Seat 6: f3b8bc9d folded before Flop (didn't bet)


Poker Hand #RC2078445160: Hold'em No Limit ($0.02/$0.05) - 2023/12/22 21:06:50
Table 'RushAndCash778290' 6-max Seat #1 is the button
Seat 1: 521feab9 ($5.07 in chips)
Seat 2: Hero ($5.17 in chips)
Seat 3: 3b6e2f77 ($5 in chips)
Seat 4: e7562cd9 ($5.03 in chips)
Seat 5: c18ede1f ($5.28 in chips)
Seat 6: e3589ec ($2.16 in chips)
Hero: posts small blind $0.02
3b6e2f77: posts big blind $0.05
*** HOLE CARDS ***
Dealt to 521feab9 
Dealt to Hero [7h Ah]
Dealt to 3b6e2f77 
Dealt to e7562cd9 
Dealt to c18ede1f 
Dealt to e3589ec 
e7562cd9: folds
c18ede1f: folds
e3589ec: folds
521feab9: folds
Hero: raises $0.1 to $0.15
3b6e2f77: folds
Uncalled bet ($0.1) returned to Hero
*** SHOWDOWN ***
Hero collected $0.1 from pot
*** SUMMARY ***
Total pot $0.1 | Rake $0 | Jackpot $0 | Bingo $0 | Fortune $0 | Tax $0
Seat 1: 521feab9 (button) folded before Flop (didn't bet)
Seat 2: Hero (small blind) collected ($0.1)
Seat 3: 3b6e2f77 (big blind) folded before Flop
Seat 4: e7562cd9 folded before Flop (didn't bet)
Seat 5: c18ede1f folded before Flop (didn't bet)
Seat 6: e3589ec folded before Flop (didn't bet)


Poker Hand #RC2078444810: Hold'em No Limit ($0.02/$0.05) - 2023/12/22 21:06:30
Table 'RushAndCash778118' 6-max Seat #1 is the button
Seat 1: Hero ($5.17 in chips)
Seat 2: a8759ecd ($4.56 in chips)
Seat 3: 8e45cdc4 ($9.84 in chips)
Seat 4: de1c7123 ($4.25 in chips)
Seat 5: 25941725 ($4.07 in chips)
Seat 6: f92e05a8 ($17.39 in chips)
a8759ecd: posts small blind $0.02
8e45cdc4: posts big blind $0.05
*** HOLE CARDS ***
Dealt to Hero [5c Jh]
Dealt to a8759ecd 
Dealt to 8e45cdc4 
Dealt to de1c7123 
Dealt to 25941725 
Dealt to f92e05a8 
de1c7123: folds
25941725: raises $0.07 to $0.12
f92e05a8: folds
Hero: folds
a8759ecd: folds
8e45cdc4: folds
Uncalled bet ($0.07) returned to 25941725
*** SHOWDOWN ***
25941725 collected $0.12 from pot
*** SUMMARY ***
Total pot $0.12 | Rake $0 | Jackpot $0 | Bingo $0 | Fortune $0 | Tax $0
Seat 1: Hero (button) folded before Flop (didn't bet)
Seat 2: a8759ecd (small blind) folded before Flop
Seat 3: 8e45cdc4 (big blind) folded before Flop
Seat 4: de1c7123 folded before Flop (didn't bet)
Seat 5: 25941725 collected ($0.12)
Seat 6: f92e05a8 folded before Flop (didn't bet)


Poker Hand #RC2078424699: Hold'em No Limit ($0.02/$0.05) - 2023/12/22 21:06:24
Table 'RushAndCash778065' 6-max Seat #1 is the button
Seat 1: 90b129bf ($9.12 in chips)
Seat 2: 8b0c9357 ($5.27 in chips)
Seat 3: 11811683 ($5.19 in chips)
Seat 4: Hero ($5.17 in chips)
Seat 5: 2880461b ($5.72 in chips)
Seat 6: a7392a18 ($17.6 in chips)
8b0c9357: posts small blind $0.02
11811683: posts big blind $0.05
*** HOLE CARDS ***
Dealt to 90b129bf 
Dealt to 8b0c9357 
Dealt to 11811683 
Dealt to Hero [2d 4h]
Dealt to 2880461b 
Dealt to a7392a18 
Hero: folds
2880461b: folds
a7392a18: folds
90b129bf: raises $0.06 to $0.11
8b0c9357: folds
11811683: folds
Uncalled bet ($0.06) returned to 90b129bf
*** SHOWDOWN ***
90b129bf collected $0.12 from pot
*** SUMMARY ***
Total pot $0.12 | Rake $0 | Jackpot $0 | Bingo $0 | Fortune $0 | Tax $0
Seat 1: 90b129bf (button) collected ($0.12)
Seat 2: 8b0c9357 (small blind) folded before Flop
Seat 3: 11811683 (big blind) folded before Flop
Seat 4: Hero folded before Flop (didn't bet)
Seat 5: 2880461b folded before Flop (didn't bet)
Seat 6: a7392a18 folded before Flop (didn't bet)


Poker Hand #RC2078424629: Hold'em No Limit ($0.02/$0.05) - 2023/12/22 21:06:20
Table 'RushAndCash778033' 6-max Seat #1 is the button
Seat 1: 1adb19a8 ($3.9 in chips)
Seat 2: ff769430 ($6.14 in chips)
Seat 3: cddb31fe ($4.37 in chips)
Seat 4: Hero ($5.17 in chips)
Seat 5: 7300213f ($6.08 in chips)
Seat 6: 9fd86997 ($21.91 in chips)
ff769430: posts small blind $0.02
cddb31fe: posts big blind $0.05
*** HOLE CARDS ***
Dealt to 1adb19a8 
Dealt to ff769430 
Dealt to cddb31fe 
Dealt to Hero [Kh 2h]
Dealt to 7300213f 
Dealt to 9fd86997 
Hero: folds
7300213f: folds
9fd86997: raises $0.08 to $0.13
1adb19a8: folds
ff769430: calls $0.11
cddb31fe: folds
*** FLOP *** [8s 6d 3h]
ff769430: checks
9fd86997: bets $0.16
ff769430: folds
Uncalled bet ($0.16) returned to 9fd86997
*** SHOWDOWN ***
9fd86997 collected $0.3 from pot
*** SUMMARY ***
Total pot $0.31 | Rake $0.01 | Jackpot $0 | Bingo $0 | Fortune $0 | Tax $0
Board [8s 6d 3h]
Seat 1: 1adb19a8 (button) folded before Flop (didn't bet)
Seat 2: ff769430 (small blind) folded on the Flop
Seat 3: cddb31fe (big blind) folded before Flop
Seat 4: Hero folded before Flop (didn't bet)
Seat 5: 7300213f folded before Flop (didn't bet)
Seat 6: 9fd86997 won ($0.3)


Poker Hand #RC2078424555: Hold'em No Limit ($0.02/$0.05) - 2023/12/22 21:06:15
Table 'RushAndCash777995' 6-max Seat #1 is the button
Seat 1: 52f74b76 ($6.35 in chips)
Seat 2: 8d0bca32 ($6.62 in chips)
Seat 3: f3501d52 ($5 in chips)
Seat 4: dcd1ce07 ($19.84 in chips)
Seat 5: Hero ($5.17 in chips)
Seat 6: c8926f6d ($3.51 in chips)
8d0bca32: posts small blind $0.02
f3501d52: posts big blind $0.05
*** HOLE CARDS ***
Dealt to 52f74b76 
Dealt to 8d0bca32 
Dealt to f3501d52 
Dealt to dcd1ce07 
Dealt to Hero [Kd 2s]
Dealt to c8926f6d 
dcd1ce07: folds
Hero: folds
c8926f6d: folds
52f74b76: raises $0.08 to $0.13
8d0bca32: raises $0.36 to $0.49
f3501d52: folds
52f74b76: folds
Uncalled bet ($0.36) returned to 8d0bca32
*** SHOWDOWN ***
8d0bca32 collected $0.3 from pot
*** SUMMARY ***
Total pot $0.31 | Rake $0.01 | Jackpot $0 | Bingo $0 | Fortune $0 | Tax $0
Seat 1: 52f74b76 (button) folded before Flop
Seat 2: 8d0bca32 (small blind) collected ($0.3)
Seat 3: f3501d52 (big blind) folded before Flop
Seat 4: dcd1ce07 folded before Flop (didn't bet)
Seat 5: Hero folded before Flop (didn't bet)
Seat 6: c8926f6d folded before Flop (didn't bet)


Poker Hand #RC2078423788: Hold'em No Limit ($0.02/$0.05) - 2023/12/22 21:05:32
Table 'RushAndCash777638' 6-max Seat #1 is the button
Seat 1: 52f74b76 ($6.21 in chips)
Seat 2: 622d6af4 ($5.19 in chips)
Seat 3: Hero ($5.3 in chips)
Seat 4: ff769430 ($6.21 in chips)
Seat 5: 33b0f432 ($6.18 in chips)
Seat 6: 8acef960 ($3.66 in chips)
622d6af4: posts small blind $0.02
Hero: posts big blind $0.05
*** HOLE CARDS ***
Dealt to 52f74b76 
Dealt to 622d6af4 
Dealt to Hero [3h Ac]
Dealt to ff769430 
Dealt to 33b0f432 
Dealt to 8acef960 
ff769430: folds
33b0f432: folds
8acef960: folds
52f74b76: raises $0.08 to $0.13
622d6af4: folds
Hero: calls $0.08
*** FLOP *** [Ts 7d 8s]
Hero: checks
52f74b76: checks
*** TURN *** [Ts 7d 8s] [Kh]
Hero: checks
52f74b76: checks
*** RIVER *** [Ts 7d 8s Kh] [Kd]
Hero: checks
52f74b76: checks
Hero: shows [3h Ac] (Pair of Kings)
52f74b76: shows [Qc As] (Pair of Kings)
*** SHOWDOWN ***
52f74b76 collected $0.27 from pot
*** SUMMARY ***
Total pot $0.28 | Rake $0.01 | Jackpot $0 | Bingo $0 | Fortune $0 | Tax $0
Board [Ts 7d 8s Kh Kd]
Seat 1: 52f74b76 (button) showed [Qc As] and won ($0.27) with Pair of Kings
Seat 2: 622d6af4 (small blind) folded before Flop
Seat 3: Hero (big blind) showed [3h Ac] and lost with Pair of Kings
Seat 4: ff769430 folded before Flop (didn't bet)
Seat 5: 33b0f432 folded before Flop (didn't bet)
Seat 6: 8acef960 folded before Flop (didn't bet)


Poker Hand #RC2078423710: Hold'em No Limit ($0.02/$0.05) - 2023/12/22 21:05:28
Table 'RushAndCash777603' 6-max Seat #1 is the button
Seat 1: Hero ($5.3 in chips)
Seat 2: f92e05a8 ($18.14 in chips)
Seat 3: 7ddba90d ($3.24 in chips)
Seat 4: 8acef960 ($3.66 in chips)
Seat 5: 1fff7a0a ($5.26 in chips)
Seat 6: 45392e2c ($18.44 in chips)
f92e05a8: posts small blind $0.02
7ddba90d: posts big blind $0.05
*** HOLE CARDS ***
Dealt to Hero [3c 5d]
Dealt to f92e05a8 
Dealt to 7ddba90d 
Dealt to 8acef960 
Dealt to 1fff7a0a 
Dealt to 45392e2c 
8acef960: folds
1fff7a0a: folds
45392e2c: folds
Hero: folds
f92e05a8: raises $0.1 to $0.15
7ddba90d: folds
Uncalled bet ($0.1) returned to f92e05a8
*** SHOWDOWN ***
f92e05a8 collected $0.1 from pot
*** SUMMARY ***
Total pot $0.1 | Rake $0 | Jackpot $0 | Bingo $0 | Fortune $0 | Tax $0
Seat 1: Hero (button) folded before Flop (didn't bet)
Seat 2: f92e05a8 (small blind) collected ($0.1)
Seat 3: 7ddba90d (big blind) folded before Flop
Seat 4: 8acef960 folded before Flop (didn't bet)
Seat 5: 1fff7a0a folded before Flop (didn't bet)
Seat 6: 45392e2c folded before Flop (didn't bet)


Poker Hand #RC2078423486: Hold'em No Limit ($0.02/$0.05) - 2023/12/22 21:05:16
Table 'RushAndCash777505' 6-max Seat #1 is the button
Seat 1: a7392a18 ($17.41 in chips)
Seat 2: Hero ($5.32 in chips)
Seat 3: 911fbb72 ($5.55 in chips)
Seat 4: 91937678 ($5.17 in chips)
Seat 5: d21a0c3 ($8.81 in chips)
Seat 6: 3f112fc ($7.72 in chips)
Hero: posts small blind $0.02
911fbb72: posts big blind $0.05
*** HOLE CARDS ***
Dealt to a7392a18 
Dealt to Hero [2h Qs]
Dealt to 911fbb72 
Dealt to 91937678 
Dealt to d21a0c3 
Dealt to 3f112fc 
91937678: folds
d21a0c3: folds
3f112fc: folds
a7392a18: raises $0.07 to $0.12
Hero: folds
911fbb72: calls $0.07
*** FLOP *** [Ah 5s 8c]
911fbb72: checks
a7392a18: bets $0.09
911fbb72: calls $0.09
*** TURN *** [Ah 5s 8c] [4h]
911fbb72: checks
a7392a18: checks
*** RIVER *** [Ah 5s 8c 4h] [6h]
911fbb72: checks
a7392a18: checks
911fbb72: shows [Td 5d] (Pair of Fives)
a7392a18: shows [9d 9h] (Pair of Nines)
*** SHOWDOWN ***
a7392a18 collected $0.42 from pot
*** SUMMARY ***
Total pot $0.44 | Rake $0.02 | Jackpot $0 | Bingo $0 | Fortune $0 | Tax $0
Board [Ah 5s 8c 4h 6h]
Seat 1: a7392a18 (button) showed [9d 9h] and won ($0.42) with Pair of Nines
Seat 2: Hero (small blind) folded before Flop
Seat 3: 911fbb72 (big blind) showed [Td 5d] and lost with Pair of Fives
Seat 4: 91937678 folded before Flop (didn't bet)
Seat 5: d21a0c3 folded before Flop (didn't bet)
Seat 6: 3f112fc folded before Flop (didn't bet)


Poker Hand #RC2078423273: Hold'em No Limit ($0.02/$0.05) - 2023/12/22 21:05:04
Table 'RushAndCash777411' 6-max Seat #1 is the button
Seat 1: 3dbf95c1 ($9.83 in chips)
Seat 2: 91937678 ($5.19 in chips)
Seat 3: 243211d7 ($6.22 in chips)
Seat 4: 36626ded ($5.89 in chips)
Seat 5: 2df55086 ($7.12 in chips)
Seat 6: Hero ($5.25 in chips)
91937678: posts small blind $0.02
243211d7: posts big blind $0.05
*** HOLE CARDS ***
Dealt to 3dbf95c1 
Dealt to 91937678 
Dealt to 243211d7 
Dealt to 36626ded 
Dealt to 2df55086 
Dealt to Hero [2c 2h]
36626ded: folds
2df55086: folds
Hero: raises $0.05 to $0.1
3dbf95c1: folds
91937678: folds
243211d7: folds
Uncalled bet ($0.05) returned to Hero
*** SHOWDOWN ***
Hero collected $0.12 from pot
*** SUMMARY ***
Total pot $0.12 | Rake $0 | Jackpot $0 | Bingo $0 | Fortune $0 | Tax $0
Seat 1: 3dbf95c1 (button) folded before Flop (didn't bet)
Seat 2: 91937678 (small blind) folded before Flop
Seat 3: 243211d7 (big blind) folded before Flop
Seat 4: 36626ded folded before Flop (didn't bet)
Seat 5: 2df55086 folded before Flop (didn't bet)
Seat 6: Hero collected ($0.12)


Poker Hand #RC2078423196: Hold'em No Limit ($0.02/$0.05) - 2023/12/22 21:05:00
Table 'RushAndCash777377' 6-max Seat #1 is the button
Seat 1: f2f8c789 ($19.66 in chips)
Seat 2: 89a27c2 ($4.46 in chips)
Seat 3: 18f9cb34 ($6.34 in chips)
Seat 4: 1adb19a8 ($3.9 in chips)
Seat 5: 3f112fc ($7.72 in chips)
Seat 6: Hero ($5.25 in chips)
89a27c2: posts small blind $0.02
18f9cb34: posts big blind $0.05
*** HOLE CARDS ***
Dealt to f2f8c789 
Dealt to 89a27c2 
Dealt to 18f9cb34 
Dealt to 1adb19a8 
Dealt to 3f112fc 
Dealt to Hero [Jc 6s]
1adb19a8: raises $0.08 to $0.13
3f112fc: folds
Hero: folds
f2f8c789: folds
89a27c2: folds
18f9cb34: folds
Uncalled bet ($0.08) returned to 1adb19a8
*** SHOWDOWN ***
1adb19a8 collected $0.12 from pot
*** SUMMARY ***
Total pot $0.12 | Rake $0 | Jackpot $0 | Bingo $0 | Fortune $0 | Tax $0
Seat 1: f2f8c789 (button) folded before Flop (didn't bet)
Seat 2: 89a27c2 (small blind) folded before Flop
Seat 3: 18f9cb34 (big blind) folded before Flop
Seat 4: 1adb19a8 collected ($0.12)
Seat 5: 3f112fc folded before Flop (didn't bet)
Seat 6: Hero folded before Flop (didn't bet)


Poker Hand #RC2078423102: Hold'em No Limit ($0.02/$0.05) - 2023/12/22 21:04:54
Table 'RushAndCash777336' 6-max Seat #1 is the button
Seat 1: 2df55086 ($7.17 in chips)
Seat 2: Hero ($5.27 in chips)
Seat 3: 711581a0 ($5 in chips)
Seat 4: a9abc4b1 ($8.21 in chips)
Seat 5: 6e872e9c ($18.8 in chips)
Seat 6: 22426c35 ($5.61 in chips)
Hero: posts small blind $0.02
711581a0: posts big blind $0.05
*** HOLE CARDS ***
Dealt to 2df55086 
Dealt to Hero [3c 6s]
Dealt to 711581a0 
Dealt to a9abc4b1 
Dealt to 6e872e9c 
Dealt to 22426c35 
a9abc4b1: folds
6e872e9c: folds
22426c35: folds
2df55086: folds
Hero: folds
Uncalled bet ($0.03) returned to 711581a0
*** SHOWDOWN ***
711581a0 collected $0.04 from pot
*** SUMMARY ***
Total pot $0.04 | Rake $0 | Jackpot $0 | Bingo $0 | Fortune $0 | Tax $0
Seat 1: 2df55086 (button) folded before Flop (didn't bet)
Seat 2: Hero (small blind) folded before Flop
Seat 3: 711581a0 (big blind) collected ($0.04)
Seat 4: a9abc4b1 folded before Flop (didn't bet)
Seat 5: 6e872e9c folded before Flop (didn't bet)
Seat 6: 22426c35 folded before Flop (didn't bet)


Poker Hand #RC2078423037: Hold'em No Limit ($0.02/$0.05) - 2023/12/22 21:04:50
Table 'RushAndCash777307' 6-max Seat #1 is the button
Seat 1: 8eab241d ($6.38 in chips)
Seat 2: 859547f3 ($5 in chips)
Seat 3: c7451cf4 ($8.44 in chips)
Seat 4: c08cf99d ($9.44 in chips)
Seat 5: 7ab29bd ($5.07 in chips)
Seat 6: Hero ($5.27 in chips)
859547f3: posts small blind $0.02
c7451cf4: posts big blind $0.05
*** HOLE CARDS ***
Dealt to 8eab241d 
Dealt to 859547f3 
Dealt to c7451cf4 
Dealt to c08cf99d 
Dealt to 7ab29bd 
Dealt to Hero [5c Qc]
c08cf99d: folds
7ab29bd: folds
Hero: folds
8eab241d: folds
859547f3: folds
Uncalled bet ($0.03) returned to c7451cf4
*** SHOWDOWN ***
c7451cf4 collected $0.04 from pot
*** SUMMARY ***
Total pot $0.04 | Rake $0 | Jackpot $0 | Bingo $0 | Fortune $0 | Tax $0
Seat 1: 8eab241d (button) folded before Flop (didn't bet)
Seat 2: 859547f3 (small blind) folded before Flop
Seat 3: c7451cf4 (big blind) collected ($0.04)
Seat 4: c08cf99d folded before Flop (didn't bet)
Seat 5: 7ab29bd folded before Flop (didn't bet)
Seat 6: Hero folded before Flop (didn't bet)


Poker Hand #RC2078422884: Hold'em No Limit ($0.02/$0.05) - 2023/12/22 21:04:41
Table 'RushAndCash777236' 6-max Seat #1 is the button
Seat 1: 911fbb72 ($5.43 in chips)
Seat 2: 1ff063e8 ($8.01 in chips)
Seat 3: Hero ($5.32 in chips)
Seat 4: 8fe58320 ($2.29 in chips)
Seat 5: e734080a ($7.21 in chips)
Seat 6: 2075befd ($5.14 in chips)
1ff063e8: posts small blind $0.02
Hero: posts big blind $0.05
*** HOLE CARDS ***
Dealt to 911fbb72 
Dealt to 1ff063e8 
Dealt to Hero [9c 5c]
Dealt to 8fe58320 
Dealt to e734080a 
Dealt to 2075befd 
8fe58320: folds
e734080a: raises $0.07 to $0.12
2075befd: raises $0.31 to $0.43
911fbb72: folds
1ff063e8: folds
Hero: folds
e734080a: calls $0.31
*** FLOP *** [6c 2h 3c]
e734080a: checks
2075befd: checks
*** TURN *** [6c 2h 3c] [7h]
e734080a: bets $0.47
2075befd: folds
Uncalled bet ($0.47) returned to e734080a
*** SHOWDOWN ***
e734080a collected $0.89 from pot
*** SUMMARY ***
Total pot $0.93 | Rake $0.04 | Jackpot $0 | Bingo $0 | Fortune $0 | Tax $0
Board [6c 2h 3c 7h]
Seat 1: 911fbb72 (button) folded before Flop (didn't bet)
Seat 2: 1ff063e8 (small blind) folded before Flop
Seat 3: Hero (big blind) folded before Flop
Seat 4: 8fe58320 folded before Flop (didn't bet)
Seat 5: e734080a won ($0.89)
Seat 6: 2075befd folded on the Turn


Poker Hand #RC2078422562: Hold'em No Limit ($0.02/$0.05) - 2023/12/22 21:04:23
Table 'RushAndCash777091' 6-max Seat #1 is the button
Seat 1: Hero ($5.45 in chips)
Seat 2: aa6d4c49 ($18.06 in chips)
Seat 3: a04ab5b3 ($5.13 in chips)
Seat 4: 59ad445d ($5.06 in chips)
Seat 5: 8d0bca32 ($6.95 in chips)
Seat 6: f69cdf3f ($5.22 in chips)
aa6d4c49: posts small blind $0.02
a04ab5b3: posts big blind $0.05
*** HOLE CARDS ***
Dealt to Hero [Kh Qs]
Dealt to aa6d4c49 
Dealt to a04ab5b3 
Dealt to 59ad445d 
Dealt to 8d0bca32 
Dealt to f69cdf3f 
59ad445d: folds
8d0bca32: folds
f69cdf3f: folds
Hero: raises $0.08 to $0.13
aa6d4c49: raises $0.32 to $0.45
a04ab5b3: raises $1 to $1.45
Hero: folds
aa6d4c49: calls $1
*** FLOP *** [2d 7d 3s]
aa6d4c49: checks
a04ab5b3: checks
*** TURN *** [2d 7d 3s] [9d]
aa6d4c49: bets $0.91
a04ab5b3: calls $0.91
*** RIVER *** [2d 7d 3s 9d] [As]
aa6d4c49: checks
a04ab5b3: bets $2.77 and is all-in
aa6d4c49: calls $2.77
a04ab5b3: shows [Ah Kc] (Pair of Aces)
aa6d4c49: shows [Qh Ad] (Pair of Aces)
*** SHOWDOWN ***
a04ab5b3 collected $10.17 from pot
*** SUMMARY ***
Total pot $10.39 | Rake $0.15 | Jackpot $0.07 | Bingo $0 | Fortune $0 | Tax $0
Board [2d 7d 3s 9d As]
Seat 1: Hero (button) folded before Flop
Seat 2: aa6d4c49 (small blind) showed [Qh Ad] and lost with Pair of Aces
Seat 3: a04ab5b3 (big blind) showed [Ah Kc] and won ($10.17) with Pair of Aces
Seat 4: 59ad445d folded before Flop (didn't bet)
Seat 5: 8d0bca32 folded before Flop (didn't bet)
Seat 6: f69cdf3f folded before Flop (didn't bet)


Poker Hand #RC2078422462: Hold'em No Limit ($0.02/$0.05) - 2023/12/22 21:04:17
Table 'RushAndCash777048' 6-max Seat #1 is the button
Seat 1: e44205f6 ($6.54 in chips)
Seat 2: b5259737 ($14.79 in chips)
Seat 3: edce49c5 ($8.32 in chips)
Seat 4: 8a8eafe4 ($14.37 in chips)
Seat 5: Hero ($5.45 in chips)
Seat 6: 81f09a8e ($6.27 in chips)
b5259737: posts small blind $0.02
edce49c5: posts big blind $0.05
*** HOLE CARDS ***
Dealt to e44205f6 
Dealt to b5259737 
Dealt to edce49c5 
Dealt to 8a8eafe4 
Dealt to Hero [3s 7d]
Dealt to 81f09a8e 
8a8eafe4: folds
Hero: folds
81f09a8e: folds
e44205f6: folds
b5259737: raises $0.1 to $0.15
edce49c5: folds
Uncalled bet ($0.1) returned to b5259737
*** SHOWDOWN ***
b5259737 collected $0.1 from pot
*** SUMMARY ***
Total pot $0.1 | Rake $0 | Jackpot $0 | Bingo $0 | Fortune $0 | Tax $0
Seat 1: e44205f6 (button) folded before Flop (didn't bet)
Seat 2: b5259737 (small blind) collected ($0.1)
Seat 3: edce49c5 (big blind) folded before Flop
Seat 4: 8a8eafe4 folded before Flop (didn't bet)
Seat 5: Hero folded before Flop (didn't bet)
Seat 6: 81f09a8e folded before Flop (didn't bet)


Poker Hand #RC2078422381: Hold'em No Limit ($0.02/$0.05) - 2023/12/22 21:04:13
Table 'RushAndCash777012' 6-max Seat #1 is the button
Seat 1: dddaf9db ($5 in chips)
Seat 2: a420712c ($10.24 in chips)
Seat 3: e7283841 ($2.03 in chips)
Seat 4: 40c4a4f ($11.1 in chips)
Seat 5: Hero ($5.45 in chips)
Seat 6: 93d5c821 ($5.09 in chips)
a420712c: posts small blind $0.02
e7283841: posts big blind $0.05
*** HOLE CARDS ***
Dealt to dddaf9db 
Dealt to a420712c 
Dealt to e7283841 
Dealt to 40c4a4f 
Dealt to Hero [Td 6c]
Dealt to 93d5c821 
40c4a4f: folds
Hero: folds
93d5c821: raises $0.05 to $0.1
dddaf9db: folds
a420712c: folds
e7283841: calls $0.05
*** FLOP *** [5d 7s 6s]
e7283841: checks
93d5c821: bets $0.06
e7283841: folds
Uncalled bet ($0.06) returned to 93d5c821
*** SHOWDOWN ***
93d5c821 collected $0.21 from pot
*** SUMMARY ***
Total pot $0.22 | Rake $0.01 | Jackpot $0 | Bingo $0 | Fortune $0 | Tax $0
Board [5d 7s 6s]
Seat 1: dddaf9db (button) folded before Flop (didn't bet)
Seat 2: a420712c (small blind) folded before Flop
Seat 3: e7283841 (big blind) folded on the Flop
Seat 4: 40c4a4f folded before Flop (didn't bet)
Seat 5: Hero folded before Flop (didn't bet)
Seat 6: 93d5c821 won ($0.21)


Poker Hand #RC2078422291: Hold'em No Limit ($0.02/$0.05) - 2023/12/22 21:04:08
Table 'RushAndCash776974' 6-max Seat #1 is the button
Seat 1: 2075befd ($5.14 in chips)
Seat 2: 3c54b026 ($11.74 in chips)
Seat 3: 58864a6e ($15.15 in chips)
Seat 4: f7997560 ($2.58 in chips)
Seat 5: Hero ($5.45 in chips)
Seat 6: ad963d07 ($3.94 in chips)
3c54b026: posts small blind $0.02
58864a6e: posts big blind $0.05
*** HOLE CARDS ***
Dealt to 2075befd 
Dealt to 3c54b026 
Dealt to 58864a6e 
Dealt to f7997560 
Dealt to Hero [Jh 8s]
Dealt to ad963d07 
f7997560: folds
Hero: folds
ad963d07: raises $0.1 to $0.15
2075befd: folds
3c54b026: folds
58864a6e: folds
Uncalled bet ($0.1) returned to ad963d07
*** SHOWDOWN ***
ad963d07 collected $0.12 from pot
*** SUMMARY ***
Total pot $0.12 | Rake $0 | Jackpot $0 | Bingo $0 | Fortune $0 | Tax $0
Seat 1: 2075befd (button) folded before Flop (didn't bet)
Seat 2: 3c54b026 (small blind) folded before Flop
Seat 3: 58864a6e (big blind) folded before Flop
Seat 4: f7997560 folded before Flop (didn't bet)
Seat 5: Hero folded before Flop (didn't bet)
Seat 6: ad963d07 collected ($0.12)


Poker Hand #RC2078421858: Hold'em No Limit ($0.02/$0.05) - 2023/12/22 21:03:44
Table 'RushAndCash776769' 6-max Seat #1 is the button
Seat 1: f2f8c789 ($19.73 in chips)
Seat 2: 81f09a8e ($6.29 in chips)
Seat 3: Hero ($5.43 in chips)
Seat 4: 82e9c1ba ($12.02 in chips)
Seat 5: d9ac0d0f ($5.72 in chips)
Seat 6: 2b1ac9c7 ($7.98 in chips)
81f09a8e: posts small blind $0.02
Hero: posts big blind $0.05
*** HOLE CARDS ***
Dealt to f2f8c789 
Dealt to 81f09a8e 
Dealt to Hero [Jd Td]
Dealt to 82e9c1ba 
Dealt to d9ac0d0f 
Dealt to 2b1ac9c7 
82e9c1ba: folds
d9ac0d0f: folds
2b1ac9c7: folds
f2f8c789: folds
81f09a8e: folds
Uncalled bet ($0.03) returned to Hero
*** SHOWDOWN ***
Hero collected $0.04 from pot
*** SUMMARY ***
Total pot $0.04 | Rake $0 | Jackpot $0 | Bingo $0 | Fortune $0 | Tax $0
Seat 1: f2f8c789 (button) folded before Flop (didn't bet)
Seat 2: 81f09a8e (small blind) folded before Flop
Seat 3: Hero (big blind) collected ($0.04)
Seat 4: 82e9c1ba folded before Flop (didn't bet)
Seat 5: d9ac0d0f folded before Flop (didn't bet)
Seat 6: 2b1ac9c7 folded before Flop (didn't bet)


Poker Hand #RC2078421319: Hold'em No Limit ($0.02/$0.05) - 2023/12/22 21:03:16
Table 'RushAndCash776524' 6-max Seat #1 is the button
Seat 1: Hero ($5 in chips)
Seat 2: fbeaaad2 ($9.98 in chips)
Seat 3: f69cdf3f ($4.97 in chips)
Seat 4: 8e45cdc4 ($5 in chips)
Seat 5: 7020d421 ($16.01 in chips)
Seat 6: 33d498f7 ($5 in chips)
fbeaaad2: posts small blind $0.02
f69cdf3f: posts big blind $0.05
*** HOLE CARDS ***
Dealt to Hero [Qd Qh]
Dealt to fbeaaad2 
Dealt to f69cdf3f 
Dealt to 8e45cdc4 
Dealt to 7020d421 
Dealt to 33d498f7 
8e45cdc4: folds
7020d421: folds
33d498f7: raises $0.06 to $0.11
Hero: raises $0.29 to $0.4
fbeaaad2: folds
f69cdf3f: folds
33d498f7: calls $0.29
*** FLOP *** [Qc 5d 6h]
33d498f7: checks
Hero: checks
*** TURN *** [Qc 5d 6h] [9s]
33d498f7: checks
Hero: checks
*** RIVER *** [Qc 5d 6h 9s] [7h]
33d498f7: checks
Hero: bets $0.29
33d498f7: folds
Uncalled bet ($0.29) returned to Hero
*** SHOWDOWN ***
Hero collected $0.83 from pot
*** SUMMARY ***
Total pot $0.87 | Rake $0.04 | Jackpot $0 | Bingo $0 | Fortune $0 | Tax $0
Board [Qc 5d 6h 9s 7h]
Seat 1: Hero (button) won ($0.83)
Seat 2: fbeaaad2 (small blind) folded before Flop
Seat 3: f69cdf3f (big blind) folded before Flop
Seat 4: 8e45cdc4 folded before Flop (didn't bet)
Seat 5: 7020d421 folded before Flop (didn't bet)
Seat 6: 33d498f7 folded on the River


Poker Hand #RC2078421219: Hold'em No Limit ($0.02/$0.05) - 2023/12/22 21:03:10
Table 'RushAndCash776476' 6-max Seat #1 is the button
Seat 1: 38eafb19 ($5.14 in chips)
Seat 2: Hero ($5 in chips)
Seat 3: cbfe1acc ($8.77 in chips)
Seat 4: f804ce50 ($15.8 in chips)
Seat 5: 1259a422 ($5.81 in chips)
Seat 6: ff769430 ($6.18 in chips)
Hero: posts small blind $0.02
cbfe1acc: posts big blind $0.05
*** HOLE CARDS ***
Dealt to 38eafb19 
Dealt to Hero [4s 8s]
Dealt to cbfe1acc 
Dealt to f804ce50 
Dealt to 1259a422 
Dealt to ff769430 
f804ce50: folds
1259a422: folds
ff769430: folds
38eafb19: folds
Hero: folds
Uncalled bet ($0.03) returned to cbfe1acc
*** SHOWDOWN ***
cbfe1acc collected $0.04 from pot
*** SUMMARY ***
Total pot $0.04 | Rake $0 | Jackpot $0 | Bingo $0 | Fortune $0 | Tax $0
Seat 1: 38eafb19 (button) folded before Flop (didn't bet)
Seat 2: Hero (small blind) folded before Flop
Seat 3: cbfe1acc (big blind) collected ($0.04)
Seat 4: f804ce50 folded before Flop (didn't bet)
Seat 5: 1259a422 folded before Flop (didn't bet)
Seat 6: ff769430 folded before Flop (didn't bet)


Poker Hand #RC2078421122: Hold'em No Limit ($0.02/$0.05) - 2023/12/22 21:03:05
Table 'RushAndCash776428' 6-max Seat #1 is the button
Seat 1: 5d55167a ($9.56 in chips)
Seat 2: 91937678 ($4.95 in chips)
Seat 3: d0442df9 ($9.08 in chips)
Seat 4: 84bf8c0b ($5.43 in chips)
Seat 5: 70c6a9c7 ($5.51 in chips)
Seat 6: Hero ($5 in chips)
91937678: posts small blind $0.02
d0442df9: posts big blind $0.05
*** HOLE CARDS ***
Dealt to 5d55167a 
Dealt to 91937678 
Dealt to d0442df9 
Dealt to 84bf8c0b 
Dealt to 70c6a9c7 
Dealt to Hero [3d 6d]
84bf8c0b: folds
70c6a9c7: folds
Hero: folds
5d55167a: folds
91937678: raises $0.08 to $0.13
d0442df9: raises $0.09 to $0.22
91937678: calls $0.09
*** FLOP *** [8d 5s 8h]
91937678: checks
d0442df9: checks
*** TURN *** [8d 5s 8h] [7h]
91937678: checks
d0442df9: bets $0.33
91937678: calls $0.33
*** RIVER *** [8d 5s 8h 7h] [Ad]
91937678: checks
d0442df9: bets $1.1
91937678: folds
Uncalled bet ($1.1) returned to d0442df9
*** SHOWDOWN ***
d0442df9 collected $1.05 from pot
*** SUMMARY ***
Total pot $1.1 | Rake $0.05 | Jackpot $0 | Bingo $0 | Fortune $0 | Tax $0
Board [8d 5s 8h 7h Ad]
Seat 1: 5d55167a (button) folded before Flop (didn't bet)
Seat 2: 91937678 (small blind) folded on the River
Seat 3: d0442df9 (big blind) won ($1.05)
Seat 4: 84bf8c0b folded before Flop (didn't bet)
Seat 5: 70c6a9c7 folded before Flop (didn't bet)
Seat 6: Hero folded before Flop (didn't bet)


Poker Hand #RC2078420393: Hold'em No Limit ($0.02/$0.05) - 2023/12/22 21:02:23
Table 'RushAndCash776101' 6-max Seat #1 is the button
Seat 1: c18ede1f ($5.37 in chips)
Seat 2: f1ad1c02 ($4.95 in chips)
Seat 3: 8d09c020 ($6.19 in chips)
Seat 4: Hero ($5 in chips)
Seat 5: 94b80c38 ($3.79 in chips)
Seat 6: 60a54531 ($5.49 in chips)
f1ad1c02: posts small blind $0.02
8d09c020: posts big blind $0.05
*** HOLE CARDS ***
Dealt to c18ede1f 
Dealt to f1ad1c02 
Dealt to 8d09c020 
Dealt to Hero [5c 5h]
Dealt to 94b80c38 
Dealt to 60a54531 
Hero: raises $0.05 to $0.1
94b80c38: folds
60a54531: folds
c18ede1f: folds
f1ad1c02: calls $0.08
8d09c020: folds
*** FLOP *** [8s 9c 9h]
f1ad1c02: checks
Hero: checks
*** TURN *** [8s 9c 9h] [8h]
f1ad1c02: checks
Hero: checks
*** RIVER *** [8s 9c 9h 8h] [3c]
f1ad1c02: checks
Hero: checks
f1ad1c02: shows [Js Ah] (Pair of Nines and Pair of Eights)
Hero: shows [5c 5h] (Pair of Nines and Pair of Eights)
*** SHOWDOWN ***
f1ad1c02 collected $0.24 from pot
*** SUMMARY ***
Total pot $0.25 | Rake $0.01 | Jackpot $0 | Bingo $0 | Fortune $0 | Tax $0
Board [8s 9c 9h 8h 3c]
Seat 1: c18ede1f (button) folded before Flop (didn't bet)
Seat 2: f1ad1c02 (small blind) showed [Js Ah] and won ($0.24) with Pair of Nines and Pair of Eights
Seat 3: 8d09c020 (big blind) folded before Flop
Seat 4: Hero showed [5c 5h] and lost with Pair of Nines and Pair of Eights
Seat 5: 94b80c38 folded before Flop (didn't bet)
Seat 6: 60a54531 folded before Flop (didn't bet)


Poker Hand #RC2078420263: Hold'em No Limit ($0.02/$0.05) - 2023/12/22 21:02:16
Table 'RushAndCash776044' 6-max Seat #1 is the button
Seat 1: 8e45cdc4 ($4.98 in chips)
Seat 2: 30a2950b ($9.92 in chips)
Seat 3: 3dc18159 ($4.95 in chips)
Seat 4: 79509da9 ($5.2 in chips)
Seat 5: 2d2ea0a5 ($6.32 in chips)
Seat 6: Hero ($5 in chips)
30a2950b: posts small blind $0.02
3dc18159: posts big blind $0.05
*** HOLE CARDS ***
Dealt to 8e45cdc4 
Dealt to 30a2950b 
Dealt to 3dc18159 
Dealt to 79509da9 
Dealt to 2d2ea0a5 
Dealt to Hero [6h Qh]
79509da9: folds
2d2ea0a5: calls $0.05
Hero: folds
8e45cdc4: raises $0.13 to $0.18
30a2950b: folds
3dc18159: folds
2d2ea0a5: calls $0.13
*** FLOP *** [7h As 8c]
2d2ea0a5: checks
8e45cdc4: bets $0.15
2d2ea0a5: calls $0.15
*** TURN *** [7h As 8c] [4s]
2d2ea0a5: checks
8e45cdc4: checks
*** RIVER *** [7h As 8c 4s] [Ts]
2d2ea0a5: bets $0.55
8e45cdc4: raises $0.95 to $1.5
2d2ea0a5: raises $3.73 to $5.23
8e45cdc4: folds
Uncalled bet ($3.73) returned to 2d2ea0a5
*** SHOWDOWN ***
2d2ea0a5 collected $3.44 from pot
*** SUMMARY ***
Total pot $3.73 | Rake $0.22 | Jackpot $0.07 | Bingo $0 | Fortune $0 | Tax $0
Board [7h As 8c 4s Ts]
Seat 1: 8e45cdc4 (button) folded on the River
Seat 2: 30a2950b (small blind) folded before Flop
Seat 3: 3dc18159 (big blind) folded before Flop
Seat 4: 79509da9 folded before Flop (didn't bet)
Seat 5: 2d2ea0a5 won ($3.44)
Seat 6: Hero folded before Flop (didn't bet)


Poker Hand #RC2078420208: Hold'em No Limit ($0.02/$0.05) - 2023/12/22 21:02:13
Table 'RushAndCash776018' 6-max Seat #1 is the button
Seat 1: Hero ($5 in chips)
Seat 2: 879060f7 ($18.76 in chips)
Seat 3: 36060128 ($8.15 in chips)
Seat 4: 58e3e360 ($6.86 in chips)
Seat 5: 1fff7a0a ($5 in chips)
Seat 6: 8b805e5d ($0.94 in chips)
879060f7: posts small blind $0.02
36060128: posts big blind $0.05
*** HOLE CARDS ***
Dealt to Hero [Th 7s]
Dealt to 879060f7 
Dealt to 36060128 
Dealt to 58e3e360 
Dealt to 1fff7a0a 
Dealt to 8b805e5d 
58e3e360: folds
1fff7a0a: folds
8b805e5d: folds
Hero: folds
879060f7: raises $0.07 to $0.12
36060128: folds
Uncalled bet ($0.07) returned to 879060f7
*** SHOWDOWN ***
879060f7 collected $0.1 from pot
*** SUMMARY ***
Total pot $0.1 | Rake $0 | Jackpot $0 | Bingo $0 | Fortune $0 | Tax $0
Seat 1: Hero (button) folded before Flop (didn't bet)
Seat 2: 879060f7 (small blind) collected ($0.1)
Seat 3: 36060128 (big blind) folded before Flop
Seat 4: 58e3e360 folded before Flop (didn't bet)
Seat 5: 1fff7a0a folded before Flop (didn't bet)
Seat 6: 8b805e5d folded before Flop (didn't bet)


Poker Hand #RC2078420141: Hold'em No Limit ($0.02/$0.05) - 2023/12/22 21:02:09
Table 'RushAndCash775984' 6-max Seat #1 is the button
Seat 1: 5928d8a3 ($3.68 in chips)
Seat 2: 36626ded ($5.07 in chips)
Seat 3: c5af17e2 ($5.64 in chips)
Seat 4: Hero ($5 in chips)
Seat 5: 1cfe329a ($6.22 in chips)
Seat 6: ffed537c ($2.62 in chips)
36626ded: posts small blind $0.02
c5af17e2: posts big blind $0.05
*** HOLE CARDS ***
Dealt to 5928d8a3 
Dealt to 36626ded 
Dealt to c5af17e2 
Dealt to Hero [5s Qd]
Dealt to 1cfe329a 
Dealt to ffed537c 
Hero: folds
1cfe329a: folds
ffed537c: folds
5928d8a3: folds
36626ded: folds
Uncalled bet ($0.03) returned to c5af17e2
*** SHOWDOWN ***
c5af17e2 collected $0.04 from pot
*** SUMMARY ***
Total pot $0.04 | Rake $0 | Jackpot $0 | Bingo $0 | Fortune $0 | Tax $0
Seat 1: 5928d8a3 (button) folded before Flop (didn't bet)
Seat 2: 36626ded (small blind) folded before Flop
Seat 3: c5af17e2 (big blind) collected ($0.04)
Seat 4: Hero folded before Flop (didn't bet)
Seat 5: 1cfe329a folded before Flop (didn't bet)
Seat 6: ffed537c folded before Flop (didn't bet)


Poker Hand #RC2078419190: Hold'em No Limit ($0.02/$0.05) - 2023/12/22 21:01:14
Table 'RushAndCash775530' 6-max Seat #1 is the button
Seat 1: d32741ba ($6.68 in chips)
Seat 2: 8d0bca32 ($5.74 in chips)
Seat 3: Hero ($5.51 in chips)
Seat 4: 780930d2 ($6.79 in chips)
Seat 5: 1adb19a8 ($4.16 in chips)
Seat 6: 7f11da5e ($2.54 in chips)
8d0bca32: posts small blind $0.02
Hero: posts big blind $0.05
*** HOLE CARDS ***
Dealt to d32741ba 
Dealt to 8d0bca32 
Dealt to Hero [Ah Ts]
Dealt to 780930d2 
Dealt to 1adb19a8 
Dealt to 7f11da5e 
780930d2: folds
1adb19a8: folds
7f11da5e: raises $0.05 to $0.1
d32741ba: folds
8d0bca32: calls $0.08
Hero: calls $0.05
*** FLOP *** [9d Js 8c]
8d0bca32: checks
Hero: checks
7f11da5e: bets $0.15
8d0bca32: calls $0.15
Hero: calls $0.15
*** TURN *** [9d Js 8c] [Ad]
8d0bca32: checks
Hero: checks
7f11da5e: bets $0.38
8d0bca32: calls $0.38
Hero: calls $0.38
*** RIVER *** [9d Js 8c Ad] [Td]
8d0bca32: checks
Hero: checks
7f11da5e: checks
8d0bca32: shows [Ac Qh] (Queens-High Straight)
Hero: shows [Ah Ts] (Pair of Aces and Pair of Tens)
7f11da5e: shows [9c Jc] (Pair of Jacks and Pair of Nines)
*** SHOWDOWN ***
8d0bca32 collected $1.73 from pot
*** SUMMARY ***
Total pot $1.89 | Rake $0.09 | Jackpot $0.07 | Bingo $0 | Fortune $0 | Tax $0
Board [9d Js 8c Ad Td]
Seat 1: d32741ba (button) folded before Flop (didn't bet)
Seat 2: 8d0bca32 (small blind) showed [Ac Qh] and won ($1.73) with Queens-High Straight
Seat 3: Hero (big blind) showed [Ah Ts] and lost with Pair of Aces and Pair of Tens
Seat 4: 780930d2 folded before Flop (didn't bet)
Seat 5: 1adb19a8 folded before Flop (didn't bet)
Seat 6: 7f11da5e showed [9c Jc] and lost with Pair of Jacks and Pair of Nines


Poker Hand #RC2078419122: Hold'em No Limit ($0.02/$0.05) - 2023/12/22 21:01:09
Table 'RushAndCash775498' 6-max Seat #1 is the button
Seat 1: 3a44e48f ($5.02 in chips)
Seat 2: Hero ($5.53 in chips)
Seat 3: c4c1c89a ($5.22 in chips)
Seat 4: 780930d2 ($6.79 in chips)
Seat 5: 1f940f2d ($9.29 in chips)
Seat 6: 1adb19a8 ($4.16 in chips)
Hero: posts small blind $0.02
c4c1c89a: posts big blind $0.05
*** HOLE CARDS ***
Dealt to 3a44e48f 
Dealt to Hero [6s 7h]
Dealt to c4c1c89a 
Dealt to 780930d2 
Dealt to 1f940f2d 
Dealt to 1adb19a8 
780930d2: folds
1f940f2d: folds
1adb19a8: folds
3a44e48f: folds
Hero: folds
Uncalled bet ($0.03) returned to c4c1c89a
*** SHOWDOWN ***
c4c1c89a collected $0.04 from pot
*** SUMMARY ***
Total pot $0.04 | Rake $0 | Jackpot $0 | Bingo $0 | Fortune $0 | Tax $0
Seat 1: 3a44e48f (button) folded before Flop (didn't bet)
Seat 2: Hero (small blind) folded before Flop
Seat 3: c4c1c89a (big blind) collected ($0.04)
Seat 4: 780930d2 folded before Flop (didn't bet)
Seat 5: 1f940f2d folded before Flop (didn't bet)
Seat 6: 1adb19a8 folded before Flop (didn't bet)


Poker Hand #RC2078419061: Hold'em No Limit ($0.02/$0.05) - 2023/12/22 21:01:06
Table 'RushAndCash775472' 6-max Seat #1 is the button
Seat 1: 44231a0a ($18.69 in chips)
Seat 2: 20a35d2e ($8.76 in chips)
Seat 3: 4fe2d26d ($4.98 in chips)
Seat 4: d04b341b ($4.93 in chips)
Seat 5: 711581a0 ($5.9 in chips)
Seat 6: Hero ($5.53 in chips)
20a35d2e: posts small blind $0.02
4fe2d26d: posts big blind $0.05
*** HOLE CARDS ***
Dealt to 44231a0a 
Dealt to 20a35d2e 
Dealt to 4fe2d26d 
Dealt to d04b341b 
Dealt to 711581a0 
Dealt to Hero [3h Jd]
d04b341b: raises $0.05 to $0.1
711581a0: calls $0.1
Hero: folds
44231a0a: folds
20a35d2e: calls $0.08
4fe2d26d: folds
*** FLOP *** [8h 8s As]
20a35d2e: checks
d04b341b: bets $0.27
711581a0: folds
20a35d2e: folds
Uncalled bet ($0.27) returned to d04b341b
*** SHOWDOWN ***
d04b341b collected $0.34 from pot
*** SUMMARY ***
Total pot $0.35 | Rake $0.01 | Jackpot $0 | Bingo $0 | Fortune $0 | Tax $0
Board [8h 8s As]
Seat 1: 44231a0a (button) folded before Flop (didn't bet)
Seat 2: 20a35d2e (small blind) folded on the Flop
Seat 3: 4fe2d26d (big blind) folded before Flop
Seat 4: d04b341b won ($0.34)
Seat 5: 711581a0 folded on the Flop
Seat 6: Hero folded before Flop (didn't bet)


Poker Hand #RC2078418999: Hold'em No Limit ($0.02/$0.05) - 2023/12/22 21:01:02
Table 'RushAndCash775443' 6-max Seat #1 is the button
Seat 1: 2b810e8b ($5 in chips)
Seat 2: 44231a0a ($18.64 in chips)
Seat 3: e4d2f8b7 ($5.14 in chips)
Seat 4: Hero ($5.53 in chips)
Seat 5: ad142c24 ($10.3 in chips)
Seat 6: 532b7af3 ($7.93 in chips)
44231a0a: posts small blind $0.02
e4d2f8b7: posts big blind $0.05
*** HOLE CARDS ***
Dealt to 2b810e8b 
Dealt to 44231a0a 
Dealt to e4d2f8b7 
Dealt to Hero [Ts 7h]
Dealt to ad142c24 
Dealt to 532b7af3 
Hero: folds
ad142c24: raises $0.05 to $0.1
532b7af3: folds
2b810e8b: folds
44231a0a: folds
e4d2f8b7: folds
Uncalled bet ($0.05) returned to ad142c24
*** SHOWDOWN ***
ad142c24 collected $0.12 from pot
*** SUMMARY ***
Total pot $0.12 | Rake $0 | Jackpot $0 | Bingo $0 | Fortune $0 | Tax $0
Seat 1: 2b810e8b (button) folded before Flop (didn't bet)
Seat 2: 44231a0a (small blind) folded before Flop
Seat 3: e4d2f8b7 (big blind) folded before Flop
Seat 4: Hero folded before Flop (didn't bet)
Seat 5: ad142c24 collected ($0.12)
Seat 6: 532b7af3 folded before Flop (didn't bet)


Poker Hand #RC2078418939: Hold'em No Limit ($0.02/$0.05) - 2023/12/22 21:00:59
Table 'RushAndCash775415' 6-max Seat #1 is the button
Seat 1: 8e29353e ($5.91 in chips)
Seat 2: 53442c3b ($9.82 in chips)
Seat 3: 44231a0a ($18.69 in chips)
Seat 4: Hero ($5.53 in chips)
Seat 5: 3091c4e7 ($5.07 in chips)
Seat 6: 44d3a861 ($5.03 in chips)
53442c3b: posts small blind $0.02
44231a0a: posts big blind $0.05
*** HOLE CARDS ***
Dealt to 8e29353e 
Dealt to 53442c3b 
Dealt to 44231a0a 
Dealt to Hero [8c As]
Dealt to 3091c4e7 
Dealt to 44d3a861 
Hero: folds
3091c4e7: folds
44d3a861: folds
8e29353e: folds
53442c3b: folds
Uncalled bet ($0.03) returned to 44231a0a
*** SHOWDOWN ***
44231a0a collected $0.04 from pot
*** SUMMARY ***
Total pot $0.04 | Rake $0 | Jackpot $0 | Bingo $0 | Fortune $0 | Tax $0
Seat 1: 8e29353e (button) folded before Flop (didn't bet)
Seat 2: 53442c3b (small blind) folded before Flop
Seat 3: 44231a0a (big blind) collected ($0.04)
Seat 4: Hero folded before Flop (didn't bet)
Seat 5: 3091c4e7 folded before Flop (didn't bet)
Seat 6: 44d3a861 folded before Flop (didn't bet)


Poker Hand #RC2078418409: Hold'em No Limit ($0.02/$0.05) - 2023/12/22 21:00:28
Table 'RushAndCash775183' 6-max Seat #1 is the button
Seat 1: 3bfed236 ($5.56 in chips)
Seat 2: Hero ($5.63 in chips)
Seat 3: 9b0ec3a ($5.78 in chips)
Seat 4: 8e0f056d ($7.49 in chips)
Seat 5: c8ce09a2 ($8.81 in chips)
Seat 6: 53442c3b ($9.68 in chips)
Hero: posts small blind $0.02
9b0ec3a: posts big blind $0.05
*** HOLE CARDS ***
Dealt to 3bfed236 
Dealt to Hero [5c 5h]
Dealt to 9b0ec3a 
Dealt to 8e0f056d 
Dealt to c8ce09a2 
Dealt to 53442c3b 
8e0f056d: folds
c8ce09a2: folds
53442c3b: raises $0.05 to $0.1
3bfed236: folds
Hero: calls $0.08
9b0ec3a: folds
*** FLOP *** [Ts 9h Qh]
Hero: checks
53442c3b: bets $0.2
Hero: folds
Uncalled bet ($0.2) returned to 53442c3b
*** SHOWDOWN ***
53442c3b collected $0.24 from pot
*** SUMMARY ***
Total pot $0.25 | Rake $0.01 | Jackpot $0 | Bingo $0 | Fortune $0 | Tax $0
Board [Ts 9h Qh]
Seat 1: 3bfed236 (button) folded before Flop (didn't bet)
Seat 2: Hero (small blind) folded on the Flop
Seat 3: 9b0ec3a (big blind) folded before Flop
Seat 4: 8e0f056d folded before Flop (didn't bet)
Seat 5: c8ce09a2 folded before Flop (didn't bet)
Seat 6: 53442c3b won ($0.24)


Poker Hand #RC2078418312: Hold'em No Limit ($0.02/$0.05) - 2023/12/22 21:00:23
Table 'RushAndCash775142' 6-max Seat #1 is the button
Seat 1: a7076373 ($11.01 in chips)
Seat 2: 29a59401 ($1.76 in chips)
Seat 3: Hero ($5.68 in chips)
Seat 4: 10a50152 ($23.15 in chips)
Seat 5: f59d97af ($5.52 in chips)
Seat 6: 96eff031 ($2.15 in chips)
29a59401: posts small blind $0.02
Hero: posts big blind $0.05
*** HOLE CARDS ***
Dealt to a7076373 
Dealt to 29a59401 
Dealt to Hero [2s 7d]
Dealt to 10a50152 
Dealt to f59d97af 
Dealt to 96eff031 
10a50152: raises $0.1 to $0.15
f59d97af: folds
96eff031: folds
a7076373: folds
29a59401: folds
Hero: folds
Uncalled bet ($0.1) returned to 10a50152
*** SHOWDOWN ***
10a50152 collected $0.12 from pot
*** SUMMARY ***
Total pot $0.12 | Rake $0 | Jackpot $0 | Bingo $0 | Fortune $0 | Tax $0
Seat 1: a7076373 (button) folded before Flop (didn't bet)
Seat 2: 29a59401 (small blind) folded before Flop
Seat 3: Hero (big blind) folded before Flop
Seat 4: 10a50152 collected ($0.12)
Seat 5: f59d97af folded before Flop (didn't bet)
Seat 6: 96eff031 folded before Flop (didn't bet)


Poker Hand #RC2078418206: Hold'em No Limit ($0.02/$0.05) - 2023/12/22 21:00:17
Table 'RushAndCash775099' 6-max Seat #1 is the button
Seat 1: Hero ($5.68 in chips)
Seat 2: b7c101a2 ($3.51 in chips)
Seat 3: 5fea4bbc ($11.55 in chips)
Seat 4: 23378cb ($4 in chips)
Seat 5: 879060f7 ($18.56 in chips)
Seat 6: 6e44b4b ($5 in chips)
b7c101a2: posts small blind $0.02
5fea4bbc: posts big blind $0.05
*** HOLE CARDS ***
Dealt to Hero [Td 2s]
Dealt to b7c101a2 
Dealt to 5fea4bbc 
Dealt to 23378cb 
Dealt to 879060f7 
Dealt to 6e44b4b 
23378cb: raises $0.05 to $0.1
879060f7: folds
6e44b4b: folds
Hero: folds
b7c101a2: folds
5fea4bbc: calls $0.05
*** FLOP *** [Qc Qs 7d]
5fea4bbc: checks
23378cb: checks
*** TURN *** [Qc Qs 7d] [Kc]
5fea4bbc: checks
23378cb: checks
*** RIVER *** [Qc Qs 7d Kc] [2c]
5fea4bbc: bets $0.17
23378cb: calls $0.17
5fea4bbc: shows [3c 6c] (King High Flush)
23378cb: shows [2d Ad] (Pair of Queens and Pair of Twos)
*** SHOWDOWN ***
5fea4bbc collected $0.54 from pot
*** SUMMARY ***
Total pot $0.56 | Rake $0.02 | Jackpot $0 | Bingo $0 | Fortune $0 | Tax $0
Board [Qc Qs 7d Kc 2c]
Seat 1: Hero (button) folded before Flop (didn't bet)
Seat 2: b7c101a2 (small blind) folded before Flop
Seat 3: 5fea4bbc (big blind) showed [3c 6c] and won ($0.54) with King High Flush
Seat 4: 23378cb showed [2d Ad] and lost with Pair of Queens and Pair of Twos
Seat 5: 879060f7 folded before Flop (didn't bet)
Seat 6: 6e44b4b folded before Flop (didn't bet)


Poker Hand #RC2078418131: Hold'em No Limit ($0.02/$0.05) - 2023/12/22 21:00:13
Table 'RushAndCash775070' 6-max Seat #1 is the button
Seat 1: 27517d94 ($7.31 in chips)
Seat 2: 8d09c020 ($6.57 in chips)
Seat 3: 8818ba78 ($7.54 in chips)
Seat 4: Hero ($5.68 in chips)
Seat 5: 5a299033 ($5.07 in chips)
Seat 6: 409f5cad ($5.22 in chips)
8d09c020: posts small blind $0.02
8818ba78: posts big blind $0.05
*** HOLE CARDS ***
Dealt to 27517d94 
Dealt to 8d09c020 
Dealt to 8818ba78 
Dealt to Hero [4d 9d]
Dealt to 5a299033 
Dealt to 409f5cad 
Hero: folds
5a299033: folds
409f5cad: raises $0.07 to $0.12
27517d94: folds
8d09c020: folds
8818ba78: folds
Uncalled bet ($0.07) returned to 409f5cad
*** SHOWDOWN ***
409f5cad collected $0.12 from pot
*** SUMMARY ***
Total pot $0.12 | Rake $0 | Jackpot $0 | Bingo $0 | Fortune $0 | Tax $0
Seat 1: 27517d94 (button) folded before Flop (didn't bet)
Seat 2: 8d09c020 (small blind) folded before Flop
Seat 3: 8818ba78 (big blind) folded before Flop
Seat 4: Hero folded before Flop (didn't bet)
Seat 5: 5a299033 folded before Flop (didn't bet)
Seat 6: 409f5cad collected ($0.12)


Poker Hand #RC2078418067: Hold'em No Limit ($0.02/$0.05) - 2023/12/22 21:00:09
Table 'RushAndCash775042' 6-max Seat #1 is the button
Seat 1: 8014c02 ($19.68 in chips)
Seat 2: Hero ($5.7 in chips)
Seat 3: 8a1c58b7 ($11.26 in chips)
Seat 4: 409f5cad ($5.22 in chips)
Seat 5: 9b819678 ($2.7 in chips)
Seat 6: 168ef649 ($5.11 in chips)
Hero: posts small blind $0.02
8a1c58b7: posts big blind $0.05
*** HOLE CARDS ***
Dealt to 8014c02 
Dealt to Hero [9c 6d]
Dealt to 8a1c58b7 
Dealt to 409f5cad 
Dealt to 9b819678 
Dealt to 168ef649 
409f5cad: folds
9b819678: raises $0.05 to $0.1
168ef649: folds
8014c02: folds
Hero: folds
8a1c58b7: raises $0.3 to $0.4
9b819678: calls $0.3
*** FLOP *** [Ad 2h 5d]
8a1c58b7: checks
9b819678: bets $0.41
8a1c58b7: folds
Uncalled bet ($0.41) returned to 9b819678
*** SHOWDOWN ***
9b819678 collected $0.78 from pot
*** SUMMARY ***
Total pot $0.82 | Rake $0.04 | Jackpot $0 | Bingo $0 | Fortune $0 | Tax $0
Board [Ad 2h 5d]
Seat 1: 8014c02 (button) folded before Flop (didn't bet)
Seat 2: Hero (small blind) folded before Flop
Seat 3: 8a1c58b7 (big blind) folded on the Flop
Seat 4: 409f5cad folded before Flop (didn't bet)
Seat 5: 9b819678 won ($0.78)
Seat 6: 168ef649 folded before Flop (didn't bet)


Poker Hand #RC2078417987: Hold'em No Limit ($0.02/$0.05) - 2023/12/22 21:00:05
Table 'RushAndCash775008' 6-max Seat #1 is the button
Seat 1: d6d8d23b ($7.84 in chips)
Seat 2: b976716a ($16.39 in chips)
Seat 3: Hero ($5.75 in chips)
Seat 4: 3e2e2010 ($5 in chips)
Seat 5: d0d9a2a3 ($4.6 in chips)
Seat 6: 86aa2c94 ($5.39 in chips)
b976716a: posts small blind $0.02
Hero: posts big blind $0.05
*** HOLE CARDS ***
Dealt to d6d8d23b 
Dealt to b976716a 
Dealt to Hero [2s Qd]
Dealt to 3e2e2010 
Dealt to d0d9a2a3 
Dealt to 86aa2c94 
3e2e2010: folds
d0d9a2a3: folds
86aa2c94: folds
d6d8d23b: raises $0.07 to $0.12
b976716a: folds
Hero: folds
Uncalled bet ($0.07) returned to d6d8d23b
*** SHOWDOWN ***
d6d8d23b collected $0.12 from pot
*** SUMMARY ***
Total pot $0.12 | Rake $0 | Jackpot $0 | Bingo $0 | Fortune $0 | Tax $0
Seat 1: d6d8d23b (button) collected ($0.12)
Seat 2: b976716a (small blind) folded before Flop
Seat 3: Hero (big blind) folded before Flop
Seat 4: 3e2e2010 folded before Flop (didn't bet)
Seat 5: d0d9a2a3 folded before Flop (didn't bet)
Seat 6: 86aa2c94 folded before Flop (didn't bet)


Poker Hand #RC2078417922: Hold'em No Limit ($0.02/$0.05) - 2023/12/22 21:00:01
Table 'RushAndCash774980' 6-max Seat #1 is the button
Seat 1: 8eab241d ($6.18 in chips)
Seat 2: 494d7c43 ($5 in chips)
Seat 3: b2a82774 ($5.42 in chips)
Seat 4: f4ef789c ($9.35 in chips)
Seat 5: Hero ($5.75 in chips)
Seat 6: e530eac5 ($5 in chips)
494d7c43: posts small blind $0.02
b2a82774: posts big blind $0.05
*** HOLE CARDS ***
Dealt to 8eab241d 
Dealt to 494d7c43 
Dealt to b2a82774 
Dealt to f4ef789c 
Dealt to Hero [7d 8c]
Dealt to e530eac5 
f4ef789c: folds
Hero: folds
e530eac5: folds
8eab241d: folds
494d7c43: raises $0.1 to $0.15
b2a82774: folds
Uncalled bet ($0.1) returned to 494d7c43
*** SHOWDOWN ***
494d7c43 collected $0.1 from pot
*** SUMMARY ***
Total pot $0.1 | Rake $0 | Jackpot $0 | Bingo $0 | Fortune $0 | Tax $0
Seat 1: 8eab241d (button) folded before Flop (didn't bet)
Seat 2: 494d7c43 (small blind) collected ($0.1)
Seat 3: b2a82774 (big blind) folded before Flop
Seat 4: f4ef789c folded before Flop (didn't bet)
Seat 5: Hero folded before Flop (didn't bet)
Seat 6: e530eac5 folded before Flop (didn't bet)


Poker Hand #RC2078417835: Hold'em No Limit ($0.02/$0.05) - 2023/12/22 20:59:56
Table 'RushAndCash774940' 6-max Seat #1 is the button
Seat 1: 134b65d0 ($6.54 in chips)
Seat 2: 71e37bdd ($3.27 in chips)
Seat 3: 7157dd36 ($5.27 in chips)
Seat 4: 38bb8e26 ($5.1 in chips)
Seat 5: 2e44f78e ($18.14 in chips)
Seat 6: Hero ($5.75 in chips)
71e37bdd: posts small blind $0.02
7157dd36: posts big blind $0.05
*** HOLE CARDS ***
Dealt to 134b65d0 
Dealt to 71e37bdd 
Dealt to 7157dd36 
Dealt to 38bb8e26 
Dealt to 2e44f78e 
Dealt to Hero [3h 6h]
38bb8e26: folds
2e44f78e: raises $0.05 to $0.1
Hero: folds
134b65d0: folds
71e37bdd: folds
7157dd36: folds
Uncalled bet ($0.05) returned to 2e44f78e
*** SHOWDOWN ***
2e44f78e collected $0.12 from pot
*** SUMMARY ***
Total pot $0.12 | Rake $0 | Jackpot $0 | Bingo $0 | Fortune $0 | Tax $0
Seat 1: 134b65d0 (button) folded before Flop (didn't bet)
Seat 2: 71e37bdd (small blind) folded before Flop
Seat 3: 7157dd36 (big blind) folded before Flop
Seat 4: 38bb8e26 folded before Flop (didn't bet)
Seat 5: 2e44f78e collected ($0.12)
Seat 6: Hero folded before Flop (didn't bet)


Poker Hand #RC2078417718: Hold'em No Limit ($0.02/$0.05) - 2023/12/22 20:59:49
Table 'RushAndCash774886' 6-max Seat #1 is the button
Seat 1: Hero ($5.75 in chips)
Seat 2: 1db6ddb1 ($4.97 in chips)
Seat 3: 3a44e48f ($5 in chips)
Seat 4: 567a37c4 ($5.05 in chips)
Seat 5: dad35107 ($12.06 in chips)
Seat 6: 25941725 ($5.04 in chips)
1db6ddb1: posts small blind $0.02
3a44e48f: posts big blind $0.05
*** HOLE CARDS ***
Dealt to Hero [Js 9h]
Dealt to 1db6ddb1 
Dealt to 3a44e48f 
Dealt to 567a37c4 
Dealt to dad35107 
Dealt to 25941725 
567a37c4: folds
dad35107: folds
25941725: raises $0.06 to $0.11
Hero: folds
1db6ddb1: raises $0.41 to $0.52
3a44e48f: folds
25941725: folds
Uncalled bet ($0.41) returned to 1db6ddb1
*** SHOWDOWN ***
1db6ddb1 collected $0.26 from pot
*** SUMMARY ***
Total pot $0.27 | Rake $0.01 | Jackpot $0 | Bingo $0 | Fortune $0 | Tax $0
Seat 1: Hero (button) folded before Flop (didn't bet)
Seat 2: 1db6ddb1 (small blind) collected ($0.26)
Seat 3: 3a44e48f (big blind) folded before Flop
Seat 4: 567a37c4 folded before Flop (didn't bet)
Seat 5: dad35107 folded before Flop (didn't bet)
Seat 6: 25941725 folded before Flop


Poker Hand #RC2078417656: Hold'em No Limit ($0.02/$0.05) - 2023/12/22 20:59:45
Table 'RushAndCash774858' 6-max Seat #1 is the button
Seat 1: 548ecbec ($5.03 in chips)
Seat 2: 59a39874 ($9.49 in chips)
Seat 3: 3928912e ($5 in chips)
Seat 4: f751acea ($3.11 in chips)
Seat 5: 3b97cce8 ($9.29 in chips)
Seat 6: Hero ($5.75 in chips)
59a39874: posts small blind $0.02
3928912e: posts big blind $0.05
*** HOLE CARDS ***
Dealt to 548ecbec 
Dealt to 59a39874 
Dealt to 3928912e 
Dealt to f751acea 
Dealt to 3b97cce8 
Dealt to Hero [2d As]
f751acea: calls $0.05
3b97cce8: folds
Hero: folds
548ecbec: folds
59a39874: folds
3928912e: checks
*** FLOP *** [2c 5s Qh]
3928912e: checks
f751acea: bets $0.05
3928912e: folds
Uncalled bet ($0.05) returned to f751acea
*** SHOWDOWN ***
f751acea collected $0.12 from pot
*** SUMMARY ***
Total pot $0.12 | Rake $0 | Jackpot $0 | Bingo $0 | Fortune $0 | Tax $0
Board [2c 5s Qh]
Seat 1: 548ecbec (button) folded before Flop (didn't bet)
Seat 2: 59a39874 (small blind) folded before Flop
Seat 3: 3928912e (big blind) folded on the Flop
Seat 4: f751acea won ($0.12)
Seat 5: 3b97cce8 folded before Flop (didn't bet)
Seat 6: Hero folded before Flop (didn't bet)


Poker Hand #RC2078417551: Hold'em No Limit ($0.02/$0.05) - 2023/12/22 20:59:39
Table 'RushAndCash774811' 6-max Seat #1 is the button
Seat 1: f9c6a467 ($17.15 in chips)
Seat 2: 2075befd ($5.76 in chips)
Seat 3: 89dad04f ($10.41 in chips)
Seat 4: Hero ($5.75 in chips)
Seat 5: c581b38e ($8.78 in chips)
Seat 6: 22426c35 ($5 in chips)
2075befd: posts small blind $0.02
89dad04f: posts big blind $0.05
*** HOLE CARDS ***
Dealt to f9c6a467 
Dealt to 2075befd 
Dealt to 89dad04f 
Dealt to Hero [4s Js]
Dealt to c581b38e 
Dealt to 22426c35 
Hero: folds
c581b38e: folds
22426c35: folds
f9c6a467: folds
2075befd: folds
Uncalled bet ($0.03) returned to 89dad04f
*** SHOWDOWN ***
89dad04f collected $0.04 from pot
*** SUMMARY ***
Total pot $0.04 | Rake $0 | Jackpot $0 | Bingo $0 | Fortune $0 | Tax $0
Seat 1: f9c6a467 (button) folded before Flop (didn't bet)
Seat 2: 2075befd (small blind) folded before Flop
Seat 3: 89dad04f (big blind) collected ($0.04)
Seat 4: Hero folded before Flop (didn't bet)
Seat 5: c581b38e folded before Flop (didn't bet)
Seat 6: 22426c35 folded before Flop (didn't bet)


Poker Hand #RC2078417455: Hold'em No Limit ($0.02/$0.05) - 2023/12/22 20:59:33
Table 'RushAndCash774766' 6-max Seat #1 is the button
Seat 1: Hero ($5.75 in chips)
Seat 2: 83d24812 ($5 in chips)
Seat 3: 780930d2 ($6.97 in chips)
Seat 4: cdb7c904 ($8.14 in chips)
Seat 5: d52ccee4 ($9.32 in chips)
Seat 6: 10a50152 ($23 in chips)
83d24812: posts small blind $0.02
780930d2: posts big blind $0.05
*** HOLE CARDS ***
Dealt to Hero [Jc 8h]
Dealt to 83d24812 
Dealt to 780930d2 
Dealt to cdb7c904 
Dealt to d52ccee4 
Dealt to 10a50152 
cdb7c904: folds
d52ccee4: folds
10a50152: folds
Hero: folds
83d24812: folds
Uncalled bet ($0.03) returned to 780930d2
*** SHOWDOWN ***
780930d2 collected $0.04 from pot
*** SUMMARY ***
Total pot $0.04 | Rake $0 | Jackpot $0 | Bingo $0 | Fortune $0 | Tax $0
Seat 1: Hero (button) folded before Flop (didn't bet)
Seat 2: 83d24812 (small blind) folded before Flop
Seat 3: 780930d2 (big blind) collected ($0.04)
Seat 4: cdb7c904 folded before Flop (didn't bet)
Seat 5: d52ccee4 folded before Flop (didn't bet)
Seat 6: 10a50152 folded before Flop (didn't bet)


Poker Hand #RC2078417369: Hold'em No Limit ($0.02/$0.05) - 2023/12/22 20:59:28
Table 'RushAndCash774724' 6-max Seat #1 is the button
Seat 1: 931b59bd ($5 in chips)
Seat 2: 933d69ee ($7.83 in chips)
Seat 3: d7068847 ($3.05 in chips)
Seat 4: Hero ($5.75 in chips)
Seat 5: 54daf47b ($10.18 in chips)
Seat 6: 12953fac ($7.51 in chips)
933d69ee: posts small blind $0.02
d7068847: posts big blind $0.05
*** HOLE CARDS ***
Dealt to 931b59bd 
Dealt to 933d69ee 
Dealt to d7068847 
Dealt to Hero [Kh 3s]
Dealt to 54daf47b 
Dealt to 12953fac 
Hero: folds
54daf47b: folds
12953fac: folds
931b59bd: folds
933d69ee: raises $0.1 to $0.15
d7068847: calls $0.1
*** FLOP *** [6h 8c 5d]
933d69ee: checks
d7068847: bets $0.1
933d69ee: calls $0.1
*** TURN *** [6h 8c 5d] [6c]
933d69ee: checks
d7068847: bets $0.25
933d69ee: folds
Uncalled bet ($0.25) returned to d7068847
*** SHOWDOWN ***
d7068847 collected $0.47 from pot
*** SUMMARY ***
Total pot $0.5 | Rake $0.03 | Jackpot $0 | Bingo $0 | Fortune $0 | Tax $0
Board [6h 8c 5d 6c]
Seat 1: 931b59bd (button) folded before Flop (didn't bet)
Seat 2: 933d69ee (small blind) folded on the Turn
Seat 3: d7068847 (big blind) won ($0.47)
Seat 4: Hero folded before Flop (didn't bet)
Seat 5: 54daf47b folded before Flop (didn't bet)
Seat 6: 12953fac folded before Flop (didn't bet)


Poker Hand #RC2078417289: Hold'em No Limit ($0.02/$0.05) - 2023/12/22 20:59:24
Table 'RushAndCash774684' 6-max Seat #1 is the button
Seat 1: fe9fbc4f ($5 in chips)
Seat 2: 69a8b613 ($6.07 in chips)
Seat 3: Hero ($5.8 in chips)
Seat 4: 2471888a ($5.15 in chips)
Seat 5: a92141ad ($4.81 in chips)
Seat 6: 220b0aae ($10.19 in chips)
69a8b613: posts small blind $0.02
Hero: posts big blind $0.05
*** HOLE CARDS ***
Dealt to fe9fbc4f 
Dealt to 69a8b613 
Dealt to Hero [4d 7s]
Dealt to 2471888a 
Dealt to a92141ad 
Dealt to 220b0aae 
2471888a: raises $0.08 to $0.13
a92141ad: folds
220b0aae: folds
fe9fbc4f: folds
69a8b613: folds
Hero: folds
Uncalled bet ($0.08) returned to 2471888a
*** SHOWDOWN ***
2471888a collected $0.12 from pot
*** SUMMARY ***
Total pot $0.12 | Rake $0 | Jackpot $0 | Bingo $0 | Fortune $0 | Tax $0
Seat 1: fe9fbc4f (button) folded before Flop (didn't bet)
Seat 2: 69a8b613 (small blind) folded before Flop
Seat 3: Hero (big blind) folded before Flop
Seat 4: 2471888a collected ($0.12)
Seat 5: a92141ad folded before Flop (didn't bet)
Seat 6: 220b0aae folded before Flop (didn't bet)


Poker Hand #RC2078417083: Hold'em No Limit ($0.02/$0.05) - 2023/12/22 20:59:12
Table 'RushAndCash774590' 6-max Seat #1 is the button
Seat 1: b03a70ec ($5.62 in chips)
Seat 2: Hero ($5.82 in chips)
Seat 3: 16153105 ($1.84 in chips)
Seat 4: b00070f4 ($6.56 in chips)
Seat 5: fd07586a ($5.66 in chips)
Seat 6: 1f940f2d ($9.29 in chips)
Hero: posts small blind $0.02
16153105: posts big blind $0.05
*** HOLE CARDS ***
Dealt to b03a70ec 
Dealt to Hero [Jd 5h]
Dealt to 16153105 
Dealt to b00070f4 
Dealt to fd07586a 
Dealt to 1f940f2d 
b00070f4: raises $0.08 to $0.13
fd07586a: folds
1f940f2d: folds
b03a70ec: calls $0.13
Hero: folds
16153105: folds
*** FLOP *** [3s As Ks]
b00070f4: checks
b03a70ec: bets $0.11
b00070f4: folds
Uncalled bet ($0.11) returned to b03a70ec
*** SHOWDOWN ***
b03a70ec collected $0.32 from pot
*** SUMMARY ***
Total pot $0.33 | Rake $0.01 | Jackpot $0 | Bingo $0 | Fortune $0 | Tax $0
Board [3s As Ks]
Seat 1: b03a70ec (button) won ($0.32)
Seat 2: Hero (small blind) folded before Flop
Seat 3: 16153105 (big blind) folded before Flop
Seat 4: b00070f4 folded on the Flop
Seat 5: fd07586a folded before Flop (didn't bet)
Seat 6: 1f940f2d folded before Flop (didn't bet)


Poker Hand #RC2078417019: Hold'em No Limit ($0.02/$0.05) - 2023/12/22 20:59:08
Table 'RushAndCash774560' 6-max Seat #1 is the button
Seat 1: eb19bb65 ($10.23 in chips)
Seat 2: 996b9d6e ($2.54 in chips)
Seat 3: 2e26b9c1 ($7.98 in chips)
Seat 4: Hero ($5.82 in chips)
Seat 5: 50cbc258 ($6.56 in chips)
Seat 6: 8d09c020 ($6.64 in chips)
996b9d6e: posts small blind $0.02
2e26b9c1: posts big blind $0.05
*** HOLE CARDS ***
Dealt to eb19bb65 
Dealt to 996b9d6e 
Dealt to 2e26b9c1 
Dealt to Hero [6s 2h]
Dealt to 50cbc258 
Dealt to 8d09c020 
Hero: folds
50cbc258: folds
8d09c020: folds
eb19bb65: folds
996b9d6e: folds
Uncalled bet ($0.03) returned to 2e26b9c1
*** SHOWDOWN ***
2e26b9c1 collected $0.04 from pot
*** SUMMARY ***
Total pot $0.04 | Rake $0 | Jackpot $0 | Bingo $0 | Fortune $0 | Tax $0
Seat 1: eb19bb65 (button) folded before Flop (didn't bet)
Seat 2: 996b9d6e (small blind) folded before Flop
Seat 3: 2e26b9c1 (big blind) collected ($0.04)
Seat 4: Hero folded before Flop (didn't bet)
Seat 5: 50cbc258 folded before Flop (didn't bet)
Seat 6: 8d09c020 folded before Flop (didn't bet)


Poker Hand #RC2078416936: Hold'em No Limit ($0.02/$0.05) - 2023/12/22 20:59:03
Table 'RushAndCash774521' 6-max Seat #1 is the button
Seat 1: 933d69ee ($7.94 in chips)
Seat 2: 12953fac ($7.36 in chips)
Seat 3: e674731e ($5 in chips)
Seat 4: e65ad772 ($5.61 in chips)
Seat 5: Hero ($5.82 in chips)
Seat 6: 567a37c4 ($4.51 in chips)
12953fac: posts small blind $0.02
e674731e: posts big blind $0.05
*** HOLE CARDS ***
Dealt to 933d69ee 
Dealt to 12953fac 
Dealt to e674731e 
Dealt to e65ad772 
Dealt to Hero [8h Kc]
Dealt to 567a37c4 
e65ad772: folds
Hero: folds
567a37c4: folds
933d69ee: raises $0.06 to $0.11
12953fac: raises $0.29 to $0.4
e674731e: folds
933d69ee: folds
Uncalled bet ($0.29) returned to 12953fac
*** SHOWDOWN ***
12953fac collected $0.26 from pot
*** SUMMARY ***
Total pot $0.27 | Rake $0.01 | Jackpot $0 | Bingo $0 | Fortune $0 | Tax $0
Seat 1: 933d69ee (button) folded before Flop
Seat 2: 12953fac (small blind) collected ($0.26)
Seat 3: e674731e (big blind) folded before Flop
Seat 4: e65ad772 folded before Flop (didn't bet)
Seat 5: Hero folded before Flop (didn't bet)
Seat 6: 567a37c4 folded before Flop (didn't bet)


Poker Hand #RC2078416718: Hold'em No Limit ($0.02/$0.05) - 2023/12/22 20:58:50
Table 'RushAndCash774419' 6-max Seat #1 is the button
Seat 1: e059cc13 ($1.83 in chips)
Seat 2: c81ea267 ($5.27 in chips)
Seat 3: fbeaaad2 ($10.79 in chips)
Seat 4: Hero ($5.75 in chips)
Seat 5: ff6f425f ($12.28 in chips)
Seat 6: 488f1674 ($14.58 in chips)
c81ea267: posts small blind $0.02
fbeaaad2: posts big blind $0.05
*** HOLE CARDS ***
Dealt to e059cc13 
Dealt to c81ea267 
Dealt to fbeaaad2 
Dealt to Hero [Tc Ac]
Dealt to ff6f425f 
Dealt to 488f1674 
Hero: raises $0.05 to $0.1
ff6f425f: folds
488f1674: folds
e059cc13: folds
c81ea267: folds
fbeaaad2: folds
Uncalled bet ($0.05) returned to Hero
*** SHOWDOWN ***
Hero collected $0.12 from pot
*** SUMMARY ***
Total pot $0.12 | Rake $0 | Jackpot $0 | Bingo $0 | Fortune $0 | Tax $0
Seat 1: e059cc13 (button) folded before Flop (didn't bet)
Seat 2: c81ea267 (small blind) folded before Flop
Seat 3: fbeaaad2 (big blind) folded before Flop
Seat 4: Hero collected ($0.12)
Seat 5: ff6f425f folded before Flop (didn't bet)
Seat 6: 488f1674 folded before Flop (didn't bet)


Poker Hand #RC2078416570: Hold'em No Limit ($0.02/$0.05) - 2023/12/22 20:58:42
Table 'RushAndCash774348' 6-max Seat #1 is the button
Seat 1: Hero ($5.75 in chips)
Seat 2: c08cf99d ($11.88 in chips)
Seat 3: f6f7aa18 ($6.07 in chips)
Seat 4: 7020d421 ($15.53 in chips)
Seat 5: 8d0bca32 ($5.28 in chips)
Seat 6: 2e44f78e ($17.87 in chips)
c08cf99d: posts small blind $0.02
f6f7aa18: posts big blind $0.05
*** HOLE CARDS ***
Dealt to Hero [4s Ah]
Dealt to c08cf99d 
Dealt to f6f7aa18 
Dealt to 7020d421 
Dealt to 8d0bca32 
Dealt to 2e44f78e 
7020d421: folds
8d0bca32: folds
2e44f78e: raises $0.07 to $0.12
Hero: folds
c08cf99d: calls $0.1
f6f7aa18: folds
*** FLOP *** [7c As Kd]
c08cf99d: checks
2e44f78e: bets $0.16
c08cf99d: calls $0.16
*** TURN *** [7c As Kd] [2h]
c08cf99d: checks
2e44f78e: bets $0.92
c08cf99d: folds
Uncalled bet ($0.92) returned to 2e44f78e
*** SHOWDOWN ***
2e44f78e collected $0.58 from pot
*** SUMMARY ***
Total pot $0.61 | Rake $0.03 | Jackpot $0 | Bingo $0 | Fortune $0 | Tax $0
Board [7c As Kd 2h]
Seat 1: Hero (button) folded before Flop (didn't bet)
Seat 2: c08cf99d (small blind) folded on the Turn
Seat 3: f6f7aa18 (big blind) folded before Flop
Seat 4: 7020d421 folded before Flop (didn't bet)
Seat 5: 8d0bca32 folded before Flop (didn't bet)
Seat 6: 2e44f78e won ($0.58)


Poker Hand #RC2078415932: Hold'em No Limit ($0.02/$0.05) - 2023/12/22 20:58:06
Table 'RushAndCash774062' 6-max Seat #1 is the button
Seat 1: ac89ef05 ($9.23 in chips)
Seat 2: e7dae1d3 ($5.3 in chips)
Seat 3: Hero ($5.85 in chips)
Seat 4: 8d0bca32 ($5 in chips)
Seat 5: c198759 ($5.05 in chips)
Seat 6: f6f7aa18 ($6.17 in chips)
e7dae1d3: posts small blind $0.02
Hero: posts big blind $0.05
*** HOLE CARDS ***
Dealt to ac89ef05 
Dealt to e7dae1d3 
Dealt to Hero [Jh Qs]
Dealt to 8d0bca32 
Dealt to c198759 
Dealt to f6f7aa18 
8d0bca32: raises $0.05 to $0.1
c198759: folds
f6f7aa18: calls $0.1
ac89ef05: folds
e7dae1d3: calls $0.08
Hero: calls $0.05
*** FLOP *** [6s 7h Kh]
e7dae1d3: checks
Hero: checks
8d0bca32: bets $0.14
f6f7aa18: folds
e7dae1d3: folds
Hero: folds
Uncalled bet ($0.14) returned to 8d0bca32
*** SHOWDOWN ***
8d0bca32 collected $0.38 from pot
*** SUMMARY ***
Total pot $0.4 | Rake $0.02 | Jackpot $0 | Bingo $0 | Fortune $0 | Tax $0
Board [6s 7h Kh]
Seat 1: ac89ef05 (button) folded before Flop (didn't bet)
Seat 2: e7dae1d3 (small blind) folded on the Flop
Seat 3: Hero (big blind) folded on the Flop
Seat 4: 8d0bca32 won ($0.38)
Seat 5: c198759 folded before Flop (didn't bet)
Seat 6: f6f7aa18 folded on the Flop


Poker Hand #RC2078415861: Hold'em No Limit ($0.02/$0.05) - 2023/12/22 20:58:02
Table 'RushAndCash774027' 6-max Seat #1 is the button
Seat 1: 3c9a47db ($6.53 in chips)
Seat 2: Hero ($5.87 in chips)
Seat 3: 469c47cc ($4.91 in chips)
Seat 4: 69a8b613 ($6.27 in chips)
Seat 5: 7157dd36 ($5.27 in chips)
Seat 6: bc7afeb2 ($5.06 in chips)
Hero: posts small blind $0.02
469c47cc: posts big blind $0.05
*** HOLE CARDS ***
Dealt to 3c9a47db 
Dealt to Hero [4d 3h]
Dealt to 469c47cc 
Dealt to 69a8b613 
Dealt to 7157dd36 
Dealt to bc7afeb2 
69a8b613: folds
7157dd36: folds
bc7afeb2: raises $0.05 to $0.1
3c9a47db: folds
Hero: folds
469c47cc: folds
Uncalled bet ($0.05) returned to bc7afeb2
*** SHOWDOWN ***
bc7afeb2 collected $0.12 from pot
*** SUMMARY ***
Total pot $0.12 | Rake $0 | Jackpot $0 | Bingo $0 | Fortune $0 | Tax $0
Seat 1: 3c9a47db (button) folded before Flop (didn't bet)
Seat 2: Hero (small blind) folded before Flop
Seat 3: 469c47cc (big blind) folded before Flop
Seat 4: 69a8b613 folded before Flop (didn't bet)
Seat 5: 7157dd36 folded before Flop (didn't bet)
Seat 6: bc7afeb2 collected ($0.12)


Poker Hand #RC2078415671: Hold'em No Limit ($0.02/$0.05) - 2023/12/22 20:57:51
Table 'RushAndCash773935' 6-max Seat #1 is the button
Seat 1: d456b5e8 ($6.06 in chips)
Seat 2: cb9a7609 ($5.02 in chips)
Seat 3: 7732abf7 ($20.44 in chips)
Seat 4: Hero ($5.8 in chips)
Seat 5: 21196b97 ($5.04 in chips)
Seat 6: e519a9e8 ($14.41 in chips)
cb9a7609: posts small blind $0.02
7732abf7: posts big blind $0.05
*** HOLE CARDS ***
Dealt to d456b5e8 
Dealt to cb9a7609 
Dealt to 7732abf7 
Dealt to Hero [Ah Kd]
Dealt to 21196b97 
Dealt to e519a9e8 
Hero: raises $0.05 to $0.1
21196b97: folds
e519a9e8: folds
d456b5e8: folds
cb9a7609: folds
7732abf7: folds
Uncalled bet ($0.05) returned to Hero
*** SHOWDOWN ***
Hero collected $0.12 from pot
*** SUMMARY ***
Total pot $0.12 | Rake $0 | Jackpot $0 | Bingo $0 | Fortune $0 | Tax $0
Seat 1: d456b5e8 (button) folded before Flop (didn't bet)
Seat 2: cb9a7609 (small blind) folded before Flop
Seat 3: 7732abf7 (big blind) folded before Flop
Seat 4: Hero collected ($0.12)
Seat 5: 21196b97 folded before Flop (didn't bet)
Seat 6: e519a9e8 folded before Flop (didn't bet)


Poker Hand #RC2078415575: Hold'em No Limit ($0.02/$0.05) - 2023/12/22 20:57:46
Table 'RushAndCash773891' 6-max Seat #1 is the button
Seat 1: 86bb6ec4 ($6.52 in chips)
Seat 2: 3d929f9f ($6.43 in chips)
Seat 3: 39b35662 ($5.02 in chips)
Seat 4: 8f87a7f3 ($5.5 in chips)
Seat 5: Hero ($5.8 in chips)
Seat 6: f59d97af ($5.76 in chips)
3d929f9f: posts small blind $0.02
39b35662: posts big blind $0.05
*** HOLE CARDS ***
Dealt to 86bb6ec4 
Dealt to 3d929f9f 
Dealt to 39b35662 
Dealt to 8f87a7f3 
Dealt to Hero [6d Qd]
Dealt to f59d97af 
8f87a7f3: folds
Hero: folds
f59d97af: raises $0.06 to $0.11
86bb6ec4: raises $0.77 to $0.88
3d929f9f: folds
39b35662: folds
f59d97af: folds
Uncalled bet ($0.77) returned to 86bb6ec4
*** SHOWDOWN ***
86bb6ec4 collected $0.28 from pot
*** SUMMARY ***
Total pot $0.29 | Rake $0.01 | Jackpot $0 | Bingo $0 | Fortune $0 | Tax $0
Seat 1: 86bb6ec4 (button) collected ($0.28)
Seat 2: 3d929f9f (small blind) folded before Flop
Seat 3: 39b35662 (big blind) folded before Flop
Seat 4: 8f87a7f3 folded before Flop (didn't bet)
Seat 5: Hero folded before Flop (didn't bet)
Seat 6: f59d97af folded before Flop


Poker Hand #RC2078415491: Hold'em No Limit ($0.02/$0.05) - 2023/12/22 20:57:42
Table 'RushAndCash773852' 6-max Seat #1 is the button
Seat 1: Hero ($5.8 in chips)
Seat 2: bd4a4d17 ($8.81 in chips)
Seat 3: ac89ef05 ($9.38 in chips)
Seat 4: 7c10f852 ($14.48 in chips)
Seat 5: c9c293e2 ($5.24 in chips)
Seat 6: f6f7aa18 ($6.01 in chips)
bd4a4d17: posts small blind $0.02
ac89ef05: posts big blind $0.05
*** HOLE CARDS ***
Dealt to Hero [4d Kc]
Dealt to bd4a4d17 
Dealt to ac89ef05 
Dealt to 7c10f852 
Dealt to c9c293e2 
Dealt to f6f7aa18 
7c10f852: folds
c9c293e2: folds
f6f7aa18: raises $0.1 to $0.15
Hero: folds
bd4a4d17: folds
ac89ef05: calls $0.1
*** FLOP *** [Jc Tc 9s]
ac89ef05: checks
f6f7aa18: bets $0.24
ac89ef05: folds
Uncalled bet ($0.24) returned to f6f7aa18
*** SHOWDOWN ***
f6f7aa18 collected $0.31 from pot
*** SUMMARY ***
Total pot $0.32 | Rake $0.01 | Jackpot $0 | Bingo $0 | Fortune $0 | Tax $0
Board [Jc Tc 9s]
Seat 1: Hero (button) folded before Flop (didn't bet)
Seat 2: bd4a4d17 (small blind) folded before Flop
Seat 3: ac89ef05 (big blind) folded on the Flop
Seat 4: 7c10f852 folded before Flop (didn't bet)
Seat 5: c9c293e2 folded before Flop (didn't bet)
Seat 6: f6f7aa18 won ($0.31)


Poker Hand #RC2078415423: Hold'em No Limit ($0.02/$0.05) - 2023/12/22 20:57:38
Table 'RushAndCash773821' 6-max Seat #1 is the button
Seat 1: eb19bb65 ($10.43 in chips)
Seat 2: Hero ($5.82 in chips)
Seat 3: 86bb6ec4 ($6.5 in chips)
Seat 4: feab607e ($5 in chips)
Seat 5: ceb10c49 ($5.99 in chips)
Seat 6: 23378cb ($3.92 in chips)
Hero: posts small blind $0.02
86bb6ec4: posts big blind $0.05
*** HOLE CARDS ***
Dealt to eb19bb65 
Dealt to Hero [Jh 5s]
Dealt to 86bb6ec4 
Dealt to feab607e 
Dealt to ceb10c49 
Dealt to 23378cb 
feab607e: folds
ceb10c49: folds
23378cb: folds
eb19bb65: folds
Hero: folds
Uncalled bet ($0.03) returned to 86bb6ec4
*** SHOWDOWN ***
86bb6ec4 collected $0.04 from pot
*** SUMMARY ***
Total pot $0.04 | Rake $0 | Jackpot $0 | Bingo $0 | Fortune $0 | Tax $0
Seat 1: eb19bb65 (button) folded before Flop (didn't bet)
Seat 2: Hero (small blind) folded before Flop
Seat 3: 86bb6ec4 (big blind) collected ($0.04)
Seat 4: feab607e folded before Flop (didn't bet)
Seat 5: ceb10c49 folded before Flop (didn't bet)
Seat 6: 23378cb folded before Flop (didn't bet)


Poker Hand #RC2078415301: Hold'em No Limit ($0.02/$0.05) - 2023/12/22 20:57:31
Table 'RushAndCash773764' 6-max Seat #1 is the button
Seat 1: 16153105 ($2.68 in chips)
Seat 2: 13f0dad9 ($5.73 in chips)
Seat 3: Hero ($5.87 in chips)
Seat 4: c08cf99d ($5.71 in chips)
Seat 5: 38e5e2fb ($5.82 in chips)
Seat 6: ac89ef05 ($9.31 in chips)
13f0dad9: posts small blind $0.02
Hero: posts big blind $0.05
*** HOLE CARDS ***
Dealt to 16153105 
Dealt to 13f0dad9 
Dealt to Hero [5h 4d]
Dealt to c08cf99d 
Dealt to 38e5e2fb 
Dealt to ac89ef05 
c08cf99d: folds
38e5e2fb: folds
ac89ef05: raises $0.08 to $0.13
16153105: folds
13f0dad9: folds
Hero: folds
Uncalled bet ($0.08) returned to ac89ef05
*** SHOWDOWN ***
ac89ef05 collected $0.12 from pot
*** SUMMARY ***
Total pot $0.12 | Rake $0 | Jackpot $0 | Bingo $0 | Fortune $0 | Tax $0
Seat 1: 16153105 (button) folded before Flop (didn't bet)
Seat 2: 13f0dad9 (small blind) folded before Flop
Seat 3: Hero (big blind) folded before Flop
Seat 4: c08cf99d folded before Flop (didn't bet)
Seat 5: 38e5e2fb folded before Flop (didn't bet)
Seat 6: ac89ef05 collected ($0.12)


Poker Hand #RC2078415244: Hold'em No Limit ($0.02/$0.05) - 2023/12/22 20:57:28
Table 'RushAndCash773739' 6-max Seat #1 is the button
Seat 1: b8534e0 ($11.84 in chips)
Seat 2: c0d3508b ($2.49 in chips)
Seat 3: 8f87a7f3 ($5.57 in chips)
Seat 4: e519a9e8 ($14.51 in chips)
Seat 5: Hero ($5.87 in chips)
Seat 6: f98a24d8 ($5.32 in chips)
c0d3508b: posts small blind $0.02
8f87a7f3: posts big blind $0.05
*** HOLE CARDS ***
Dealt to b8534e0 
Dealt to c0d3508b 
Dealt to 8f87a7f3 
Dealt to e519a9e8 
Dealt to Hero [5s 7c]
Dealt to f98a24d8 
e519a9e8: raises $0.05 to $0.1
Hero: folds
f98a24d8: raises $0.21 to $0.31
b8534e0: folds
c0d3508b: calls $0.29
8f87a7f3: folds
e519a9e8: folds
*** FLOP *** [3h Qh Kd]
c0d3508b: checks
f98a24d8: bets $0.26
c0d3508b: folds
Uncalled bet ($0.26) returned to f98a24d8
*** SHOWDOWN ***
f98a24d8 collected $0.74 from pot
*** SUMMARY ***
Total pot $0.77 | Rake $0.03 | Jackpot $0 | Bingo $0 | Fortune $0 | Tax $0
Board [3h Qh Kd]
Seat 1: b8534e0 (button) folded before Flop (didn't bet)
Seat 2: c0d3508b (small blind) folded on the Flop
Seat 3: 8f87a7f3 (big blind) folded before Flop
Seat 4: e519a9e8 folded before Flop
Seat 5: Hero folded before Flop (didn't bet)
Seat 6: f98a24d8 won ($0.74)


Poker Hand #RC2078415153: Hold'em No Limit ($0.02/$0.05) - 2023/12/22 20:57:23
Table 'RushAndCash773697' 6-max Seat #1 is the button
Seat 1: c6dd581a ($9.58 in chips)
Seat 2: d22a3e70 ($8.17 in chips)
Seat 3: b3c6f80c ($8.73 in chips)
Seat 4: 8ced9a44 ($6.85 in chips)
Seat 5: Hero ($5.87 in chips)
Seat 6: 8429395c ($5.5 in chips)
d22a3e70: posts small blind $0.02
b3c6f80c: posts big blind $0.05
*** HOLE CARDS ***
Dealt to c6dd581a 
Dealt to d22a3e70 
Dealt to b3c6f80c 
Dealt to 8ced9a44 
Dealt to Hero [9s Kc]
Dealt to 8429395c 
8ced9a44: folds
Hero: folds
8429395c: folds
c6dd581a: raises $0.05 to $0.1
d22a3e70: folds
b3c6f80c: folds
Uncalled bet ($0.05) returned to c6dd581a
*** SHOWDOWN ***
c6dd581a collected $0.12 from pot
*** SUMMARY ***
Total pot $0.12 | Rake $0 | Jackpot $0 | Bingo $0 | Fortune $0 | Tax $0
Seat 1: c6dd581a (button) collected ($0.12)
Seat 2: d22a3e70 (small blind) folded before Flop
Seat 3: b3c6f80c (big blind) folded before Flop
Seat 4: 8ced9a44 folded before Flop (didn't bet)
Seat 5: Hero folded before Flop (didn't bet)
Seat 6: 8429395c folded before Flop (didn't bet)


Poker Hand #RC2078404268: Hold'em No Limit ($0.02/$0.05) - 2023/12/22 20:56:33
Table 'RushAndCash773288' 6-max Seat #1 is the button
Seat 1: 7c950e30 ($10.47 in chips)
Seat 2: edaa2500 ($5.82 in chips)
Seat 3: cdb7c904 ($7.97 in chips)
Seat 4: 69a8b613 ($6.66 in chips)
Seat 5: 985b2ecb ($4.72 in chips)
Seat 6: Hero ($5 in chips)
edaa2500: posts small blind $0.02
cdb7c904: posts big blind $0.05
*** HOLE CARDS ***
Dealt to 7c950e30 
Dealt to edaa2500 
Dealt to cdb7c904 
Dealt to 69a8b613 
Dealt to 985b2ecb 
Dealt to Hero [Ad 4d]
69a8b613: raises $0.08 to $0.13
985b2ecb: folds
Hero: raises $0.33 to $0.46
7c950e30: folds
edaa2500: folds
cdb7c904: calls $0.41
69a8b613: calls $0.33
*** FLOP *** [7c 7s 3s]
cdb7c904: checks
69a8b613: checks
Hero: bets $0.57
cdb7c904: folds
69a8b613: folds
Uncalled bet ($0.57) returned to Hero
*** SHOWDOWN ***
Hero collected $1.33 from pot
*** SUMMARY ***
Total pot $1.4 | Rake $0.07 | Jackpot $0 | Bingo $0 | Fortune $0 | Tax $0
Board [7c 7s 3s]
Seat 1: 7c950e30 (button) folded before Flop (didn't bet)
Seat 2: edaa2500 (small blind) folded before Flop
Seat 3: cdb7c904 (big blind) folded on the Flop
Seat 4: 69a8b613 folded on the Flop
Seat 5: 985b2ecb folded before Flop (didn't bet)
Seat 6: Hero won ($1.33)


Poker Hand #RC2078404179: Hold'em No Limit ($0.02/$0.05) - 2023/12/22 20:56:28
Table 'RushAndCash773245' 6-max Seat #1 is the button
Seat 1: Hero ($5 in chips)
Seat 2: 885ae6ee ($8.95 in chips)
Seat 3: 892809dd ($4.65 in chips)
Seat 4: c81ea267 ($5.06 in chips)
Seat 5: 44231a0a ($18.88 in chips)
Seat 6: 2372be7b ($5.07 in chips)
885ae6ee: posts small blind $0.02
892809dd: posts big blind $0.05
*** HOLE CARDS ***
Dealt to Hero [As 9h]
Dealt to 885ae6ee 
Dealt to 892809dd 
Dealt to c81ea267 
Dealt to 44231a0a 
Dealt to 2372be7b 
c81ea267: folds
44231a0a: folds
2372be7b: raises $0.08 to $0.13
Hero: folds
885ae6ee: folds
892809dd: folds
Uncalled bet ($0.08) returned to 2372be7b
*** SHOWDOWN ***
2372be7b collected $0.12 from pot
*** SUMMARY ***
Total pot $0.12 | Rake $0 | Jackpot $0 | Bingo $0 | Fortune $0 | Tax $0
Seat 1: Hero (button) folded before Flop (didn't bet)
Seat 2: 885ae6ee (small blind) folded before Flop
Seat 3: 892809dd (big blind) folded before Flop
Seat 4: c81ea267 folded before Flop (didn't bet)
Seat 5: 44231a0a folded before Flop (didn't bet)
Seat 6: 2372be7b collected ($0.12)


Poker Hand #RC2078404052: Hold'em No Limit ($0.02/$0.05) - 2023/12/22 20:56:21
Table 'RushAndCash773186' 6-max Seat #1 is the button
Seat 1: c9faf803 ($11.52 in chips)
Seat 2: Hero ($5 in chips)
Seat 3: 38444444 ($12.46 in chips)
Seat 4: c6bf1d22 ($7.07 in chips)
Seat 5: dce31b8a ($5.93 in chips)
Seat 6: a4441de9 ($5 in chips)
Hero: posts small blind $0.02
38444444: posts big blind $0.05
*** HOLE CARDS ***
Dealt to c9faf803 
Dealt to Hero [Td 7d]
Dealt to 38444444 
Dealt to c6bf1d22 
Dealt to dce31b8a 
Dealt to a4441de9 
c6bf1d22: raises $0.06 to $0.11
dce31b8a: folds
a4441de9: folds
c9faf803: folds
Hero: folds
38444444: folds
Uncalled bet ($0.06) returned to c6bf1d22
*** SHOWDOWN ***
c6bf1d22 collected $0.12 from pot
*** SUMMARY ***
Total pot $0.12 | Rake $0 | Jackpot $0 | Bingo $0 | Fortune $0 | Tax $0
Seat 1: c9faf803 (button) folded before Flop (didn't bet)
Seat 2: Hero (small blind) folded before Flop
Seat 3: 38444444 (big blind) folded before Flop
Seat 4: c6bf1d22 collected ($0.12)
Seat 5: dce31b8a folded before Flop (didn't bet)
Seat 6: a4441de9 folded before Flop (didn't bet)


Poker Hand #RC2078403971: Hold'em No Limit ($0.02/$0.05) - 2023/12/22 20:56:17
Table 'RushAndCash773149' 6-max Seat #1 is the button
Seat 1: b7c101a2 ($3.21 in chips)
Seat 2: 4e20b85a ($9.32 in chips)
Seat 3: Hero ($5 in chips)
Seat 4: c3c9a58d ($1.68 in chips)
Seat 5: 22ac85ec ($7.16 in chips)
Seat 6: de3b84bb ($24.58 in chips)
4e20b85a: posts small blind $0.02
Hero: posts big blind $0.05
*** HOLE CARDS ***
Dealt to b7c101a2 
Dealt to 4e20b85a 
Dealt to Hero [8c 2h]
Dealt to c3c9a58d 
Dealt to 22ac85ec 
Dealt to de3b84bb 
c3c9a58d: folds
22ac85ec: folds
de3b84bb: folds
b7c101a2: raises $0.07 to $0.12
4e20b85a: folds
Hero: folds
Uncalled bet ($0.07) returned to b7c101a2
*** SHOWDOWN ***
b7c101a2 collected $0.12 from pot
*** SUMMARY ***
Total pot $0.12 | Rake $0 | Jackpot $0 | Bingo $0 | Fortune $0 | Tax $0
Seat 1: b7c101a2 (button) collected ($0.12)
Seat 2: 4e20b85a (small blind) folded before Flop
Seat 3: Hero (big blind) folded before Flop
Seat 4: c3c9a58d folded before Flop (didn't bet)
Seat 5: 22ac85ec folded before Flop (didn't bet)
Seat 6: de3b84bb folded before Flop (didn't bet)


Poker Hand #RC2078403049: Hold'em No Limit ($0.02/$0.05) - 2023/12/22 20:55:24
Table 'RushAndCash772720' 6-max Seat #1 is the button
Seat 1: 6c88f65e ($4.15 in chips)
Seat 2: cc7466f8 ($7.54 in chips)
Seat 3: e2f19b93 ($6.48 in chips)
Seat 4: 873b5865 ($5 in chips)
Seat 5: d4c9514b ($4.31 in chips)
Seat 6: Hero ($5.38 in chips)
cc7466f8: posts small blind $0.02
e2f19b93: posts big blind $0.05
*** HOLE CARDS ***
Dealt to 6c88f65e 
Dealt to cc7466f8 
Dealt to e2f19b93 
Dealt to 873b5865 
Dealt to d4c9514b 
Dealt to Hero [Ac Qc]
873b5865: folds
d4c9514b: folds
Hero: raises $0.05 to $0.1
6c88f65e: folds
cc7466f8: folds
e2f19b93: calls $0.05
*** FLOP *** [4d 9d 5c]
e2f19b93: checks
Hero: bets $0.1
e2f19b93: calls $0.1
*** TURN *** [4d 9d 5c] [Jc]
e2f19b93: checks
Hero: bets $0.21
e2f19b93: raises $0.42 to $0.63
Hero: calls $0.42
*** RIVER *** [4d 9d 5c Jc] [3s]
e2f19b93: checks
Hero: checks
e2f19b93: shows [8d 9c] (Pair of Nines)
Hero: shows [Ac Qc] (Ace-High)
*** SHOWDOWN ***
e2f19b93 collected $1.53 from pot
*** SUMMARY ***
Total pot $1.68 | Rake $0.08 | Jackpot $0.07 | Bingo $0 | Fortune $0 | Tax $0
Board [4d 9d 5c Jc 3s]
Seat 1: 6c88f65e (button) folded before Flop (didn't bet)
Seat 2: cc7466f8 (small blind) folded before Flop
Seat 3: e2f19b93 (big blind) showed [8d 9c] and won ($1.53) with Pair of Nines
Seat 4: 873b5865 folded before Flop (didn't bet)
Seat 5: d4c9514b folded before Flop (didn't bet)
Seat 6: Hero showed [Ac Qc] and lost with Ace-High


Poker Hand #RC2078402988: Hold'em No Limit ($0.02/$0.05) - 2023/12/22 20:55:21
Table 'RushAndCash772689' 6-max Seat #1 is the button
Seat 1: 32dfaf2b ($7.6 in chips)
Seat 2: c3ac0c83 ($4.72 in chips)
Seat 3: d51e5ac3 ($11.72 in chips)
Seat 4: 873b5865 ($5 in chips)
Seat 5: Hero ($5.38 in chips)
Seat 6: cadbc8d6 ($5.19 in chips)
c3ac0c83: posts small blind $0.02
d51e5ac3: posts big blind $0.05
*** HOLE CARDS ***
Dealt to 32dfaf2b 
Dealt to c3ac0c83 
Dealt to d51e5ac3 
Dealt to 873b5865 
Dealt to Hero [5h 6d]
Dealt to cadbc8d6 
873b5865: folds
Hero: folds
cadbc8d6: raises $0.08 to $0.13
32dfaf2b: folds
c3ac0c83: folds
d51e5ac3: calls $0.08
*** FLOP *** [Qc 3d 3c]
d51e5ac3: checks
cadbc8d6: bets $0.15
d51e5ac3: raises $0.3 to $0.45
cadbc8d6: calls $0.3
*** TURN *** [Qc 3d 3c] [7h]
d51e5ac3: checks
cadbc8d6: bets $0.39
d51e5ac3: raises $0.39 to $0.78
cadbc8d6: calls $0.39
*** RIVER *** [Qc 3d 3c 7h] [6c]
d51e5ac3: checks
cadbc8d6: checks
d51e5ac3: shows [7c Ad] (Pair of Sevens and Pair of Treys)
cadbc8d6: shows [Ts Td] (Pair of Tens and Pair of Treys)
*** SHOWDOWN ***
cadbc8d6 collected $2.54 from pot
*** SUMMARY ***
Total pot $2.74 | Rake $0.13 | Jackpot $0.07 | Bingo $0 | Fortune $0 | Tax $0
Board [Qc 3d 3c 7h 6c]
Seat 1: 32dfaf2b (button) folded before Flop (didn't bet)
Seat 2: c3ac0c83 (small blind) folded before Flop
Seat 3: d51e5ac3 (big blind) showed [7c Ad] and lost with Pair of Sevens and Pair of Treys
Seat 4: 873b5865 folded before Flop (didn't bet)
Seat 5: Hero folded before Flop (didn't bet)
Seat 6: cadbc8d6 showed [Ts Td] and won ($2.54) with Pair of Tens and Pair of Treys


Poker Hand #RC2078402915: Hold'em No Limit ($0.02/$0.05) - 2023/12/22 20:55:17
Table 'RushAndCash772654' 6-max Seat #1 is the button
Seat 1: Hero ($5.38 in chips)
Seat 2: cada0d1d ($5.06 in chips)
Seat 3: 19134d79 ($5.66 in chips)
Seat 4: c8389234 ($15.05 in chips)
Seat 5: b2ff1a5d ($10.26 in chips)
Seat 6: 288917ef ($1.83 in chips)
cada0d1d: posts small blind $0.02
19134d79: posts big blind $0.05
*** HOLE CARDS ***
Dealt to Hero [9h 2h]
Dealt to cada0d1d 
Dealt to 19134d79 
Dealt to c8389234 
Dealt to b2ff1a5d 
Dealt to 288917ef 
c8389234: raises $0.1 to $0.15
b2ff1a5d: folds
288917ef: folds
Hero: folds
cada0d1d: folds
19134d79: folds
Uncalled bet ($0.1) returned to c8389234
*** SHOWDOWN ***
c8389234 collected $0.12 from pot
*** SUMMARY ***
Total pot $0.12 | Rake $0 | Jackpot $0 | Bingo $0 | Fortune $0 | Tax $0
Seat 1: Hero (button) folded before Flop (didn't bet)
Seat 2: cada0d1d (small blind) folded before Flop
Seat 3: 19134d79 (big blind) folded before Flop
Seat 4: c8389234 collected ($0.12)
Seat 5: b2ff1a5d folded before Flop (didn't bet)
Seat 6: 288917ef folded before Flop (didn't bet)


Poker Hand #RC2078402847: Hold'em No Limit ($0.02/$0.05) - 2023/12/22 20:55:13
Table 'RushAndCash772622' 6-max Seat #1 is the button
Seat 1: bc7afeb2 ($5 in chips)
Seat 2: 365a060c ($5.38 in chips)
Seat 3: cbfe1acc ($7.66 in chips)
Seat 4: 869465ff ($14.17 in chips)
Seat 5: Hero ($5.38 in chips)
Seat 6: 610343c3 ($5 in chips)
365a060c: posts small blind $0.02
cbfe1acc: posts big blind $0.05
*** HOLE CARDS ***
Dealt to bc7afeb2 
Dealt to 365a060c 
Dealt to cbfe1acc 
Dealt to 869465ff 
Dealt to Hero [Qd 8s]
Dealt to 610343c3 
869465ff: folds
Hero: folds
610343c3: folds
bc7afeb2: raises $0.1 to $0.15
365a060c: calls $0.13
cbfe1acc: folds
*** FLOP *** [Kh 9d 6s]
365a060c: checks
bc7afeb2: bets $0.1
365a060c: calls $0.1
*** TURN *** [Kh 9d 6s] [Ah]
365a060c: checks
bc7afeb2: bets $0.05
365a060c: folds
Uncalled bet ($0.05) returned to bc7afeb2
*** SHOWDOWN ***
bc7afeb2 collected $0.53 from pot
*** SUMMARY ***
Total pot $0.55 | Rake $0.02 | Jackpot $0 | Bingo $0 | Fortune $0 | Tax $0
Board [Kh 9d 6s Ah]
Seat 1: bc7afeb2 (button) won ($0.53)
Seat 2: 365a060c (small blind) folded on the Turn
Seat 3: cbfe1acc (big blind) folded before Flop
Seat 4: 869465ff folded before Flop (didn't bet)
Seat 5: Hero folded before Flop (didn't bet)
Seat 6: 610343c3 folded before Flop (didn't bet)


Poker Hand #RC2078402701: Hold'em No Limit ($0.02/$0.05) - 2023/12/22 20:55:05
Table 'RushAndCash772550' 6-max Seat #1 is the button
Seat 1: ddbe951e ($10.16 in chips)
Seat 2: Hero ($5.4 in chips)
Seat 3: a04ab5b3 ($5.21 in chips)
Seat 4: 341cb855 ($5.5 in chips)
Seat 5: 1f940f2d ($5.04 in chips)
Seat 6: 933d69ee ($7.66 in chips)
Hero: posts small blind $0.02
a04ab5b3: posts big blind $0.05
*** HOLE CARDS ***
Dealt to ddbe951e 
Dealt to Hero [Qd 3c]
Dealt to a04ab5b3 
Dealt to 341cb855 
Dealt to 1f940f2d 
Dealt to 933d69ee 
341cb855: folds
1f940f2d: folds
933d69ee: raises $0.06 to $0.11
ddbe951e: folds
Hero: folds
a04ab5b3: calls $0.06
*** FLOP *** [Kd 5c As]
a04ab5b3: checks
933d69ee: bets $0.12
a04ab5b3: folds
Uncalled bet ($0.12) returned to 933d69ee
*** SHOWDOWN ***
933d69ee collected $0.23 from pot
*** SUMMARY ***
Total pot $0.24 | Rake $0.01 | Jackpot $0 | Bingo $0 | Fortune $0 | Tax $0
Board [Kd 5c As]
Seat 1: ddbe951e (button) folded before Flop (didn't bet)
Seat 2: Hero (small blind) folded before Flop
Seat 3: a04ab5b3 (big blind) folded on the Flop
Seat 4: 341cb855 folded before Flop (didn't bet)
Seat 5: 1f940f2d folded before Flop (didn't bet)
Seat 6: 933d69ee won ($0.23)


Poker Hand #RC2078402516: Hold'em No Limit ($0.02/$0.05) - 2023/12/22 20:54:55
Table 'RushAndCash772464' 6-max Seat #1 is the button
Seat 1: 193ba103 ($2.28 in chips)
Seat 2: d51e5ac3 ($11.6 in chips)
Seat 3: Hero ($5.45 in chips)
Seat 4: 673162b7 ($5.42 in chips)
Seat 5: 885ae6ee ($9.05 in chips)
Seat 6: c7451cf4 ($6.02 in chips)
d51e5ac3: posts small blind $0.02
Hero: posts big blind $0.05
*** HOLE CARDS ***
Dealt to 193ba103 
Dealt to d51e5ac3 
Dealt to Hero [9d Js]
Dealt to 673162b7 
Dealt to 885ae6ee 
Dealt to c7451cf4 
673162b7: folds
885ae6ee: folds
c7451cf4: folds
193ba103: folds
d51e5ac3: raises $0.1 to $0.15
Hero: folds
Uncalled bet ($0.1) returned to d51e5ac3
*** SHOWDOWN ***
d51e5ac3 collected $0.1 from pot
*** SUMMARY ***
Total pot $0.1 | Rake $0 | Jackpot $0 | Bingo $0 | Fortune $0 | Tax $0
Seat 1: 193ba103 (button) folded before Flop (didn't bet)
Seat 2: d51e5ac3 (small blind) collected ($0.1)
Seat 3: Hero (big blind) folded before Flop
Seat 4: 673162b7 folded before Flop (didn't bet)
Seat 5: 885ae6ee folded before Flop (didn't bet)
Seat 6: c7451cf4 folded before Flop (didn't bet)


Poker Hand #RC2078402447: Hold'em No Limit ($0.02/$0.05) - 2023/12/22 20:54:51
Table 'RushAndCash772432' 6-max Seat #1 is the button
Seat 1: 103d682c ($5.23 in chips)
Seat 2: f92e05a8 ($15.6 in chips)
Seat 3: 12953fac ($5.17 in chips)
Seat 4: 23800602 ($4.51 in chips)
Seat 5: cadbc8d6 ($5.19 in chips)
Seat 6: Hero ($5.45 in chips)
f92e05a8: posts small blind $0.02
12953fac: posts big blind $0.05
*** HOLE CARDS ***
Dealt to 103d682c 
Dealt to f92e05a8 
Dealt to 12953fac 
Dealt to 23800602 
Dealt to cadbc8d6 
Dealt to Hero [8h Jd]
23800602: folds
cadbc8d6: folds
Hero: folds
103d682c: raises $0.05 to $0.1
f92e05a8: folds
12953fac: calls $0.05
*** FLOP *** [4s 4d Ad]
12953fac: checks
103d682c: checks
*** TURN *** [4s 4d Ad] [Qd]
12953fac: bets $0.16
103d682c: calls $0.16
*** RIVER *** [4s 4d Ad Qd] [Qc]
12953fac: bets $0.44
103d682c: calls $0.44
12953fac: shows [5d 8d] (Ace High Flush)
103d682c: shows [3s As] (Pair of Aces and Pair of Queens)
*** SHOWDOWN ***
12953fac collected $1.37 from pot
*** SUMMARY ***
Total pot $1.42 | Rake $0.05 | Jackpot $0 | Bingo $0 | Fortune $0 | Tax $0
Board [4s 4d Ad Qd Qc]
Seat 1: 103d682c (button) showed [3s As] and lost with Pair of Aces and Pair of Queens
Seat 2: f92e05a8 (small blind) folded before Flop
Seat 3: 12953fac (big blind) showed [5d 8d] and won ($1.37) with Ace High Flush
Seat 4: 23800602 folded before Flop (didn't bet)
Seat 5: cadbc8d6 folded before Flop (didn't bet)
Seat 6: Hero folded before Flop (didn't bet)


Poker Hand #RC2078402386: Hold'em No Limit ($0.02/$0.05) - 2023/12/22 20:54:48
Table 'RushAndCash772404' 6-max Seat #1 is the button
Seat 1: 49ea92ea ($6.01 in chips)
Seat 2: b80e619f ($3.76 in chips)
Seat 3: bd4a4d17 ($9.65 in chips)
Seat 4: 7810e6bd ($5.1 in chips)
Seat 5: fbeaaad2 ($10.2 in chips)
Seat 6: Hero ($5.45 in chips)
b80e619f: posts small blind $0.02
bd4a4d17: posts big blind $0.05
*** HOLE CARDS ***
Dealt to 49ea92ea 
Dealt to b80e619f 
Dealt to bd4a4d17 
Dealt to 7810e6bd 
Dealt to fbeaaad2 
Dealt to Hero [5s 6c]
7810e6bd: folds
fbeaaad2: folds
Hero: folds
49ea92ea: folds
b80e619f: folds
Uncalled bet ($0.03) returned to bd4a4d17
*** SHOWDOWN ***
bd4a4d17 collected $0.04 from pot
*** SUMMARY ***
Total pot $0.04 | Rake $0 | Jackpot $0 | Bingo $0 | Fortune $0 | Tax $0
Seat 1: 49ea92ea (button) folded before Flop (didn't bet)
Seat 2: b80e619f (small blind) folded before Flop
Seat 3: bd4a4d17 (big blind) collected ($0.04)
Seat 4: 7810e6bd folded before Flop (didn't bet)
Seat 5: fbeaaad2 folded before Flop (didn't bet)
Seat 6: Hero folded before Flop (didn't bet)


Poker Hand #RC2078402321: Hold'em No Limit ($0.02/$0.05) - 2023/12/22 20:54:44
Table 'RushAndCash772375' 6-max Seat #1 is the button
Seat 1: de1c7123 ($5.07 in chips)
Seat 2: 81f09a8e ($5 in chips)
Seat 3: 38bb8e26 ($7.77 in chips)
Seat 4: 409f5cad ($5 in chips)
Seat 5: 658e3f71 ($7.64 in chips)
Seat 6: Hero ($5.45 in chips)
81f09a8e: posts small blind $0.02
38bb8e26: posts big blind $0.05
*** HOLE CARDS ***
Dealt to de1c7123 
Dealt to 81f09a8e 
Dealt to 38bb8e26 
Dealt to 409f5cad 
Dealt to 658e3f71 
Dealt to Hero [8h 6c]
409f5cad: raises $0.07 to $0.12
658e3f71: folds
Hero: folds
de1c7123: folds
81f09a8e: folds
38bb8e26: folds
Uncalled bet ($0.07) returned to 409f5cad
*** SHOWDOWN ***
409f5cad collected $0.12 from pot
*** SUMMARY ***
Total pot $0.12 | Rake $0 | Jackpot $0 | Bingo $0 | Fortune $0 | Tax $0
Seat 1: de1c7123 (button) folded before Flop (didn't bet)
Seat 2: 81f09a8e (small blind) folded before Flop
Seat 3: 38bb8e26 (big blind) folded before Flop
Seat 4: 409f5cad collected ($0.12)
Seat 5: 658e3f71 folded before Flop (didn't bet)
Seat 6: Hero folded before Flop (didn't bet)


Poker Hand #RC2078402254: Hold'em No Limit ($0.02/$0.05) - 2023/12/22 20:54:40
Table 'RushAndCash772347' 6-max Seat #1 is the button
Seat 1: 409f5cad ($5 in chips)
Seat 2: a8ee5981 ($4.88 in chips)
Seat 3: 886872c9 ($5 in chips)
Seat 4: 86aa2c94 ($4.86 in chips)
Seat 5: cdb7c904 ($7.52 in chips)
Seat 6: Hero ($5.45 in chips)
a8ee5981: posts small blind $0.02
886872c9: posts big blind $0.05
*** HOLE CARDS ***
Dealt to 409f5cad 
Dealt to a8ee5981 
Dealt to 886872c9 
Dealt to 86aa2c94 
Dealt to cdb7c904 
Dealt to Hero [4c Ks]
86aa2c94: folds
cdb7c904: folds
Hero: folds
409f5cad: folds
a8ee5981: folds
Uncalled bet ($0.03) returned to 886872c9
*** SHOWDOWN ***
886872c9 collected $0.04 from pot
*** SUMMARY ***
Total pot $0.04 | Rake $0 | Jackpot $0 | Bingo $0 | Fortune $0 | Tax $0
Seat 1: 409f5cad (button) folded before Flop (didn't bet)
Seat 2: a8ee5981 (small blind) folded before Flop
Seat 3: 886872c9 (big blind) collected ($0.04)
Seat 4: 86aa2c94 folded before Flop (didn't bet)
Seat 5: cdb7c904 folded before Flop (didn't bet)
Seat 6: Hero folded before Flop (didn't bet)


Poker Hand #RC2078402127: Hold'em No Limit ($0.02/$0.05) - 2023/12/22 20:54:34
Table 'RushAndCash772292' 6-max Seat #1 is the button
Seat 1: Hero ($5.45 in chips)
Seat 2: a0d73ae9 ($4.47 in chips)
Seat 3: 873b5865 ($5.07 in chips)
Seat 4: 7020d421 ($15.51 in chips)
Seat 5: 29b0f5be ($5.07 in chips)
Seat 6: d0442df9 ($4.36 in chips)
a0d73ae9: posts small blind $0.02
873b5865: posts big blind $0.05
*** HOLE CARDS ***
Dealt to Hero [Js 6d]
Dealt to a0d73ae9 
Dealt to 873b5865 
Dealt to 7020d421 
Dealt to 29b0f5be 
Dealt to d0442df9 
7020d421: raises $0.05 to $0.1
29b0f5be: folds
d0442df9: folds
Hero: folds
a0d73ae9: calls $0.08
873b5865: folds
*** FLOP *** [Qh 5h 2h]
a0d73ae9: bets $0.09
7020d421: folds
Uncalled bet ($0.09) returned to a0d73ae9
*** SHOWDOWN ***
a0d73ae9 collected $0.24 from pot
*** SUMMARY ***
Total pot $0.25 | Rake $0.01 | Jackpot $0 | Bingo $0 | Fortune $0 | Tax $0
Board [Qh 5h 2h]
Seat 1: Hero (button) folded before Flop (didn't bet)
Seat 2: a0d73ae9 (small blind) won ($0.24)
Seat 3: 873b5865 (big blind) folded before Flop
Seat 4: 7020d421 folded on the Flop
Seat 5: 29b0f5be folded before Flop (didn't bet)
Seat 6: d0442df9 folded before Flop (didn't bet)


Poker Hand #RC2078401941: Hold'em No Limit ($0.02/$0.05) - 2023/12/22 20:54:24
Table 'RushAndCash772208' 6-max Seat #1 is the button
Seat 1: f51712b3 ($7.95 in chips)
Seat 2: e8df5901 ($9.11 in chips)
Seat 3: Hero ($5.43 in chips)
Seat 4: d44a85a3 ($4.91 in chips)
Seat 5: 86bb6ec4 ($7.94 in chips)
Seat 6: cc7466f8 ($7.86 in chips)
e8df5901: posts small blind $0.02
Hero: posts big blind $0.05
*** HOLE CARDS ***
Dealt to f51712b3 
Dealt to e8df5901 
Dealt to Hero [9d 9c]
Dealt to d44a85a3 
Dealt to 86bb6ec4 
Dealt to cc7466f8 
d44a85a3: folds
86bb6ec4: folds
cc7466f8: folds
f51712b3: folds
e8df5901: folds
Uncalled bet ($0.03) returned to Hero
*** SHOWDOWN ***
Hero collected $0.04 from pot
*** SUMMARY ***
Total pot $0.04 | Rake $0 | Jackpot $0 | Bingo $0 | Fortune $0 | Tax $0
Seat 1: f51712b3 (button) folded before Flop (didn't bet)
Seat 2: e8df5901 (small blind) folded before Flop
Seat 3: Hero (big blind) collected ($0.04)
Seat 4: d44a85a3 folded before Flop (didn't bet)
Seat 5: 86bb6ec4 folded before Flop (didn't bet)
Seat 6: cc7466f8 folded before Flop (didn't bet)


Poker Hand #RC2078401876: Hold'em No Limit ($0.02/$0.05) - 2023/12/22 20:54:21
Table 'RushAndCash772178' 6-max Seat #1 is the button
Seat 1: d2f469dd ($14.26 in chips)
Seat 2: Hero ($5.45 in chips)
Seat 3: 3c028e9 ($4.87 in chips)
Seat 4: 38bb8e26 ($7.72 in chips)
Seat 5: 559a8f6f ($8.87 in chips)
Seat 6: b2ff1a5d ($10.88 in chips)
Hero: posts small blind $0.02
3c028e9: posts big blind $0.05
*** HOLE CARDS ***
Dealt to d2f469dd 
Dealt to Hero [6h Qd]
Dealt to 3c028e9 
Dealt to 38bb8e26 
Dealt to 559a8f6f 
Dealt to b2ff1a5d 
38bb8e26: folds
559a8f6f: folds
b2ff1a5d: folds
d2f469dd: folds
Hero: folds
Uncalled bet ($0.03) returned to 3c028e9
*** SHOWDOWN ***
3c028e9 collected $0.04 from pot
*** SUMMARY ***
Total pot $0.04 | Rake $0 | Jackpot $0 | Bingo $0 | Fortune $0 | Tax $0
Seat 1: d2f469dd (button) folded before Flop (didn't bet)
Seat 2: Hero (small blind) folded before Flop
Seat 3: 3c028e9 (big blind) collected ($0.04)
Seat 4: 38bb8e26 folded before Flop (didn't bet)
Seat 5: 559a8f6f folded before Flop (didn't bet)
Seat 6: b2ff1a5d folded before Flop (didn't bet)


Poker Hand #RC2078401095: Hold'em No Limit ($0.02/$0.05) - 2023/12/22 20:53:38
Table 'RushAndCash771817' 6-max Seat #1 is the button
Seat 1: 4810f2d7 ($7.23 in chips)
Seat 2: 68c6c5e7 ($13.09 in chips)
Seat 3: 2ce216bb ($6.05 in chips)
Seat 4: 869465ff ($13.53 in chips)
Seat 5: 915de7e4 ($5.21 in chips)
Seat 6: Hero ($5 in chips)
68c6c5e7: posts small blind $0.02
2ce216bb: posts big blind $0.05
*** HOLE CARDS ***
Dealt to 4810f2d7 
Dealt to 68c6c5e7 
Dealt to 2ce216bb 
Dealt to 869465ff 
Dealt to 915de7e4 
Dealt to Hero [Kd 6d]
869465ff: folds
915de7e4: folds
Hero: raises $0.05 to $0.1
4810f2d7: folds
68c6c5e7: folds
2ce216bb: calls $0.05
*** FLOP *** [Kc 4d Ah]
2ce216bb: checks
Hero: checks
*** TURN *** [Kc 4d Ah] [Qd]
2ce216bb: bets $0.08
Hero: calls $0.08
*** RIVER *** [Kc 4d Ah Qd] [Jd]
2ce216bb: bets $0.29
Hero: calls $0.29
2ce216bb: shows [Ts Ac] (Aces-High Straight)
Hero: shows [Kd 6d] (King High Flush)
*** SHOWDOWN ***
Hero collected $0.92 from pot
*** SUMMARY ***
Total pot $0.96 | Rake $0.04 | Jackpot $0 | Bingo $0 | Fortune $0 | Tax $0
Board [Kc 4d Ah Qd Jd]
Seat 1: 4810f2d7 (button) folded before Flop (didn't bet)
Seat 2: 68c6c5e7 (small blind) folded before Flop
Seat 3: 2ce216bb (big blind) showed [Ts Ac] and lost with Aces-High Straight
Seat 4: 869465ff folded before Flop (didn't bet)
Seat 5: 915de7e4 folded before Flop (didn't bet)
Seat 6: Hero showed [Kd 6d] and won ($0.92) with King High Flush


Poker Hand #RC2078401018: Hold'em No Limit ($0.02/$0.05) - 2023/12/22 20:53:34
Table 'RushAndCash771785' 6-max Seat #1 is the button
Seat 1: 960a23e5 ($3.54 in chips)
Seat 2: b6b18568 ($5.97 in chips)
Seat 3: 42186a8a ($5.23 in chips)
Seat 4: Hero ($5 in chips)
Seat 5: 84bf8c0b ($5 in chips)
Seat 6: 53442c3b ($9.79 in chips)
b6b18568: posts small blind $0.02
42186a8a: posts big blind $0.05
*** HOLE CARDS ***
Dealt to 960a23e5 
Dealt to b6b18568 
Dealt to 42186a8a 
Dealt to Hero [5h 7s]
Dealt to 84bf8c0b 
Dealt to 53442c3b 
Hero: folds
84bf8c0b: folds
53442c3b: raises $0.1 to $0.15
960a23e5: folds
b6b18568: folds
42186a8a: folds
Uncalled bet ($0.1) returned to 53442c3b
*** SHOWDOWN ***
53442c3b collected $0.12 from pot
*** SUMMARY ***
Total pot $0.12 | Rake $0 | Jackpot $0 | Bingo $0 | Fortune $0 | Tax $0
Seat 1: 960a23e5 (button) folded before Flop (didn't bet)
Seat 2: b6b18568 (small blind) folded before Flop
Seat 3: 42186a8a (big blind) folded before Flop
Seat 4: Hero folded before Flop (didn't bet)
Seat 5: 84bf8c0b folded before Flop (didn't bet)
Seat 6: 53442c3b collected ($0.12)


Poker Hand #RC2078400952: Hold'em No Limit ($0.02/$0.05) - 2023/12/22 20:53:30
Table 'RushAndCash771756' 6-max Seat #1 is the button
Seat 1: Hero ($5 in chips)
Seat 2: e65ad772 ($5.37 in chips)
Seat 3: d6363be2 ($5.14 in chips)
Seat 4: 2f3b003a ($6.36 in chips)
Seat 5: b6b18568 ($5.97 in chips)
Seat 6: ff6f425f ($7.23 in chips)
e65ad772: posts small blind $0.02
d6363be2: posts big blind $0.05
*** HOLE CARDS ***
Dealt to Hero [Td 4c]
Dealt to e65ad772 
Dealt to d6363be2 
Dealt to 2f3b003a 
Dealt to b6b18568 
Dealt to ff6f425f 
2f3b003a: raises $0.08 to $0.13
b6b18568: folds
ff6f425f: folds
Hero: folds
e65ad772: folds
d6363be2: folds
Uncalled bet ($0.08) returned to 2f3b003a
*** SHOWDOWN ***
2f3b003a collected $0.12 from pot
*** SUMMARY ***
Total pot $0.12 | Rake $0 | Jackpot $0 | Bingo $0 | Fortune $0 | Tax $0
Seat 1: Hero (button) folded before Flop (didn't bet)
Seat 2: e65ad772 (small blind) folded before Flop
Seat 3: d6363be2 (big blind) folded before Flop
Seat 4: 2f3b003a collected ($0.12)
Seat 5: b6b18568 folded before Flop (didn't bet)
Seat 6: ff6f425f folded before Flop (didn't bet)


Poker Hand #RC2078400766: Hold'em No Limit ($0.02/$0.05) - 2023/12/22 20:53:20
Table 'RushAndCash771668' 6-max Seat #1 is the button
Seat 1: d7f451d5 ($6.28 in chips)
Seat 2: Hero ($5.02 in chips)
Seat 3: 30a2950b ($5 in chips)
Seat 4: b6cbb21f ($5.11 in chips)
Seat 5: e65ad772 ($5.37 in chips)
Seat 6: 2df55086 ($7.03 in chips)
Hero: posts small blind $0.02
30a2950b: posts big blind $0.05
*** HOLE CARDS ***
Dealt to d7f451d5 
Dealt to Hero [8h 6h]
Dealt to 30a2950b 
Dealt to b6cbb21f 
Dealt to e65ad772 
Dealt to 2df55086 
b6cbb21f: folds
e65ad772: folds
2df55086: folds
d7f451d5: raises $0.08 to $0.13
Hero: folds
30a2950b: raises $0.37 to $0.5
d7f451d5: calls $0.37
*** FLOP *** [5c 9h 7s]
30a2950b: checks
d7f451d5: checks
*** TURN *** [5c 9h 7s] [8s]
30a2950b: checks
d7f451d5: bets $0.68
30a2950b: folds
Uncalled bet ($0.68) returned to d7f451d5
*** SHOWDOWN ***
d7f451d5 collected $0.97 from pot
*** SUMMARY ***
Total pot $1.02 | Rake $0.05 | Jackpot $0 | Bingo $0 | Fortune $0 | Tax $0
Board [5c 9h 7s 8s]
Seat 1: d7f451d5 (button) won ($0.97)
Seat 2: Hero (small blind) folded before Flop
Seat 3: 30a2950b (big blind) folded on the Turn
Seat 4: b6cbb21f folded before Flop (didn't bet)
Seat 5: e65ad772 folded before Flop (didn't bet)
Seat 6: 2df55086 folded before Flop (didn't bet)


Poker Hand #RC2078400474: Hold'em No Limit ($0.02/$0.05) - 2023/12/22 20:53:04
Table 'RushAndCash771539' 6-max Seat #1 is the button
Seat 1: 1699fc0f ($5.53 in chips)
Seat 2: a8ee5981 ($5.02 in chips)
Seat 3: Hero ($5 in chips)
Seat 4: c87acea2 ($5 in chips)
Seat 5: 22818fb2 ($8.57 in chips)
Seat 6: 3b87467 ($6.68 in chips)
a8ee5981: posts small blind $0.02
Hero: posts big blind $0.05
*** HOLE CARDS ***
Dealt to 1699fc0f 
Dealt to a8ee5981 
Dealt to Hero [5h Qd]
Dealt to c87acea2 
Dealt to 22818fb2 
Dealt to 3b87467 
c87acea2: folds
22818fb2: folds
3b87467: folds
1699fc0f: folds
a8ee5981: folds
Uncalled bet ($0.03) returned to Hero
*** SHOWDOWN ***
Hero collected $0.04 from pot
*** SUMMARY ***
Total pot $0.04 | Rake $0 | Jackpot $0 | Bingo $0 | Fortune $0 | Tax $0
Seat 1: 1699fc0f (button) folded before Flop (didn't bet)
Seat 2: a8ee5981 (small blind) folded before Flop
Seat 3: Hero (big blind) collected ($0.04)
Seat 4: c87acea2 folded before Flop (didn't bet)
Seat 5: 22818fb2 folded before Flop (didn't bet)
Seat 6: 3b87467 folded before Flop (didn't bet)


Poker Hand #RC2078400409: Hold'em No Limit ($0.02/$0.05) - 2023/12/22 20:53:01
Table 'RushAndCash771510' 6-max Seat #1 is the button
Seat 1: 4b5380b0 ($65.12 in chips)
Seat 2: 29b0f5be ($5 in chips)
Seat 3: 534d7dcf ($5.67 in chips)
Seat 4: 3979e411 ($7.42 in chips)
Seat 5: Hero ($5 in chips)
Seat 6: 750bae61 ($8.09 in chips)
29b0f5be: posts small blind $0.02
534d7dcf: posts big blind $0.05
*** HOLE CARDS ***
Dealt to 4b5380b0 
Dealt to 29b0f5be 
Dealt to 534d7dcf 
Dealt to 3979e411 
Dealt to Hero [9d 3s]
Dealt to 750bae61 
3979e411: folds
Hero: folds
750bae61: folds
4b5380b0: folds
29b0f5be: folds
Uncalled bet ($0.03) returned to 534d7dcf
*** SHOWDOWN ***
534d7dcf collected $0.04 from pot
*** SUMMARY ***
Total pot $0.04 | Rake $0 | Jackpot $0 | Bingo $0 | Fortune $0 | Tax $0
Seat 1: 4b5380b0 (button) folded before Flop (didn't bet)
Seat 2: 29b0f5be (small blind) folded before Flop
Seat 3: 534d7dcf (big blind) collected ($0.04)
Seat 4: 3979e411 folded before Flop (didn't bet)
Seat 5: Hero folded before Flop (didn't bet)
Seat 6: 750bae61 folded before Flop (didn't bet)


Poker Hand #RC2078400347: Hold'em No Limit ($0.02/$0.05) - 2023/12/22 20:52:57
Table 'RushAndCash771481' 6-max Seat #1 is the button
Seat 1: c7592cbf ($11.48 in chips)
Seat 2: 49d0f319 ($6.3 in chips)
Seat 3: 73aadc66 ($5.72 in chips)
Seat 4: cbfe1acc ($7.93 in chips)
Seat 5: 2471888a ($6.17 in chips)
Seat 6: Hero ($5 in chips)
49d0f319: posts small blind $0.02
73aadc66: posts big blind $0.05
*** HOLE CARDS ***
Dealt to c7592cbf 
Dealt to 49d0f319 
Dealt to 73aadc66 
Dealt to cbfe1acc 
Dealt to 2471888a 
Dealt to Hero [2d 5s]
cbfe1acc: folds
2471888a: folds
Hero: folds
c7592cbf: raises $0.06 to $0.11
49d0f319: folds
73aadc66: calls $0.06
*** FLOP *** [7c 8d 7s]
73aadc66: checks
c7592cbf: bets $0.08
73aadc66: calls $0.08
*** TURN *** [7c 8d 7s] [4c]
73aadc66: checks
c7592cbf: bets $0.24
73aadc66: calls $0.24
*** RIVER *** [7c 8d 7s 4c] [Tc]
73aadc66: checks
c7592cbf: bets $0.98
73aadc66: calls $0.98
c7592cbf: shows [Ad 7d] (Three Sevens)
73aadc66: shows [Ac 2c] (Ace High Flush)
*** SHOWDOWN ***
73aadc66 collected $2.64 from pot
*** SUMMARY ***
Total pot $2.84 | Rake $0.13 | Jackpot $0.07 | Bingo $0 | Fortune $0 | Tax $0
Board [7c 8d 7s 4c Tc]
Seat 1: c7592cbf (button) showed [Ad 7d] and lost with Three Sevens
Seat 2: 49d0f319 (small blind) folded before Flop
Seat 3: 73aadc66 (big blind) showed [Ac 2c] and won ($2.64) with Ace High Flush
Seat 4: cbfe1acc folded before Flop (didn't bet)
Seat 5: 2471888a folded before Flop (didn't bet)
Seat 6: Hero folded before Flop (didn't bet)


Poker Hand #RC2078399858: Hold'em No Limit ($0.02/$0.05) - 2023/12/22 20:52:30
Table 'RushAndCash771257' 6-max Seat #1 is the button
Seat 1: cbfe1acc ($8.03 in chips)
Seat 2: 38e42730 ($5 in chips)
Seat 3: 680eb0e1 ($8.48 in chips)
Seat 4: Hero ($5 in chips)
Seat 5: 73aadc66 ($5.04 in chips)
Seat 6: 3b613695 ($8.65 in chips)
Cash Drop to Pot : total $0.5 
38e42730: posts small blind $0.02
680eb0e1: posts big blind $0.05
*** HOLE CARDS ***
Dealt to cbfe1acc 
Dealt to 38e42730 
Dealt to 680eb0e1 
Dealt to Hero [Th 5s]
Dealt to 73aadc66 
Dealt to 3b613695 
Hero: folds
73aadc66: raises $0.05 to $0.1
3b613695: folds
cbfe1acc: calls $0.1
38e42730: folds
680eb0e1: calls $0.05
*** FLOP *** [8d Jd 9s]
680eb0e1: checks
73aadc66: bets $0.41
cbfe1acc: folds
680eb0e1: folds
Uncalled bet ($0.41) returned to 73aadc66
*** SHOWDOWN ***
73aadc66 collected $0.78 from pot
*** SUMMARY ***
Total pot $0.82 | Rake $0.04 | Jackpot $0 | Bingo $0 | Fortune $0 | Tax $0
Board [8d Jd 9s]
Seat 1: cbfe1acc (button) folded on the Flop
Seat 2: 38e42730 (small blind) folded before Flop
Seat 3: 680eb0e1 (big blind) folded on the Flop
Seat 4: Hero folded before Flop (didn't bet)
Seat 5: 73aadc66 won ($0.78)
Seat 6: 3b613695 folded before Flop (didn't bet)


Poker Hand #RC2078399147: Hold'em No Limit ($0.02/$0.05) - 2023/12/22 20:51:50
Table 'RushAndCash770943' 6-max Seat #1 is the button
Seat 1: Hero ($5 in chips)
Seat 2: 2c867a7e ($13.13 in chips)
Seat 3: 4b57c53e ($10.9 in chips)
Seat 4: 48914dc6 ($3 in chips)
Seat 5: 2ce216bb ($6.05 in chips)
Seat 6: 9af3794b ($5.6 in chips)
2c867a7e: posts small blind $0.02
4b57c53e: posts big blind $0.05
*** HOLE CARDS ***
Dealt to Hero [4h Kh]
Dealt to 2c867a7e 
Dealt to 4b57c53e 
Dealt to 48914dc6 
Dealt to 2ce216bb 
Dealt to 9af3794b 
48914dc6: folds
2ce216bb: folds
9af3794b: folds
Hero: raises $0.08 to $0.13
2c867a7e: folds
4b57c53e: calls $0.08
*** FLOP *** [8d Qs Tc]
4b57c53e: checks
Hero: bets $0.1
4b57c53e: raises $0.24 to $0.34
Hero: folds
Uncalled bet ($0.24) returned to 4b57c53e
*** SHOWDOWN ***
4b57c53e collected $0.46 from pot
*** SUMMARY ***
Total pot $0.48 | Rake $0.02 | Jackpot $0 | Bingo $0 | Fortune $0 | Tax $0
Board [8d Qs Tc]
Seat 1: Hero (button) folded on the Flop
Seat 2: 2c867a7e (small blind) folded before Flop
Seat 3: 4b57c53e (big blind) won ($0.46)
Seat 4: 48914dc6 folded before Flop (didn't bet)
Seat 5: 2ce216bb folded before Flop (didn't bet)
Seat 6: 9af3794b folded before Flop (didn't bet)


Poker Hand #RC2078399051: Hold'em No Limit ($0.02/$0.05) - 2023/12/22 20:51:45
Table 'RushAndCash770901' 6-max Seat #1 is the button
Seat 1: 5e4c4d4e ($4.51 in chips)
Seat 2: 8eb71456 ($7.86 in chips)
Seat 3: dcd1ce07 ($19.99 in chips)
Seat 4: b54f6671 ($4.94 in chips)
Seat 5: d29426f7 ($3.37 in chips)
Seat 6: Hero ($5 in chips)
8eb71456: posts small blind $0.02
dcd1ce07: posts big blind $0.05
*** HOLE CARDS ***
Dealt to 5e4c4d4e 
Dealt to 8eb71456 
Dealt to dcd1ce07 
Dealt to b54f6671 
Dealt to d29426f7 
Dealt to Hero [4s 6h]
b54f6671: folds
d29426f7: folds
Hero: folds
5e4c4d4e: folds
8eb71456: folds
Uncalled bet ($0.03) returned to dcd1ce07
*** SHOWDOWN ***
dcd1ce07 collected $0.04 from pot
*** SUMMARY ***
Total pot $0.04 | Rake $0 | Jackpot $0 | Bingo $0 | Fortune $0 | Tax $0
Seat 1: 5e4c4d4e (button) folded before Flop (didn't bet)
Seat 2: 8eb71456 (small blind) folded before Flop
Seat 3: dcd1ce07 (big blind) collected ($0.04)
Seat 4: b54f6671 folded before Flop (didn't bet)
Seat 5: d29426f7 folded before Flop (didn't bet)
Seat 6: Hero folded before Flop (didn't bet)


Poker Hand #RC2078398956: Hold'em No Limit ($0.02/$0.05) - 2023/12/22 20:51:40
Table 'RushAndCash770859' 6-max Seat #1 is the button
Seat 1: 879060f7 ($19.05 in chips)
Seat 2: Hero ($5 in chips)
Seat 3: 3d929f9f ($5.03 in chips)
Seat 4: 93990934 ($13.72 in chips)
Seat 5: 292f111d ($6.31 in chips)
Seat 6: 5aa55d39 ($5.07 in chips)
Hero: posts small blind $0.02
3d929f9f: posts big blind $0.05
*** HOLE CARDS ***
Dealt to 879060f7 
Dealt to Hero [7d 2h]
Dealt to 3d929f9f 
Dealt to 93990934 
Dealt to 292f111d 
Dealt to 5aa55d39 
93990934: folds
292f111d: folds
5aa55d39: folds
879060f7: folds
Hero: folds
Uncalled bet ($0.03) returned to 3d929f9f
*** SHOWDOWN ***
3d929f9f collected $0.04 from pot
*** SUMMARY ***
Total pot $0.04 | Rake $0 | Jackpot $0 | Bingo $0 | Fortune $0 | Tax $0
Seat 1: 879060f7 (button) folded before Flop (didn't bet)
Seat 2: Hero (small blind) folded before Flop
Seat 3: 3d929f9f (big blind) collected ($0.04)
Seat 4: 93990934 folded before Flop (didn't bet)
Seat 5: 292f111d folded before Flop (didn't bet)
Seat 6: 5aa55d39 folded before Flop (didn't bet)


Poker Hand #RC2078398770: Hold'em No Limit ($0.02/$0.05) - 2023/12/22 20:51:30
Table 'RushAndCash770775' 6-max Seat #1 is the button
Seat 1: fcc5325d ($4.93 in chips)
Seat 2: 8bde3280 ($12.55 in chips)
Seat 3: Hero ($5 in chips)
Seat 4: e40a779 ($5.39 in chips)
Seat 5: b6b18568 ($6.05 in chips)
Seat 6: c7592cbf ($11.54 in chips)
8bde3280: posts small blind $0.02
Hero: posts big blind $0.05
*** HOLE CARDS ***
Dealt to fcc5325d 
Dealt to 8bde3280 
Dealt to Hero [Qd 2c]
Dealt to e40a779 
Dealt to b6b18568 
Dealt to c7592cbf 
e40a779: folds
b6b18568: raises $0.07 to $0.12
c7592cbf: folds
fcc5325d: folds
8bde3280: folds
Hero: folds
Uncalled bet ($0.07) returned to b6b18568
*** SHOWDOWN ***
b6b18568 collected $0.12 from pot
*** SUMMARY ***
Total pot $0.12 | Rake $0 | Jackpot $0 | Bingo $0 | Fortune $0 | Tax $0
Seat 1: fcc5325d (button) folded before Flop (didn't bet)
Seat 2: 8bde3280 (small blind) folded before Flop
Seat 3: Hero (big blind) folded before Flop
Seat 4: e40a779 folded before Flop (didn't bet)
Seat 5: b6b18568 collected ($0.12)
Seat 6: c7592cbf folded before Flop (didn't bet)


