Poker Hand #RC2075603045: Hold'em No Limit ($0.05/$0.1) - 2023/12/21 23:42:21
Table 'RushAndCash302249' 6-max Seat #1 is the button
Seat 1: b882ee6 ($13.3 in chips)
Seat 2: 2bbb668e ($14.45 in chips)
Seat 3: 7d8f33e0 ($10.72 in chips)
Seat 4: 2ca8cd2b ($10.41 in chips)
Seat 5: c4199f7d ($4.33 in chips)
Seat 6: Hero ($13.1 in chips)
2bbb668e: posts small blind $0.05
7d8f33e0: posts big blind $0.1
*** HOLE CARDS ***
Dealt to b882ee6 
Dealt to 2bbb668e 
Dealt to 7d8f33e0 
Dealt to 2ca8cd2b 
Dealt to c4199f7d 
Dealt to Hero [Qd Ts]
2ca8cd2b: folds
c4199f7d: folds
Hero: folds
b882ee6: folds
2bbb668e: folds
Uncalled bet ($0.05) returned to 7d8f33e0
*** SHOWDOWN ***
7d8f33e0 collected $0.1 from pot
*** SUMMARY ***
Total pot $0.1 | Rake $0 | Jackpot $0 | Bingo $0 | Fortune $0 | Tax $0
Seat 1: b882ee6 (button) folded before Flop (didn't bet)
Seat 2: 2bbb668e (small blind) folded before Flop
Seat 3: 7d8f33e0 (big blind) collected ($0.1)
Seat 4: 2ca8cd2b folded before Flop (didn't bet)
Seat 5: c4199f7d folded before Flop (didn't bet)
Seat 6: Hero folded before Flop (didn't bet)


Poker Hand #RC2075602846: Hold'em No Limit ($0.05/$0.1) - 2023/12/21 23:42:12
Table 'RushAndCash302144' 6-max Seat #1 is the button
Seat 1: db45a1dd ($10 in chips)
Seat 2: Hero ($13.15 in chips)
Seat 3: f3cc3e7 ($38.23 in chips)
Seat 4: 6ccc8ac3 ($13.51 in chips)
Seat 5: 8cb1fe0a ($11 in chips)
Seat 6: bb4af1b2 ($10.37 in chips)
Hero: posts small blind $0.05
f3cc3e7: posts big blind $0.1
*** HOLE CARDS ***
Dealt to db45a1dd 
Dealt to Hero [9d Kh]
Dealt to f3cc3e7 
Dealt to 6ccc8ac3 
Dealt to 8cb1fe0a 
Dealt to bb4af1b2 
6ccc8ac3: folds
8cb1fe0a: folds
bb4af1b2: raises $0.15 to $0.25
db45a1dd: folds
Hero: folds
f3cc3e7: folds
Uncalled bet ($0.15) returned to bb4af1b2
*** SHOWDOWN ***
bb4af1b2 collected $0.25 from pot
*** SUMMARY ***
Total pot $0.25 | Rake $0 | Jackpot $0 | Bingo $0 | Fortune $0 | Tax $0
Seat 1: db45a1dd (button) folded before Flop (didn't bet)
Seat 2: Hero (small blind) folded before Flop
Seat 3: f3cc3e7 (big blind) folded before Flop
Seat 4: 6ccc8ac3 folded before Flop (didn't bet)
Seat 5: 8cb1fe0a folded before Flop (didn't bet)
Seat 6: bb4af1b2 collected ($0.25)


Poker Hand #RC2075602768: Hold'em No Limit ($0.05/$0.1) - 2023/12/21 23:42:09
Table 'RushAndCash302101' 6-max Seat #1 is the button
Seat 1: 320aaa96 ($9.3 in chips)
Seat 2: 42ec9313 ($10.1 in chips)
Seat 3: 6f26ac45 ($10.75 in chips)
Seat 4: 835eed05 ($17.99 in chips)
Seat 5: Hero ($13.15 in chips)
Seat 6: 46b22a80 ($19.71 in chips)
42ec9313: posts small blind $0.05
6f26ac45: posts big blind $0.1
*** HOLE CARDS ***
Dealt to 320aaa96 
Dealt to 42ec9313 
Dealt to 6f26ac45 
Dealt to 835eed05 
Dealt to Hero [Qd 3s]
Dealt to 46b22a80 
835eed05: folds
Hero: folds
46b22a80: folds
320aaa96: raises $0.15 to $0.25
42ec9313: folds
6f26ac45: folds
Uncalled bet ($0.15) returned to 320aaa96
*** SHOWDOWN ***
320aaa96 collected $0.25 from pot
*** SUMMARY ***
Total pot $0.25 | Rake $0 | Jackpot $0 | Bingo $0 | Fortune $0 | Tax $0
Seat 1: 320aaa96 (button) collected ($0.25)
Seat 2: 42ec9313 (small blind) folded before Flop
Seat 3: 6f26ac45 (big blind) folded before Flop
Seat 4: 835eed05 folded before Flop (didn't bet)
Seat 5: Hero folded before Flop (didn't bet)
Seat 6: 46b22a80 folded before Flop (didn't bet)


Poker Hand #RC2075602672: Hold'em No Limit ($0.05/$0.1) - 2023/12/21 23:42:04
Table 'RushAndCash302050' 6-max Seat #1 is the button
Seat 1: 42ec9313 ($10.1 in chips)
Seat 2: 1080fc59 ($19.51 in chips)
Seat 3: e6ef7605 ($28.28 in chips)
Seat 4: 8d1f065b ($10.6 in chips)
Seat 5: Hero ($13.15 in chips)
Seat 6: 701efe20 ($10.41 in chips)
1080fc59: posts small blind $0.05
e6ef7605: posts big blind $0.1
*** HOLE CARDS ***
Dealt to 42ec9313 
Dealt to 1080fc59 
Dealt to e6ef7605 
Dealt to 8d1f065b 
Dealt to Hero [Td 4c]
Dealt to 701efe20 
8d1f065b: folds
Hero: folds
701efe20: raises $0.15 to $0.25
42ec9313: folds
1080fc59: raises $0.85 to $1.1
e6ef7605: folds
701efe20: folds
Uncalled bet ($0.85) returned to 1080fc59
*** SHOWDOWN ***
1080fc59 collected $0.57 from pot
*** SUMMARY ***
Total pot $0.6 | Rake $0.03 | Jackpot $0 | Bingo $0 | Fortune $0 | Tax $0
Seat 1: 42ec9313 (button) folded before Flop (didn't bet)
Seat 2: 1080fc59 (small blind) collected ($0.57)
Seat 3: e6ef7605 (big blind) folded before Flop
Seat 4: 8d1f065b folded before Flop (didn't bet)
Seat 5: Hero folded before Flop (didn't bet)
Seat 6: 701efe20 folded before Flop


Poker Hand #RC2075602486: Hold'em No Limit ($0.05/$0.1) - 2023/12/21 23:41:56
Table 'RushAndCash301954' 6-max Seat #1 is the button
Seat 1: f5e3eb2a ($9.64 in chips)
Seat 2: 5dd4c176 ($18.66 in chips)
Seat 3: Hero ($13.25 in chips)
Seat 4: 285e59ea ($14.64 in chips)
Seat 5: 96432614 ($13.67 in chips)
Seat 6: 3d6ee92 ($10.08 in chips)
5dd4c176: posts small blind $0.05
Hero: posts big blind $0.1
*** HOLE CARDS ***
Dealt to f5e3eb2a 
Dealt to 5dd4c176 
Dealt to Hero [7h 3d]
Dealt to 285e59ea 
Dealt to 96432614 
Dealt to 3d6ee92 
285e59ea: raises $0.1 to $0.2
96432614: folds
3d6ee92: folds
f5e3eb2a: folds
5dd4c176: folds
Hero: folds
Uncalled bet ($0.1) returned to 285e59ea
*** SHOWDOWN ***
285e59ea collected $0.25 from pot
*** SUMMARY ***
Total pot $0.25 | Rake $0 | Jackpot $0 | Bingo $0 | Fortune $0 | Tax $0
Seat 1: f5e3eb2a (button) folded before Flop (didn't bet)
Seat 2: 5dd4c176 (small blind) folded before Flop
Seat 3: Hero (big blind) folded before Flop
Seat 4: 285e59ea collected ($0.25)
Seat 5: 96432614 folded before Flop (didn't bet)
Seat 6: 3d6ee92 folded before Flop (didn't bet)


Poker Hand #RC2075602205: Hold'em No Limit ($0.05/$0.1) - 2023/12/21 23:41:44
Table 'RushAndCash301805' 6-max Seat #1 is the button
Seat 1: Hero ($13.25 in chips)
Seat 2: aa0d6009 ($23.05 in chips)
Seat 3: 3b161be4 ($9.47 in chips)
Seat 4: 4c5377e4 ($10 in chips)
Seat 5: 4a98b50f ($21.72 in chips)
Seat 6: 988faf17 ($40.63 in chips)
aa0d6009: posts small blind $0.05
3b161be4: posts big blind $0.1
*** HOLE CARDS ***
Dealt to Hero [5d 5c]
Dealt to aa0d6009 
Dealt to 3b161be4 
Dealt to 4c5377e4 
Dealt to 4a98b50f 
Dealt to 988faf17 
4c5377e4: raises $0.15 to $0.25
4a98b50f: calls $0.25
988faf17: folds
Hero: folds
aa0d6009: calls $0.2
3b161be4: calls $0.15
*** FLOP *** [Ad 5h 4h]
aa0d6009: checks
3b161be4: checks
4c5377e4: checks
4a98b50f: bets $0.5
aa0d6009: raises $2 to $2.5
3b161be4: calls $2.5
4c5377e4: folds
4a98b50f: calls $2
*** TURN *** [Ad 5h 4h] [9h]
aa0d6009: checks
3b161be4: bets $6.72 and is all-in
4a98b50f: folds
aa0d6009: folds
Uncalled bet ($6.72) returned to 3b161be4
*** SHOWDOWN ***
3b161be4 collected $8.05 from pot
*** SUMMARY ***
Total pot $8.5 | Rake $0.3 | Jackpot $0.15 | Bingo $0 | Fortune $0 | Tax $0
Board [Ad 5h 4h 9h]
Seat 1: Hero (button) folded before Flop (didn't bet)
Seat 2: aa0d6009 (small blind) folded on the Turn
Seat 3: 3b161be4 (big blind) won ($8.05)
Seat 4: 4c5377e4 folded on the Flop
Seat 5: 4a98b50f folded on the Turn
Seat 6: 988faf17 folded before Flop (didn't bet)


Poker Hand #RC2075601974: Hold'em No Limit ($0.05/$0.1) - 2023/12/21 23:41:34
Table 'RushAndCash301676' 6-max Seat #1 is the button
Seat 1: 6e680b78 ($11.85 in chips)
Seat 2: Hero ($13.3 in chips)
Seat 3: f4f320ca ($13.1 in chips)
Seat 4: a37412e9 ($14.32 in chips)
Seat 5: f22e4c47 ($10.42 in chips)
Seat 6: 3892cf8a ($13.2 in chips)
Hero: posts small blind $0.05
f4f320ca: posts big blind $0.1
*** HOLE CARDS ***
Dealt to 6e680b78 
Dealt to Hero [Jh 7d]
Dealt to f4f320ca 
Dealt to a37412e9 
Dealt to f22e4c47 
Dealt to 3892cf8a 
a37412e9: folds
f22e4c47: folds
3892cf8a: folds
6e680b78: raises $0.15 to $0.25
Hero: folds
f4f320ca: folds
Uncalled bet ($0.15) returned to 6e680b78
*** SHOWDOWN ***
6e680b78 collected $0.25 from pot
*** SUMMARY ***
Total pot $0.25 | Rake $0 | Jackpot $0 | Bingo $0 | Fortune $0 | Tax $0
Seat 1: 6e680b78 (button) collected ($0.25)
Seat 2: Hero (small blind) folded before Flop
Seat 3: f4f320ca (big blind) folded before Flop
Seat 4: a37412e9 folded before Flop (didn't bet)
Seat 5: f22e4c47 folded before Flop (didn't bet)
Seat 6: 3892cf8a folded before Flop (didn't bet)


Poker Hand #RC2075601323: Hold'em No Limit ($0.05/$0.1) - 2023/12/21 23:41:06
Table 'RushAndCash301306' 6-max Seat #1 is the button
Seat 1: d135650e ($12.46 in chips)
Seat 2: f22e4c47 ($10.47 in chips)
Seat 3: 6e680b78 ($11.48 in chips)
Seat 4: Hero ($13.5 in chips)
Seat 5: 701efe20 ($10.66 in chips)
Seat 6: b9b654c2 ($11.92 in chips)
f22e4c47: posts small blind $0.05
6e680b78: posts big blind $0.1
*** HOLE CARDS ***
Dealt to d135650e 
Dealt to f22e4c47 
Dealt to 6e680b78 
Dealt to Hero [Th Kh]
Dealt to 701efe20 
Dealt to b9b654c2 
Hero: raises $0.1 to $0.2
701efe20: folds
b9b654c2: folds
d135650e: folds
f22e4c47: calls $0.15
6e680b78: calls $0.1
*** FLOP *** [4c 7d 3d]
f22e4c47: checks
6e680b78: checks
Hero: checks
*** TURN *** [4c 7d 3d] [Qh]
f22e4c47: checks
6e680b78: bets $0.45
Hero: folds
f22e4c47: folds
Uncalled bet ($0.45) returned to 6e680b78
*** SHOWDOWN ***
6e680b78 collected $0.57 from pot
*** SUMMARY ***
Total pot $0.6 | Rake $0.03 | Jackpot $0 | Bingo $0 | Fortune $0 | Tax $0
Board [4c 7d 3d Qh]
Seat 1: d135650e (button) folded before Flop (didn't bet)
Seat 2: f22e4c47 (small blind) folded on the Turn
Seat 3: 6e680b78 (big blind) won ($0.57)
Seat 4: Hero folded on the Turn
Seat 5: 701efe20 folded before Flop (didn't bet)
Seat 6: b9b654c2 folded before Flop (didn't bet)


Poker Hand #RC2075600732: Hold'em No Limit ($0.05/$0.1) - 2023/12/21 23:40:42
Table 'RushAndCash300963' 6-max Seat #1 is the button
Seat 1: 344bed61 ($10.35 in chips)
Seat 2: bc69bf06 ($10.1 in chips)
Seat 3: 88436705 ($27.6 in chips)
Seat 4: 96ef3cb ($11.14 in chips)
Seat 5: a8e34387 ($12.31 in chips)
Seat 6: Hero ($13.8 in chips)
bc69bf06: posts small blind $0.05
88436705: posts big blind $0.1
*** HOLE CARDS ***
Dealt to 344bed61 
Dealt to bc69bf06 
Dealt to 88436705 
Dealt to 96ef3cb 
Dealt to a8e34387 
Dealt to Hero [2h 2c]
96ef3cb: folds
a8e34387: raises $0.2 to $0.3
Hero: calls $0.3
344bed61: folds
bc69bf06: folds
88436705: folds
*** FLOP *** [Kc Jd Td]
a8e34387: bets $0.25
Hero: folds
Uncalled bet ($0.25) returned to a8e34387
*** SHOWDOWN ***
a8e34387 collected $0.72 from pot
*** SUMMARY ***
Total pot $0.75 | Rake $0.03 | Jackpot $0 | Bingo $0 | Fortune $0 | Tax $0
Board [Kc Jd Td]
Seat 1: 344bed61 (button) folded before Flop (didn't bet)
Seat 2: bc69bf06 (small blind) folded before Flop
Seat 3: 88436705 (big blind) folded before Flop
Seat 4: 96ef3cb folded before Flop (didn't bet)
Seat 5: a8e34387 won ($0.72)
Seat 6: Hero folded on the Flop


Poker Hand #RC2075600637: Hold'em No Limit ($0.05/$0.1) - 2023/12/21 23:40:38
Table 'RushAndCash300910' 6-max Seat #1 is the button
Seat 1: 80a265e5 ($11.04 in chips)
Seat 2: cc4dc124 ($8.78 in chips)
Seat 3: Hero ($13.9 in chips)
Seat 4: bc69bf06 ($10.1 in chips)
Seat 5: 32e4434f ($10.4 in chips)
Seat 6: a8cfedf9 ($10.84 in chips)
cc4dc124: posts small blind $0.05
Hero: posts big blind $0.1
*** HOLE CARDS ***
Dealt to 80a265e5 
Dealt to cc4dc124 
Dealt to Hero [Ts 6d]
Dealt to bc69bf06 
Dealt to 32e4434f 
Dealt to a8cfedf9 
bc69bf06: folds
32e4434f: folds
a8cfedf9: folds
80a265e5: folds
cc4dc124: raises $0.2 to $0.3
Hero: folds
Uncalled bet ($0.2) returned to cc4dc124
*** SHOWDOWN ***
cc4dc124 collected $0.2 from pot
*** SUMMARY ***
Total pot $0.2 | Rake $0 | Jackpot $0 | Bingo $0 | Fortune $0 | Tax $0
Seat 1: 80a265e5 (button) folded before Flop (didn't bet)
Seat 2: cc4dc124 (small blind) collected ($0.2)
Seat 3: Hero (big blind) folded before Flop
Seat 4: bc69bf06 folded before Flop (didn't bet)
Seat 5: 32e4434f folded before Flop (didn't bet)
Seat 6: a8cfedf9 folded before Flop (didn't bet)


Poker Hand #RC2075600549: Hold'em No Limit ($0.05/$0.1) - 2023/12/21 23:40:34
Table 'RushAndCash300863' 6-max Seat #1 is the button
Seat 1: Hero ($13.9 in chips)
Seat 2: 626eaf5a ($25.35 in chips)
Seat 3: 18f9a329 ($25.46 in chips)
Seat 4: c949dac3 ($20.28 in chips)
Seat 5: e5c25b4a ($12.16 in chips)
Seat 6: 1b4de972 ($15.31 in chips)
626eaf5a: posts small blind $0.05
18f9a329: posts big blind $0.1
*** HOLE CARDS ***
Dealt to Hero [Ad 3h]
Dealt to 626eaf5a 
Dealt to 18f9a329 
Dealt to c949dac3 
Dealt to e5c25b4a 
Dealt to 1b4de972 
c949dac3: folds
e5c25b4a: folds
1b4de972: folds
Hero: folds
626eaf5a: folds
Uncalled bet ($0.05) returned to 18f9a329
*** SHOWDOWN ***
18f9a329 collected $0.1 from pot
*** SUMMARY ***
Total pot $0.1 | Rake $0 | Jackpot $0 | Bingo $0 | Fortune $0 | Tax $0
Seat 1: Hero (button) folded before Flop (didn't bet)
Seat 2: 626eaf5a (small blind) folded before Flop
Seat 3: 18f9a329 (big blind) collected ($0.1)
Seat 4: c949dac3 folded before Flop (didn't bet)
Seat 5: e5c25b4a folded before Flop (didn't bet)
Seat 6: 1b4de972 folded before Flop (didn't bet)


Poker Hand #RC2075600473: Hold'em No Limit ($0.05/$0.1) - 2023/12/21 23:40:30
Table 'RushAndCash300822' 6-max Seat #1 is the button
Seat 1: 4ce89de8 ($10.47 in chips)
Seat 2: ebbff81a ($3.95 in chips)
Seat 3: 7fe627bf ($64.2 in chips)
Seat 4: 7ce7a48e ($11.17 in chips)
Seat 5: Hero ($13.9 in chips)
Seat 6: af8e879e ($16.95 in chips)
ebbff81a: posts small blind $0.05
7fe627bf: posts big blind $0.1
*** HOLE CARDS ***
Dealt to 4ce89de8 
Dealt to ebbff81a 
Dealt to 7fe627bf 
Dealt to 7ce7a48e 
Dealt to Hero [5c Jh]
Dealt to af8e879e 
7ce7a48e: folds
Hero: folds
af8e879e: folds
4ce89de8: folds
ebbff81a: folds
Uncalled bet ($0.05) returned to 7fe627bf
*** SHOWDOWN ***
7fe627bf collected $0.1 from pot
*** SUMMARY ***
Total pot $0.1 | Rake $0 | Jackpot $0 | Bingo $0 | Fortune $0 | Tax $0
Seat 1: 4ce89de8 (button) folded before Flop (didn't bet)
Seat 2: ebbff81a (small blind) folded before Flop
Seat 3: 7fe627bf (big blind) collected ($0.1)
Seat 4: 7ce7a48e folded before Flop (didn't bet)
Seat 5: Hero folded before Flop (didn't bet)
Seat 6: af8e879e folded before Flop (didn't bet)


Poker Hand #RC2075600380: Hold'em No Limit ($0.05/$0.1) - 2023/12/21 23:40:26
Table 'RushAndCash300772' 6-max Seat #1 is the button
Seat 1: 354bc0f1 ($11.29 in chips)
Seat 2: 47678a27 ($10.32 in chips)
Seat 3: 2b0be38a ($12.67 in chips)
Seat 4: Hero ($13.9 in chips)
Seat 5: 866fef18 ($15.48 in chips)
Seat 6: 220d2aa5 ($11.81 in chips)
47678a27: posts small blind $0.05
2b0be38a: posts big blind $0.1
*** HOLE CARDS ***
Dealt to 354bc0f1 
Dealt to 47678a27 
Dealt to 2b0be38a 
Dealt to Hero [As 2c]
Dealt to 866fef18 
Dealt to 220d2aa5 
Hero: folds
866fef18: folds
220d2aa5: folds
354bc0f1: folds
47678a27: folds
Uncalled bet ($0.05) returned to 2b0be38a
*** SHOWDOWN ***
2b0be38a collected $0.1 from pot
*** SUMMARY ***
Total pot $0.1 | Rake $0 | Jackpot $0 | Bingo $0 | Fortune $0 | Tax $0
Seat 1: 354bc0f1 (button) folded before Flop (didn't bet)
Seat 2: 47678a27 (small blind) folded before Flop
Seat 3: 2b0be38a (big blind) collected ($0.1)
Seat 4: Hero folded before Flop (didn't bet)
Seat 5: 866fef18 folded before Flop (didn't bet)
Seat 6: 220d2aa5 folded before Flop (didn't bet)


Poker Hand #RC2075600239: Hold'em No Limit ($0.05/$0.1) - 2023/12/21 23:40:19
Table 'RushAndCash300694' 6-max Seat #1 is the button
Seat 1: 414bf0e1 ($13.81 in chips)
Seat 2: 835eed05 ($17.55 in chips)
Seat 3: 5a7aed9f ($32.94 in chips)
Seat 4: 723d83eb ($20.83 in chips)
Seat 5: Hero ($13.9 in chips)
Seat 6: 6ae577ca ($10.61 in chips)
835eed05: posts small blind $0.05
5a7aed9f: posts big blind $0.1
*** HOLE CARDS ***
Dealt to 414bf0e1 
Dealt to 835eed05 
Dealt to 5a7aed9f 
Dealt to 723d83eb 
Dealt to Hero [2s 3h]
Dealt to 6ae577ca 
723d83eb: raises $0.14 to $0.24
Hero: folds
6ae577ca: folds
414bf0e1: calls $0.24
835eed05: raises $1.06 to $1.3
5a7aed9f: folds
723d83eb: folds
414bf0e1: folds
Uncalled bet ($1.06) returned to 835eed05
*** SHOWDOWN ***
835eed05 collected $0.78 from pot
*** SUMMARY ***
Total pot $0.82 | Rake $0.04 | Jackpot $0 | Bingo $0 | Fortune $0 | Tax $0
Seat 1: 414bf0e1 (button) folded before Flop
Seat 2: 835eed05 (small blind) collected ($0.78)
Seat 3: 5a7aed9f (big blind) folded before Flop
Seat 4: 723d83eb folded before Flop
Seat 5: Hero folded before Flop (didn't bet)
Seat 6: 6ae577ca folded before Flop (didn't bet)


Poker Hand #RC2075600067: Hold'em No Limit ($0.05/$0.1) - 2023/12/21 23:40:12
Table 'RushAndCash300595' 6-max Seat #1 is the button
Seat 1: b7943418 ($10.78 in chips)
Seat 2: Hero ($13.95 in chips)
Seat 3: 7fd44cd7 ($30.87 in chips)
Seat 4: 550a1a33 ($13.49 in chips)
Seat 5: 5ab9056f ($12.21 in chips)
Seat 6: 8eeea9a5 ($35 in chips)
Hero: posts small blind $0.05
7fd44cd7: posts big blind $0.1
*** HOLE CARDS ***
Dealt to b7943418 
Dealt to Hero [6d Ks]
Dealt to 7fd44cd7 
Dealt to 550a1a33 
Dealt to 5ab9056f 
Dealt to 8eeea9a5 
550a1a33: folds
5ab9056f: folds
8eeea9a5: folds
b7943418: raises $0.15 to $0.25
Hero: folds
7fd44cd7: calls $0.15
*** FLOP *** [Jd 7d 2h]
7fd44cd7: checks
b7943418: bets $0.28
7fd44cd7: folds
Uncalled bet ($0.28) returned to b7943418
*** SHOWDOWN ***
b7943418 collected $0.53 from pot
*** SUMMARY ***
Total pot $0.55 | Rake $0.02 | Jackpot $0 | Bingo $0 | Fortune $0 | Tax $0
Board [Jd 7d 2h]
Seat 1: b7943418 (button) won ($0.53)
Seat 2: Hero (small blind) folded before Flop
Seat 3: 7fd44cd7 (big blind) folded on the Flop
Seat 4: 550a1a33 folded before Flop (didn't bet)
Seat 5: 5ab9056f folded before Flop (didn't bet)
Seat 6: 8eeea9a5 folded before Flop (didn't bet)


Poker Hand #RC2075599795: Hold'em No Limit ($0.05/$0.1) - 2023/12/21 23:40:00
Table 'RushAndCash300432' 6-max Seat #1 is the button
Seat 1: f83f639e ($9.46 in chips)
Seat 2: dc070463 ($8.1 in chips)
Seat 3: 1080fc59 ($18.39 in chips)
Seat 4: Hero ($13.95 in chips)
Seat 5: c373bc25 ($10.09 in chips)
Seat 6: cc034b89 ($18.95 in chips)
dc070463: posts small blind $0.05
1080fc59: posts big blind $0.1
*** HOLE CARDS ***
Dealt to f83f639e 
Dealt to dc070463 
Dealt to 1080fc59 
Dealt to Hero [Td 9c]
Dealt to c373bc25 
Dealt to cc034b89 
Hero: folds
c373bc25: folds
cc034b89: raises $0.12 to $0.22
f83f639e: calls $0.22
dc070463: folds
1080fc59: raises $18.17 to $18.39 and is all-in
cc034b89: folds
f83f639e: folds
Uncalled bet ($18.17) returned to 1080fc59
*** SHOWDOWN ***
1080fc59 collected $0.68 from pot
*** SUMMARY ***
Total pot $0.71 | Rake $0.03 | Jackpot $0 | Bingo $0 | Fortune $0 | Tax $0
Seat 1: f83f639e (button) folded before Flop
Seat 2: dc070463 (small blind) folded before Flop
Seat 3: 1080fc59 (big blind) collected ($0.68)
Seat 4: Hero folded before Flop (didn't bet)
Seat 5: c373bc25 folded before Flop (didn't bet)
Seat 6: cc034b89 folded before Flop


Poker Hand #RC2075599636: Hold'em No Limit ($0.05/$0.1) - 2023/12/21 23:39:53
Table 'RushAndCash300339' 6-max Seat #1 is the button
Seat 1: 25a4e10d ($12.49 in chips)
Seat 2: d8d7dbd5 ($12.22 in chips)
Seat 3: Hero ($13.9 in chips)
Seat 4: 4369227d ($10.15 in chips)
Seat 5: cbc7bd10 ($10.92 in chips)
Seat 6: d4949a52 ($10 in chips)
d8d7dbd5: posts small blind $0.05
Hero: posts big blind $0.1
*** HOLE CARDS ***
Dealt to 25a4e10d 
Dealt to d8d7dbd5 
Dealt to Hero [8h Ks]
Dealt to 4369227d 
Dealt to cbc7bd10 
Dealt to d4949a52 
4369227d: folds
cbc7bd10: folds
d4949a52: folds
25a4e10d: folds
d8d7dbd5: folds
Uncalled bet ($0.05) returned to Hero
*** SHOWDOWN ***
Hero collected $0.1 from pot
*** SUMMARY ***
Total pot $0.1 | Rake $0 | Jackpot $0 | Bingo $0 | Fortune $0 | Tax $0
Seat 1: 25a4e10d (button) folded before Flop (didn't bet)
Seat 2: d8d7dbd5 (small blind) folded before Flop
Seat 3: Hero (big blind) collected ($0.1)
Seat 4: 4369227d folded before Flop (didn't bet)
Seat 5: cbc7bd10 folded before Flop (didn't bet)
Seat 6: d4949a52 folded before Flop (didn't bet)


Poker Hand #RC2075599465: Hold'em No Limit ($0.05/$0.1) - 2023/12/21 23:39:46
Table 'RushAndCash300237' 6-max Seat #1 is the button
Seat 1: 3eb1acae ($9.31 in chips)
Seat 2: bfed6b68 ($1.96 in chips)
Seat 3: Hero ($14 in chips)
Seat 4: 512705f5 ($6.91 in chips)
Seat 5: 1e74bd5 ($37.44 in chips)
Seat 6: bba4186b ($10.41 in chips)
bfed6b68: posts small blind $0.05
Hero: posts big blind $0.1
*** HOLE CARDS ***
Dealt to 3eb1acae 
Dealt to bfed6b68 
Dealt to Hero [4s Kc]
Dealt to 512705f5 
Dealt to 1e74bd5 
Dealt to bba4186b 
512705f5: folds
1e74bd5: folds
bba4186b: folds
3eb1acae: raises $0.15 to $0.25
bfed6b68: raises $0.55 to $0.8
Hero: folds
3eb1acae: raises $1.8 to $2.6
bfed6b68: calls $1.16 and is all-in
Uncalled bet ($0.64) returned to 3eb1acae
3eb1acae: shows [Ad Ac]
bfed6b68: shows [Qh As]
*** FLOP *** [6c 4h Kh]
*** TURN *** [6c 4h Kh] [Kd]
*** RIVER *** [6c 4h Kh Kd] [3h]
*** SHOWDOWN ***
3eb1acae collected $3.68 from pot
*** SUMMARY ***
Total pot $4.02 | Rake $0.19 | Jackpot $0.15 | Bingo $0 | Fortune $0 | Tax $0
Board [6c 4h Kh Kd 3h]
Seat 1: 3eb1acae (button) showed [Ad Ac] and won ($3.68) with Pair of Aces and Pair of Kings
Seat 2: bfed6b68 (small blind) showed [Qh As] and lost with Pair of Kings
Seat 3: Hero (big blind) folded before Flop
Seat 4: 512705f5 folded before Flop (didn't bet)
Seat 5: 1e74bd5 folded before Flop (didn't bet)
Seat 6: bba4186b folded before Flop (didn't bet)


Poker Hand #RC2075598498: Hold'em No Limit ($0.05/$0.1) - 2023/12/21 23:39:05
Table 'RushAndCash299681' 6-max Seat #1 is the button
Seat 1: Hero ($14.2 in chips)
Seat 2: be8f622b ($10.17 in chips)
Seat 3: fd119e11 ($10 in chips)
Seat 4: 5ef63e7a ($9.85 in chips)
Seat 5: d2d5dda5 ($7.55 in chips)
Seat 6: 512705f5 ($6.58 in chips)
be8f622b: posts small blind $0.05
fd119e11: posts big blind $0.1
*** HOLE CARDS ***
Dealt to Hero [Kh Qc]
Dealt to be8f622b 
Dealt to fd119e11 
Dealt to 5ef63e7a 
Dealt to d2d5dda5 
Dealt to 512705f5 
5ef63e7a: folds
d2d5dda5: folds
512705f5: raises $0.1 to $0.2
Hero: calls $0.2
be8f622b: folds
fd119e11: folds
*** FLOP *** [Ts 2d 8d]
512705f5: checks
Hero: checks
*** TURN *** [Ts 2d 8d] [5d]
512705f5: checks
Hero: checks
*** RIVER *** [Ts 2d 8d 5d] [Tc]
512705f5: checks
Hero: checks
512705f5: shows [4s As] (Pair of Tens)
Hero: shows [Kh Qc] (Pair of Tens)
*** SHOWDOWN ***
512705f5 collected $0.53 from pot
*** SUMMARY ***
Total pot $0.55 | Rake $0.02 | Jackpot $0 | Bingo $0 | Fortune $0 | Tax $0
Board [Ts 2d 8d 5d Tc]
Seat 1: Hero (button) showed [Kh Qc] and lost with Pair of Tens
Seat 2: be8f622b (small blind) folded before Flop
Seat 3: fd119e11 (big blind) folded before Flop
Seat 4: 5ef63e7a folded before Flop (didn't bet)
Seat 5: d2d5dda5 folded before Flop (didn't bet)
Seat 6: 512705f5 showed [4s As] and won ($0.53) with Pair of Tens


Poker Hand #RC2075598387: Hold'em No Limit ($0.05/$0.1) - 2023/12/21 23:39:00
Table 'RushAndCash299618' 6-max Seat #1 is the button
Seat 1: 51e30a44 ($19.89 in chips)
Seat 2: 1f4c58ca ($10.05 in chips)
Seat 3: 599bfa63 ($12.31 in chips)
Seat 4: Hero ($14.2 in chips)
Seat 5: b695b6df ($43 in chips)
Seat 6: fadc397c ($10.34 in chips)
1f4c58ca: posts small blind $0.05
599bfa63: posts big blind $0.1
*** HOLE CARDS ***
Dealt to 51e30a44 
Dealt to 1f4c58ca 
Dealt to 599bfa63 
Dealt to Hero [5c Qh]
Dealt to b695b6df 
Dealt to fadc397c 
Hero: folds
b695b6df: folds
fadc397c: folds
51e30a44: folds
1f4c58ca: raises $0.3 to $0.4
599bfa63: folds
Uncalled bet ($0.3) returned to 1f4c58ca
*** SHOWDOWN ***
1f4c58ca collected $0.2 from pot
*** SUMMARY ***
Total pot $0.2 | Rake $0 | Jackpot $0 | Bingo $0 | Fortune $0 | Tax $0
Seat 1: 51e30a44 (button) folded before Flop (didn't bet)
Seat 2: 1f4c58ca (small blind) collected ($0.2)
Seat 3: 599bfa63 (big blind) folded before Flop
Seat 4: Hero folded before Flop (didn't bet)
Seat 5: b695b6df folded before Flop (didn't bet)
Seat 6: fadc397c folded before Flop (didn't bet)


Poker Hand #RC2075598284: Hold'em No Limit ($0.05/$0.1) - 2023/12/21 23:38:55
Table 'RushAndCash299562' 6-max Seat #1 is the button
Seat 1: d473227f ($10.56 in chips)
Seat 2: Hero ($14.25 in chips)
Seat 3: 6f725eb5 ($10.76 in chips)
Seat 4: 36d8de0f ($20.28 in chips)
Seat 5: b3d96f83 ($10 in chips)
Seat 6: 56730e2d ($16.88 in chips)
Hero: posts small blind $0.05
6f725eb5: posts big blind $0.1
*** HOLE CARDS ***
Dealt to d473227f 
Dealt to Hero [7s 2c]
Dealt to 6f725eb5 
Dealt to 36d8de0f 
Dealt to b3d96f83 
Dealt to 56730e2d 
36d8de0f: folds
b3d96f83: raises $0.1 to $0.2
56730e2d: folds
d473227f: folds
Hero: folds
6f725eb5: folds
Uncalled bet ($0.1) returned to b3d96f83
*** SHOWDOWN ***
b3d96f83 collected $0.25 from pot
*** SUMMARY ***
Total pot $0.25 | Rake $0 | Jackpot $0 | Bingo $0 | Fortune $0 | Tax $0
Seat 1: d473227f (button) folded before Flop (didn't bet)
Seat 2: Hero (small blind) folded before Flop
Seat 3: 6f725eb5 (big blind) folded before Flop
Seat 4: 36d8de0f folded before Flop (didn't bet)
Seat 5: b3d96f83 collected ($0.25)
Seat 6: 56730e2d folded before Flop (didn't bet)


Poker Hand #RC2075598161: Hold'em No Limit ($0.05/$0.1) - 2023/12/21 23:38:50
Table 'RushAndCash299491' 6-max Seat #1 is the button
Seat 1: Hero ($14.25 in chips)
Seat 2: d473227f ($10.61 in chips)
Seat 3: 988faf17 ($39.77 in chips)
Seat 4: 28d15b39 ($10.7 in chips)
Seat 5: d7b02d48 ($11.26 in chips)
Seat 6: e4a39dd0 ($16.75 in chips)
d473227f: posts small blind $0.05
988faf17: posts big blind $0.1
*** HOLE CARDS ***
Dealt to Hero [3h 9h]
Dealt to d473227f 
Dealt to 988faf17 
Dealt to 28d15b39 
Dealt to d7b02d48 
Dealt to e4a39dd0 
28d15b39: folds
d7b02d48: folds
e4a39dd0: folds
Hero: folds
d473227f: folds
Uncalled bet ($0.05) returned to 988faf17
*** SHOWDOWN ***
988faf17 collected $0.1 from pot
*** SUMMARY ***
Total pot $0.1 | Rake $0 | Jackpot $0 | Bingo $0 | Fortune $0 | Tax $0
Seat 1: Hero (button) folded before Flop (didn't bet)
Seat 2: d473227f (small blind) folded before Flop
Seat 3: 988faf17 (big blind) collected ($0.1)
Seat 4: 28d15b39 folded before Flop (didn't bet)
Seat 5: d7b02d48 folded before Flop (didn't bet)
Seat 6: e4a39dd0 folded before Flop (didn't bet)


Poker Hand #RC2075598045: Hold'em No Limit ($0.05/$0.1) - 2023/12/21 23:38:45
Table 'RushAndCash299425' 6-max Seat #1 is the button
Seat 1: 7fd44cd7 ($30.57 in chips)
Seat 2: Hero ($14.3 in chips)
Seat 3: a377dd30 ($17.94 in chips)
Seat 4: 3e9d02d0 ($10 in chips)
Seat 5: ca39ef1 ($25.11 in chips)
Seat 6: 696644e5 ($12.39 in chips)
Hero: posts small blind $0.05
a377dd30: posts big blind $0.1
*** HOLE CARDS ***
Dealt to 7fd44cd7 
Dealt to Hero [7s 4c]
Dealt to a377dd30 
Dealt to 3e9d02d0 
Dealt to ca39ef1 
Dealt to 696644e5 
3e9d02d0: folds
ca39ef1: folds
696644e5: folds
7fd44cd7: folds
Hero: folds
Uncalled bet ($0.05) returned to a377dd30
*** SHOWDOWN ***
a377dd30 collected $0.1 from pot
*** SUMMARY ***
Total pot $0.1 | Rake $0 | Jackpot $0 | Bingo $0 | Fortune $0 | Tax $0
Seat 1: 7fd44cd7 (button) folded before Flop (didn't bet)
Seat 2: Hero (small blind) folded before Flop
Seat 3: a377dd30 (big blind) collected ($0.1)
Seat 4: 3e9d02d0 folded before Flop (didn't bet)
Seat 5: ca39ef1 folded before Flop (didn't bet)
Seat 6: 696644e5 folded before Flop (didn't bet)


Poker Hand #RC2075597341: Hold'em No Limit ($0.05/$0.1) - 2023/12/21 23:38:14
Table 'RushAndCash299030' 6-max Seat #1 is the button
Seat 1: a377dd30 ($18.56 in chips)
Seat 2: fe7ba3a6 ($8.9 in chips)
Seat 3: 6e2681d5 ($13.89 in chips)
Seat 4: 4a1ee628 ($6.33 in chips)
Seat 5: 3f3ce363 ($10.09 in chips)
Seat 6: Hero ($13.6 in chips)
fe7ba3a6: posts small blind $0.05
6e2681d5: posts big blind $0.1
*** HOLE CARDS ***
Dealt to a377dd30 
Dealt to fe7ba3a6 
Dealt to 6e2681d5 
Dealt to 4a1ee628 
Dealt to 3f3ce363 
Dealt to Hero [Ac 4c]
4a1ee628: folds
3f3ce363: folds
Hero: raises $0.1 to $0.2
a377dd30: raises $0.42 to $0.62
fe7ba3a6: folds
6e2681d5: folds
Hero: raises $1.25 to $1.87
a377dd30: folds
Uncalled bet ($1.25) returned to Hero
*** SHOWDOWN ***
Hero collected $1.32 from pot
*** SUMMARY ***
Total pot $1.39 | Rake $0.07 | Jackpot $0 | Bingo $0 | Fortune $0 | Tax $0
Seat 1: a377dd30 (button) folded before Flop
Seat 2: fe7ba3a6 (small blind) folded before Flop
Seat 3: 6e2681d5 (big blind) folded before Flop
Seat 4: 4a1ee628 folded before Flop (didn't bet)
Seat 5: 3f3ce363 folded before Flop (didn't bet)
Seat 6: Hero collected ($1.32)


Poker Hand #RC2075596534: Hold'em No Limit ($0.05/$0.1) - 2023/12/21 23:37:38
Table 'RushAndCash298567' 6-max Seat #1 is the button
Seat 1: c87aa6bf ($15.77 in chips)
Seat 2: e65abf6f ($11.98 in chips)
Seat 3: 2fb0491b ($10.62 in chips)
Seat 4: b0f10ea2 ($9.85 in chips)
Seat 5: 1bcbba55 ($10 in chips)
Seat 6: Hero ($13.23 in chips)
e65abf6f: posts small blind $0.05
2fb0491b: posts big blind $0.1
*** HOLE CARDS ***
Dealt to c87aa6bf 
Dealt to e65abf6f 
Dealt to 2fb0491b 
Dealt to b0f10ea2 
Dealt to 1bcbba55 
Dealt to Hero [Ad 6d]
b0f10ea2: folds
1bcbba55: raises $0.15 to $0.25
Hero: raises $0.75 to $1
c87aa6bf: folds
e65abf6f: folds
2fb0491b: folds
1bcbba55: folds
Uncalled bet ($0.75) returned to Hero
*** SHOWDOWN ***
Hero collected $0.62 from pot
*** SUMMARY ***
Total pot $0.65 | Rake $0.03 | Jackpot $0 | Bingo $0 | Fortune $0 | Tax $0
Seat 1: c87aa6bf (button) folded before Flop (didn't bet)
Seat 2: e65abf6f (small blind) folded before Flop
Seat 3: 2fb0491b (big blind) folded before Flop
Seat 4: b0f10ea2 folded before Flop (didn't bet)
Seat 5: 1bcbba55 folded before Flop
Seat 6: Hero collected ($0.62)


Poker Hand #RC2075596400: Hold'em No Limit ($0.05/$0.1) - 2023/12/21 23:37:32
Table 'RushAndCash298492' 6-max Seat #1 is the button
Seat 1: Hero ($13.23 in chips)
Seat 2: 72b6a9a0 ($3.64 in chips)
Seat 3: 25c08dc8 ($3.65 in chips)
Seat 4: dbc67535 ($10.33 in chips)
Seat 5: 3b161be4 ($9.95 in chips)
Seat 6: 391c843f ($36.23 in chips)
72b6a9a0: posts small blind $0.05
25c08dc8: posts big blind $0.1
*** HOLE CARDS ***
Dealt to Hero [7h Tc]
Dealt to 72b6a9a0 
Dealt to 25c08dc8 
Dealt to dbc67535 
Dealt to 3b161be4 
Dealt to 391c843f 
dbc67535: folds
3b161be4: folds
391c843f: raises $0.1 to $0.2
Hero: folds
72b6a9a0: calls $0.15
25c08dc8: raises $0.6 to $0.8
391c843f: folds
72b6a9a0: folds
Uncalled bet ($0.6) returned to 25c08dc8
*** SHOWDOWN ***
25c08dc8 collected $0.57 from pot
*** SUMMARY ***
Total pot $0.6 | Rake $0.03 | Jackpot $0 | Bingo $0 | Fortune $0 | Tax $0
Seat 1: Hero (button) folded before Flop (didn't bet)
Seat 2: 72b6a9a0 (small blind) folded before Flop
Seat 3: 25c08dc8 (big blind) collected ($0.57)
Seat 4: dbc67535 folded before Flop (didn't bet)
Seat 5: 3b161be4 folded before Flop (didn't bet)
Seat 6: 391c843f folded before Flop


Poker Hand #RC2075596325: Hold'em No Limit ($0.05/$0.1) - 2023/12/21 23:37:29
Table 'RushAndCash298450' 6-max Seat #1 is the button
Seat 1: f89a8725 ($15.47 in chips)
Seat 2: a3dd2069 ($12.44 in chips)
Seat 3: d7fea7e5 ($13.74 in chips)
Seat 4: 15699fcc ($10.14 in chips)
Seat 5: Hero ($13.23 in chips)
Seat 6: a56ebe0c ($26.11 in chips)
a3dd2069: posts small blind $0.05
d7fea7e5: posts big blind $0.1
*** HOLE CARDS ***
Dealt to f89a8725 
Dealt to a3dd2069 
Dealt to d7fea7e5 
Dealt to 15699fcc 
Dealt to Hero [Qd 8c]
Dealt to a56ebe0c 
15699fcc: folds
Hero: folds
a56ebe0c: folds
f89a8725: folds
a3dd2069: raises $0.2 to $0.3
d7fea7e5: folds
Uncalled bet ($0.2) returned to a3dd2069
*** SHOWDOWN ***
a3dd2069 collected $0.2 from pot
*** SUMMARY ***
Total pot $0.2 | Rake $0 | Jackpot $0 | Bingo $0 | Fortune $0 | Tax $0
Seat 1: f89a8725 (button) folded before Flop (didn't bet)
Seat 2: a3dd2069 (small blind) collected ($0.2)
Seat 3: d7fea7e5 (big blind) folded before Flop
Seat 4: 15699fcc folded before Flop (didn't bet)
Seat 5: Hero folded before Flop (didn't bet)
Seat 6: a56ebe0c folded before Flop (didn't bet)


Poker Hand #RC2075596210: Hold'em No Limit ($0.05/$0.1) - 2023/12/21 23:37:24
Table 'RushAndCash298386' 6-max Seat #1 is the button
Seat 1: ff572048 ($7.14 in chips)
Seat 2: 92d95b97 ($12.01 in chips)
Seat 3: 8bffd3fd ($14.53 in chips)
Seat 4: 24c6e84e ($10 in chips)
Seat 5: Hero ($13.23 in chips)
Seat 6: 17b4b3dc ($5.85 in chips)
92d95b97: posts small blind $0.05
8bffd3fd: posts big blind $0.1
*** HOLE CARDS ***
Dealt to ff572048 
Dealt to 92d95b97 
Dealt to 8bffd3fd 
Dealt to 24c6e84e 
Dealt to Hero [7c 4c]
Dealt to 17b4b3dc 
24c6e84e: folds
Hero: folds
17b4b3dc: raises $0.2 to $0.3
ff572048: folds
92d95b97: folds
8bffd3fd: folds
Uncalled bet ($0.2) returned to 17b4b3dc
*** SHOWDOWN ***
17b4b3dc collected $0.25 from pot
*** SUMMARY ***
Total pot $0.25 | Rake $0 | Jackpot $0 | Bingo $0 | Fortune $0 | Tax $0
Seat 1: ff572048 (button) folded before Flop (didn't bet)
Seat 2: 92d95b97 (small blind) folded before Flop
Seat 3: 8bffd3fd (big blind) folded before Flop
Seat 4: 24c6e84e folded before Flop (didn't bet)
Seat 5: Hero folded before Flop (didn't bet)
Seat 6: 17b4b3dc collected ($0.25)


Poker Hand #RC2075596009: Hold'em No Limit ($0.05/$0.1) - 2023/12/21 23:37:15
Table 'RushAndCash298268' 6-max Seat #1 is the button
Seat 1: a9ea3fe3 ($10.97 in chips)
Seat 2: 5d172986 ($12.85 in chips)
Seat 3: Hero ($13.33 in chips)
Seat 4: c07c4200 ($14.29 in chips)
Seat 5: 1f60f6b4 ($14.86 in chips)
Seat 6: 4d5f8c4f ($11 in chips)
5d172986: posts small blind $0.05
Hero: posts big blind $0.1
*** HOLE CARDS ***
Dealt to a9ea3fe3 
Dealt to 5d172986 
Dealt to Hero [7c 5c]
Dealt to c07c4200 
Dealt to 1f60f6b4 
Dealt to 4d5f8c4f 
c07c4200: folds
1f60f6b4: folds
4d5f8c4f: folds
a9ea3fe3: raises $0.2 to $0.3
5d172986: folds
Hero: folds
Uncalled bet ($0.2) returned to a9ea3fe3
*** SHOWDOWN ***
a9ea3fe3 collected $0.25 from pot
*** SUMMARY ***
Total pot $0.25 | Rake $0 | Jackpot $0 | Bingo $0 | Fortune $0 | Tax $0
Seat 1: a9ea3fe3 (button) collected ($0.25)
Seat 2: 5d172986 (small blind) folded before Flop
Seat 3: Hero (big blind) folded before Flop
Seat 4: c07c4200 folded before Flop (didn't bet)
Seat 5: 1f60f6b4 folded before Flop (didn't bet)
Seat 6: 4d5f8c4f folded before Flop (didn't bet)


Poker Hand #RC2075595878: Hold'em No Limit ($0.05/$0.1) - 2023/12/21 23:37:09
Table 'RushAndCash298193' 6-max Seat #1 is the button
Seat 1: 1fa4f905 ($13.06 in chips)
Seat 2: caf9a75 ($22.9 in chips)
Seat 3: 283a352f ($10 in chips)
Seat 4: Hero ($13.33 in chips)
Seat 5: 2b0be38a ($12.86 in chips)
Seat 6: 1bcbba55 ($10.15 in chips)
caf9a75: posts small blind $0.05
283a352f: posts big blind $0.1
*** HOLE CARDS ***
Dealt to 1fa4f905 
Dealt to caf9a75 
Dealt to 283a352f 
Dealt to Hero [4c 8d]
Dealt to 2b0be38a 
Dealt to 1bcbba55 
Hero: folds
2b0be38a: folds
1bcbba55: folds
1fa4f905: folds
caf9a75: folds
Uncalled bet ($0.05) returned to 283a352f
*** SHOWDOWN ***
283a352f collected $0.1 from pot
*** SUMMARY ***
Total pot $0.1 | Rake $0 | Jackpot $0 | Bingo $0 | Fortune $0 | Tax $0
Seat 1: 1fa4f905 (button) folded before Flop (didn't bet)
Seat 2: caf9a75 (small blind) folded before Flop
Seat 3: 283a352f (big blind) collected ($0.1)
Seat 4: Hero folded before Flop (didn't bet)
Seat 5: 2b0be38a folded before Flop (didn't bet)
Seat 6: 1bcbba55 folded before Flop (didn't bet)


Poker Hand #RC2075595745: Hold'em No Limit ($0.05/$0.1) - 2023/12/21 23:37:03
Table 'RushAndCash298119' 6-max Seat #1 is the button
Seat 1: 4f95ff1c ($13.4 in chips)
Seat 2: d4949a52 ($10 in chips)
Seat 3: d8212adf ($35.05 in chips)
Seat 4: Hero ($13.33 in chips)
Seat 5: 796cbdba ($10 in chips)
Seat 6: 47678a27 ($10 in chips)
d4949a52: posts small blind $0.05
d8212adf: posts big blind $0.1
*** HOLE CARDS ***
Dealt to 4f95ff1c 
Dealt to d4949a52 
Dealt to d8212adf 
Dealt to Hero [4c 7h]
Dealt to 796cbdba 
Dealt to 47678a27 
Hero: folds
796cbdba: folds
47678a27: raises $0.1 to $0.2
4f95ff1c: raises $0.6 to $0.8
d4949a52: raises $9.2 to $10 and is all-in
d8212adf: folds
47678a27: folds
4f95ff1c: calls $9.2
d4949a52: shows [Ac Ks]
4f95ff1c: shows [Kd As]
*** FLOP *** [Qs Td Kc]
*** TURN *** [Qs Td Kc] [4h]
*** RIVER *** [Qs Td Kc 4h] [3c]
*** SHOWDOWN ***
4f95ff1c collected $9.92 from pot
d4949a52 collected $9.93 from pot
*** SUMMARY ***
Total pot $20.3 | Rake $0.3 | Jackpot $0.15 | Bingo $0 | Fortune $0 | Tax $0
Board [Qs Td Kc 4h 3c]
Seat 1: 4f95ff1c (button) showed [Kd As] and won ($9.92) with Pair of Kings
Seat 2: d4949a52 (small blind) showed [Ac Ks] and won ($9.93) with Pair of Kings
Seat 3: d8212adf (big blind) folded before Flop
Seat 4: Hero folded before Flop (didn't bet)
Seat 5: 796cbdba folded before Flop (didn't bet)
Seat 6: 47678a27 folded before Flop


Poker Hand #RC2075595606: Hold'em No Limit ($0.05/$0.1) - 2023/12/21 23:36:57
Table 'RushAndCash298039' 6-max Seat #1 is the button
Seat 1: Hero ($13.33 in chips)
Seat 2: 6e680b78 ($10.05 in chips)
Seat 3: 2e9f052c ($14.33 in chips)
Seat 4: eb16ca9a ($30.59 in chips)
Seat 5: 9b8a916d ($9.95 in chips)
Seat 6: 4703e6e2 ($12.89 in chips)
6e680b78: posts small blind $0.05
2e9f052c: posts big blind $0.1
*** HOLE CARDS ***
Dealt to Hero [2c 7c]
Dealt to 6e680b78 
Dealt to 2e9f052c 
Dealt to eb16ca9a 
Dealt to 9b8a916d 
Dealt to 4703e6e2 
eb16ca9a: raises $0.13 to $0.23
9b8a916d: folds
4703e6e2: calls $0.23
Hero: folds
6e680b78: folds
2e9f052c: folds
*** FLOP *** [6s Qh 2d]
eb16ca9a: bets $0.32
4703e6e2: folds
Uncalled bet ($0.32) returned to eb16ca9a
*** SHOWDOWN ***
eb16ca9a collected $0.58 from pot
*** SUMMARY ***
Total pot $0.61 | Rake $0.03 | Jackpot $0 | Bingo $0 | Fortune $0 | Tax $0
Board [6s Qh 2d]
Seat 1: Hero (button) folded before Flop (didn't bet)
Seat 2: 6e680b78 (small blind) folded before Flop
Seat 3: 2e9f052c (big blind) folded before Flop
Seat 4: eb16ca9a won ($0.58)
Seat 5: 9b8a916d folded before Flop (didn't bet)
Seat 6: 4703e6e2 folded on the Flop


Poker Hand #RC2075595345: Hold'em No Limit ($0.05/$0.1) - 2023/12/21 23:36:45
Table 'RushAndCash297889' 6-max Seat #1 is the button
Seat 1: 5a167ff9 ($6.4 in chips)
Seat 2: 22c92514 ($10.93 in chips)
Seat 3: 5992ab97 ($10.22 in chips)
Seat 4: 1816bbd5 ($21.78 in chips)
Seat 5: f4ad4c17 ($21.01 in chips)
Seat 6: Hero ($13.33 in chips)
22c92514: posts small blind $0.05
5992ab97: posts big blind $0.1
*** HOLE CARDS ***
Dealt to 5a167ff9 
Dealt to 22c92514 
Dealt to 5992ab97 
Dealt to 1816bbd5 
Dealt to f4ad4c17 
Dealt to Hero [Jh Tc]
1816bbd5: raises $0.1 to $0.2
f4ad4c17: folds
Hero: folds
5a167ff9: folds
22c92514: folds
5992ab97: folds
Uncalled bet ($0.1) returned to 1816bbd5
*** SHOWDOWN ***
1816bbd5 collected $0.25 from pot
*** SUMMARY ***
Total pot $0.25 | Rake $0 | Jackpot $0 | Bingo $0 | Fortune $0 | Tax $0
Seat 1: 5a167ff9 (button) folded before Flop (didn't bet)
Seat 2: 22c92514 (small blind) folded before Flop
Seat 3: 5992ab97 (big blind) folded before Flop
Seat 4: 1816bbd5 collected ($0.25)
Seat 5: f4ad4c17 folded before Flop (didn't bet)
Seat 6: Hero folded before Flop (didn't bet)


Poker Hand #RC2075595244: Hold'em No Limit ($0.05/$0.1) - 2023/12/21 23:36:41
Table 'RushAndCash297833' 6-max Seat #1 is the button
Seat 1: b7959b4f ($10.15 in chips)
Seat 2: deaad42c ($8.69 in chips)
Seat 3: Hero ($13.43 in chips)
Seat 4: d473227f ($10 in chips)
Seat 5: e5c25b4a ($12.66 in chips)
Seat 6: 291fe735 ($11.76 in chips)
deaad42c: posts small blind $0.05
Hero: posts big blind $0.1
*** HOLE CARDS ***
Dealt to b7959b4f 
Dealt to deaad42c 
Dealt to Hero [7h 8d]
Dealt to d473227f 
Dealt to e5c25b4a 
Dealt to 291fe735 
d473227f: folds
e5c25b4a: folds
291fe735: raises $0.15 to $0.25
b7959b4f: folds
deaad42c: folds
Hero: folds
Uncalled bet ($0.15) returned to 291fe735
*** SHOWDOWN ***
291fe735 collected $0.25 from pot
*** SUMMARY ***
Total pot $0.25 | Rake $0 | Jackpot $0 | Bingo $0 | Fortune $0 | Tax $0
Seat 1: b7959b4f (button) folded before Flop (didn't bet)
Seat 2: deaad42c (small blind) folded before Flop
Seat 3: Hero (big blind) folded before Flop
Seat 4: d473227f folded before Flop (didn't bet)
Seat 5: e5c25b4a folded before Flop (didn't bet)
Seat 6: 291fe735 collected ($0.25)


Poker Hand #RC2075595164: Hold'em No Limit ($0.05/$0.1) - 2023/12/21 23:36:37
Table 'RushAndCash297786' 6-max Seat #1 is the button
Seat 1: 950b0368 ($20.77 in chips)
Seat 2: b7959b4f ($10.2 in chips)
Seat 3: 329a57d7 ($29.67 in chips)
Seat 4: d473227f ($10 in chips)
Seat 5: Hero ($13.43 in chips)
Seat 6: afa229e0 ($7.46 in chips)
b7959b4f: posts small blind $0.05
329a57d7: posts big blind $0.1
*** HOLE CARDS ***
Dealt to 950b0368 
Dealt to b7959b4f 
Dealt to 329a57d7 
Dealt to d473227f 
Dealt to Hero [8d Jh]
Dealt to afa229e0 
d473227f: folds
Hero: folds
afa229e0: folds
950b0368: folds
b7959b4f: folds
Uncalled bet ($0.05) returned to 329a57d7
*** SHOWDOWN ***
329a57d7 collected $0.1 from pot
*** SUMMARY ***
Total pot $0.1 | Rake $0 | Jackpot $0 | Bingo $0 | Fortune $0 | Tax $0
Seat 1: 950b0368 (button) folded before Flop (didn't bet)
Seat 2: b7959b4f (small blind) folded before Flop
Seat 3: 329a57d7 (big blind) collected ($0.1)
Seat 4: d473227f folded before Flop (didn't bet)
Seat 5: Hero folded before Flop (didn't bet)
Seat 6: afa229e0 folded before Flop (didn't bet)


Poker Hand #RC2075595053: Hold'em No Limit ($0.05/$0.1) - 2023/12/21 23:36:33
Table 'RushAndCash297721' 6-max Seat #1 is the button
Seat 1: 96721776 ($11.18 in chips)
Seat 2: Hero ($13.48 in chips)
Seat 3: 2e959b01 ($11.88 in chips)
Seat 4: f6a330f5 ($16.6 in chips)
Seat 5: 273a60ae ($19.59 in chips)
Seat 6: c949dac3 ($19.62 in chips)
Hero: posts small blind $0.05
2e959b01: posts big blind $0.1
*** HOLE CARDS ***
Dealt to 96721776 
Dealt to Hero [4d 8c]
Dealt to 2e959b01 
Dealt to f6a330f5 
Dealt to 273a60ae 
Dealt to c949dac3 
f6a330f5: raises $0.15 to $0.25
273a60ae: folds
c949dac3: raises $0.49 to $0.74
96721776: folds
Hero: folds
2e959b01: folds
f6a330f5: calls $0.49
*** FLOP *** [4c Ad 5d]
f6a330f5: checks
c949dac3: checks
*** TURN *** [4c Ad 5d] [6c]
f6a330f5: checks
c949dac3: bets $1.75
f6a330f5: folds
Uncalled bet ($1.75) returned to c949dac3
*** SHOWDOWN ***
c949dac3 collected $1.55 from pot
*** SUMMARY ***
Total pot $1.63 | Rake $0.08 | Jackpot $0 | Bingo $0 | Fortune $0 | Tax $0
Board [4c Ad 5d 6c]
Seat 1: 96721776 (button) folded before Flop (didn't bet)
Seat 2: Hero (small blind) folded before Flop
Seat 3: 2e959b01 (big blind) folded before Flop
Seat 4: f6a330f5 folded on the Turn
Seat 5: 273a60ae folded before Flop (didn't bet)
Seat 6: c949dac3 won ($1.55)


Poker Hand #RC2075594960: Hold'em No Limit ($0.05/$0.1) - 2023/12/21 23:36:29
Table 'RushAndCash297665' 6-max Seat #1 is the button
Seat 1: eaf71731 ($20.8 in chips)
Seat 2: dd84fd1b ($10 in chips)
Seat 3: b8105230 ($12.16 in chips)
Seat 4: 33d2b8fc ($30.06 in chips)
Seat 5: 43a8aa03 ($15.41 in chips)
Seat 6: Hero ($13.48 in chips)
dd84fd1b: posts small blind $0.05
b8105230: posts big blind $0.1
*** HOLE CARDS ***
Dealt to eaf71731 
Dealt to dd84fd1b 
Dealt to b8105230 
Dealt to 33d2b8fc 
Dealt to 43a8aa03 
Dealt to Hero [5c 8c]
33d2b8fc: folds
43a8aa03: raises $0.2 to $0.3
Hero: folds
eaf71731: folds
dd84fd1b: folds
b8105230: folds
Uncalled bet ($0.2) returned to 43a8aa03
*** SHOWDOWN ***
43a8aa03 collected $0.25 from pot
*** SUMMARY ***
Total pot $0.25 | Rake $0 | Jackpot $0 | Bingo $0 | Fortune $0 | Tax $0
Seat 1: eaf71731 (button) folded before Flop (didn't bet)
Seat 2: dd84fd1b (small blind) folded before Flop
Seat 3: b8105230 (big blind) folded before Flop
Seat 4: 33d2b8fc folded before Flop (didn't bet)
Seat 5: 43a8aa03 collected ($0.25)
Seat 6: Hero folded before Flop (didn't bet)


Poker Hand #RC2075594885: Hold'em No Limit ($0.05/$0.1) - 2023/12/21 23:36:26
Table 'RushAndCash297620' 6-max Seat #1 is the button
Seat 1: 43a8aa03 ($15.41 in chips)
Seat 2: Hero ($13.53 in chips)
Seat 3: 362f4bf3 ($12.55 in chips)
Seat 4: dd84fd1b ($10 in chips)
Seat 5: 15103267 ($10.3 in chips)
Seat 6: b79ccabb ($11.39 in chips)
Hero: posts small blind $0.05
362f4bf3: posts big blind $0.1
*** HOLE CARDS ***
Dealt to 43a8aa03 
Dealt to Hero [7s Qd]
Dealt to 362f4bf3 
Dealt to dd84fd1b 
Dealt to 15103267 
Dealt to b79ccabb 
dd84fd1b: folds
15103267: folds
b79ccabb: folds
43a8aa03: folds
Hero: folds
Uncalled bet ($0.05) returned to 362f4bf3
*** SHOWDOWN ***
362f4bf3 collected $0.1 from pot
*** SUMMARY ***
Total pot $0.1 | Rake $0 | Jackpot $0 | Bingo $0 | Fortune $0 | Tax $0
Seat 1: 43a8aa03 (button) folded before Flop (didn't bet)
Seat 2: Hero (small blind) folded before Flop
Seat 3: 362f4bf3 (big blind) collected ($0.1)
Seat 4: dd84fd1b folded before Flop (didn't bet)
Seat 5: 15103267 folded before Flop (didn't bet)
Seat 6: b79ccabb folded before Flop (didn't bet)


Poker Hand #RC2075594783: Hold'em No Limit ($0.05/$0.1) - 2023/12/21 23:36:21
Table 'RushAndCash297561' 6-max Seat #1 is the button
Seat 1: Hero ($13.53 in chips)
Seat 2: 9df027a7 ($11.2 in chips)
Seat 3: 5e617a08 ($11.82 in chips)
Seat 4: 6f725eb5 ($11.18 in chips)
Seat 5: 3e2719f9 ($20.64 in chips)
Seat 6: 5a167ff9 ($6.55 in chips)
9df027a7: posts small blind $0.05
5e617a08: posts big blind $0.1
*** HOLE CARDS ***
Dealt to Hero [3c Ks]
Dealt to 9df027a7 
Dealt to 5e617a08 
Dealt to 6f725eb5 
Dealt to 3e2719f9 
Dealt to 5a167ff9 
6f725eb5: raises $0.1 to $0.2
3e2719f9: folds
5a167ff9: folds
Hero: folds
9df027a7: folds
5e617a08: folds
Uncalled bet ($0.1) returned to 6f725eb5
*** SHOWDOWN ***
6f725eb5 collected $0.25 from pot
*** SUMMARY ***
Total pot $0.25 | Rake $0 | Jackpot $0 | Bingo $0 | Fortune $0 | Tax $0
Seat 1: Hero (button) folded before Flop (didn't bet)
Seat 2: 9df027a7 (small blind) folded before Flop
Seat 3: 5e617a08 (big blind) folded before Flop
Seat 4: 6f725eb5 collected ($0.25)
Seat 5: 3e2719f9 folded before Flop (didn't bet)
Seat 6: 5a167ff9 folded before Flop (didn't bet)


Poker Hand #RC2075584680: Hold'em No Limit ($0.05/$0.1) - 2023/12/21 23:36:16
Table 'RushAndCash297495' 6-max Seat #1 is the button
Seat 1: e0b74dd7 ($37.23 in chips)
Seat 2: b7959b4f ($10.35 in chips)
Seat 3: Hero ($13.63 in chips)
Seat 4: cf27fc93 ($11.15 in chips)
Seat 5: 256d833 ($6.44 in chips)
Seat 6: 69a3e403 ($10.52 in chips)
b7959b4f: posts small blind $0.05
Hero: posts big blind $0.1
*** HOLE CARDS ***
Dealt to e0b74dd7 
Dealt to b7959b4f 
Dealt to Hero [Qs 7c]
Dealt to cf27fc93 
Dealt to 256d833 
Dealt to 69a3e403 
cf27fc93: folds
256d833: raises $0.1 to $0.2
69a3e403: folds
e0b74dd7: raises $0.55 to $0.75
b7959b4f: folds
Hero: folds
256d833: calls $0.55
*** FLOP *** [Ts Js 2c]
256d833: checks
e0b74dd7: checks
*** TURN *** [Ts Js 2c] [6s]
256d833: bets $1.24
e0b74dd7: calls $1.24
*** RIVER *** [Ts Js 2c 6s] [3s]
256d833: bets $3
e0b74dd7: raises $3 to $6
256d833: calls $1.45 and is all-in
Uncalled bet ($1.55) returned to e0b74dd7
e0b74dd7: shows [5s As] (Ace High Flush)
256d833: shows [9h Ks] (King High Flush)
*** SHOWDOWN ***
e0b74dd7 collected $12.58 from pot
*** SUMMARY ***
Total pot $13.03 | Rake $0.3 | Jackpot $0.15 | Bingo $0 | Fortune $0 | Tax $0
Board [Ts Js 2c 6s 3s]
Seat 1: e0b74dd7 (button) showed [5s As] and won ($12.58) with Ace High Flush
Seat 2: b7959b4f (small blind) folded before Flop
Seat 3: Hero (big blind) folded before Flop
Seat 4: cf27fc93 folded before Flop (didn't bet)
Seat 5: 256d833 showed [9h Ks] and lost with King High Flush
Seat 6: 69a3e403 folded before Flop (didn't bet)


Poker Hand #RC2075584595: Hold'em No Limit ($0.05/$0.1) - 2023/12/21 23:36:12
Table 'RushAndCash297440' 6-max Seat #1 is the button
Seat 1: 7539525b ($10.68 in chips)
Seat 2: fd721595 ($11.52 in chips)
Seat 3: ba2c88e ($10 in chips)
Seat 4: 3b544772 ($13.8 in chips)
Seat 5: 2e164fe9 ($14.06 in chips)
Seat 6: Hero ($13.63 in chips)
fd721595: posts small blind $0.05
ba2c88e: posts big blind $0.1
*** HOLE CARDS ***
Dealt to 7539525b 
Dealt to fd721595 
Dealt to ba2c88e 
Dealt to 3b544772 
Dealt to 2e164fe9 
Dealt to Hero [Ts 5h]
3b544772: raises $0.15 to $0.25
2e164fe9: raises $0.5 to $0.75
Hero: folds
7539525b: folds
fd721595: folds
ba2c88e: folds
3b544772: calls $0.5
*** FLOP *** [Jd 9d Qc]
3b544772: checks
2e164fe9: checks
*** TURN *** [Jd 9d Qc] [Ac]
3b544772: checks
2e164fe9: bets $0.55
3b544772: calls $0.55
*** RIVER *** [Jd 9d Qc Ac] [Jh]
3b544772: checks
2e164fe9: checks
3b544772: shows [Js Ks] (Three Jacks)
2e164fe9: shows [Ah 2h] (Pair of Aces and Pair of Jacks)
*** SHOWDOWN ***
3b544772 collected $2.62 from pot
*** SUMMARY ***
Total pot $2.75 | Rake $0.13 | Jackpot $0 | Bingo $0 | Fortune $0 | Tax $0
Board [Jd 9d Qc Ac Jh]
Seat 1: 7539525b (button) folded before Flop (didn't bet)
Seat 2: fd721595 (small blind) folded before Flop
Seat 3: ba2c88e (big blind) folded before Flop
Seat 4: 3b544772 showed [Js Ks] and won ($2.62) with Three Jacks
Seat 5: 2e164fe9 showed [Ah 2h] and lost with Pair of Aces and Pair of Jacks
Seat 6: Hero folded before Flop (didn't bet)


Poker Hand #RC2075584443: Hold'em No Limit ($0.05/$0.1) - 2023/12/21 23:36:05
Table 'RushAndCash297348' 6-max Seat #1 is the button
Seat 1: b0f2c17b ($12.2 in chips)
Seat 2: Hero ($13.68 in chips)
Seat 3: 7f563768 ($23.51 in chips)
Seat 4: dae3a72f ($10.17 in chips)
Seat 5: bba4186b ($7.78 in chips)
Seat 6: aadda150 ($25.94 in chips)
Hero: posts small blind $0.05
7f563768: posts big blind $0.1
*** HOLE CARDS ***
Dealt to b0f2c17b 
Dealt to Hero [3s Tc]
Dealt to 7f563768 
Dealt to dae3a72f 
Dealt to bba4186b 
Dealt to aadda150 
dae3a72f: raises $0.1 to $0.2
bba4186b: folds
aadda150: folds
b0f2c17b: folds
Hero: folds
7f563768: folds
Uncalled bet ($0.1) returned to dae3a72f
*** SHOWDOWN ***
dae3a72f collected $0.25 from pot
*** SUMMARY ***
Total pot $0.25 | Rake $0 | Jackpot $0 | Bingo $0 | Fortune $0 | Tax $0
Seat 1: b0f2c17b (button) folded before Flop (didn't bet)
Seat 2: Hero (small blind) folded before Flop
Seat 3: 7f563768 (big blind) folded before Flop
Seat 4: dae3a72f collected ($0.25)
Seat 5: bba4186b folded before Flop (didn't bet)
Seat 6: aadda150 folded before Flop (didn't bet)


Poker Hand #RC2075584258: Hold'em No Limit ($0.05/$0.1) - 2023/12/21 23:35:57
Table 'RushAndCash297244' 6-max Seat #1 is the button
Seat 1: e32fa9f2 ($12.82 in chips)
Seat 2: 679c1bc5 ($9.48 in chips)
Seat 3: 2939d766 ($9.95 in chips)
Seat 4: d8958743 ($24.03 in chips)
Seat 5: 5b0ddb11 ($10 in chips)
Seat 6: Hero ($13.68 in chips)
679c1bc5: posts small blind $0.05
2939d766: posts big blind $0.1
*** HOLE CARDS ***
Dealt to e32fa9f2 
Dealt to 679c1bc5 
Dealt to 2939d766 
Dealt to d8958743 
Dealt to 5b0ddb11 
Dealt to Hero [4s Ac]
d8958743: folds
5b0ddb11: raises $0.1 to $0.2
Hero: folds
e32fa9f2: folds
679c1bc5: folds
2939d766: folds
Uncalled bet ($0.1) returned to 5b0ddb11
*** SHOWDOWN ***
5b0ddb11 collected $0.25 from pot
*** SUMMARY ***
Total pot $0.25 | Rake $0 | Jackpot $0 | Bingo $0 | Fortune $0 | Tax $0
Seat 1: e32fa9f2 (button) folded before Flop (didn't bet)
Seat 2: 679c1bc5 (small blind) folded before Flop
Seat 3: 2939d766 (big blind) folded before Flop
Seat 4: d8958743 folded before Flop (didn't bet)
Seat 5: 5b0ddb11 collected ($0.25)
Seat 6: Hero folded before Flop (didn't bet)


Poker Hand #RC2075584102: Hold'em No Limit ($0.05/$0.1) - 2023/12/21 23:35:50
Table 'RushAndCash297156' 6-max Seat #1 is the button
Seat 1: Hero ($13.68 in chips)
Seat 2: 4661efa1 ($11.48 in chips)
Seat 3: 6e20c9c3 ($12.4 in chips)
Seat 4: f6051b97 ($12.12 in chips)
Seat 5: 8f692637 ($10 in chips)
Seat 6: 243279ca ($10 in chips)
4661efa1: posts small blind $0.05
6e20c9c3: posts big blind $0.1
*** HOLE CARDS ***
Dealt to Hero [5c 3c]
Dealt to 4661efa1 
Dealt to 6e20c9c3 
Dealt to f6051b97 
Dealt to 8f692637 
Dealt to 243279ca 
f6051b97: folds
8f692637: folds
243279ca: folds
Hero: folds
4661efa1: folds
Uncalled bet ($0.05) returned to 6e20c9c3
*** SHOWDOWN ***
6e20c9c3 collected $0.1 from pot
*** SUMMARY ***
Total pot $0.1 | Rake $0 | Jackpot $0 | Bingo $0 | Fortune $0 | Tax $0
Seat 1: Hero (button) folded before Flop (didn't bet)
Seat 2: 4661efa1 (small blind) folded before Flop
Seat 3: 6e20c9c3 (big blind) collected ($0.1)
Seat 4: f6051b97 folded before Flop (didn't bet)
Seat 5: 8f692637 folded before Flop (didn't bet)
Seat 6: 243279ca folded before Flop (didn't bet)


Poker Hand #RC2075583896: Hold'em No Limit ($0.05/$0.1) - 2023/12/21 23:35:42
Table 'RushAndCash297041' 6-max Seat #1 is the button
Seat 1: 31c6bc43 ($5.97 in chips)
Seat 2: ade497b9 ($10 in chips)
Seat 3: 2db4abd4 ($11.64 in chips)
Seat 4: Hero ($13.68 in chips)
Seat 5: caf9a75 ($22.82 in chips)
Seat 6: 5ab39b42 ($10.22 in chips)
ade497b9: posts small blind $0.05
2db4abd4: posts big blind $0.1
*** HOLE CARDS ***
Dealt to 31c6bc43 
Dealt to ade497b9 
Dealt to 2db4abd4 
Dealt to Hero [Tc 7c]
Dealt to caf9a75 
Dealt to 5ab39b42 
Hero: folds
caf9a75: folds
5ab39b42: folds
31c6bc43: raises $0.2 to $0.3
ade497b9: folds
2db4abd4: folds
Uncalled bet ($0.2) returned to 31c6bc43
*** SHOWDOWN ***
31c6bc43 collected $0.25 from pot
*** SUMMARY ***
Total pot $0.25 | Rake $0 | Jackpot $0 | Bingo $0 | Fortune $0 | Tax $0
Seat 1: 31c6bc43 (button) collected ($0.25)
Seat 2: ade497b9 (small blind) folded before Flop
Seat 3: 2db4abd4 (big blind) folded before Flop
Seat 4: Hero folded before Flop (didn't bet)
Seat 5: caf9a75 folded before Flop (didn't bet)
Seat 6: 5ab39b42 folded before Flop (didn't bet)


Poker Hand #RC2075582734: Hold'em No Limit ($0.05/$0.1) - 2023/12/21 23:34:52
Table 'RushAndCash296383' 6-max Seat #1 is the button
Seat 1: df7b97b2 ($10 in chips)
Seat 2: 31c6bc43 ($5.18 in chips)
Seat 3: Hero ($14.31 in chips)
Seat 4: 5ab39b42 ($10.47 in chips)
Seat 5: ce81fa61 ($6.76 in chips)
Seat 6: f401f958 ($10.99 in chips)
31c6bc43: posts small blind $0.05
Hero: posts big blind $0.1
*** HOLE CARDS ***
Dealt to df7b97b2 
Dealt to 31c6bc43 
Dealt to Hero [9d Jd]
Dealt to 5ab39b42 
Dealt to ce81fa61 
Dealt to f401f958 
5ab39b42: raises $0.15 to $0.25
ce81fa61: folds
f401f958: folds
df7b97b2: folds
31c6bc43: calls $0.2
Hero: calls $0.15
*** FLOP *** [5c 2s 8c]
31c6bc43: checks
Hero: checks
5ab39b42: checks
*** TURN *** [5c 2s 8c] [9c]
31c6bc43: bets $0.38
Hero: calls $0.38
5ab39b42: folds
*** RIVER *** [5c 2s 8c 9c] [3s]
31c6bc43: bets $0.8
Hero: folds
Uncalled bet ($0.8) returned to 31c6bc43
*** SHOWDOWN ***
31c6bc43 collected $1.42 from pot
*** SUMMARY ***
Total pot $1.51 | Rake $0.09 | Jackpot $0 | Bingo $0 | Fortune $0 | Tax $0
Board [5c 2s 8c 9c 3s]
Seat 1: df7b97b2 (button) folded before Flop (didn't bet)
Seat 2: 31c6bc43 (small blind) won ($1.42)
Seat 3: Hero (big blind) folded on the River
Seat 4: 5ab39b42 folded on the Turn
Seat 5: ce81fa61 folded before Flop (didn't bet)
Seat 6: f401f958 folded before Flop (didn't bet)


Poker Hand #RC2075581828: Hold'em No Limit ($0.05/$0.1) - 2023/12/21 23:34:13
Table 'RushAndCash295848' 6-max Seat #1 is the button
Seat 1: 3089b429 ($27.03 in chips)
Seat 2: 26203563 ($13.21 in chips)
Seat 3: 31c6bc43 ($5.38 in chips)
Seat 4: a7e691c9 ($13.41 in chips)
Seat 5: Hero ($14.08 in chips)
Seat 6: f10afb5d ($13.5 in chips)
26203563: posts small blind $0.05
31c6bc43: posts big blind $0.1
*** HOLE CARDS ***
Dealt to 3089b429 
Dealt to 26203563 
Dealt to 31c6bc43 
Dealt to a7e691c9 
Dealt to Hero [Jd Jh]
Dealt to f10afb5d 
a7e691c9: folds
Hero: raises $0.1 to $0.2
f10afb5d: folds
3089b429: folds
26203563: folds
31c6bc43: calls $0.1
*** FLOP *** [3s Kc Qd]
31c6bc43: checks
Hero: checks
*** TURN *** [3s Kc Qd] [8h]
31c6bc43: checks
Hero: checks
*** RIVER *** [3s Kc Qd 8h] [4s]
31c6bc43: checks
Hero: checks
31c6bc43: shows [Js Th] (King-High)
Hero: shows [Jd Jh] (Pair of Jacks)
*** SHOWDOWN ***
Hero collected $0.43 from pot
*** SUMMARY ***
Total pot $0.45 | Rake $0.02 | Jackpot $0 | Bingo $0 | Fortune $0 | Tax $0
Board [3s Kc Qd 8h 4s]
Seat 1: 3089b429 (button) folded before Flop (didn't bet)
Seat 2: 26203563 (small blind) folded before Flop
Seat 3: 31c6bc43 (big blind) showed [Js Th] and lost with King-High
Seat 4: a7e691c9 folded before Flop (didn't bet)
Seat 5: Hero showed [Jd Jh] and won ($0.43) with Pair of Jacks
Seat 6: f10afb5d folded before Flop (didn't bet)


Poker Hand #RC2075581728: Hold'em No Limit ($0.05/$0.1) - 2023/12/21 23:34:09
Table 'RushAndCash295791' 6-max Seat #1 is the button
Seat 1: df309ad0 ($10.37 in chips)
Seat 2: 6905cf61 ($4.28 in chips)
Seat 3: 3a7412a7 ($11.57 in chips)
Seat 4: 21484a5 ($5.68 in chips)
Seat 5: dd69db1b ($11.32 in chips)
Seat 6: Hero ($14.08 in chips)
6905cf61: posts small blind $0.05
3a7412a7: posts big blind $0.1
*** HOLE CARDS ***
Dealt to df309ad0 
Dealt to 6905cf61 
Dealt to 3a7412a7 
Dealt to 21484a5 
Dealt to dd69db1b 
Dealt to Hero [Qc 6s]
21484a5: raises $0.1 to $0.2
dd69db1b: folds
Hero: folds
df309ad0: folds
6905cf61: folds
3a7412a7: folds
Uncalled bet ($0.1) returned to 21484a5
*** SHOWDOWN ***
21484a5 collected $0.25 from pot
*** SUMMARY ***
Total pot $0.25 | Rake $0 | Jackpot $0 | Bingo $0 | Fortune $0 | Tax $0
Seat 1: df309ad0 (button) folded before Flop (didn't bet)
Seat 2: 6905cf61 (small blind) folded before Flop
Seat 3: 3a7412a7 (big blind) folded before Flop
Seat 4: 21484a5 collected ($0.25)
Seat 5: dd69db1b folded before Flop (didn't bet)
Seat 6: Hero folded before Flop (didn't bet)


Poker Hand #RC2075581622: Hold'em No Limit ($0.05/$0.1) - 2023/12/21 23:34:04
Table 'RushAndCash295733' 6-max Seat #1 is the button
Seat 1: f6f7c205 ($12.88 in chips)
Seat 2: 2c2c64b ($27.46 in chips)
Seat 3: f3ec2670 ($10 in chips)
Seat 4: eb48a647 ($11.19 in chips)
Seat 5: 45e373d9 ($19.92 in chips)
Seat 6: Hero ($14.08 in chips)
2c2c64b: posts small blind $0.05
f3ec2670: posts big blind $0.1
*** HOLE CARDS ***
Dealt to f6f7c205 
Dealt to 2c2c64b 
Dealt to f3ec2670 
Dealt to eb48a647 
Dealt to 45e373d9 
Dealt to Hero [4h 9s]
eb48a647: raises $0.1 to $0.2
45e373d9: folds
Hero: folds
f6f7c205: folds
2c2c64b: folds
f3ec2670: folds
Uncalled bet ($0.1) returned to eb48a647
*** SHOWDOWN ***
eb48a647 collected $0.25 from pot
*** SUMMARY ***
Total pot $0.25 | Rake $0 | Jackpot $0 | Bingo $0 | Fortune $0 | Tax $0
Seat 1: f6f7c205 (button) folded before Flop (didn't bet)
Seat 2: 2c2c64b (small blind) folded before Flop
Seat 3: f3ec2670 (big blind) folded before Flop
Seat 4: eb48a647 collected ($0.25)
Seat 5: 45e373d9 folded before Flop (didn't bet)
Seat 6: Hero folded before Flop (didn't bet)


Poker Hand #RC2075581517: Hold'em No Limit ($0.05/$0.1) - 2023/12/21 23:34:00
Table 'RushAndCash295673' 6-max Seat #1 is the button
Seat 1: 48585871 ($11.83 in chips)
Seat 2: 30675df0 ($35.07 in chips)
Seat 3: Hero ($14.18 in chips)
Seat 4: 40428c85 ($16.84 in chips)
Seat 5: 354bc0f1 ($10.15 in chips)
Seat 6: 31924eb3 ($19.7 in chips)
30675df0: posts small blind $0.05
Hero: posts big blind $0.1
*** HOLE CARDS ***
Dealt to 48585871 
Dealt to 30675df0 
Dealt to Hero [5c 7s]
Dealt to 40428c85 
Dealt to 354bc0f1 
Dealt to 31924eb3 
40428c85: folds
354bc0f1: folds
31924eb3: raises $0.15 to $0.25
48585871: folds
30675df0: folds
Hero: folds
Uncalled bet ($0.15) returned to 31924eb3
*** SHOWDOWN ***
31924eb3 collected $0.25 from pot
*** SUMMARY ***
Total pot $0.25 | Rake $0 | Jackpot $0 | Bingo $0 | Fortune $0 | Tax $0
Seat 1: 48585871 (button) folded before Flop (didn't bet)
Seat 2: 30675df0 (small blind) folded before Flop
Seat 3: Hero (big blind) folded before Flop
Seat 4: 40428c85 folded before Flop (didn't bet)
Seat 5: 354bc0f1 folded before Flop (didn't bet)
Seat 6: 31924eb3 collected ($0.25)


Poker Hand #RC2075581425: Hold'em No Limit ($0.05/$0.1) - 2023/12/21 23:33:56
Table 'RushAndCash295621' 6-max Seat #1 is the button
Seat 1: Hero ($14.18 in chips)
Seat 2: ab187254 ($21.29 in chips)
Seat 3: 56602784 ($11.99 in chips)
Seat 4: 4f13ac3b ($11.03 in chips)
Seat 5: a618b3f0 ($6.76 in chips)
Seat 6: 430d4eb8 ($10.52 in chips)
ab187254: posts small blind $0.05
56602784: posts big blind $0.1
*** HOLE CARDS ***
Dealt to Hero [6c 2s]
Dealt to ab187254 
Dealt to 56602784 
Dealt to 4f13ac3b 
Dealt to a618b3f0 
Dealt to 430d4eb8 
4f13ac3b: folds
a618b3f0: folds
430d4eb8: folds
Hero: folds
ab187254: raises $0.2 to $0.3
56602784: calls $0.2
*** FLOP *** [Jd 9c 5d]
ab187254: checks
56602784: bets $0.3
ab187254: folds
Uncalled bet ($0.3) returned to 56602784
*** SHOWDOWN ***
56602784 collected $0.57 from pot
*** SUMMARY ***
Total pot $0.6 | Rake $0.03 | Jackpot $0 | Bingo $0 | Fortune $0 | Tax $0
Board [Jd 9c 5d]
Seat 1: Hero (button) folded before Flop (didn't bet)
Seat 2: ab187254 (small blind) folded on the Flop
Seat 3: 56602784 (big blind) won ($0.57)
Seat 4: 4f13ac3b folded before Flop (didn't bet)
Seat 5: a618b3f0 folded before Flop (didn't bet)
Seat 6: 430d4eb8 folded before Flop (didn't bet)


Poker Hand #RC2075580725: Hold'em No Limit ($0.05/$0.1) - 2023/12/21 23:33:27
Table 'RushAndCash295217' 6-max Seat #1 is the button
Seat 1: 2c0aeb87 ($47.91 in chips)
Seat 2: Hero ($14.68 in chips)
Seat 3: 540c7fb5 ($3.3 in chips)
Seat 4: e043dc53 ($11.24 in chips)
Seat 5: 6e6fec39 ($16.82 in chips)
Seat 6: f0421476 ($6.18 in chips)
Hero: posts small blind $0.05
540c7fb5: posts big blind $0.1
*** HOLE CARDS ***
Dealt to 2c0aeb87 
Dealt to Hero [9c Ac]
Dealt to 540c7fb5 
Dealt to e043dc53 
Dealt to 6e6fec39 
Dealt to f0421476 
e043dc53: raises $0.1 to $0.2
6e6fec39: folds
f0421476: folds
2c0aeb87: folds
Hero: calls $0.15
540c7fb5: calls $0.1
*** FLOP *** [3h Kh Jc]
Hero: checks
540c7fb5: checks
e043dc53: bets $0.3
Hero: calls $0.3
540c7fb5: calls $0.3
*** TURN *** [3h Kh Jc] [Kd]
Hero: checks
540c7fb5: bets $0.5
e043dc53: calls $0.5
Hero: folds
*** RIVER *** [3h Kh Jc Kd] [Qc]
540c7fb5: bets $0.83
e043dc53: raises $5.2 to $6.03
540c7fb5: folds
Uncalled bet ($5.2) returned to e043dc53
*** SHOWDOWN ***
e043dc53 collected $3.81 from pot
*** SUMMARY ***
Total pot $4.16 | Rake $0.2 | Jackpot $0.15 | Bingo $0 | Fortune $0 | Tax $0
Board [3h Kh Jc Kd Qc]
Seat 1: 2c0aeb87 (button) folded before Flop (didn't bet)
Seat 2: Hero (small blind) folded on the Turn
Seat 3: 540c7fb5 (big blind) folded on the River
Seat 4: e043dc53 won ($3.81)
Seat 5: 6e6fec39 folded before Flop (didn't bet)
Seat 6: f0421476 folded before Flop (didn't bet)


Poker Hand #RC2075580638: Hold'em No Limit ($0.05/$0.1) - 2023/12/21 23:33:23
Table 'RushAndCash295168' 6-max Seat #1 is the button
Seat 1: bc69bf06 ($11.21 in chips)
Seat 2: b882ee6 ($13.2 in chips)
Seat 3: 503d5038 ($35.28 in chips)
Seat 4: Hero ($14.68 in chips)
Seat 5: 7b9adc2 ($10 in chips)
Seat 6: f6f7c205 ($13.08 in chips)
b882ee6: posts small blind $0.05
503d5038: posts big blind $0.1
*** HOLE CARDS ***
Dealt to bc69bf06 
Dealt to b882ee6 
Dealt to 503d5038 
Dealt to Hero [Th 9s]
Dealt to 7b9adc2 
Dealt to f6f7c205 
Hero: folds
7b9adc2: folds
f6f7c205: folds
bc69bf06: folds
b882ee6: folds
Uncalled bet ($0.05) returned to 503d5038
*** SHOWDOWN ***
503d5038 collected $0.1 from pot
*** SUMMARY ***
Total pot $0.1 | Rake $0 | Jackpot $0 | Bingo $0 | Fortune $0 | Tax $0
Seat 1: bc69bf06 (button) folded before Flop (didn't bet)
Seat 2: b882ee6 (small blind) folded before Flop
Seat 3: 503d5038 (big blind) collected ($0.1)
Seat 4: Hero folded before Flop (didn't bet)
Seat 5: 7b9adc2 folded before Flop (didn't bet)
Seat 6: f6f7c205 folded before Flop (didn't bet)


Poker Hand #RC2075579276: Hold'em No Limit ($0.05/$0.1) - 2023/12/21 23:32:25
Table 'RushAndCash294385' 6-max Seat #1 is the button
Seat 1: 503d5038 ($34.1 in chips)
Seat 2: 1f60f6b4 ($11.34 in chips)
Seat 3: e205620a ($18.64 in chips)
Seat 4: 719ceb6 ($10.4 in chips)
Seat 5: 782f63eb ($13.1 in chips)
Seat 6: Hero ($15.83 in chips)
1f60f6b4: posts small blind $0.05
e205620a: posts big blind $0.1
*** HOLE CARDS ***
Dealt to 503d5038 
Dealt to 1f60f6b4 
Dealt to e205620a 
Dealt to 719ceb6 
Dealt to 782f63eb 
Dealt to Hero [Ac 4c]
719ceb6: folds
782f63eb: folds
Hero: raises $0.1 to $0.2
503d5038: calls $0.2
1f60f6b4: folds
e205620a: folds
*** FLOP *** [Js 6h 7c]
Hero: checks
503d5038: checks
*** TURN *** [Js 6h 7c] [5c]
Hero: checks
503d5038: bets $0.95
Hero: calls $0.95
*** RIVER *** [Js 6h 7c 5c] [Ah]
Hero: checks
503d5038: bets $3.4
Hero: folds
Uncalled bet ($3.4) returned to 503d5038
*** SHOWDOWN ***
503d5038 collected $2.33 from pot
*** SUMMARY ***
Total pot $2.45 | Rake $0.12 | Jackpot $0 | Bingo $0 | Fortune $0 | Tax $0
Board [Js 6h 7c 5c Ah]
Seat 1: 503d5038 (button) won ($2.33)
Seat 2: 1f60f6b4 (small blind) folded before Flop
Seat 3: e205620a (big blind) folded before Flop
Seat 4: 719ceb6 folded before Flop (didn't bet)
Seat 5: 782f63eb folded before Flop (didn't bet)
Seat 6: Hero folded on the River


Poker Hand #RC2075579126: Hold'em No Limit ($0.05/$0.1) - 2023/12/21 23:32:19
Table 'RushAndCash294300' 6-max Seat #1 is the button
Seat 1: 93a4ad46 ($13.47 in chips)
Seat 2: 8a752503 ($23.3 in chips)
Seat 3: 9c562155 ($10 in chips)
Seat 4: bd0bb645 ($5.32 in chips)
Seat 5: Hero ($15.83 in chips)
Seat 6: b942c546 ($10 in chips)
8a752503: posts small blind $0.05
9c562155: posts big blind $0.1
*** HOLE CARDS ***
Dealt to 93a4ad46 
Dealt to 8a752503 
Dealt to 9c562155 
Dealt to bd0bb645 
Dealt to Hero [Tc 2h]
Dealt to b942c546 
bd0bb645: folds
Hero: folds
b942c546: folds
93a4ad46: folds
8a752503: folds
Uncalled bet ($0.05) returned to 9c562155
*** SHOWDOWN ***
9c562155 collected $0.1 from pot
*** SUMMARY ***
Total pot $0.1 | Rake $0 | Jackpot $0 | Bingo $0 | Fortune $0 | Tax $0
Seat 1: 93a4ad46 (button) folded before Flop (didn't bet)
Seat 2: 8a752503 (small blind) folded before Flop
Seat 3: 9c562155 (big blind) collected ($0.1)
Seat 4: bd0bb645 folded before Flop (didn't bet)
Seat 5: Hero folded before Flop (didn't bet)
Seat 6: b942c546 folded before Flop (didn't bet)


Poker Hand #RC2075578878: Hold'em No Limit ($0.05/$0.1) - 2023/12/21 23:32:07
Table 'RushAndCash294164' 6-max Seat #1 is the button
Seat 1: e303078c ($11.62 in chips)
Seat 2: 4a1ee628 ($6.87 in chips)
Seat 3: Hero ($15.93 in chips)
Seat 4: e568a613 ($19.59 in chips)
Seat 5: 9bc3a2f3 ($10.16 in chips)
Seat 6: 71677e1b ($45.35 in chips)
4a1ee628: posts small blind $0.05
Hero: posts big blind $0.1
*** HOLE CARDS ***
Dealt to e303078c 
Dealt to 4a1ee628 
Dealt to Hero [9c 2d]
Dealt to e568a613 
Dealt to 9bc3a2f3 
Dealt to 71677e1b 
e568a613: raises $0.15 to $0.25
9bc3a2f3: folds
71677e1b: folds
e303078c: folds
4a1ee628: folds
Hero: folds
Uncalled bet ($0.15) returned to e568a613
*** SHOWDOWN ***
e568a613 collected $0.25 from pot
*** SUMMARY ***
Total pot $0.25 | Rake $0 | Jackpot $0 | Bingo $0 | Fortune $0 | Tax $0
Seat 1: e303078c (button) folded before Flop (didn't bet)
Seat 2: 4a1ee628 (small blind) folded before Flop
Seat 3: Hero (big blind) folded before Flop
Seat 4: e568a613 collected ($0.25)
Seat 5: 9bc3a2f3 folded before Flop (didn't bet)
Seat 6: 71677e1b folded before Flop (didn't bet)


Poker Hand #RC2075578787: Hold'em No Limit ($0.05/$0.1) - 2023/12/21 23:32:03
Table 'RushAndCash294111' 6-max Seat #1 is the button
Seat 1: 7ddc107 ($12.92 in chips)
Seat 2: afd0eb43 ($10.55 in chips)
Seat 3: 1fa4f905 ($7.29 in chips)
Seat 4: Hero ($15.93 in chips)
Seat 5: e4426deb ($9.59 in chips)
Seat 6: af8e879e ($23.21 in chips)
afd0eb43: posts small blind $0.05
1fa4f905: posts big blind $0.1
*** HOLE CARDS ***
Dealt to 7ddc107 
Dealt to afd0eb43 
Dealt to 1fa4f905 
Dealt to Hero [5h Ad]
Dealt to e4426deb 
Dealt to af8e879e 
Hero: folds
e4426deb: raises $0.15 to $0.25
af8e879e: folds
7ddc107: folds
afd0eb43: raises $0.55 to $0.8
1fa4f905: calls $0.7
e4426deb: calls $0.55
*** FLOP *** [Qh 7d 4c]
afd0eb43: bets $0.9
1fa4f905: calls $0.9
e4426deb: folds
*** TURN *** [Qh 7d 4c] [Th]
afd0eb43: checks
1fa4f905: checks
*** RIVER *** [Qh 7d 4c Th] [Qc]
afd0eb43: checks
1fa4f905: bets $2.2
afd0eb43: calls $2.2
1fa4f905: shows [Qs Ks] (Three Queens)
afd0eb43: shows [Jc Jd] (Pair of Queens and Pair of Jacks)
*** SHOWDOWN ***
1fa4f905 collected $8.15 from pot
*** SUMMARY ***
Total pot $8.6 | Rake $0.3 | Jackpot $0.15 | Bingo $0 | Fortune $0 | Tax $0
Board [Qh 7d 4c Th Qc]
Seat 1: 7ddc107 (button) folded before Flop (didn't bet)
Seat 2: afd0eb43 (small blind) showed [Jc Jd] and lost with Pair of Queens and Pair of Jacks
Seat 3: 1fa4f905 (big blind) showed [Qs Ks] and won ($8.15) with Three Queens
Seat 4: Hero folded before Flop (didn't bet)
Seat 5: e4426deb folded on the Flop
Seat 6: af8e879e folded before Flop (didn't bet)


Poker Hand #RC2075578689: Hold'em No Limit ($0.05/$0.1) - 2023/12/21 23:31:59
Table 'RushAndCash294055' 6-max Seat #1 is the button
Seat 1: Hero ($15.93 in chips)
Seat 2: 696644e5 ($13.17 in chips)
Seat 3: f7053607 ($10 in chips)
Seat 4: 3ef96e15 ($8.8 in chips)
Seat 5: 4d3be08a ($16.14 in chips)
Seat 6: 5cb9d1d7 ($10 in chips)
696644e5: posts small blind $0.05
f7053607: posts big blind $0.1
*** HOLE CARDS ***
Dealt to Hero [3c Kd]
Dealt to 696644e5 
Dealt to f7053607 
Dealt to 3ef96e15 
Dealt to 4d3be08a 
Dealt to 5cb9d1d7 
3ef96e15: folds
4d3be08a: raises $0.15 to $0.25
5cb9d1d7: folds
Hero: folds
696644e5: folds
f7053607: folds
Uncalled bet ($0.15) returned to 4d3be08a
*** SHOWDOWN ***
4d3be08a collected $0.25 from pot
*** SUMMARY ***
Total pot $0.25 | Rake $0 | Jackpot $0 | Bingo $0 | Fortune $0 | Tax $0
Seat 1: Hero (button) folded before Flop (didn't bet)
Seat 2: 696644e5 (small blind) folded before Flop
Seat 3: f7053607 (big blind) folded before Flop
Seat 4: 3ef96e15 folded before Flop (didn't bet)
Seat 5: 4d3be08a collected ($0.25)
Seat 6: 5cb9d1d7 folded before Flop (didn't bet)


Poker Hand #RC2075578417: Hold'em No Limit ($0.05/$0.1) - 2023/12/21 23:31:48
Table 'RushAndCash293904' 6-max Seat #1 is the button
Seat 1: 2859beab ($29.07 in chips)
Seat 2: Hero ($15.98 in chips)
Seat 3: 3c5defae ($11.59 in chips)
Seat 4: 3c99e01f ($9.78 in chips)
Seat 5: 354bc0f1 ($10.3 in chips)
Seat 6: 59d570ce ($15.61 in chips)
Hero: posts small blind $0.05
3c5defae: posts big blind $0.1
*** HOLE CARDS ***
Dealt to 2859beab 
Dealt to Hero [7d Js]
Dealt to 3c5defae 
Dealt to 3c99e01f 
Dealt to 354bc0f1 
Dealt to 59d570ce 
3c99e01f: folds
354bc0f1: folds
59d570ce: folds
2859beab: folds
Hero: folds
Uncalled bet ($0.05) returned to 3c5defae
*** SHOWDOWN ***
3c5defae collected $0.1 from pot
*** SUMMARY ***
Total pot $0.1 | Rake $0 | Jackpot $0 | Bingo $0 | Fortune $0 | Tax $0
Seat 1: 2859beab (button) folded before Flop (didn't bet)
Seat 2: Hero (small blind) folded before Flop
Seat 3: 3c5defae (big blind) collected ($0.1)
Seat 4: 3c99e01f folded before Flop (didn't bet)
Seat 5: 354bc0f1 folded before Flop (didn't bet)
Seat 6: 59d570ce folded before Flop (didn't bet)


Poker Hand #RC2075578260: Hold'em No Limit ($0.05/$0.1) - 2023/12/21 23:31:41
Table 'RushAndCash293811' 6-max Seat #1 is the button
Seat 1: 904d4419 ($6.11 in chips)
Seat 2: f616323e ($20.31 in chips)
Seat 3: caace5a7 ($10 in chips)
Seat 4: 93a4ad46 ($13.47 in chips)
Seat 5: 92ab9934 ($6.42 in chips)
Seat 6: Hero ($15.98 in chips)
f616323e: posts small blind $0.05
caace5a7: posts big blind $0.1
*** HOLE CARDS ***
Dealt to 904d4419 
Dealt to f616323e 
Dealt to caace5a7 
Dealt to 93a4ad46 
Dealt to 92ab9934 
Dealt to Hero [8d 7d]
93a4ad46: folds
92ab9934: folds
Hero: folds
904d4419: calls $0.1
f616323e: folds
caace5a7: checks
*** FLOP *** [Qd 8h 7s]
caace5a7: checks
904d4419: checks
*** TURN *** [Qd 8h 7s] [Ah]
caace5a7: checks
904d4419: checks
*** RIVER *** [Qd 8h 7s Ah] [6s]
caace5a7: checks
904d4419: bets $0.19
caace5a7: folds
Uncalled bet ($0.19) returned to 904d4419
*** SHOWDOWN ***
904d4419 collected $0.24 from pot
*** SUMMARY ***
Total pot $0.25 | Rake $0.01 | Jackpot $0 | Bingo $0 | Fortune $0 | Tax $0
Board [Qd 8h 7s Ah 6s]
Seat 1: 904d4419 (button) won ($0.24)
Seat 2: f616323e (small blind) folded before Flop
Seat 3: caace5a7 (big blind) folded on the River
Seat 4: 93a4ad46 folded before Flop (didn't bet)
Seat 5: 92ab9934 folded before Flop (didn't bet)
Seat 6: Hero folded before Flop (didn't bet)


Poker Hand #RC2075578028: Hold'em No Limit ($0.05/$0.1) - 2023/12/21 23:31:31
Table 'RushAndCash293675' 6-max Seat #1 is the button
Seat 1: 5b57c126 ($10.72 in chips)
Seat 2: Hero ($15.88 in chips)
Seat 3: 98881624 ($11.52 in chips)
Seat 4: 387a6e45 ($6.62 in chips)
Seat 5: 55a6af7c ($9.76 in chips)
Seat 6: 70c222e3 ($36.06 in chips)
Hero: posts small blind $0.05
98881624: posts big blind $0.1
*** HOLE CARDS ***
Dealt to 5b57c126 
Dealt to Hero [2h Jh]
Dealt to 98881624 
Dealt to 387a6e45 
Dealt to 55a6af7c 
Dealt to 70c222e3 
387a6e45: folds
55a6af7c: folds
70c222e3: folds
5b57c126: folds
Hero: raises $0.2 to $0.3
98881624: folds
Uncalled bet ($0.2) returned to Hero
*** SHOWDOWN ***
Hero collected $0.2 from pot
*** SUMMARY ***
Total pot $0.2 | Rake $0 | Jackpot $0 | Bingo $0 | Fortune $0 | Tax $0
Seat 1: 5b57c126 (button) folded before Flop (didn't bet)
Seat 2: Hero (small blind) collected ($0.2)
Seat 3: 98881624 (big blind) folded before Flop
Seat 4: 387a6e45 folded before Flop (didn't bet)
Seat 5: 55a6af7c folded before Flop (didn't bet)
Seat 6: 70c222e3 folded before Flop (didn't bet)


Poker Hand #RC2075577938: Hold'em No Limit ($0.05/$0.1) - 2023/12/21 23:31:26
Table 'RushAndCash293626' 6-max Seat #1 is the button
Seat 1: b445bdd1 ($29.49 in chips)
Seat 2: 701efe20 ($11.15 in chips)
Seat 3: b3320195 ($10.52 in chips)
Seat 4: Hero ($15.88 in chips)
Seat 5: b14398ca ($16.99 in chips)
Seat 6: e752a7fd ($10 in chips)
701efe20: posts small blind $0.05
b3320195: posts big blind $0.1
*** HOLE CARDS ***
Dealt to b445bdd1 
Dealt to 701efe20 
Dealt to b3320195 
Dealt to Hero [Jh 5c]
Dealt to b14398ca 
Dealt to e752a7fd 
Hero: folds
b14398ca: folds
e752a7fd: folds
b445bdd1: folds
701efe20: folds
Uncalled bet ($0.05) returned to b3320195
*** SHOWDOWN ***
b3320195 collected $0.1 from pot
*** SUMMARY ***
Total pot $0.1 | Rake $0 | Jackpot $0 | Bingo $0 | Fortune $0 | Tax $0
Seat 1: b445bdd1 (button) folded before Flop (didn't bet)
Seat 2: 701efe20 (small blind) folded before Flop
Seat 3: b3320195 (big blind) collected ($0.1)
Seat 4: Hero folded before Flop (didn't bet)
Seat 5: b14398ca folded before Flop (didn't bet)
Seat 6: e752a7fd folded before Flop (didn't bet)


Poker Hand #RC2075577849: Hold'em No Limit ($0.05/$0.1) - 2023/12/21 23:31:23
Table 'RushAndCash293579' 6-max Seat #1 is the button
Seat 1: Hero ($15.88 in chips)
Seat 2: 90ed276d ($10 in chips)
Seat 3: 14d41046 ($12.83 in chips)
Seat 4: 47fde94b ($10.9 in chips)
Seat 5: 968686f2 ($11.89 in chips)
Seat 6: c82e544f ($9.53 in chips)
90ed276d: posts small blind $0.05
14d41046: posts big blind $0.1
*** HOLE CARDS ***
Dealt to Hero [7s 5c]
Dealt to 90ed276d 
Dealt to 14d41046 
Dealt to 47fde94b 
Dealt to 968686f2 
Dealt to c82e544f 
47fde94b: folds
968686f2: raises $0.1 to $0.2
c82e544f: folds
Hero: folds
90ed276d: folds
14d41046: folds
Uncalled bet ($0.1) returned to 968686f2
*** SHOWDOWN ***
968686f2 collected $0.25 from pot
*** SUMMARY ***
Total pot $0.25 | Rake $0 | Jackpot $0 | Bingo $0 | Fortune $0 | Tax $0
Seat 1: Hero (button) folded before Flop (didn't bet)
Seat 2: 90ed276d (small blind) folded before Flop
Seat 3: 14d41046 (big blind) folded before Flop
Seat 4: 47fde94b folded before Flop (didn't bet)
Seat 5: 968686f2 collected ($0.25)
Seat 6: c82e544f folded before Flop (didn't bet)


Poker Hand #RC2075577602: Hold'em No Limit ($0.05/$0.1) - 2023/12/21 23:31:12
Table 'RushAndCash293441' 6-max Seat #1 is the button
Seat 1: 3eb1acae ($12.84 in chips)
Seat 2: 56602784 ($11.71 in chips)
Seat 3: Hero ($15.98 in chips)
Seat 4: 47fde94b ($11 in chips)
Seat 5: a015d585 ($10.09 in chips)
Seat 6: 647b442f ($35.83 in chips)
56602784: posts small blind $0.05
Hero: posts big blind $0.1
*** HOLE CARDS ***
Dealt to 3eb1acae 
Dealt to 56602784 
Dealt to Hero [9s Kh]
Dealt to 47fde94b 
Dealt to a015d585 
Dealt to 647b442f 
47fde94b: folds
a015d585: folds
647b442f: raises $0.15 to $0.25
3eb1acae: folds
56602784: folds
Hero: folds
Uncalled bet ($0.15) returned to 647b442f
*** SHOWDOWN ***
647b442f collected $0.25 from pot
*** SUMMARY ***
Total pot $0.25 | Rake $0 | Jackpot $0 | Bingo $0 | Fortune $0 | Tax $0
Seat 1: 3eb1acae (button) folded before Flop (didn't bet)
Seat 2: 56602784 (small blind) folded before Flop
Seat 3: Hero (big blind) folded before Flop
Seat 4: 47fde94b folded before Flop (didn't bet)
Seat 5: a015d585 folded before Flop (didn't bet)
Seat 6: 647b442f collected ($0.25)


Poker Hand #RC2075577523: Hold'em No Limit ($0.05/$0.1) - 2023/12/21 23:31:08
Table 'RushAndCash293396' 6-max Seat #1 is the button
Seat 1: 8932199d ($11.55 in chips)
Seat 2: 12ed0b3f ($10.86 in chips)
Seat 3: 6c088572 ($10.17 in chips)
Seat 4: Hero ($15.98 in chips)
Seat 5: 989c86be ($25.47 in chips)
Seat 6: 243279ca ($11.44 in chips)
12ed0b3f: posts small blind $0.05
6c088572: posts big blind $0.1
*** HOLE CARDS ***
Dealt to 8932199d 
Dealt to 12ed0b3f 
Dealt to 6c088572 
Dealt to Hero [8c 3h]
Dealt to 989c86be 
Dealt to 243279ca 
Hero: folds
989c86be: folds
243279ca: folds
8932199d: raises $0.15 to $0.25
12ed0b3f: raises $0.53 to $0.78
6c088572: folds
8932199d: raises $1.25 to $2.03
12ed0b3f: folds
Uncalled bet ($1.25) returned to 8932199d
*** SHOWDOWN ***
8932199d collected $1.58 from pot
*** SUMMARY ***
Total pot $1.66 | Rake $0.08 | Jackpot $0 | Bingo $0 | Fortune $0 | Tax $0
Seat 1: 8932199d (button) collected ($1.58)
Seat 2: 12ed0b3f (small blind) folded before Flop
Seat 3: 6c088572 (big blind) folded before Flop
Seat 4: Hero folded before Flop (didn't bet)
Seat 5: 989c86be folded before Flop (didn't bet)
Seat 6: 243279ca folded before Flop (didn't bet)


Poker Hand #RC2075577437: Hold'em No Limit ($0.05/$0.1) - 2023/12/21 23:31:04
Table 'RushAndCash293343' 6-max Seat #1 is the button
Seat 1: 370d7ea8 ($8.41 in chips)
Seat 2: c5573840 ($9.9 in chips)
Seat 3: 9744ecc5 ($12.45 in chips)
Seat 4: Hero ($15.98 in chips)
Seat 5: cf69763e ($10.8 in chips)
Seat 6: 550a1a33 ($13.32 in chips)
c5573840: posts small blind $0.05
9744ecc5: posts big blind $0.1
*** HOLE CARDS ***
Dealt to 370d7ea8 
Dealt to c5573840 
Dealt to 9744ecc5 
Dealt to Hero [Js 8c]
Dealt to cf69763e 
Dealt to 550a1a33 
Hero: folds
cf69763e: folds
550a1a33: folds
370d7ea8: raises $0.12 to $0.22
c5573840: folds
9744ecc5: folds
Uncalled bet ($0.12) returned to 370d7ea8
*** SHOWDOWN ***
370d7ea8 collected $0.25 from pot
*** SUMMARY ***
Total pot $0.25 | Rake $0 | Jackpot $0 | Bingo $0 | Fortune $0 | Tax $0
Seat 1: 370d7ea8 (button) collected ($0.25)
Seat 2: c5573840 (small blind) folded before Flop
Seat 3: 9744ecc5 (big blind) folded before Flop
Seat 4: Hero folded before Flop (didn't bet)
Seat 5: cf69763e folded before Flop (didn't bet)
Seat 6: 550a1a33 folded before Flop (didn't bet)


Poker Hand #RC2075577350: Hold'em No Limit ($0.05/$0.1) - 2023/12/21 23:31:00
Table 'RushAndCash293290' 6-max Seat #1 is the button
Seat 1: Hero ($15.98 in chips)
Seat 2: bfed6b68 ($9.18 in chips)
Seat 3: 4ea304af ($37.07 in chips)
Seat 4: c3c2420 ($10 in chips)
Seat 5: deaad42c ($9.17 in chips)
Seat 6: cac5f00e ($35.52 in chips)
bfed6b68: posts small blind $0.05
4ea304af: posts big blind $0.1
*** HOLE CARDS ***
Dealt to Hero [5s Qd]
Dealt to bfed6b68 
Dealt to 4ea304af 
Dealt to c3c2420 
Dealt to deaad42c 
Dealt to cac5f00e 
c3c2420: folds
deaad42c: raises $0.13 to $0.23
cac5f00e: calls $0.23
Hero: folds
bfed6b68: folds
4ea304af: calls $0.13
*** FLOP *** [Ad 8c Jh]
4ea304af: checks
deaad42c: bets $0.3
cac5f00e: calls $0.3
4ea304af: folds
*** TURN *** [Ad 8c Jh] [Th]
deaad42c: checks
cac5f00e: checks
*** RIVER *** [Ad 8c Jh Th] [Kd]
deaad42c: checks
cac5f00e: checks
deaad42c: shows [7h As] (Pair of Aces)
cac5f00e: shows [9h 8h] (Pair of Eights)
*** SHOWDOWN ***
deaad42c collected $1.28 from pot
*** SUMMARY ***
Total pot $1.34 | Rake $0.06 | Jackpot $0 | Bingo $0 | Fortune $0 | Tax $0
Board [Ad 8c Jh Th Kd]
Seat 1: Hero (button) folded before Flop (didn't bet)
Seat 2: bfed6b68 (small blind) folded before Flop
Seat 3: 4ea304af (big blind) folded on the Flop
Seat 4: c3c2420 folded before Flop (didn't bet)
Seat 5: deaad42c showed [7h As] and won ($1.28) with Pair of Aces
Seat 6: cac5f00e showed [9h 8h] and lost with Pair of Eights


Poker Hand #RC2075577275: Hold'em No Limit ($0.05/$0.1) - 2023/12/21 23:30:57
Table 'RushAndCash293245' 6-max Seat #1 is the button
Seat 1: 8e9bd235 ($10 in chips)
Seat 2: b1570850 ($11.75 in chips)
Seat 3: 389dd668 ($22.68 in chips)
Seat 4: abc8ed7f ($10 in chips)
Seat 5: Hero ($15.98 in chips)
Seat 6: d826cd9e ($10 in chips)
b1570850: posts small blind $0.05
389dd668: posts big blind $0.1
*** HOLE CARDS ***
Dealt to 8e9bd235 
Dealt to b1570850 
Dealt to 389dd668 
Dealt to abc8ed7f 
Dealt to Hero [2c 9h]
Dealt to d826cd9e 
abc8ed7f: folds
Hero: folds
d826cd9e: raises $0.2 to $0.3
8e9bd235: folds
b1570850: folds
389dd668: raises $0.8 to $1.1
d826cd9e: raises $1.13 to $2.23
389dd668: raises $20.45 to $22.68 and is all-in
d826cd9e: calls $7.77 and is all-in
Uncalled bet ($12.68) returned to 389dd668
389dd668: shows [Ac Ad]
d826cd9e: shows [Ks As]
*** FLOP *** [3d Kc Td]
*** TURN *** [3d Kc Td] [Jh]
*** RIVER *** [3d Kc Td Jh] [5h]
*** SHOWDOWN ***
389dd668 collected $19.6 from pot
*** SUMMARY ***
Total pot $20.05 | Rake $0.3 | Jackpot $0.15 | Bingo $0 | Fortune $0 | Tax $0
Board [3d Kc Td Jh 5h]
Seat 1: 8e9bd235 (button) folded before Flop (didn't bet)
Seat 2: b1570850 (small blind) folded before Flop
Seat 3: 389dd668 (big blind) showed [Ac Ad] and won ($19.6) with Pair of Aces
Seat 4: abc8ed7f folded before Flop (didn't bet)
Seat 5: Hero folded before Flop (didn't bet)
Seat 6: d826cd9e showed [Ks As] and lost with Pair of Kings


Poker Hand #RC2075576919: Hold'em No Limit ($0.05/$0.1) - 2023/12/21 23:30:41
Table 'RushAndCash293042' 6-max Seat #1 is the button
Seat 1: b6f96cb ($7.99 in chips)
Seat 2: Hero ($16.03 in chips)
Seat 3: c3c2420 ($10 in chips)
Seat 4: 77edba6c ($10.6 in chips)
Seat 5: 56666f92 ($10 in chips)
Seat 6: dd84fd1b ($10.05 in chips)
Hero: posts small blind $0.05
c3c2420: posts big blind $0.1
*** HOLE CARDS ***
Dealt to b6f96cb 
Dealt to Hero [2c 8h]
Dealt to c3c2420 
Dealt to 77edba6c 
Dealt to 56666f92 
Dealt to dd84fd1b 
77edba6c: raises $0.11 to $0.21
56666f92: folds
dd84fd1b: raises $0.59 to $0.8
b6f96cb: folds
Hero: folds
c3c2420: folds
77edba6c: folds
Uncalled bet ($0.59) returned to dd84fd1b
*** SHOWDOWN ***
dd84fd1b collected $0.55 from pot
*** SUMMARY ***
Total pot $0.57 | Rake $0.02 | Jackpot $0 | Bingo $0 | Fortune $0 | Tax $0
Seat 1: b6f96cb (button) folded before Flop (didn't bet)
Seat 2: Hero (small blind) folded before Flop
Seat 3: c3c2420 (big blind) folded before Flop
Seat 4: 77edba6c folded before Flop
Seat 5: 56666f92 folded before Flop (didn't bet)
Seat 6: dd84fd1b collected ($0.55)


Poker Hand #RC2075576654: Hold'em No Limit ($0.05/$0.1) - 2023/12/21 23:30:30
Table 'RushAndCash292888' 6-max Seat #1 is the button
Seat 1: 9c66bf60 ($11.32 in chips)
Seat 2: f15e57df ($50.11 in chips)
Seat 3: Hero ($15.98 in chips)
Seat 4: 76f4ebd9 ($27.1 in chips)
Seat 5: d712e513 ($27.47 in chips)
Seat 6: c87aa6bf ($13.94 in chips)
f15e57df: posts small blind $0.05
Hero: posts big blind $0.1
*** HOLE CARDS ***
Dealt to 9c66bf60 
Dealt to f15e57df 
Dealt to Hero [Kc Qs]
Dealt to 76f4ebd9 
Dealt to d712e513 
Dealt to c87aa6bf 
76f4ebd9: folds
d712e513: folds
c87aa6bf: folds
9c66bf60: folds
f15e57df: folds
Uncalled bet ($0.05) returned to Hero
*** SHOWDOWN ***
Hero collected $0.1 from pot
*** SUMMARY ***
Total pot $0.1 | Rake $0 | Jackpot $0 | Bingo $0 | Fortune $0 | Tax $0
Seat 1: 9c66bf60 (button) folded before Flop (didn't bet)
Seat 2: f15e57df (small blind) folded before Flop
Seat 3: Hero (big blind) collected ($0.1)
Seat 4: 76f4ebd9 folded before Flop (didn't bet)
Seat 5: d712e513 folded before Flop (didn't bet)
Seat 6: c87aa6bf folded before Flop (didn't bet)


Poker Hand #RC2075576353: Hold'em No Limit ($0.05/$0.1) - 2023/12/21 23:30:16
Table 'RushAndCash292714' 6-max Seat #1 is the button
Seat 1: 184f6e3b ($10.83 in chips)
Seat 2: 85952fee ($13.96 in chips)
Seat 3: 456368e8 ($9.5 in chips)
Seat 4: 92d95b97 ($13.77 in chips)
Seat 5: 5b0ddb11 ($10.18 in chips)
Seat 6: Hero ($15.83 in chips)
85952fee: posts small blind $0.05
456368e8: posts big blind $0.1
*** HOLE CARDS ***
Dealt to 184f6e3b 
Dealt to 85952fee 
Dealt to 456368e8 
Dealt to 92d95b97 
Dealt to 5b0ddb11 
Dealt to Hero [Ad Kc]
92d95b97: folds
5b0ddb11: folds
Hero: raises $0.1 to $0.2
184f6e3b: folds
85952fee: folds
456368e8: folds
Uncalled bet ($0.1) returned to Hero
*** SHOWDOWN ***
Hero collected $0.25 from pot
*** SUMMARY ***
Total pot $0.25 | Rake $0 | Jackpot $0 | Bingo $0 | Fortune $0 | Tax $0
Seat 1: 184f6e3b (button) folded before Flop (didn't bet)
Seat 2: 85952fee (small blind) folded before Flop
Seat 3: 456368e8 (big blind) folded before Flop
Seat 4: 92d95b97 folded before Flop (didn't bet)
Seat 5: 5b0ddb11 folded before Flop (didn't bet)
Seat 6: Hero collected ($0.25)


Poker Hand #RC2075576250: Hold'em No Limit ($0.05/$0.1) - 2023/12/21 23:30:12
Table 'RushAndCash292657' 6-max Seat #1 is the button
Seat 1: 5a7794f3 ($9.95 in chips)
Seat 2: 63d320d0 ($13.68 in chips)
Seat 3: Hero ($15.93 in chips)
Seat 4: 853fd2b7 ($26.19 in chips)
Seat 5: 1e74bd5 ($37.7 in chips)
Seat 6: f7053607 ($10.3 in chips)
63d320d0: posts small blind $0.05
Hero: posts big blind $0.1
*** HOLE CARDS ***
Dealt to 5a7794f3 
Dealt to 63d320d0 
Dealt to Hero [6c 5c]
Dealt to 853fd2b7 
Dealt to 1e74bd5 
Dealt to f7053607 
853fd2b7: folds
1e74bd5: folds
f7053607: folds
5a7794f3: folds
63d320d0: raises $0.2 to $0.3
Hero: folds
Uncalled bet ($0.2) returned to 63d320d0
*** SHOWDOWN ***
63d320d0 collected $0.2 from pot
*** SUMMARY ***
Total pot $0.2 | Rake $0 | Jackpot $0 | Bingo $0 | Fortune $0 | Tax $0
Seat 1: 5a7794f3 (button) folded before Flop (didn't bet)
Seat 2: 63d320d0 (small blind) collected ($0.2)
Seat 3: Hero (big blind) folded before Flop
Seat 4: 853fd2b7 folded before Flop (didn't bet)
Seat 5: 1e74bd5 folded before Flop (didn't bet)
Seat 6: f7053607 folded before Flop (didn't bet)


Poker Hand #RC2075576170: Hold'em No Limit ($0.05/$0.1) - 2023/12/21 23:30:09
Table 'RushAndCash292611' 6-max Seat #1 is the button
Seat 1: 12fba559 ($26.3 in chips)
Seat 2: Hero ($15.98 in chips)
Seat 3: 354bc0f1 ($10 in chips)
Seat 4: 27d2c161 ($12.38 in chips)
Seat 5: 872819d1 ($22.86 in chips)
Seat 6: 92e35b8f ($11.43 in chips)
Hero: posts small blind $0.05
354bc0f1: posts big blind $0.1
*** HOLE CARDS ***
Dealt to 12fba559 
Dealt to Hero [4s 9d]
Dealt to 354bc0f1 
Dealt to 27d2c161 
Dealt to 872819d1 
Dealt to 92e35b8f 
27d2c161: raises $0.1 to $0.2
872819d1: folds
92e35b8f: folds
12fba559: raises $0.42 to $0.62
Hero: folds
354bc0f1: folds
27d2c161: calls $0.42
*** FLOP *** [5d Kh 4d]
27d2c161: checks
12fba559: bets $0.7
27d2c161: calls $0.7
*** TURN *** [5d Kh 4d] [Ah]
27d2c161: checks
12fba559: bets $1.4
27d2c161: calls $1.4
*** RIVER *** [5d Kh 4d Ah] [7d]
27d2c161: bets $4.2
12fba559: calls $4.2
27d2c161: shows [Kd Qd] (King High Flush)
12fba559: shows [Ad Ac] (Three Aces)
*** SHOWDOWN ***
27d2c161 collected $13.54 from pot
*** SUMMARY ***
Total pot $13.99 | Rake $0.3 | Jackpot $0.15 | Bingo $0 | Fortune $0 | Tax $0
Board [5d Kh 4d Ah 7d]
Seat 1: 12fba559 (button) showed [Ad Ac] and lost with Three Aces
Seat 2: Hero (small blind) folded before Flop
Seat 3: 354bc0f1 (big blind) folded before Flop
Seat 4: 27d2c161 showed [Kd Qd] and won ($13.54) with King High Flush
Seat 5: 872819d1 folded before Flop (didn't bet)
Seat 6: 92e35b8f folded before Flop (didn't bet)


Poker Hand #RC2075576098: Hold'em No Limit ($0.05/$0.1) - 2023/12/21 23:30:05
Table 'RushAndCash292569' 6-max Seat #1 is the button
Seat 1: 8932199d ($11.42 in chips)
Seat 2: 866fef18 ($11.41 in chips)
Seat 3: 7a0a5636 ($5.59 in chips)
Seat 4: Hero ($15.98 in chips)
Seat 5: 27e5b815 ($17.45 in chips)
Seat 6: 8f692637 ($10 in chips)
866fef18: posts small blind $0.05
7a0a5636: posts big blind $0.1
*** HOLE CARDS ***
Dealt to 8932199d 
Dealt to 866fef18 
Dealt to 7a0a5636 
Dealt to Hero [Th 9s]
Dealt to 27e5b815 
Dealt to 8f692637 
Hero: folds
27e5b815: folds
8f692637: folds
8932199d: raises $0.15 to $0.25
866fef18: folds
7a0a5636: folds
Uncalled bet ($0.15) returned to 8932199d
*** SHOWDOWN ***
8932199d collected $0.25 from pot
*** SUMMARY ***
Total pot $0.25 | Rake $0 | Jackpot $0 | Bingo $0 | Fortune $0 | Tax $0
Seat 1: 8932199d (button) collected ($0.25)
Seat 2: 866fef18 (small blind) folded before Flop
Seat 3: 7a0a5636 (big blind) folded before Flop
Seat 4: Hero folded before Flop (didn't bet)
Seat 5: 27e5b815 folded before Flop (didn't bet)
Seat 6: 8f692637 folded before Flop (didn't bet)


Poker Hand #RC2075576009: Hold'em No Limit ($0.05/$0.1) - 2023/12/21 23:30:02
Table 'RushAndCash292520' 6-max Seat #1 is the button
Seat 1: c26846bf ($24.23 in chips)
Seat 2: 5d3a28af ($19.39 in chips)
Seat 3: ebba7fd5 ($22.02 in chips)
Seat 4: a8e34387 ($10.1 in chips)
Seat 5: 6dde7fdf ($13.69 in chips)
Seat 6: Hero ($15.98 in chips)
5d3a28af: posts small blind $0.05
ebba7fd5: posts big blind $0.1
*** HOLE CARDS ***
Dealt to c26846bf 
Dealt to 5d3a28af 
Dealt to ebba7fd5 
Dealt to a8e34387 
Dealt to 6dde7fdf 
Dealt to Hero [7d 2s]
a8e34387: raises $0.2 to $0.3
6dde7fdf: folds
Hero: folds
c26846bf: folds
5d3a28af: folds
ebba7fd5: folds
Uncalled bet ($0.2) returned to a8e34387
*** SHOWDOWN ***
a8e34387 collected $0.25 from pot
*** SUMMARY ***
Total pot $0.25 | Rake $0 | Jackpot $0 | Bingo $0 | Fortune $0 | Tax $0
Seat 1: c26846bf (button) folded before Flop (didn't bet)
Seat 2: 5d3a28af (small blind) folded before Flop
Seat 3: ebba7fd5 (big blind) folded before Flop
Seat 4: a8e34387 collected ($0.25)
Seat 5: 6dde7fdf folded before Flop (didn't bet)
Seat 6: Hero folded before Flop (didn't bet)


Poker Hand #RC2075575193: Hold'em No Limit ($0.05/$0.1) - 2023/12/21 23:29:28
Table 'RushAndCash292033' 6-max Seat #1 is the button
Seat 1: Hero ($15.7 in chips)
Seat 2: e087d3e2 ($10.35 in chips)
Seat 3: a8e34387 ($10.35 in chips)
Seat 4: 3b0a2baf ($10.67 in chips)
Seat 5: 3008004f ($20.78 in chips)
Seat 6: 9b5e26de ($32.28 in chips)
e087d3e2: posts small blind $0.05
a8e34387: posts big blind $0.1
*** HOLE CARDS ***
Dealt to Hero [Qh 9h]
Dealt to e087d3e2 
Dealt to a8e34387 
Dealt to 3b0a2baf 
Dealt to 3008004f 
Dealt to 9b5e26de 
3b0a2baf: folds
3008004f: folds
9b5e26de: folds
Hero: raises $0.15 to $0.25
e087d3e2: folds
a8e34387: calls $0.15
*** FLOP *** [5s 2h 7s]
a8e34387: checks
Hero: checks
*** TURN *** [5s 2h 7s] [Th]
a8e34387: checks
Hero: checks
*** RIVER *** [5s 2h 7s Th] [Qd]
a8e34387: checks
Hero: bets $0.28
a8e34387: folds
Uncalled bet ($0.28) returned to Hero
*** SHOWDOWN ***
Hero collected $0.53 from pot
*** SUMMARY ***
Total pot $0.55 | Rake $0.02 | Jackpot $0 | Bingo $0 | Fortune $0 | Tax $0
Board [5s 2h 7s Th Qd]
Seat 1: Hero (button) won ($0.53)
Seat 2: e087d3e2 (small blind) folded before Flop
Seat 3: a8e34387 (big blind) folded on the River
Seat 4: 3b0a2baf folded before Flop (didn't bet)
Seat 5: 3008004f folded before Flop (didn't bet)
Seat 6: 9b5e26de folded before Flop (didn't bet)


Poker Hand #RC2075575110: Hold'em No Limit ($0.05/$0.1) - 2023/12/21 23:29:24
Table 'RushAndCash291982' 6-max Seat #1 is the button
Seat 1: cf879fe7 ($12.57 in chips)
Seat 2: fa32d0a5 ($10.21 in chips)
Seat 3: 90b9d59d ($10.99 in chips)
Seat 4: e043dc53 ($10 in chips)
Seat 5: Hero ($15.7 in chips)
Seat 6: 3bd21455 ($10 in chips)
fa32d0a5: posts small blind $0.05
90b9d59d: posts big blind $0.1
*** HOLE CARDS ***
Dealt to cf879fe7 
Dealt to fa32d0a5 
Dealt to 90b9d59d 
Dealt to e043dc53 
Dealt to Hero [4s Qc]
Dealt to 3bd21455 
e043dc53: folds
Hero: folds
3bd21455: folds
cf879fe7: folds
fa32d0a5: folds
Uncalled bet ($0.05) returned to 90b9d59d
*** SHOWDOWN ***
90b9d59d collected $0.1 from pot
*** SUMMARY ***
Total pot $0.1 | Rake $0 | Jackpot $0 | Bingo $0 | Fortune $0 | Tax $0
Seat 1: cf879fe7 (button) folded before Flop (didn't bet)
Seat 2: fa32d0a5 (small blind) folded before Flop
Seat 3: 90b9d59d (big blind) collected ($0.1)
Seat 4: e043dc53 folded before Flop (didn't bet)
Seat 5: Hero folded before Flop (didn't bet)
Seat 6: 3bd21455 folded before Flop (didn't bet)


Poker Hand #RC2075574978: Hold'em No Limit ($0.05/$0.1) - 2023/12/21 23:29:19
Table 'RushAndCash291900' 6-max Seat #1 is the button
Seat 1: 5954c4a8 ($25.67 in chips)
Seat 2: 71ff238b ($5.55 in chips)
Seat 3: e57aeb4c ($18.18 in chips)
Seat 4: fe713d8b ($10.05 in chips)
Seat 5: Hero ($15.7 in chips)
Seat 6: 61b5e6cc ($10 in chips)
71ff238b: posts small blind $0.05
e57aeb4c: posts big blind $0.1
*** HOLE CARDS ***
Dealt to 5954c4a8 
Dealt to 71ff238b 
Dealt to e57aeb4c 
Dealt to fe713d8b 
Dealt to Hero [8h Ad]
Dealt to 61b5e6cc 
fe713d8b: raises $0.1 to $0.2
Hero: folds
61b5e6cc: folds
5954c4a8: folds
71ff238b: calls $0.15
e57aeb4c: folds
*** FLOP *** [8s 5h 2h]
71ff238b: bets $0.25
fe713d8b: calls $0.25
*** TURN *** [8s 5h 2h] [4c]
71ff238b: bets $0.5
fe713d8b: calls $0.5
*** RIVER *** [8s 5h 2h 4c] [4d]
71ff238b: bets $0.5
fe713d8b: folds
Uncalled bet ($0.5) returned to 71ff238b
*** SHOWDOWN ***
71ff238b collected $1.9 from pot
*** SUMMARY ***
Total pot $2 | Rake $0.1 | Jackpot $0 | Bingo $0 | Fortune $0 | Tax $0
Board [8s 5h 2h 4c 4d]
Seat 1: 5954c4a8 (button) folded before Flop (didn't bet)
Seat 2: 71ff238b (small blind) won ($1.9)
Seat 3: e57aeb4c (big blind) folded before Flop
Seat 4: fe713d8b folded on the River
Seat 5: Hero folded before Flop (didn't bet)
Seat 6: 61b5e6cc folded before Flop (didn't bet)


Poker Hand #RC2075574820: Hold'em No Limit ($0.05/$0.1) - 2023/12/21 23:29:12
Table 'RushAndCash291805' 6-max Seat #1 is the button
Seat 1: 930701eb ($10.9 in chips)
Seat 2: c3c2420 ($10.24 in chips)
Seat 3: 8c103229 ($10.1 in chips)
Seat 4: a39934e9 ($17.95 in chips)
Seat 5: Hero ($15.7 in chips)
Seat 6: 92e35b8f ($11.53 in chips)
c3c2420: posts small blind $0.05
8c103229: posts big blind $0.1
*** HOLE CARDS ***
Dealt to 930701eb 
Dealt to c3c2420 
Dealt to 8c103229 
Dealt to a39934e9 
Dealt to Hero [8s Qs]
Dealt to 92e35b8f 
a39934e9: raises $0.15 to $0.25
Hero: folds
92e35b8f: folds
930701eb: folds
c3c2420: raises $0.95 to $1.2
8c103229: folds
a39934e9: calls $0.95
*** FLOP *** [Kh Ks 6h]
c3c2420: checks
a39934e9: checks
*** TURN *** [Kh Ks 6h] [9h]
c3c2420: checks
a39934e9: checks
*** RIVER *** [Kh Ks 6h 9h] [4c]
c3c2420: checks
a39934e9: checks
c3c2420: shows [Jc Tc] (Pair of Kings)
a39934e9: shows [Ad Qc] (Pair of Kings)
*** SHOWDOWN ***
a39934e9 collected $2.38 from pot
*** SUMMARY ***
Total pot $2.5 | Rake $0.12 | Jackpot $0 | Bingo $0 | Fortune $0 | Tax $0
Board [Kh Ks 6h 9h 4c]
Seat 1: 930701eb (button) folded before Flop (didn't bet)
Seat 2: c3c2420 (small blind) showed [Jc Tc] and lost with Pair of Kings
Seat 3: 8c103229 (big blind) folded before Flop
Seat 4: a39934e9 showed [Ad Qc] and won ($2.38) with Pair of Kings
Seat 5: Hero folded before Flop (didn't bet)
Seat 6: 92e35b8f folded before Flop (didn't bet)


Poker Hand #RC2075554644: Hold'em No Limit ($0.05/$0.1) - 2023/12/21 23:29:04
Table 'RushAndCash291701' 6-max Seat #1 is the button
Seat 1: f6051b97 ($10 in chips)
Seat 2: 27d2c161 ($12.13 in chips)
Seat 3: f74df4bc ($10.48 in chips)
Seat 4: Hero ($15.7 in chips)
Seat 5: 304c14cf ($21.18 in chips)
Seat 6: 85952fee ($13.59 in chips)
27d2c161: posts small blind $0.05
f74df4bc: posts big blind $0.1
*** HOLE CARDS ***
Dealt to f6051b97 
Dealt to 27d2c161 
Dealt to f74df4bc 
Dealt to Hero [2s 8h]
Dealt to 304c14cf 
Dealt to 85952fee 
Hero: folds
304c14cf: folds
85952fee: folds
f6051b97: folds
27d2c161: folds
Uncalled bet ($0.05) returned to f74df4bc
*** SHOWDOWN ***
f74df4bc collected $0.1 from pot
*** SUMMARY ***
Total pot $0.1 | Rake $0 | Jackpot $0 | Bingo $0 | Fortune $0 | Tax $0
Seat 1: f6051b97 (button) folded before Flop (didn't bet)
Seat 2: 27d2c161 (small blind) folded before Flop
Seat 3: f74df4bc (big blind) collected ($0.1)
Seat 4: Hero folded before Flop (didn't bet)
Seat 5: 304c14cf folded before Flop (didn't bet)
Seat 6: 85952fee folded before Flop (didn't bet)


Poker Hand #RC2075554533: Hold'em No Limit ($0.05/$0.1) - 2023/12/21 23:29:00
Table 'RushAndCash291639' 6-max Seat #1 is the button
Seat 1: 96721776 ($12.02 in chips)
Seat 2: a8e34387 ($10.4 in chips)
Seat 3: Hero ($15.8 in chips)
Seat 4: e6287dcc ($11 in chips)
Seat 5: 2674c793 ($45.9 in chips)
Seat 6: dd84fd1b ($10 in chips)
a8e34387: posts small blind $0.05
Hero: posts big blind $0.1
*** HOLE CARDS ***
Dealt to 96721776 
Dealt to a8e34387 
Dealt to Hero [7s 3c]
Dealt to e6287dcc 
Dealt to 2674c793 
Dealt to dd84fd1b 
e6287dcc: raises $0.1 to $0.2
2674c793: folds
dd84fd1b: folds
96721776: folds
a8e34387: folds
Hero: folds
Uncalled bet ($0.1) returned to e6287dcc
*** SHOWDOWN ***
e6287dcc collected $0.25 from pot
*** SUMMARY ***
Total pot $0.25 | Rake $0 | Jackpot $0 | Bingo $0 | Fortune $0 | Tax $0
Seat 1: 96721776 (button) folded before Flop (didn't bet)
Seat 2: a8e34387 (small blind) folded before Flop
Seat 3: Hero (big blind) folded before Flop
Seat 4: e6287dcc collected ($0.25)
Seat 5: 2674c793 folded before Flop (didn't bet)
Seat 6: dd84fd1b folded before Flop (didn't bet)


Poker Hand #RC2075554461: Hold'em No Limit ($0.05/$0.1) - 2023/12/21 23:28:56
Table 'RushAndCash291597' 6-max Seat #1 is the button
Seat 1: Hero ($15.8 in chips)
Seat 2: e0ab7d9c ($11.38 in chips)
Seat 3: ba021e99 ($6.34 in chips)
Seat 4: 1c43a6ef ($18.47 in chips)
Seat 5: 7a26f848 ($9.05 in chips)
Seat 6: a8e34387 ($10.4 in chips)
e0ab7d9c: posts small blind $0.05
ba021e99: posts big blind $0.1
*** HOLE CARDS ***
Dealt to Hero [Jd 5h]
Dealt to e0ab7d9c 
Dealt to ba021e99 
Dealt to 1c43a6ef 
Dealt to 7a26f848 
Dealt to a8e34387 
1c43a6ef: folds
7a26f848: folds
a8e34387: folds
Hero: folds
e0ab7d9c: folds
Uncalled bet ($0.05) returned to ba021e99
*** SHOWDOWN ***
ba021e99 collected $0.1 from pot
*** SUMMARY ***
Total pot $0.1 | Rake $0 | Jackpot $0 | Bingo $0 | Fortune $0 | Tax $0
Seat 1: Hero (button) folded before Flop (didn't bet)
Seat 2: e0ab7d9c (small blind) folded before Flop
Seat 3: ba021e99 (big blind) collected ($0.1)
Seat 4: 1c43a6ef folded before Flop (didn't bet)
Seat 5: 7a26f848 folded before Flop (didn't bet)
Seat 6: a8e34387 folded before Flop (didn't bet)


Poker Hand #RC2075553604: Hold'em No Limit ($0.05/$0.1) - 2023/12/21 23:28:21
Table 'RushAndCash291107' 6-max Seat #1 is the button
Seat 1: 5efae841 ($13.84 in chips)
Seat 2: Hero ($15.53 in chips)
Seat 3: 1c43a6ef ($18.77 in chips)
Seat 4: 8a72c242 ($10 in chips)
Seat 5: 9bcb97f1 ($20.42 in chips)
Seat 6: 23ab2c57 ($10.2 in chips)
Hero: posts small blind $0.05
1c43a6ef: posts big blind $0.1
*** HOLE CARDS ***
Dealt to 5efae841 
Dealt to Hero [9c Ah]
Dealt to 1c43a6ef 
Dealt to 8a72c242 
Dealt to 9bcb97f1 
Dealt to 23ab2c57 
8a72c242: folds
9bcb97f1: folds
23ab2c57: folds
5efae841: folds
Hero: raises $0.2 to $0.3
1c43a6ef: calls $0.2
*** FLOP *** [4d 8d 4h]
Hero: checks
1c43a6ef: checks
*** TURN *** [4d 8d 4h] [5d]
Hero: checks
1c43a6ef: checks
*** RIVER *** [4d 8d 4h 5d] [6c]
Hero: checks
1c43a6ef: checks
Hero: shows [9c Ah] (Pair of Fours)
1c43a6ef: shows [Td Jc] (Pair of Fours)
*** SHOWDOWN ***
Hero collected $0.57 from pot
*** SUMMARY ***
Total pot $0.6 | Rake $0.03 | Jackpot $0 | Bingo $0 | Fortune $0 | Tax $0
Board [4d 8d 4h 5d 6c]
Seat 1: 5efae841 (button) folded before Flop (didn't bet)
Seat 2: Hero (small blind) showed [9c Ah] and won ($0.57) with Pair of Fours
Seat 3: 1c43a6ef (big blind) showed [Td Jc] and lost with Pair of Fours
Seat 4: 8a72c242 folded before Flop (didn't bet)
Seat 5: 9bcb97f1 folded before Flop (didn't bet)
Seat 6: 23ab2c57 folded before Flop (didn't bet)


Poker Hand #RC2075553485: Hold'em No Limit ($0.05/$0.1) - 2023/12/21 23:28:16
Table 'RushAndCash291039' 6-max Seat #1 is the button
Seat 1: 643efff8 ($10.05 in chips)
Seat 2: 41c82409 ($10 in chips)
Seat 3: 37598c58 ($11.1 in chips)
Seat 4: f7053607 ($8.98 in chips)
Seat 5: e0e638e8 ($9.17 in chips)
Seat 6: Hero ($15.53 in chips)
41c82409: posts small blind $0.05
37598c58: posts big blind $0.1
*** HOLE CARDS ***
Dealt to 643efff8 
Dealt to 41c82409 
Dealt to 37598c58 
Dealt to f7053607 
Dealt to e0e638e8 
Dealt to Hero [Ac 6h]
f7053607: folds
e0e638e8: folds
Hero: folds
643efff8: folds
41c82409: raises $0.2 to $0.3
37598c58: folds
Uncalled bet ($0.2) returned to 41c82409
*** SHOWDOWN ***
41c82409 collected $0.2 from pot
*** SUMMARY ***
Total pot $0.2 | Rake $0 | Jackpot $0 | Bingo $0 | Fortune $0 | Tax $0
Seat 1: 643efff8 (button) folded before Flop (didn't bet)
Seat 2: 41c82409 (small blind) collected ($0.2)
Seat 3: 37598c58 (big blind) folded before Flop
Seat 4: f7053607 folded before Flop (didn't bet)
Seat 5: e0e638e8 folded before Flop (didn't bet)
Seat 6: Hero folded before Flop (didn't bet)


Poker Hand #RC2075553400: Hold'em No Limit ($0.05/$0.1) - 2023/12/21 23:28:12
Table 'RushAndCash290990' 6-max Seat #1 is the button
Seat 1: 3b161be4 ($10.75 in chips)
Seat 2: e50ccad6 ($11.08 in chips)
Seat 3: f7053607 ($9.08 in chips)
Seat 4: e873eecf ($8.28 in chips)
Seat 5: 2a18e7b3 ($9.66 in chips)
Seat 6: Hero ($15.53 in chips)
e50ccad6: posts small blind $0.05
f7053607: posts big blind $0.1
*** HOLE CARDS ***
Dealt to 3b161be4 
Dealt to e50ccad6 
Dealt to f7053607 
Dealt to e873eecf 
Dealt to 2a18e7b3 
Dealt to Hero [4h Qd]
e873eecf: folds
2a18e7b3: folds
Hero: folds
3b161be4: folds
e50ccad6: folds
Uncalled bet ($0.05) returned to f7053607
*** SHOWDOWN ***
f7053607 collected $0.1 from pot
*** SUMMARY ***
Total pot $0.1 | Rake $0 | Jackpot $0 | Bingo $0 | Fortune $0 | Tax $0
Seat 1: 3b161be4 (button) folded before Flop (didn't bet)
Seat 2: e50ccad6 (small blind) folded before Flop
Seat 3: f7053607 (big blind) collected ($0.1)
Seat 4: e873eecf folded before Flop (didn't bet)
Seat 5: 2a18e7b3 folded before Flop (didn't bet)
Seat 6: Hero folded before Flop (didn't bet)


Poker Hand #RC2075553187: Hold'em No Limit ($0.05/$0.1) - 2023/12/21 23:28:03
Table 'RushAndCash290864' 6-max Seat #1 is the button
Seat 1: Hero ($15.53 in chips)
Seat 2: f3e18da3 ($10.1 in chips)
Seat 3: 5c16ab41 ($10.6 in chips)
Seat 4: 988faf17 ($36.08 in chips)
Seat 5: 8a9d84cc ($17.09 in chips)
Seat 6: cf439056 ($10.56 in chips)
f3e18da3: posts small blind $0.05
5c16ab41: posts big blind $0.1
*** HOLE CARDS ***
Dealt to Hero [8d Qc]
Dealt to f3e18da3 
Dealt to 5c16ab41 
Dealt to 988faf17 
Dealt to 8a9d84cc 
Dealt to cf439056 
988faf17: folds
8a9d84cc: folds
cf439056: folds
Hero: folds
f3e18da3: raises $0.2 to $0.3
5c16ab41: calls $0.2
*** FLOP *** [4c 9d 6d]
f3e18da3: checks
5c16ab41: checks
*** TURN *** [4c 9d 6d] [Ks]
f3e18da3: bets $0.3
5c16ab41: folds
Uncalled bet ($0.3) returned to f3e18da3
*** SHOWDOWN ***
f3e18da3 collected $0.57 from pot
*** SUMMARY ***
Total pot $0.6 | Rake $0.03 | Jackpot $0 | Bingo $0 | Fortune $0 | Tax $0
Board [4c 9d 6d Ks]
Seat 1: Hero (button) folded before Flop (didn't bet)
Seat 2: f3e18da3 (small blind) won ($0.57)
Seat 3: 5c16ab41 (big blind) folded on the Turn
Seat 4: 988faf17 folded before Flop (didn't bet)
Seat 5: 8a9d84cc folded before Flop (didn't bet)
Seat 6: cf439056 folded before Flop (didn't bet)


Poker Hand #RC2075553046: Hold'em No Limit ($0.05/$0.1) - 2023/12/21 23:27:56
Table 'RushAndCash290784' 6-max Seat #1 is the button
Seat 1: dfde7309 ($19.17 in chips)
Seat 2: 8c103229 ($10.15 in chips)
Seat 3: 1fa4f905 ($6.92 in chips)
Seat 4: f7053607 ($8.93 in chips)
Seat 5: Hero ($15.53 in chips)
Seat 6: 22420f5f ($32 in chips)
8c103229: posts small blind $0.05
1fa4f905: posts big blind $0.1
*** HOLE CARDS ***
Dealt to dfde7309 
Dealt to 8c103229 
Dealt to 1fa4f905 
Dealt to f7053607 
Dealt to Hero [8d Tc]
Dealt to 22420f5f 
f7053607: folds
Hero: folds
22420f5f: folds
dfde7309: folds
8c103229: folds
Uncalled bet ($0.05) returned to 1fa4f905
*** SHOWDOWN ***
1fa4f905 collected $0.1 from pot
*** SUMMARY ***
Total pot $0.1 | Rake $0 | Jackpot $0 | Bingo $0 | Fortune $0 | Tax $0
Seat 1: dfde7309 (button) folded before Flop (didn't bet)
Seat 2: 8c103229 (small blind) folded before Flop
Seat 3: 1fa4f905 (big blind) collected ($0.1)
Seat 4: f7053607 folded before Flop (didn't bet)
Seat 5: Hero folded before Flop (didn't bet)
Seat 6: 22420f5f folded before Flop (didn't bet)


Poker Hand #RC2075552775: Hold'em No Limit ($0.05/$0.1) - 2023/12/21 23:27:45
Table 'RushAndCash290631' 6-max Seat #1 is the button
Seat 1: 8f692637 ($10 in chips)
Seat 2: Hero ($15.58 in chips)
Seat 3: d5dc7579 ($10 in chips)
Seat 4: ab7ba7a2 ($8.18 in chips)
Seat 5: 24c6e84e ($10.69 in chips)
Seat 6: 3ef96e15 ($10.13 in chips)
Hero: posts small blind $0.05
d5dc7579: posts big blind $0.1
*** HOLE CARDS ***
Dealt to 8f692637 
Dealt to Hero [7c 9d]
Dealt to d5dc7579 
Dealt to ab7ba7a2 
Dealt to 24c6e84e 
Dealt to 3ef96e15 
ab7ba7a2: folds
24c6e84e: raises $0.1 to $0.2
3ef96e15: folds
8f692637: folds
Hero: folds
d5dc7579: folds
Uncalled bet ($0.1) returned to 24c6e84e
*** SHOWDOWN ***
24c6e84e collected $0.25 from pot
*** SUMMARY ***
Total pot $0.25 | Rake $0 | Jackpot $0 | Bingo $0 | Fortune $0 | Tax $0
Seat 1: 8f692637 (button) folded before Flop (didn't bet)
Seat 2: Hero (small blind) folded before Flop
Seat 3: d5dc7579 (big blind) folded before Flop
Seat 4: ab7ba7a2 folded before Flop (didn't bet)
Seat 5: 24c6e84e collected ($0.25)
Seat 6: 3ef96e15 folded before Flop (didn't bet)


Poker Hand #RC2075551953: Hold'em No Limit ($0.05/$0.1) - 2023/12/21 23:27:08
Table 'RushAndCash290163' 6-max Seat #1 is the button
Seat 1: 45e373d9 ($10 in chips)
Seat 2: 480caa81 ($19.31 in chips)
Seat 3: Hero ($15.3 in chips)
Seat 4: 6dde7fdf ($16.88 in chips)
Seat 5: 3b161be4 ($10.06 in chips)
Seat 6: ab7ba7a2 ($8.43 in chips)
480caa81: posts small blind $0.05
Hero: posts big blind $0.1
*** HOLE CARDS ***
Dealt to 45e373d9 
Dealt to 480caa81 
Dealt to Hero [Jh As]
Dealt to 6dde7fdf 
Dealt to 3b161be4 
Dealt to ab7ba7a2 
6dde7fdf: folds
3b161be4: folds
ab7ba7a2: raises $0.15 to $0.25
45e373d9: folds
480caa81: folds
Hero: calls $0.15
*** FLOP *** [7c 9c 3d]
Hero: checks
ab7ba7a2: checks
*** TURN *** [7c 9c 3d] [Qc]
Hero: checks
ab7ba7a2: checks
*** RIVER *** [7c 9c 3d Qc] [6d]
Hero: checks
ab7ba7a2: checks
Hero: shows [Jh As] (Ace-High)
ab7ba7a2: shows [Ad 4d] (Ace-High)
*** SHOWDOWN ***
Hero collected $0.53 from pot
*** SUMMARY ***
Total pot $0.55 | Rake $0.02 | Jackpot $0 | Bingo $0 | Fortune $0 | Tax $0
Board [7c 9c 3d Qc 6d]
Seat 1: 45e373d9 (button) folded before Flop (didn't bet)
Seat 2: 480caa81 (small blind) folded before Flop
Seat 3: Hero (big blind) showed [Jh As] and won ($0.53) with Ace-High
Seat 4: 6dde7fdf folded before Flop (didn't bet)
Seat 5: 3b161be4 folded before Flop (didn't bet)
Seat 6: ab7ba7a2 showed [Ad 4d] and lost with Ace-High


Poker Hand #RC2075551859: Hold'em No Limit ($0.05/$0.1) - 2023/12/21 23:27:04
Table 'RushAndCash290110' 6-max Seat #1 is the button
Seat 1: 981f5256 ($10.1 in chips)
Seat 2: e043dc53 ($10.01 in chips)
Seat 3: 36465e5a ($10.79 in chips)
Seat 4: 2b0be38a ($16.71 in chips)
Seat 5: Hero ($15.3 in chips)
Seat 6: 2bbb668e ($12.24 in chips)
e043dc53: posts small blind $0.05
36465e5a: posts big blind $0.1
*** HOLE CARDS ***
Dealt to 981f5256 
Dealt to e043dc53 
Dealt to 36465e5a 
Dealt to 2b0be38a 
Dealt to Hero [Ad 4c]
Dealt to 2bbb668e 
2b0be38a: folds
Hero: folds
2bbb668e: folds
981f5256: raises $0.1 to $0.2
e043dc53: folds
36465e5a: folds
Uncalled bet ($0.1) returned to 981f5256
*** SHOWDOWN ***
981f5256 collected $0.25 from pot
*** SUMMARY ***
Total pot $0.25 | Rake $0 | Jackpot $0 | Bingo $0 | Fortune $0 | Tax $0
Seat 1: 981f5256 (button) collected ($0.25)
Seat 2: e043dc53 (small blind) folded before Flop
Seat 3: 36465e5a (big blind) folded before Flop
Seat 4: 2b0be38a folded before Flop (didn't bet)
Seat 5: Hero folded before Flop (didn't bet)
Seat 6: 2bbb668e folded before Flop (didn't bet)


Poker Hand #RC2075551781: Hold'em No Limit ($0.05/$0.1) - 2023/12/21 23:27:00
Table 'RushAndCash290067' 6-max Seat #1 is the button
Seat 1: 483c34b4 ($10.1 in chips)
Seat 2: 548a2c92 ($10 in chips)
Seat 3: b2346413 ($10 in chips)
Seat 4: 75725f39 ($10.67 in chips)
Seat 5: d0e1a15f ($14.46 in chips)
Seat 6: Hero ($15.3 in chips)
548a2c92: posts small blind $0.05
b2346413: posts big blind $0.1
*** HOLE CARDS ***
Dealt to 483c34b4 
Dealt to 548a2c92 
Dealt to b2346413 
Dealt to 75725f39 
Dealt to d0e1a15f 
Dealt to Hero [5h 7h]
75725f39: folds
d0e1a15f: folds
Hero: folds
483c34b4: folds
548a2c92: raises $0.2 to $0.3
b2346413: calls $0.2
*** FLOP *** [Qh 4s Kd]
548a2c92: bets $0.3
b2346413: calls $0.3
*** TURN *** [Qh 4s Kd] [5c]
548a2c92: checks
b2346413: bets $0.6
548a2c92: folds
Uncalled bet ($0.6) returned to b2346413
*** SHOWDOWN ***
b2346413 collected $1.14 from pot
*** SUMMARY ***
Total pot $1.2 | Rake $0.06 | Jackpot $0 | Bingo $0 | Fortune $0 | Tax $0
Board [Qh 4s Kd 5c]
Seat 1: 483c34b4 (button) folded before Flop (didn't bet)
Seat 2: 548a2c92 (small blind) folded on the Turn
Seat 3: b2346413 (big blind) won ($1.14)
Seat 4: 75725f39 folded before Flop (didn't bet)
Seat 5: d0e1a15f folded before Flop (didn't bet)
Seat 6: Hero folded before Flop (didn't bet)


Poker Hand #RC2075551655: Hold'em No Limit ($0.05/$0.1) - 2023/12/21 23:26:55
Table 'RushAndCash289993' 6-max Seat #1 is the button
Seat 1: 18756e23 ($10.26 in chips)
Seat 2: a0c90946 ($29.07 in chips)
Seat 3: ebd36a7c ($10 in chips)
Seat 4: 5c16ab41 ($10.15 in chips)
Seat 5: 22420f5f ($31.95 in chips)
Seat 6: Hero ($15.3 in chips)
a0c90946: posts small blind $0.05
ebd36a7c: posts big blind $0.1
*** HOLE CARDS ***
Dealt to 18756e23 
Dealt to a0c90946 
Dealt to ebd36a7c 
Dealt to 5c16ab41 
Dealt to 22420f5f 
Dealt to Hero [Jd 2s]
5c16ab41: folds
22420f5f: folds
Hero: folds
18756e23: raises $0.12 to $0.22
a0c90946: folds
ebd36a7c: folds
Uncalled bet ($0.12) returned to 18756e23
*** SHOWDOWN ***
18756e23 collected $0.25 from pot
*** SUMMARY ***
Total pot $0.25 | Rake $0 | Jackpot $0 | Bingo $0 | Fortune $0 | Tax $0
Seat 1: 18756e23 (button) collected ($0.25)
Seat 2: a0c90946 (small blind) folded before Flop
Seat 3: ebd36a7c (big blind) folded before Flop
Seat 4: 5c16ab41 folded before Flop (didn't bet)
Seat 5: 22420f5f folded before Flop (didn't bet)
Seat 6: Hero folded before Flop (didn't bet)


Poker Hand #RC2075551269: Hold'em No Limit ($0.05/$0.1) - 2023/12/21 23:26:39
Table 'RushAndCash289769' 6-max Seat #1 is the button
Seat 1: Hero ($15.15 in chips)
Seat 2: 6dde7fdf ($16.88 in chips)
Seat 3: 33d2b8fc ($19.82 in chips)
Seat 4: 4288ffd6 ($10 in chips)
Seat 5: 3cd87350 ($15.82 in chips)
Seat 6: 9c66bf60 ($11.14 in chips)
6dde7fdf: posts small blind $0.05
33d2b8fc: posts big blind $0.1
*** HOLE CARDS ***
Dealt to Hero [Jd Jc]
Dealt to 6dde7fdf 
Dealt to 33d2b8fc 
Dealt to 4288ffd6 
Dealt to 3cd87350 
Dealt to 9c66bf60 
4288ffd6: folds
3cd87350: folds
9c66bf60: folds
Hero: raises $0.15 to $0.25
6dde7fdf: folds
33d2b8fc: folds
Uncalled bet ($0.15) returned to Hero
*** SHOWDOWN ***
Hero collected $0.25 from pot
*** SUMMARY ***
Total pot $0.25 | Rake $0 | Jackpot $0 | Bingo $0 | Fortune $0 | Tax $0
Seat 1: Hero (button) collected ($0.25)
Seat 2: 6dde7fdf (small blind) folded before Flop
Seat 3: 33d2b8fc (big blind) folded before Flop
Seat 4: 4288ffd6 folded before Flop (didn't bet)
Seat 5: 3cd87350 folded before Flop (didn't bet)
Seat 6: 9c66bf60 folded before Flop (didn't bet)


Poker Hand #RC2075551091: Hold'em No Limit ($0.05/$0.1) - 2023/12/21 23:26:31
Table 'RushAndCash289665' 6-max Seat #1 is the button
Seat 1: 804ac42a ($4.54 in chips)
Seat 2: b67d1710 ($29.2 in chips)
Seat 3: Hero ($15.25 in chips)
Seat 4: f742ed5e ($11.33 in chips)
Seat 5: 49b69c38 ($10.43 in chips)
Seat 6: 8bffd3fd ($18.29 in chips)
b67d1710: posts small blind $0.05
Hero: posts big blind $0.1
*** HOLE CARDS ***
Dealt to 804ac42a 
Dealt to b67d1710 
Dealt to Hero [Js 5d]
Dealt to f742ed5e 
Dealt to 49b69c38 
Dealt to 8bffd3fd 
f742ed5e: folds
49b69c38: folds
8bffd3fd: folds
804ac42a: folds
b67d1710: raises $0.2 to $0.3
Hero: folds
Uncalled bet ($0.2) returned to b67d1710
*** SHOWDOWN ***
b67d1710 collected $0.2 from pot
*** SUMMARY ***
Total pot $0.2 | Rake $0 | Jackpot $0 | Bingo $0 | Fortune $0 | Tax $0
Seat 1: 804ac42a (button) folded before Flop (didn't bet)
Seat 2: b67d1710 (small blind) collected ($0.2)
Seat 3: Hero (big blind) folded before Flop
Seat 4: f742ed5e folded before Flop (didn't bet)
Seat 5: 49b69c38 folded before Flop (didn't bet)
Seat 6: 8bffd3fd folded before Flop (didn't bet)


Poker Hand #RC2075550995: Hold'em No Limit ($0.05/$0.1) - 2023/12/21 23:26:27
Table 'RushAndCash289608' 6-max Seat #1 is the button
Seat 1: f6f7c205 ($11.37 in chips)
Seat 2: Hero ($15.3 in chips)
Seat 3: fe8e9d75 ($10.05 in chips)
Seat 4: 243279ca ($10.24 in chips)
Seat 5: 2a18e7b3 ($10.21 in chips)
Seat 6: 1ba2affc ($16.43 in chips)
Hero: posts small blind $0.05
fe8e9d75: posts big blind $0.1
*** HOLE CARDS ***
Dealt to f6f7c205 
Dealt to Hero [2h 5s]
Dealt to fe8e9d75 
Dealt to 243279ca 
Dealt to 2a18e7b3 
Dealt to 1ba2affc 
243279ca: folds
2a18e7b3: raises $0.15 to $0.25
1ba2affc: folds
f6f7c205: folds
Hero: folds
fe8e9d75: folds
Uncalled bet ($0.15) returned to 2a18e7b3
*** SHOWDOWN ***
2a18e7b3 collected $0.25 from pot
*** SUMMARY ***
Total pot $0.25 | Rake $0 | Jackpot $0 | Bingo $0 | Fortune $0 | Tax $0
Seat 1: f6f7c205 (button) folded before Flop (didn't bet)
Seat 2: Hero (small blind) folded before Flop
Seat 3: fe8e9d75 (big blind) folded before Flop
Seat 4: 243279ca folded before Flop (didn't bet)
Seat 5: 2a18e7b3 collected ($0.25)
Seat 6: 1ba2affc folded before Flop (didn't bet)


Poker Hand #RC2075550737: Hold'em No Limit ($0.05/$0.1) - 2023/12/21 23:26:16
Table 'RushAndCash289459' 6-max Seat #1 is the button
Seat 1: e0e638e8 ($9.14 in chips)
Seat 2: 3e1b51f7 ($10.37 in chips)
Seat 3: 2b26e2a3 ($21.53 in chips)
Seat 4: 62f9eb28 ($6.29 in chips)
Seat 5: Hero ($15.3 in chips)
Seat 6: 9ffe5b45 ($9.79 in chips)
3e1b51f7: posts small blind $0.05
2b26e2a3: posts big blind $0.1
*** HOLE CARDS ***
Dealt to e0e638e8 
Dealt to 3e1b51f7 
Dealt to 2b26e2a3 
Dealt to 62f9eb28 
Dealt to Hero [8c Tc]
Dealt to 9ffe5b45 
62f9eb28: folds
Hero: folds
9ffe5b45: raises $0.1 to $0.2
e0e638e8: raises $0.55 to $0.75
3e1b51f7: folds
2b26e2a3: folds
9ffe5b45: folds
Uncalled bet ($0.55) returned to e0e638e8
*** SHOWDOWN ***
e0e638e8 collected $0.53 from pot
*** SUMMARY ***
Total pot $0.55 | Rake $0.02 | Jackpot $0 | Bingo $0 | Fortune $0 | Tax $0
Seat 1: e0e638e8 (button) collected ($0.53)
Seat 2: 3e1b51f7 (small blind) folded before Flop
Seat 3: 2b26e2a3 (big blind) folded before Flop
Seat 4: 62f9eb28 folded before Flop (didn't bet)
Seat 5: Hero folded before Flop (didn't bet)
Seat 6: 9ffe5b45 folded before Flop


Poker Hand #RC2075550634: Hold'em No Limit ($0.05/$0.1) - 2023/12/21 23:26:11
Table 'RushAndCash289399' 6-max Seat #1 is the button
Seat 1: 6f725eb5 ($12.18 in chips)
Seat 2: abc8ed7f ($10 in chips)
Seat 3: 1bcbba55 ($11.91 in chips)
Seat 4: b14398ca ($17.23 in chips)
Seat 5: Hero ($15.3 in chips)
Seat 6: 8b9c060b ($16.99 in chips)
abc8ed7f: posts small blind $0.05
1bcbba55: posts big blind $0.1
*** HOLE CARDS ***
Dealt to 6f725eb5 
Dealt to abc8ed7f 
Dealt to 1bcbba55 
Dealt to b14398ca 
Dealt to Hero [Ad 5c]
Dealt to 8b9c060b 
b14398ca: raises $0.12 to $0.22
Hero: folds
8b9c060b: folds
6f725eb5: folds
abc8ed7f: folds
1bcbba55: folds
Uncalled bet ($0.12) returned to b14398ca
*** SHOWDOWN ***
b14398ca collected $0.25 from pot
*** SUMMARY ***
Total pot $0.25 | Rake $0 | Jackpot $0 | Bingo $0 | Fortune $0 | Tax $0
Seat 1: 6f725eb5 (button) folded before Flop (didn't bet)
Seat 2: abc8ed7f (small blind) folded before Flop
Seat 3: 1bcbba55 (big blind) folded before Flop
Seat 4: b14398ca collected ($0.25)
Seat 5: Hero folded before Flop (didn't bet)
Seat 6: 8b9c060b folded before Flop (didn't bet)


Poker Hand #RC2075550542: Hold'em No Limit ($0.05/$0.1) - 2023/12/21 23:26:07
Table 'RushAndCash289344' 6-max Seat #1 is the button
Seat 1: abed12f5 ($10.04 in chips)
Seat 2: 64564506 ($7.45 in chips)
Seat 3: 1c74df9b ($10.3 in chips)
Seat 4: 1f60f6b4 ($10.23 in chips)
Seat 5: c3b054d5 ($19.62 in chips)
Seat 6: Hero ($15.3 in chips)
64564506: posts small blind $0.05
1c74df9b: posts big blind $0.1
*** HOLE CARDS ***
Dealt to abed12f5 
Dealt to 64564506 
Dealt to 1c74df9b 
Dealt to 1f60f6b4 
Dealt to c3b054d5 
Dealt to Hero [9h 2h]
1f60f6b4: folds
c3b054d5: folds
Hero: folds
abed12f5: raises $0.2 to $0.3
64564506: folds
1c74df9b: calls $0.2
*** FLOP *** [5c Jd Qh]
1c74df9b: checks
abed12f5: bets $0.22
1c74df9b: calls $0.22
*** TURN *** [5c Jd Qh] [6h]
1c74df9b: checks
abed12f5: checks
*** RIVER *** [5c Jd Qh 6h] [Ah]
1c74df9b: bets $0.82
abed12f5: folds
Uncalled bet ($0.82) returned to 1c74df9b
*** SHOWDOWN ***
1c74df9b collected $1.04 from pot
*** SUMMARY ***
Total pot $1.09 | Rake $0.05 | Jackpot $0 | Bingo $0 | Fortune $0 | Tax $0
Board [5c Jd Qh 6h Ah]
Seat 1: abed12f5 (button) folded on the River
Seat 2: 64564506 (small blind) folded before Flop
Seat 3: 1c74df9b (big blind) won ($1.04)
Seat 4: 1f60f6b4 folded before Flop (didn't bet)
Seat 5: c3b054d5 folded before Flop (didn't bet)
Seat 6: Hero folded before Flop (didn't bet)


Poker Hand #RC2075550461: Hold'em No Limit ($0.05/$0.1) - 2023/12/21 23:26:04
Table 'RushAndCash289295' 6-max Seat #1 is the button
Seat 1: Hero ($15.3 in chips)
Seat 2: 3fe573ce ($14.19 in chips)
Seat 3: d8d6bf23 ($23.89 in chips)
Seat 4: 8644076 ($10.52 in chips)
Seat 5: 512705f5 ($5.33 in chips)
Seat 6: 86a73692 ($3.55 in chips)
3fe573ce: posts small blind $0.05
d8d6bf23: posts big blind $0.1
*** HOLE CARDS ***
Dealt to Hero [9h Td]
Dealt to 3fe573ce 
Dealt to d8d6bf23 
Dealt to 8644076 
Dealt to 512705f5 
Dealt to 86a73692 
8644076: folds
512705f5: folds
86a73692: folds
Hero: folds
3fe573ce: folds
Uncalled bet ($0.05) returned to d8d6bf23
*** SHOWDOWN ***
d8d6bf23 collected $0.1 from pot
*** SUMMARY ***
Total pot $0.1 | Rake $0 | Jackpot $0 | Bingo $0 | Fortune $0 | Tax $0
Seat 1: Hero (button) folded before Flop (didn't bet)
Seat 2: 3fe573ce (small blind) folded before Flop
Seat 3: d8d6bf23 (big blind) collected ($0.1)
Seat 4: 8644076 folded before Flop (didn't bet)
Seat 5: 512705f5 folded before Flop (didn't bet)
Seat 6: 86a73692 folded before Flop (didn't bet)


Poker Hand #RC2075550377: Hold'em No Limit ($0.05/$0.1) - 2023/12/21 23:26:00
Table 'RushAndCash289245' 6-max Seat #1 is the button
Seat 1: 7c19ab27 ($18 in chips)
Seat 2: 1816bbd5 ($10.64 in chips)
Seat 3: 6fedba16 ($11.11 in chips)
Seat 4: 3950a5bd ($2.66 in chips)
Seat 5: Hero ($15.3 in chips)
Seat 6: 4c977855 ($10 in chips)
1816bbd5: posts small blind $0.05
6fedba16: posts big blind $0.1
*** HOLE CARDS ***
Dealt to 7c19ab27 
Dealt to 1816bbd5 
Dealt to 6fedba16 
Dealt to 3950a5bd 
Dealt to Hero [Ts 4h]
Dealt to 4c977855 
3950a5bd: folds
Hero: folds
4c977855: folds
7c19ab27: raises $0.1 to $0.2
1816bbd5: folds
6fedba16: folds
Uncalled bet ($0.1) returned to 7c19ab27
*** SHOWDOWN ***
7c19ab27 collected $0.25 from pot
*** SUMMARY ***
Total pot $0.25 | Rake $0 | Jackpot $0 | Bingo $0 | Fortune $0 | Tax $0
Seat 1: 7c19ab27 (button) collected ($0.25)
Seat 2: 1816bbd5 (small blind) folded before Flop
Seat 3: 6fedba16 (big blind) folded before Flop
Seat 4: 3950a5bd folded before Flop (didn't bet)
Seat 5: Hero folded before Flop (didn't bet)
Seat 6: 4c977855 folded before Flop (didn't bet)


Poker Hand #RC2075550214: Hold'em No Limit ($0.05/$0.1) - 2023/12/21 23:25:53
Table 'RushAndCash289148' 6-max Seat #1 is the button
Seat 1: 68618e34 ($14.67 in chips)
Seat 2: a15f9181 ($10.52 in chips)
Seat 3: Hero ($15.25 in chips)
Seat 4: f83f639e ($11.89 in chips)
Seat 5: a16f0fb4 ($11.75 in chips)
Seat 6: bc69bf06 ($11.54 in chips)
a15f9181: posts small blind $0.05
Hero: posts big blind $0.1
*** HOLE CARDS ***
Dealt to 68618e34 
Dealt to a15f9181 
Dealt to Hero [Js 8s]
Dealt to f83f639e 
Dealt to a16f0fb4 
Dealt to bc69bf06 
f83f639e: folds
a16f0fb4: folds
bc69bf06: folds
68618e34: folds
a15f9181: folds
Uncalled bet ($0.05) returned to Hero
*** SHOWDOWN ***
Hero collected $0.1 from pot
*** SUMMARY ***
Total pot $0.1 | Rake $0 | Jackpot $0 | Bingo $0 | Fortune $0 | Tax $0
Seat 1: 68618e34 (button) folded before Flop (didn't bet)
Seat 2: a15f9181 (small blind) folded before Flop
Seat 3: Hero (big blind) collected ($0.1)
Seat 4: f83f639e folded before Flop (didn't bet)
Seat 5: a16f0fb4 folded before Flop (didn't bet)
Seat 6: bc69bf06 folded before Flop (didn't bet)


Poker Hand #RC2075550034: Hold'em No Limit ($0.05/$0.1) - 2023/12/21 23:25:46
Table 'RushAndCash289042' 6-max Seat #1 is the button
Seat 1: d5044a83 ($11.93 in chips)
Seat 2: Hero ($15.3 in chips)
Seat 3: 85c63a5f ($19.49 in chips)
Seat 4: 7ddc107 ($10 in chips)
Seat 5: f7c771a0 ($10 in chips)
Seat 6: 39be4c64 ($2.89 in chips)
Hero: posts small blind $0.05
85c63a5f: posts big blind $0.1
*** HOLE CARDS ***
Dealt to d5044a83 
Dealt to Hero [4d Qs]
Dealt to 85c63a5f 
Dealt to 7ddc107 
Dealt to f7c771a0 
Dealt to 39be4c64 
7ddc107: folds
f7c771a0: folds
39be4c64: folds
d5044a83: raises $0.12 to $0.22
Hero: folds
85c63a5f: folds
Uncalled bet ($0.12) returned to d5044a83
*** SHOWDOWN ***
d5044a83 collected $0.25 from pot
*** SUMMARY ***
Total pot $0.25 | Rake $0 | Jackpot $0 | Bingo $0 | Fortune $0 | Tax $0
Seat 1: d5044a83 (button) collected ($0.25)
Seat 2: Hero (small blind) folded before Flop
Seat 3: 85c63a5f (big blind) folded before Flop
Seat 4: 7ddc107 folded before Flop (didn't bet)
Seat 5: f7c771a0 folded before Flop (didn't bet)
Seat 6: 39be4c64 folded before Flop (didn't bet)


Poker Hand #RC2075549855: Hold'em No Limit ($0.05/$0.1) - 2023/12/21 23:25:39
Table 'RushAndCash288940' 6-max Seat #1 is the button
Seat 1: Hero ($15.3 in chips)
Seat 2: 3950a5bd ($2.81 in chips)
Seat 3: 220d2aa5 ($8.97 in chips)
Seat 4: 2a653cf2 ($12.55 in chips)
Seat 5: 7ba8aae3 ($12.08 in chips)
Seat 6: a38504a2 ($20.15 in chips)
3950a5bd: posts small blind $0.05
220d2aa5: posts big blind $0.1
*** HOLE CARDS ***
Dealt to Hero [Kd 2d]
Dealt to 3950a5bd 
Dealt to 220d2aa5 
Dealt to 2a653cf2 
Dealt to 7ba8aae3 
Dealt to a38504a2 
2a653cf2: folds
7ba8aae3: raises $0.12 to $0.22
a38504a2: folds
Hero: folds
3950a5bd: folds
220d2aa5: folds
Uncalled bet ($0.12) returned to 7ba8aae3
*** SHOWDOWN ***
7ba8aae3 collected $0.25 from pot
*** SUMMARY ***
Total pot $0.25 | Rake $0 | Jackpot $0 | Bingo $0 | Fortune $0 | Tax $0
Seat 1: Hero (button) folded before Flop (didn't bet)
Seat 2: 3950a5bd (small blind) folded before Flop
Seat 3: 220d2aa5 (big blind) folded before Flop
Seat 4: 2a653cf2 folded before Flop (didn't bet)
Seat 5: 7ba8aae3 collected ($0.25)
Seat 6: a38504a2 folded before Flop (didn't bet)


Poker Hand #RC2075549741: Hold'em No Limit ($0.05/$0.1) - 2023/12/21 23:25:34
Table 'RushAndCash288872' 6-max Seat #1 is the button
Seat 1: fadc397c ($10 in chips)
Seat 2: 8306c9ce ($14.6 in chips)
Seat 3: 7032505e ($14.21 in chips)
Seat 4: af11633d ($14 in chips)
Seat 5: Hero ($15.3 in chips)
Seat 6: 968686f2 ($12.09 in chips)
8306c9ce: posts small blind $0.05
7032505e: posts big blind $0.1
*** HOLE CARDS ***
Dealt to fadc397c 
Dealt to 8306c9ce 
Dealt to 7032505e 
Dealt to af11633d 
Dealt to Hero [6c 5h]
Dealt to 968686f2 
af11633d: folds
Hero: folds
968686f2: raises $0.1 to $0.2
fadc397c: folds
8306c9ce: calls $0.15
7032505e: folds
*** FLOP *** [6s 7c 5d]
8306c9ce: checks
968686f2: bets $0.38
8306c9ce: calls $0.38
*** TURN *** [6s 7c 5d] [Kh]
8306c9ce: bets $0.95
968686f2: raises $2.37 to $3.32
8306c9ce: calls $2.37
*** RIVER *** [6s 7c 5d Kh] [4d]
8306c9ce: bets $7.9
968686f2: calls $7.9
8306c9ce: shows [3h 6h] (Sevens-High Straight)
968686f2: shows [7d 7s] (Three Sevens)
*** SHOWDOWN ***
8306c9ce collected $23.25 from pot
*** SUMMARY ***
Total pot $23.7 | Rake $0.3 | Jackpot $0.15 | Bingo $0 | Fortune $0 | Tax $0
Board [6s 7c 5d Kh 4d]
Seat 1: fadc397c (button) folded before Flop (didn't bet)
Seat 2: 8306c9ce (small blind) showed [3h 6h] and won ($23.25) with Sevens-High Straight
Seat 3: 7032505e (big blind) folded before Flop
Seat 4: af11633d folded before Flop (didn't bet)
Seat 5: Hero folded before Flop (didn't bet)
Seat 6: 968686f2 showed [7d 7s] and lost with Three Sevens


Poker Hand #RC2075549253: Hold'em No Limit ($0.05/$0.1) - 2023/12/21 23:25:14
Table 'RushAndCash288580' 6-max Seat #1 is the button
Seat 1: f1aa9829 ($10 in chips)
Seat 2: Hero ($15.02 in chips)
Seat 3: 1ecdc13c ($15.41 in chips)
Seat 4: 4d3be08a ($13.64 in chips)
Seat 5: ba2c88e ($10 in chips)
Seat 6: 968686f2 ($12.29 in chips)
Hero: posts small blind $0.05
1ecdc13c: posts big blind $0.1
*** HOLE CARDS ***
Dealt to f1aa9829 
Dealt to Hero [Ad Qs]
Dealt to 1ecdc13c 
Dealt to 4d3be08a 
Dealt to ba2c88e 
Dealt to 968686f2 
4d3be08a: folds
ba2c88e: folds
968686f2: raises $0.1 to $0.2
f1aa9829: folds
Hero: raises $0.7 to $0.9
1ecdc13c: folds
968686f2: folds
Uncalled bet ($0.7) returned to Hero
*** SHOWDOWN ***
Hero collected $0.48 from pot
*** SUMMARY ***
Total pot $0.5 | Rake $0.02 | Jackpot $0 | Bingo $0 | Fortune $0 | Tax $0
Seat 1: f1aa9829 (button) folded before Flop (didn't bet)
Seat 2: Hero (small blind) collected ($0.48)
Seat 3: 1ecdc13c (big blind) folded before Flop
Seat 4: 4d3be08a folded before Flop (didn't bet)
Seat 5: ba2c88e folded before Flop (didn't bet)
Seat 6: 968686f2 folded before Flop


Poker Hand #RC2075549161: Hold'em No Limit ($0.05/$0.1) - 2023/12/21 23:25:10
Table 'RushAndCash288530' 6-max Seat #1 is the button
Seat 1: a6f943cb ($8.29 in chips)
Seat 2: 2ca8cd2b ($13.84 in chips)
Seat 3: Hero ($15.12 in chips)
Seat 4: 78c7c224 ($10.45 in chips)
Seat 5: 86ea73e6 ($14.84 in chips)
Seat 6: f06f155f ($23.48 in chips)
2ca8cd2b: posts small blind $0.05
Hero: posts big blind $0.1
*** HOLE CARDS ***
Dealt to a6f943cb 
Dealt to 2ca8cd2b 
Dealt to Hero [3d 5c]
Dealt to 78c7c224 
Dealt to 86ea73e6 
Dealt to f06f155f 
78c7c224: folds
86ea73e6: folds
f06f155f: raises $0.15 to $0.25
a6f943cb: folds
2ca8cd2b: calls $0.2
Hero: folds
*** FLOP *** [7h Qh Kc]
2ca8cd2b: checks
f06f155f: checks
*** TURN *** [7h Qh Kc] [Jh]
2ca8cd2b: checks
f06f155f: checks
*** RIVER *** [7h Qh Kc Jh] [2d]
2ca8cd2b: checks
f06f155f: checks
2ca8cd2b: shows [6s As] (Ace-High)
f06f155f: shows [8d 8s] (Pair of Eights)
*** SHOWDOWN ***
f06f155f collected $0.57 from pot
*** SUMMARY ***
Total pot $0.6 | Rake $0.03 | Jackpot $0 | Bingo $0 | Fortune $0 | Tax $0
Board [7h Qh Kc Jh 2d]
Seat 1: a6f943cb (button) folded before Flop (didn't bet)
Seat 2: 2ca8cd2b (small blind) showed [6s As] and lost with Ace-High
Seat 3: Hero (big blind) folded before Flop
Seat 4: 78c7c224 folded before Flop (didn't bet)
Seat 5: 86ea73e6 folded before Flop (didn't bet)
Seat 6: f06f155f showed [8d 8s] and won ($0.57) with Pair of Eights


Poker Hand #RC2075549076: Hold'em No Limit ($0.05/$0.1) - 2023/12/21 23:25:07
Table 'RushAndCash288484' 6-max Seat #1 is the button
Seat 1: 6fce0d8a ($10.15 in chips)
Seat 2: 8932199d ($14.5 in chips)
Seat 3: aadfcfc ($10 in chips)
Seat 4: 208f9b4d ($10 in chips)
Seat 5: a59a2f88 ($17.03 in chips)
Seat 6: Hero ($15.12 in chips)
8932199d: posts small blind $0.05
aadfcfc: posts big blind $0.1
*** HOLE CARDS ***
Dealt to 6fce0d8a 
Dealt to 8932199d 
Dealt to aadfcfc 
Dealt to 208f9b4d 
Dealt to a59a2f88 
Dealt to Hero [4d 7s]
208f9b4d: folds
a59a2f88: folds
Hero: folds
6fce0d8a: folds
8932199d: folds
Uncalled bet ($0.05) returned to aadfcfc
*** SHOWDOWN ***
aadfcfc collected $0.1 from pot
*** SUMMARY ***
Total pot $0.1 | Rake $0 | Jackpot $0 | Bingo $0 | Fortune $0 | Tax $0
Seat 1: 6fce0d8a (button) folded before Flop (didn't bet)
Seat 2: 8932199d (small blind) folded before Flop
Seat 3: aadfcfc (big blind) collected ($0.1)
Seat 4: 208f9b4d folded before Flop (didn't bet)
Seat 5: a59a2f88 folded before Flop (didn't bet)
Seat 6: Hero folded before Flop (didn't bet)


Poker Hand #RC2075549002: Hold'em No Limit ($0.05/$0.1) - 2023/12/21 23:25:03
Table 'RushAndCash288445' 6-max Seat #1 is the button
Seat 1: 304c14cf ($22.06 in chips)
Seat 2: dc46972c ($18.88 in chips)
Seat 3: 50d5f1f7 ($13.6 in chips)
Seat 4: edf421c0 ($12.06 in chips)
Seat 5: 22bdafa1 ($11.28 in chips)
Seat 6: Hero ($15.12 in chips)
dc46972c: posts small blind $0.05
50d5f1f7: posts big blind $0.1
*** HOLE CARDS ***
Dealt to 304c14cf 
Dealt to dc46972c 
Dealt to 50d5f1f7 
Dealt to edf421c0 
Dealt to 22bdafa1 
Dealt to Hero [5d Th]
edf421c0: folds
22bdafa1: folds
Hero: folds
304c14cf: raises $0.15 to $0.25
dc46972c: calls $0.2
50d5f1f7: raises $1.15 to $1.4
304c14cf: folds
dc46972c: folds
Uncalled bet ($1.15) returned to 50d5f1f7
*** SHOWDOWN ***
50d5f1f7 collected $0.72 from pot
*** SUMMARY ***
Total pot $0.75 | Rake $0.03 | Jackpot $0 | Bingo $0 | Fortune $0 | Tax $0
Seat 1: 304c14cf (button) folded before Flop
Seat 2: dc46972c (small blind) folded before Flop
Seat 3: 50d5f1f7 (big blind) collected ($0.72)
Seat 4: edf421c0 folded before Flop (didn't bet)
Seat 5: 22bdafa1 folded before Flop (didn't bet)
Seat 6: Hero folded before Flop (didn't bet)


Poker Hand #RC2075548908: Hold'em No Limit ($0.05/$0.1) - 2023/12/21 23:24:59
Table 'RushAndCash288392' 6-max Seat #1 is the button
Seat 1: 37598c58 ($10.71 in chips)
Seat 2: 81ae9e4e ($9.86 in chips)
Seat 3: 387a6e45 ($7.93 in chips)
Seat 4: Hero ($15.12 in chips)
Seat 5: 78c7c224 ($10.45 in chips)
Seat 6: ab7ba7a2 ($9.66 in chips)
81ae9e4e: posts small blind $0.05
387a6e45: posts big blind $0.1
*** HOLE CARDS ***
Dealt to 37598c58 
Dealt to 81ae9e4e 
Dealt to 387a6e45 
Dealt to Hero [3c 8s]
Dealt to 78c7c224 
Dealt to ab7ba7a2 
Hero: folds
78c7c224: folds
ab7ba7a2: folds
37598c58: raises $0.12 to $0.22
81ae9e4e: calls $0.17
387a6e45: folds
*** FLOP *** [8h 4h As]
81ae9e4e: checks
37598c58: bets $0.3
81ae9e4e: folds
Uncalled bet ($0.3) returned to 37598c58
*** SHOWDOWN ***
37598c58 collected $0.52 from pot
*** SUMMARY ***
Total pot $0.54 | Rake $0.02 | Jackpot $0 | Bingo $0 | Fortune $0 | Tax $0
Board [8h 4h As]
Seat 1: 37598c58 (button) won ($0.52)
Seat 2: 81ae9e4e (small blind) folded on the Flop
Seat 3: 387a6e45 (big blind) folded before Flop
Seat 4: Hero folded before Flop (didn't bet)
Seat 5: 78c7c224 folded before Flop (didn't bet)
Seat 6: ab7ba7a2 folded before Flop (didn't bet)


Poker Hand #RC2075548778: Hold'em No Limit ($0.05/$0.1) - 2023/12/21 23:24:54
Table 'RushAndCash288320' 6-max Seat #1 is the button
Seat 1: 2e53f43e ($12.18 in chips)
Seat 2: 6e8a349a ($13.71 in chips)
Seat 3: daa23460 ($19.85 in chips)
Seat 4: ac687723 ($10 in chips)
Seat 5: Hero ($15.12 in chips)
Seat 6: 12ed0b3f ($14.46 in chips)
6e8a349a: posts small blind $0.05
daa23460: posts big blind $0.1
*** HOLE CARDS ***
Dealt to 2e53f43e 
Dealt to 6e8a349a 
Dealt to daa23460 
Dealt to ac687723 
Dealt to Hero [Kh 4d]
Dealt to 12ed0b3f 
ac687723: raises $0.15 to $0.25
Hero: folds
12ed0b3f: folds
2e53f43e: folds
6e8a349a: folds
daa23460: folds
Uncalled bet ($0.15) returned to ac687723
*** SHOWDOWN ***
ac687723 collected $0.25 from pot
*** SUMMARY ***
Total pot $0.25 | Rake $0 | Jackpot $0 | Bingo $0 | Fortune $0 | Tax $0
Seat 1: 2e53f43e (button) folded before Flop (didn't bet)
Seat 2: 6e8a349a (small blind) folded before Flop
Seat 3: daa23460 (big blind) folded before Flop
Seat 4: ac687723 collected ($0.25)
Seat 5: Hero folded before Flop (didn't bet)
Seat 6: 12ed0b3f folded before Flop (didn't bet)


Poker Hand #RC2075548549: Hold'em No Limit ($0.05/$0.1) - 2023/12/21 23:24:45
Table 'RushAndCash288184' 6-max Seat #1 is the button
Seat 1: 70a4e509 ($6.87 in chips)
Seat 2: Hero ($15.17 in chips)
Seat 3: 593dd101 ($11.11 in chips)
Seat 4: a7e691c9 ($10.82 in chips)
Seat 5: 3ab01d16 ($15.1 in chips)
Seat 6: d75ec491 ($10 in chips)
Hero: posts small blind $0.05
593dd101: posts big blind $0.1
*** HOLE CARDS ***
Dealt to 70a4e509 
Dealt to Hero [Kd 4c]
Dealt to 593dd101 
Dealt to a7e691c9 
Dealt to 3ab01d16 
Dealt to d75ec491 
a7e691c9: folds
3ab01d16: folds
d75ec491: folds
70a4e509: folds
Hero: folds
Uncalled bet ($0.05) returned to 593dd101
*** SHOWDOWN ***
593dd101 collected $0.1 from pot
*** SUMMARY ***
Total pot $0.1 | Rake $0 | Jackpot $0 | Bingo $0 | Fortune $0 | Tax $0
Seat 1: 70a4e509 (button) folded before Flop (didn't bet)
Seat 2: Hero (small blind) folded before Flop
Seat 3: 593dd101 (big blind) collected ($0.1)
Seat 4: a7e691c9 folded before Flop (didn't bet)
Seat 5: 3ab01d16 folded before Flop (didn't bet)
Seat 6: d75ec491 folded before Flop (didn't bet)


Poker Hand #RC2075548308: Hold'em No Limit ($0.05/$0.1) - 2023/12/21 23:24:35
Table 'RushAndCash288036' 6-max Seat #1 is the button
Seat 1: cd66a58b ($13.06 in chips)
Seat 2: 6dcaef45 ($9.9 in chips)
Seat 3: Hero ($15.27 in chips)
Seat 4: 835eed05 ($17.76 in chips)
Seat 5: a602cbad ($36.09 in chips)
Seat 6: d21c8de ($15.31 in chips)
6dcaef45: posts small blind $0.05
Hero: posts big blind $0.1
*** HOLE CARDS ***
Dealt to cd66a58b 
Dealt to 6dcaef45 
Dealt to Hero [Ah 3c]
Dealt to 835eed05 
Dealt to a602cbad 
Dealt to d21c8de 
835eed05: folds
a602cbad: folds
d21c8de: folds
cd66a58b: raises $0.15 to $0.25
6dcaef45: folds
Hero: folds
Uncalled bet ($0.15) returned to cd66a58b
*** SHOWDOWN ***
cd66a58b collected $0.25 from pot
*** SUMMARY ***
Total pot $0.25 | Rake $0 | Jackpot $0 | Bingo $0 | Fortune $0 | Tax $0
Seat 1: cd66a58b (button) collected ($0.25)
Seat 2: 6dcaef45 (small blind) folded before Flop
Seat 3: Hero (big blind) folded before Flop
Seat 4: 835eed05 folded before Flop (didn't bet)
Seat 5: a602cbad folded before Flop (didn't bet)
Seat 6: d21c8de folded before Flop (didn't bet)


Poker Hand #RC2075548161: Hold'em No Limit ($0.05/$0.1) - 2023/12/21 23:24:29
Table 'RushAndCash287948' 6-max Seat #1 is the button
Seat 1: Hero ($15.27 in chips)
Seat 2: deaad42c ($8.19 in chips)
Seat 3: e1e5daa1 ($13.41 in chips)
Seat 4: 56730e2d ($21.37 in chips)
Seat 5: c5694eb2 ($39.27 in chips)
Seat 6: c3c2420 ($10.38 in chips)
deaad42c: posts small blind $0.05
e1e5daa1: posts big blind $0.1
*** HOLE CARDS ***
Dealt to Hero [Ks Tc]
Dealt to deaad42c 
Dealt to e1e5daa1 
Dealt to 56730e2d 
Dealt to c5694eb2 
Dealt to c3c2420 
56730e2d: raises $0.15 to $0.25
c5694eb2: folds
c3c2420: folds
Hero: folds
deaad42c: folds
e1e5daa1: calls $0.15
*** FLOP *** [5d 9s 3h]
e1e5daa1: checks
56730e2d: checks
*** TURN *** [5d 9s 3h] [4d]
e1e5daa1: checks
56730e2d: checks
*** RIVER *** [5d 9s 3h 4d] [7s]
e1e5daa1: checks
56730e2d: checks
e1e5daa1: shows [7d Kd] (Pair of Sevens)
56730e2d: shows [Ah Qc] (Ace-High)
*** SHOWDOWN ***
e1e5daa1 collected $0.53 from pot
*** SUMMARY ***
Total pot $0.55 | Rake $0.02 | Jackpot $0 | Bingo $0 | Fortune $0 | Tax $0
Board [5d 9s 3h 4d 7s]
Seat 1: Hero (button) folded before Flop (didn't bet)
Seat 2: deaad42c (small blind) folded before Flop
Seat 3: e1e5daa1 (big blind) showed [7d Kd] and won ($0.53) with Pair of Sevens
Seat 4: 56730e2d showed [Ah Qc] and lost with Ace-High
Seat 5: c5694eb2 folded before Flop (didn't bet)
Seat 6: c3c2420 folded before Flop (didn't bet)


Poker Hand #RC2075548075: Hold'em No Limit ($0.05/$0.1) - 2023/12/21 23:24:25
Table 'RushAndCash287897' 6-max Seat #1 is the button
Seat 1: f06f155f ($23.48 in chips)
Seat 2: 1ae739bb ($11.94 in chips)
Seat 3: d379457a ($10.01 in chips)
Seat 4: Hero ($15.27 in chips)
Seat 5: 853fd2b7 ($26.34 in chips)
Seat 6: 98ccc29 ($10 in chips)
1ae739bb: posts small blind $0.05
d379457a: posts big blind $0.1
*** HOLE CARDS ***
Dealt to f06f155f 
Dealt to 1ae739bb 
Dealt to d379457a 
Dealt to Hero [Qc 3s]
Dealt to 853fd2b7 
Dealt to 98ccc29 
Hero: folds
853fd2b7: raises $0.15 to $0.25
98ccc29: raises $0.49 to $0.74
f06f155f: folds
1ae739bb: folds
d379457a: folds
853fd2b7: calls $0.49
*** FLOP *** [7c Th Jc]
853fd2b7: checks
98ccc29: checks
*** TURN *** [7c Th Jc] [7h]
853fd2b7: checks
98ccc29: bets $0.82
853fd2b7: folds
Uncalled bet ($0.82) returned to 98ccc29
*** SHOWDOWN ***
98ccc29 collected $1.55 from pot
*** SUMMARY ***
Total pot $1.63 | Rake $0.08 | Jackpot $0 | Bingo $0 | Fortune $0 | Tax $0
Board [7c Th Jc 7h]
Seat 1: f06f155f (button) folded before Flop (didn't bet)
Seat 2: 1ae739bb (small blind) folded before Flop
Seat 3: d379457a (big blind) folded before Flop
Seat 4: Hero folded before Flop (didn't bet)
Seat 5: 853fd2b7 folded on the Turn
Seat 6: 98ccc29 won ($1.55)


Poker Hand #RC2075547951: Hold'em No Limit ($0.05/$0.1) - 2023/12/21 23:24:20
Table 'RushAndCash287827' 6-max Seat #1 is the button
Seat 1: eec070aa ($8.29 in chips)
Seat 2: 8021b10d ($10.34 in chips)
Seat 3: bcfefb74 ($10.32 in chips)
Seat 4: Hero ($15.27 in chips)
Seat 5: 6790cdfe ($9.66 in chips)
Seat 6: e873eecf ($6.01 in chips)
8021b10d: posts small blind $0.05
bcfefb74: posts big blind $0.1
*** HOLE CARDS ***
Dealt to eec070aa 
Dealt to 8021b10d 
Dealt to bcfefb74 
Dealt to Hero [4s 3c]
Dealt to 6790cdfe 
Dealt to e873eecf 
Hero: folds
6790cdfe: folds
e873eecf: folds
eec070aa: folds
8021b10d: folds
Uncalled bet ($0.05) returned to bcfefb74
*** SHOWDOWN ***
bcfefb74 collected $0.1 from pot
*** SUMMARY ***
Total pot $0.1 | Rake $0 | Jackpot $0 | Bingo $0 | Fortune $0 | Tax $0
Seat 1: eec070aa (button) folded before Flop (didn't bet)
Seat 2: 8021b10d (small blind) folded before Flop
Seat 3: bcfefb74 (big blind) collected ($0.1)
Seat 4: Hero folded before Flop (didn't bet)
Seat 5: 6790cdfe folded before Flop (didn't bet)
Seat 6: e873eecf folded before Flop (didn't bet)


Poker Hand #RC2075547628: Hold'em No Limit ($0.05/$0.1) - 2023/12/21 23:24:07
Table 'RushAndCash287641' 6-max Seat #1 is the button
Seat 1: 677e2427 ($9.34 in chips)
Seat 2: Hero ($15.32 in chips)
Seat 3: e329e1e4 ($10.23 in chips)
Seat 4: e32fa9f2 ($10.83 in chips)
Seat 5: edf421c0 ($12.33 in chips)
Seat 6: afb9feea ($18.49 in chips)
Hero: posts small blind $0.05
e329e1e4: posts big blind $0.1
*** HOLE CARDS ***
Dealt to 677e2427 
Dealt to Hero [4c Kc]
Dealt to e329e1e4 
Dealt to e32fa9f2 
Dealt to edf421c0 
Dealt to afb9feea 
e32fa9f2: folds
edf421c0: folds
afb9feea: raises $0.15 to $0.25
677e2427: folds
Hero: folds
e329e1e4: calls $0.15
*** FLOP *** [3h 5h Tc]
e329e1e4: checks
afb9feea: bets $0.37
e329e1e4: raises $0.69 to $1.06
afb9feea: calls $0.69
*** TURN *** [3h 5h Tc] [8d]
e329e1e4: bets $1.77
afb9feea: calls $1.77
*** RIVER *** [3h 5h Tc 8d] [5c]
e329e1e4: checks
afb9feea: checks
e329e1e4: shows [Ah 7h] (Pair of Fives)
afb9feea: shows [Th Qh] (Pair of Tens and Pair of Fives)
*** SHOWDOWN ***
afb9feea collected $5.7 from pot
*** SUMMARY ***
Total pot $6.21 | Rake $0.36 | Jackpot $0.15 | Bingo $0 | Fortune $0 | Tax $0
Board [3h 5h Tc 8d 5c]
Seat 1: 677e2427 (button) folded before Flop (didn't bet)
Seat 2: Hero (small blind) folded before Flop
Seat 3: e329e1e4 (big blind) showed [Ah 7h] and lost with Pair of Fives
Seat 4: e32fa9f2 folded before Flop (didn't bet)
Seat 5: edf421c0 folded before Flop (didn't bet)
Seat 6: afb9feea showed [Th Qh] and won ($5.7) with Pair of Tens and Pair of Fives


Poker Hand #RC2075546441: Hold'em No Limit ($0.05/$0.1) - 2023/12/21 23:23:17
Table 'RushAndCash286951' 6-max Seat #1 is the button
Seat 1: f168df8e ($13.49 in chips)
Seat 2: 2d32f8f3 ($17.47 in chips)
Seat 3: Hero ($15.04 in chips)
Seat 4: d3434562 ($27.38 in chips)
Seat 5: 677e2427 ($9.59 in chips)
Seat 6: a0c90946 ($27.32 in chips)
2d32f8f3: posts small blind $0.05
Hero: posts big blind $0.1
*** HOLE CARDS ***
Dealt to f168df8e 
Dealt to 2d32f8f3 
Dealt to Hero [Th Kd]
Dealt to d3434562 
Dealt to 677e2427 
Dealt to a0c90946 
d3434562: folds
677e2427: raises $0.15 to $0.25
a0c90946: folds
f168df8e: folds
2d32f8f3: folds
Hero: calls $0.15
*** FLOP *** [5s Qc Tc]
Hero: checks
677e2427: checks
*** TURN *** [5s Qc Tc] [2d]
Hero: checks
677e2427: checks
*** RIVER *** [5s Qc Tc 2d] [Ks]
Hero: bets $0.28
677e2427: folds
Uncalled bet ($0.28) returned to Hero
*** SHOWDOWN ***
Hero collected $0.53 from pot
*** SUMMARY ***
Total pot $0.55 | Rake $0.02 | Jackpot $0 | Bingo $0 | Fortune $0 | Tax $0
Board [5s Qc Tc 2d Ks]
Seat 1: f168df8e (button) folded before Flop (didn't bet)
Seat 2: 2d32f8f3 (small blind) folded before Flop
Seat 3: Hero (big blind) won ($0.53)
Seat 4: d3434562 folded before Flop (didn't bet)
Seat 5: 677e2427 folded on the River
Seat 6: a0c90946 folded before Flop (didn't bet)


Poker Hand #RC2075545383: Hold'em No Limit ($0.05/$0.1) - 2023/12/21 23:22:32
Table 'RushAndCash286330' 6-max Seat #1 is the button
Seat 1: 553f03c9 ($18.42 in chips)
Seat 2: 14d25850 ($10.19 in chips)
Seat 3: a0c90946 ($26.02 in chips)
Seat 4: f7c771a0 ($10 in chips)
Seat 5: Hero ($16.59 in chips)
Seat 6: 9b5e26de ($31.6 in chips)
14d25850: posts small blind $0.05
a0c90946: posts big blind $0.1
*** HOLE CARDS ***
Dealt to 553f03c9 
Dealt to 14d25850 
Dealt to a0c90946 
Dealt to f7c771a0 
Dealt to Hero [As 3s]
Dealt to 9b5e26de 
f7c771a0: folds
Hero: raises $0.1 to $0.2
9b5e26de: folds
553f03c9: folds
14d25850: folds
a0c90946: raises $0.6 to $0.8
Hero: calls $0.6
*** FLOP *** [7h 9h 4s]
a0c90946: bets $0.75
Hero: calls $0.75
*** TURN *** [7h 9h 4s] [7d]
a0c90946: bets $1.85
Hero: folds
Uncalled bet ($1.85) returned to a0c90946
*** SHOWDOWN ***
a0c90946 collected $2.85 from pot
*** SUMMARY ***
Total pot $3.15 | Rake $0.15 | Jackpot $0.15 | Bingo $0 | Fortune $0 | Tax $0
Board [7h 9h 4s 7d]
Seat 1: 553f03c9 (button) folded before Flop (didn't bet)
Seat 2: 14d25850 (small blind) folded before Flop
Seat 3: a0c90946 (big blind) won ($2.85)
Seat 4: f7c771a0 folded before Flop (didn't bet)
Seat 5: Hero folded on the Turn
Seat 6: 9b5e26de folded before Flop (didn't bet)


Poker Hand #RC2075545287: Hold'em No Limit ($0.05/$0.1) - 2023/12/21 23:22:28
Table 'RushAndCash286276' 6-max Seat #1 is the button
Seat 1: 478aac27 ($20.63 in chips)
Seat 2: 6867c622 ($14.4 in chips)
Seat 3: 6f89d6d3 ($6.96 in chips)
Seat 4: f20dfbdb ($10.35 in chips)
Seat 5: 9c66bf60 ($11.09 in chips)
Seat 6: Hero ($16.59 in chips)
6867c622: posts small blind $0.05
6f89d6d3: posts big blind $0.1
*** HOLE CARDS ***
Dealt to 478aac27 
Dealt to 6867c622 
Dealt to 6f89d6d3 
Dealt to f20dfbdb 
Dealt to 9c66bf60 
Dealt to Hero [4d Jh]
f20dfbdb: folds
9c66bf60: folds
Hero: folds
478aac27: folds
6867c622: folds
Uncalled bet ($0.05) returned to 6f89d6d3
*** SHOWDOWN ***
6f89d6d3 collected $0.1 from pot
*** SUMMARY ***
Total pot $0.1 | Rake $0 | Jackpot $0 | Bingo $0 | Fortune $0 | Tax $0
Seat 1: 478aac27 (button) folded before Flop (didn't bet)
Seat 2: 6867c622 (small blind) folded before Flop
Seat 3: 6f89d6d3 (big blind) collected ($0.1)
Seat 4: f20dfbdb folded before Flop (didn't bet)
Seat 5: 9c66bf60 folded before Flop (didn't bet)
Seat 6: Hero folded before Flop (didn't bet)


Poker Hand #RC2075545175: Hold'em No Limit ($0.05/$0.1) - 2023/12/21 23:22:23
Table 'RushAndCash286212' 6-max Seat #1 is the button
Seat 1: Hero ($16.59 in chips)
Seat 2: a7e691c9 ($13.29 in chips)
Seat 3: fc7ac6a6 ($10 in chips)
Seat 4: 2d32f8f3 ($19.08 in chips)
Seat 5: 9dfab98a ($15.63 in chips)
Seat 6: dc18fbf1 ($15.77 in chips)
a7e691c9: posts small blind $0.05
fc7ac6a6: posts big blind $0.1
*** HOLE CARDS ***
Dealt to Hero [2s Ah]
Dealt to a7e691c9 
Dealt to fc7ac6a6 
Dealt to 2d32f8f3 
Dealt to 9dfab98a 
Dealt to dc18fbf1 
2d32f8f3: folds
9dfab98a: folds
dc18fbf1: folds
Hero: folds
a7e691c9: raises $0.12 to $0.22
fc7ac6a6: raises $0.44 to $0.66
a7e691c9: folds
Uncalled bet ($0.44) returned to fc7ac6a6
*** SHOWDOWN ***
fc7ac6a6 collected $0.42 from pot
*** SUMMARY ***
Total pot $0.44 | Rake $0.02 | Jackpot $0 | Bingo $0 | Fortune $0 | Tax $0
Seat 1: Hero (button) folded before Flop (didn't bet)
Seat 2: a7e691c9 (small blind) folded before Flop
Seat 3: fc7ac6a6 (big blind) collected ($0.42)
Seat 4: 2d32f8f3 folded before Flop (didn't bet)
Seat 5: 9dfab98a folded before Flop (didn't bet)
Seat 6: dc18fbf1 folded before Flop (didn't bet)


Poker Hand #RC2075524683: Hold'em No Limit ($0.05/$0.1) - 2023/12/21 23:22:01
Table 'RushAndCash285937' 6-max Seat #1 is the button
Seat 1: 24c6e84e ($15.09 in chips)
Seat 2: c1ccea94 ($15.52 in chips)
Seat 3: 4f95ff1c ($12.4 in chips)
Seat 4: Hero ($16.44 in chips)
Seat 5: f1892fb5 ($11.91 in chips)
Seat 6: e9cb7359 ($37.24 in chips)
c1ccea94: posts small blind $0.05
4f95ff1c: posts big blind $0.1
*** HOLE CARDS ***
Dealt to 24c6e84e 
Dealt to c1ccea94 
Dealt to 4f95ff1c 
Dealt to Hero [Qd Ah]
Dealt to f1892fb5 
Dealt to e9cb7359 
Hero: raises $0.1 to $0.2
f1892fb5: folds
e9cb7359: folds
24c6e84e: folds
c1ccea94: folds
4f95ff1c: folds
Uncalled bet ($0.1) returned to Hero
*** SHOWDOWN ***
Hero collected $0.25 from pot
*** SUMMARY ***
Total pot $0.25 | Rake $0 | Jackpot $0 | Bingo $0 | Fortune $0 | Tax $0
Seat 1: 24c6e84e (button) folded before Flop (didn't bet)
Seat 2: c1ccea94 (small blind) folded before Flop
Seat 3: 4f95ff1c (big blind) folded before Flop
Seat 4: Hero collected ($0.25)
Seat 5: f1892fb5 folded before Flop (didn't bet)
Seat 6: e9cb7359 folded before Flop (didn't bet)


Poker Hand #RC2075524249: Hold'em No Limit ($0.05/$0.1) - 2023/12/21 23:21:42
Table 'RushAndCash285695' 6-max Seat #1 is the button
Seat 1: Hero ($16.29 in chips)
Seat 2: 9dfab98a ($15.78 in chips)
Seat 3: 8e85dc82 ($13.12 in chips)
Seat 4: 92d95b97 ($14.26 in chips)
Seat 5: 269c665c ($10.15 in chips)
Seat 6: 38f9baad ($10.14 in chips)
9dfab98a: posts small blind $0.05
8e85dc82: posts big blind $0.1
*** HOLE CARDS ***
Dealt to Hero [Ac Js]
Dealt to 9dfab98a 
Dealt to 8e85dc82 
Dealt to 92d95b97 
Dealt to 269c665c 
Dealt to 38f9baad 
92d95b97: folds
269c665c: folds
38f9baad: folds
Hero: raises $0.15 to $0.25
9dfab98a: folds
8e85dc82: folds
Uncalled bet ($0.15) returned to Hero
*** SHOWDOWN ***
Hero collected $0.25 from pot
*** SUMMARY ***
Total pot $0.25 | Rake $0 | Jackpot $0 | Bingo $0 | Fortune $0 | Tax $0
Seat 1: Hero (button) collected ($0.25)
Seat 2: 9dfab98a (small blind) folded before Flop
Seat 3: 8e85dc82 (big blind) folded before Flop
Seat 4: 92d95b97 folded before Flop (didn't bet)
Seat 5: 269c665c folded before Flop (didn't bet)
Seat 6: 38f9baad folded before Flop (didn't bet)


Poker Hand #RC2075524174: Hold'em No Limit ($0.05/$0.1) - 2023/12/21 23:21:38
Table 'RushAndCash285653' 6-max Seat #1 is the button
Seat 1: f89a8725 ($11.09 in chips)
Seat 2: a56ebe0c ($14 in chips)
Seat 3: 593dd101 ($9.33 in chips)
Seat 4: b709b035 ($10.43 in chips)
Seat 5: Hero ($16.29 in chips)
Seat 6: 220d2aa5 ($9.82 in chips)
a56ebe0c: posts small blind $0.05
593dd101: posts big blind $0.1
*** HOLE CARDS ***
Dealt to f89a8725 
Dealt to a56ebe0c 
Dealt to 593dd101 
Dealt to b709b035 
Dealt to Hero [8s 4s]
Dealt to 220d2aa5 
b709b035: raises $0.15 to $0.25
Hero: folds
220d2aa5: folds
f89a8725: folds
a56ebe0c: calls $0.2
593dd101: folds
*** FLOP *** [Th Qc Qd]
a56ebe0c: checks
b709b035: bets $0.2
a56ebe0c: folds
Uncalled bet ($0.2) returned to b709b035
*** SHOWDOWN ***
b709b035 collected $0.57 from pot
*** SUMMARY ***
Total pot $0.6 | Rake $0.03 | Jackpot $0 | Bingo $0 | Fortune $0 | Tax $0
Board [Th Qc Qd]
Seat 1: f89a8725 (button) folded before Flop (didn't bet)
Seat 2: a56ebe0c (small blind) folded on the Flop
Seat 3: 593dd101 (big blind) folded before Flop
Seat 4: b709b035 won ($0.57)
Seat 5: Hero folded before Flop (didn't bet)
Seat 6: 220d2aa5 folded before Flop (didn't bet)


Poker Hand #RC2075524030: Hold'em No Limit ($0.05/$0.1) - 2023/12/21 23:21:32
Table 'RushAndCash285573' 6-max Seat #1 is the button
Seat 1: c3b054d5 ($6.32 in chips)
Seat 2: 3ab01d16 ($17.72 in chips)
Seat 3: Hero ($16.24 in chips)
Seat 4: 1080fc59 ($14.92 in chips)
Seat 5: 5efae841 ($12.79 in chips)
Seat 6: 8326b18b ($10 in chips)
3ab01d16: posts small blind $0.05
Hero: posts big blind $0.1
*** HOLE CARDS ***
Dealt to c3b054d5 
Dealt to 3ab01d16 
Dealt to Hero [Qh 4h]
Dealt to 1080fc59 
Dealt to 5efae841 
Dealt to 8326b18b 
1080fc59: folds
5efae841: folds
8326b18b: folds
c3b054d5: folds
3ab01d16: folds
Uncalled bet ($0.05) returned to Hero
*** SHOWDOWN ***
Hero collected $0.1 from pot
*** SUMMARY ***
Total pot $0.1 | Rake $0 | Jackpot $0 | Bingo $0 | Fortune $0 | Tax $0
Seat 1: c3b054d5 (button) folded before Flop (didn't bet)
Seat 2: 3ab01d16 (small blind) folded before Flop
Seat 3: Hero (big blind) collected ($0.1)
Seat 4: 1080fc59 folded before Flop (didn't bet)
Seat 5: 5efae841 folded before Flop (didn't bet)
Seat 6: 8326b18b folded before Flop (didn't bet)


Poker Hand #RC2075523279: Hold'em No Limit ($0.05/$0.1) - 2023/12/21 23:20:59
Table 'RushAndCash285159' 6-max Seat #1 is the button
Seat 1: 5681d7bf ($10.77 in chips)
Seat 2: cdf606b8 ($28.57 in chips)
Seat 3: 7f563768 ($20.55 in chips)
Seat 4: 1e4a3d4c ($12.76 in chips)
Seat 5: 64faf049 ($7.52 in chips)
Seat 6: Hero ($15.05 in chips)
Cash Drop to Pot : total $1 
cdf606b8: posts small blind $0.05
7f563768: posts big blind $0.1
*** HOLE CARDS ***
Dealt to 5681d7bf 
Dealt to cdf606b8 
Dealt to 7f563768 
Dealt to 1e4a3d4c 
Dealt to 64faf049 
Dealt to Hero [Ac Kc]
1e4a3d4c: folds
64faf049: calls $0.1
Hero: raises $14.95 to $15.05 and is all-in
5681d7bf: folds
cdf606b8: folds
7f563768: folds
64faf049: folds
Uncalled bet ($14.95) returned to Hero
*** SHOWDOWN ***
Hero collected $1.29 from pot
*** SUMMARY ***
Total pot $1.35 | Rake $0.06 | Jackpot $0 | Bingo $0 | Fortune $0 | Tax $0
Seat 1: 5681d7bf (button) folded before Flop (didn't bet)
Seat 2: cdf606b8 (small blind) folded before Flop
Seat 3: 7f563768 (big blind) folded before Flop
Seat 4: 1e4a3d4c folded before Flop (didn't bet)
Seat 5: 64faf049 folded before Flop
Seat 6: Hero collected ($1.29)


Poker Hand #RC2075523183: Hold'em No Limit ($0.05/$0.1) - 2023/12/21 23:20:55
Table 'RushAndCash285102' 6-max Seat #1 is the button
Seat 1: 85952fee ($13.91 in chips)
Seat 2: c528838f ($10.05 in chips)
Seat 3: 7e5bf647 ($23.73 in chips)
Seat 4: Hero ($15.05 in chips)
Seat 5: bfe2728a ($10 in chips)
Seat 6: 2ea50534 ($41.94 in chips)
c528838f: posts small blind $0.05
7e5bf647: posts big blind $0.1
*** HOLE CARDS ***
Dealt to 85952fee 
Dealt to c528838f 
Dealt to 7e5bf647 
Dealt to Hero [8c Js]
Dealt to bfe2728a 
Dealt to 2ea50534 
Hero: folds
bfe2728a: raises $0.12 to $0.22
2ea50534: folds
85952fee: folds
c528838f: folds
7e5bf647: calls $0.12
*** FLOP *** [Th 9h 6c]
7e5bf647: checks
bfe2728a: bets $0.25
7e5bf647: calls $0.25
*** TURN *** [Th 9h 6c] [7s]
7e5bf647: checks
bfe2728a: checks
*** RIVER *** [Th 9h 6c 7s] [Jd]
7e5bf647: checks
bfe2728a: checks
7e5bf647: shows [Ts Kd] (Pair of Tens)
bfe2728a: shows [As 9s] (Pair of Nines)
*** SHOWDOWN ***
7e5bf647 collected $0.94 from pot
*** SUMMARY ***
Total pot $0.99 | Rake $0.05 | Jackpot $0 | Bingo $0 | Fortune $0 | Tax $0
Board [Th 9h 6c 7s Jd]
Seat 1: 85952fee (button) folded before Flop (didn't bet)
Seat 2: c528838f (small blind) folded before Flop
Seat 3: 7e5bf647 (big blind) showed [Ts Kd] and won ($0.94) with Pair of Tens
Seat 4: Hero folded before Flop (didn't bet)
Seat 5: bfe2728a showed [As 9s] and lost with Pair of Nines
Seat 6: 2ea50534 folded before Flop (didn't bet)


Poker Hand #RC2075522981: Hold'em No Limit ($0.05/$0.1) - 2023/12/21 23:20:46
Table 'RushAndCash284985' 6-max Seat #1 is the button
Seat 1: 5c16ab41 ($13.02 in chips)
Seat 2: Hero ($15.1 in chips)
Seat 3: 1c74df9b ($10 in chips)
Seat 4: cd85353e ($7.96 in chips)
Seat 5: 6ed21051 ($15.6 in chips)
Seat 6: df309ad0 ($10.05 in chips)
Hero: posts small blind $0.05
1c74df9b: posts big blind $0.1
*** HOLE CARDS ***
Dealt to 5c16ab41 
Dealt to Hero [9c Th]
Dealt to 1c74df9b 
Dealt to cd85353e 
Dealt to 6ed21051 
Dealt to df309ad0 
cd85353e: raises $0.15 to $0.25
6ed21051: folds
df309ad0: folds
5c16ab41: folds
Hero: folds
1c74df9b: calls $0.15
*** FLOP *** [6d 3d 8d]
1c74df9b: checks
cd85353e: checks
*** TURN *** [6d 3d 8d] [Jd]
1c74df9b: bets $0.14
cd85353e: folds
Uncalled bet ($0.14) returned to 1c74df9b
*** SHOWDOWN ***
1c74df9b collected $0.53 from pot
*** SUMMARY ***
Total pot $0.55 | Rake $0.02 | Jackpot $0 | Bingo $0 | Fortune $0 | Tax $0
Board [6d 3d 8d Jd]
Seat 1: 5c16ab41 (button) folded before Flop (didn't bet)
Seat 2: Hero (small blind) folded before Flop
Seat 3: 1c74df9b (big blind) won ($0.53)
Seat 4: cd85353e folded on the Turn
Seat 5: 6ed21051 folded before Flop (didn't bet)
Seat 6: df309ad0 folded before Flop (didn't bet)


Poker Hand #RC2075522815: Hold'em No Limit ($0.05/$0.1) - 2023/12/21 23:20:39
Table 'RushAndCash284890' 6-max Seat #1 is the button
Seat 1: d63653ff ($10 in chips)
Seat 2: 7f499688 ($9.65 in chips)
Seat 3: 42ec9313 ($12.28 in chips)
Seat 4: b3daa05a ($10 in chips)
Seat 5: bc69bf06 ($10.14 in chips)
Seat 6: Hero ($15.1 in chips)
7f499688: posts small blind $0.05
42ec9313: posts big blind $0.1
*** HOLE CARDS ***
Dealt to d63653ff 
Dealt to 7f499688 
Dealt to 42ec9313 
Dealt to b3daa05a 
Dealt to bc69bf06 
Dealt to Hero [5c 2d]
b3daa05a: folds
bc69bf06: folds
Hero: folds
d63653ff: folds
7f499688: folds
Uncalled bet ($0.05) returned to 42ec9313
*** SHOWDOWN ***
42ec9313 collected $0.1 from pot
*** SUMMARY ***
Total pot $0.1 | Rake $0 | Jackpot $0 | Bingo $0 | Fortune $0 | Tax $0
Seat 1: d63653ff (button) folded before Flop (didn't bet)
Seat 2: 7f499688 (small blind) folded before Flop
Seat 3: 42ec9313 (big blind) collected ($0.1)
Seat 4: b3daa05a folded before Flop (didn't bet)
Seat 5: bc69bf06 folded before Flop (didn't bet)
Seat 6: Hero folded before Flop (didn't bet)


Poker Hand #RC2075522600: Hold'em No Limit ($0.05/$0.1) - 2023/12/21 23:20:29
Table 'RushAndCash284770' 6-max Seat #1 is the button
Seat 1: a6f43aa7 ($10 in chips)
Seat 2: 534d15d2 ($10.46 in chips)
Seat 3: Hero ($15.2 in chips)
Seat 4: 4c112b72 ($10.24 in chips)
Seat 5: 1e29268 ($17.39 in chips)
Seat 6: e3c7083d ($10 in chips)
534d15d2: posts small blind $0.05
Hero: posts big blind $0.1
*** HOLE CARDS ***
Dealt to a6f43aa7 
Dealt to 534d15d2 
Dealt to Hero [4h Kd]
Dealt to 4c112b72 
Dealt to 1e29268 
Dealt to e3c7083d 
4c112b72: folds
1e29268: raises $0.15 to $0.25
e3c7083d: folds
a6f43aa7: folds
534d15d2: folds
Hero: folds
Uncalled bet ($0.15) returned to 1e29268
*** SHOWDOWN ***
1e29268 collected $0.25 from pot
*** SUMMARY ***
Total pot $0.25 | Rake $0 | Jackpot $0 | Bingo $0 | Fortune $0 | Tax $0
Seat 1: a6f43aa7 (button) folded before Flop (didn't bet)
Seat 2: 534d15d2 (small blind) folded before Flop
Seat 3: Hero (big blind) folded before Flop
Seat 4: 4c112b72 folded before Flop (didn't bet)
Seat 5: 1e29268 collected ($0.25)
Seat 6: e3c7083d folded before Flop (didn't bet)


Poker Hand #RC2075522482: Hold'em No Limit ($0.05/$0.1) - 2023/12/21 23:20:24
Table 'RushAndCash284704' 6-max Seat #1 is the button
Seat 1: f742ed5e ($9.93 in chips)
Seat 2: Hero ($15.25 in chips)
Seat 3: ec7b0e83 ($11.74 in chips)
Seat 4: 69513d91 ($10.14 in chips)
Seat 5: fb5d750 ($17.23 in chips)
Seat 6: f116cb16 ($14.58 in chips)
Hero: posts small blind $0.05
ec7b0e83: posts big blind $0.1
*** HOLE CARDS ***
Dealt to f742ed5e 
Dealt to Hero [4s Jh]
Dealt to ec7b0e83 
Dealt to 69513d91 
Dealt to fb5d750 
Dealt to f116cb16 
69513d91: folds
fb5d750: raises $0.1 to $0.2
f116cb16: folds
f742ed5e: folds
Hero: folds
ec7b0e83: folds
Uncalled bet ($0.1) returned to fb5d750
*** SHOWDOWN ***
fb5d750 collected $0.25 from pot
*** SUMMARY ***
Total pot $0.25 | Rake $0 | Jackpot $0 | Bingo $0 | Fortune $0 | Tax $0
Seat 1: f742ed5e (button) folded before Flop (didn't bet)
Seat 2: Hero (small blind) folded before Flop
Seat 3: ec7b0e83 (big blind) folded before Flop
Seat 4: 69513d91 folded before Flop (didn't bet)
Seat 5: fb5d750 collected ($0.25)
Seat 6: f116cb16 folded before Flop (didn't bet)


Poker Hand #RC2075522373: Hold'em No Limit ($0.05/$0.1) - 2023/12/21 23:20:19
Table 'RushAndCash284639' 6-max Seat #1 is the button
Seat 1: Hero ($15.25 in chips)
Seat 2: 16096224 ($11.99 in chips)
Seat 3: 70c222e3 ($27.03 in chips)
Seat 4: e7322801 ($8.19 in chips)
Seat 5: 73ced8be ($39.6 in chips)
Seat 6: fe8e9d75 ($10.63 in chips)
16096224: posts small blind $0.05
70c222e3: posts big blind $0.1
*** HOLE CARDS ***
Dealt to Hero [Js Td]
Dealt to 16096224 
Dealt to 70c222e3 
Dealt to e7322801 
Dealt to 73ced8be 
Dealt to fe8e9d75 
e7322801: folds
73ced8be: folds
fe8e9d75: folds
Hero: folds
16096224: folds
Uncalled bet ($0.05) returned to 70c222e3
*** SHOWDOWN ***
70c222e3 collected $0.1 from pot
*** SUMMARY ***
Total pot $0.1 | Rake $0 | Jackpot $0 | Bingo $0 | Fortune $0 | Tax $0
Seat 1: Hero (button) folded before Flop (didn't bet)
Seat 2: 16096224 (small blind) folded before Flop
Seat 3: 70c222e3 (big blind) collected ($0.1)
Seat 4: e7322801 folded before Flop (didn't bet)
Seat 5: 73ced8be folded before Flop (didn't bet)
Seat 6: fe8e9d75 folded before Flop (didn't bet)


Poker Hand #RC2075522041: Hold'em No Limit ($0.05/$0.1) - 2023/12/21 23:20:04
Table 'RushAndCash284452' 6-max Seat #1 is the button
Seat 1: 6e6fec39 ($17.91 in chips)
Seat 2: fe8e9d75 ($10.78 in chips)
Seat 3: 1f049a71 ($9.74 in chips)
Seat 4: c4337915 ($10.61 in chips)
Seat 5: e1263251 ($19.7 in chips)
Seat 6: Hero ($15.25 in chips)
fe8e9d75: posts small blind $0.05
1f049a71: posts big blind $0.1
*** HOLE CARDS ***
Dealt to 6e6fec39 
Dealt to fe8e9d75 
Dealt to 1f049a71 
Dealt to c4337915 
Dealt to e1263251 
Dealt to Hero [Qd 6d]
c4337915: folds
e1263251: folds
Hero: folds
6e6fec39: raises $0.15 to $0.25
fe8e9d75: folds
1f049a71: folds
Uncalled bet ($0.15) returned to 6e6fec39
*** SHOWDOWN ***
6e6fec39 collected $0.25 from pot
*** SUMMARY ***
Total pot $0.25 | Rake $0 | Jackpot $0 | Bingo $0 | Fortune $0 | Tax $0
Seat 1: 6e6fec39 (button) collected ($0.25)
Seat 2: fe8e9d75 (small blind) folded before Flop
Seat 3: 1f049a71 (big blind) folded before Flop
Seat 4: c4337915 folded before Flop (didn't bet)
Seat 5: e1263251 folded before Flop (didn't bet)
Seat 6: Hero folded before Flop (didn't bet)


Poker Hand #RC2075521939: Hold'em No Limit ($0.05/$0.1) - 2023/12/21 23:19:59
Table 'RushAndCash284394' 6-max Seat #1 is the button
Seat 1: 9bc3a2f3 ($13 in chips)
Seat 2: 56eaa298 ($6.94 in chips)
Seat 3: cbf9cbe2 ($48.71 in chips)
Seat 4: 71189ba6 ($10 in chips)
Seat 5: f1a00604 ($22.08 in chips)
Seat 6: Hero ($15.25 in chips)
56eaa298: posts small blind $0.05
cbf9cbe2: posts big blind $0.1
*** HOLE CARDS ***
Dealt to 9bc3a2f3 
Dealt to 56eaa298 
Dealt to cbf9cbe2 
Dealt to 71189ba6 
Dealt to f1a00604 
Dealt to Hero [7h Kd]
71189ba6: folds
f1a00604: folds
Hero: folds
9bc3a2f3: raises $0.2 to $0.3
56eaa298: calls $0.25
cbf9cbe2: calls $0.2
*** FLOP *** [Tc 7d 5d]
56eaa298: checks
cbf9cbe2: checks
9bc3a2f3: bets $0.34
56eaa298: calls $0.34
cbf9cbe2: folds
*** TURN *** [Tc 7d 5d] [8h]
56eaa298: checks
9bc3a2f3: checks
*** RIVER *** [Tc 7d 5d 8h] [4c]
56eaa298: bets $1.19
9bc3a2f3: calls $1.19
56eaa298: shows [Kc Qc] (King-High)
9bc3a2f3: shows [Jd 8d] (Pair of Eights)
*** SHOWDOWN ***
9bc3a2f3 collected $3.62 from pot
*** SUMMARY ***
Total pot $3.96 | Rake $0.19 | Jackpot $0.15 | Bingo $0 | Fortune $0 | Tax $0
Board [Tc 7d 5d 8h 4c]
Seat 1: 9bc3a2f3 (button) showed [Jd 8d] and won ($3.62) with Pair of Eights
Seat 2: 56eaa298 (small blind) showed [Kc Qc] and lost with King-High
Seat 3: cbf9cbe2 (big blind) folded on the Flop
Seat 4: 71189ba6 folded before Flop (didn't bet)
Seat 5: f1a00604 folded before Flop (didn't bet)
Seat 6: Hero folded before Flop (didn't bet)


Poker Hand #RC2075521849: Hold'em No Limit ($0.05/$0.1) - 2023/12/21 23:19:55
Table 'RushAndCash284343' 6-max Seat #1 is the button
Seat 1: 643461d5 ($10.05 in chips)
Seat 2: a959753e ($13.44 in chips)
Seat 3: 3f3ce363 ($12.84 in chips)
Seat 4: d6740f69 ($13.06 in chips)
Seat 5: 81e3db3a ($10 in chips)
Seat 6: Hero ($15.25 in chips)
a959753e: posts small blind $0.05
3f3ce363: posts big blind $0.1
*** HOLE CARDS ***
Dealt to 643461d5 
Dealt to a959753e 
Dealt to 3f3ce363 
Dealt to d6740f69 
Dealt to 81e3db3a 
Dealt to Hero [3h 6h]
d6740f69: raises $0.11 to $0.21
81e3db3a: folds
Hero: folds
643461d5: folds
a959753e: folds
3f3ce363: calls $0.11
*** FLOP *** [Ts Kc Ac]
3f3ce363: checks
d6740f69: checks
*** TURN *** [Ts Kc Ac] [Kd]
3f3ce363: checks
d6740f69: checks
*** RIVER *** [Ts Kc Ac Kd] [Th]
3f3ce363: bets $0.3
d6740f69: folds
Uncalled bet ($0.3) returned to 3f3ce363
*** SHOWDOWN ***
3f3ce363 collected $0.45 from pot
*** SUMMARY ***
Total pot $0.47 | Rake $0.02 | Jackpot $0 | Bingo $0 | Fortune $0 | Tax $0
Board [Ts Kc Ac Kd Th]
Seat 1: 643461d5 (button) folded before Flop (didn't bet)
Seat 2: a959753e (small blind) folded before Flop
Seat 3: 3f3ce363 (big blind) won ($0.45)
Seat 4: d6740f69 folded on the River
Seat 5: 81e3db3a folded before Flop (didn't bet)
Seat 6: Hero folded before Flop (didn't bet)


Poker Hand #RC2075521718: Hold'em No Limit ($0.05/$0.1) - 2023/12/21 23:19:50
Table 'RushAndCash284269' 6-max Seat #1 is the button
Seat 1: 760452c5 ($12.23 in chips)
Seat 2: Hero ($15.3 in chips)
Seat 3: 8e27810a ($68.78 in chips)
Seat 4: 2d32f8f3 ($21.06 in chips)
Seat 5: 8a9d84cc ($18.02 in chips)
Seat 6: f02f2947 ($10 in chips)
Hero: posts small blind $0.05
8e27810a: posts big blind $0.1
*** HOLE CARDS ***
Dealt to 760452c5 
Dealt to Hero [Jc 3s]
Dealt to 8e27810a 
Dealt to 2d32f8f3 
Dealt to 8a9d84cc 
Dealt to f02f2947 
2d32f8f3: folds
8a9d84cc: folds
f02f2947: folds
760452c5: raises $0.1 to $0.2
Hero: folds
8e27810a: folds
Uncalled bet ($0.1) returned to 760452c5
*** SHOWDOWN ***
760452c5 collected $0.25 from pot
*** SUMMARY ***
Total pot $0.25 | Rake $0 | Jackpot $0 | Bingo $0 | Fortune $0 | Tax $0
Seat 1: 760452c5 (button) collected ($0.25)
Seat 2: Hero (small blind) folded before Flop
Seat 3: 8e27810a (big blind) folded before Flop
Seat 4: 2d32f8f3 folded before Flop (didn't bet)
Seat 5: 8a9d84cc folded before Flop (didn't bet)
Seat 6: f02f2947 folded before Flop (didn't bet)


Poker Hand #RC2075521494: Hold'em No Limit ($0.05/$0.1) - 2023/12/21 23:19:40
Table 'RushAndCash284140' 6-max Seat #1 is the button
Seat 1: ae4ceda9 ($11.66 in chips)
Seat 2: 77d5115b ($13.39 in chips)
Seat 3: Hero ($15.4 in chips)
Seat 4: 15103267 ($11.58 in chips)
Seat 5: 3477a56f ($44.41 in chips)
Seat 6: 31924eb3 ($11.14 in chips)
77d5115b: posts small blind $0.05
Hero: posts big blind $0.1
*** HOLE CARDS ***
Dealt to ae4ceda9 
Dealt to 77d5115b 
Dealt to Hero [3s Kd]
Dealt to 15103267 
Dealt to 3477a56f 
Dealt to 31924eb3 
15103267: folds
3477a56f: folds
31924eb3: folds
ae4ceda9: folds
77d5115b: raises $0.2 to $0.3
Hero: folds
Uncalled bet ($0.2) returned to 77d5115b
*** SHOWDOWN ***
77d5115b collected $0.2 from pot
*** SUMMARY ***
Total pot $0.2 | Rake $0 | Jackpot $0 | Bingo $0 | Fortune $0 | Tax $0
Seat 1: ae4ceda9 (button) folded before Flop (didn't bet)
Seat 2: 77d5115b (small blind) collected ($0.2)
Seat 3: Hero (big blind) folded before Flop
Seat 4: 15103267 folded before Flop (didn't bet)
Seat 5: 3477a56f folded before Flop (didn't bet)
Seat 6: 31924eb3 folded before Flop (didn't bet)


Poker Hand #RC2075521413: Hold'em No Limit ($0.05/$0.1) - 2023/12/21 23:19:37
Table 'RushAndCash284091' 6-max Seat #1 is the button
Seat 1: 344bed61 ($10.6 in chips)
Seat 2: 58a8861f ($25.83 in chips)
Seat 3: c0a47dfa ($39.8 in chips)
Seat 4: 87436cf6 ($13.99 in chips)
Seat 5: ed5edc99 ($11.2 in chips)
Seat 6: Hero ($15.4 in chips)
58a8861f: posts small blind $0.05
c0a47dfa: posts big blind $0.1
*** HOLE CARDS ***
Dealt to 344bed61 
Dealt to 58a8861f 
Dealt to c0a47dfa 
Dealt to 87436cf6 
Dealt to ed5edc99 
Dealt to Hero [5c Kh]
87436cf6: folds
ed5edc99: folds
Hero: folds
344bed61: folds
58a8861f: folds
Uncalled bet ($0.05) returned to c0a47dfa
*** SHOWDOWN ***
c0a47dfa collected $0.1 from pot
*** SUMMARY ***
Total pot $0.1 | Rake $0 | Jackpot $0 | Bingo $0 | Fortune $0 | Tax $0
Seat 1: 344bed61 (button) folded before Flop (didn't bet)
Seat 2: 58a8861f (small blind) folded before Flop
Seat 3: c0a47dfa (big blind) collected ($0.1)
Seat 4: 87436cf6 folded before Flop (didn't bet)
Seat 5: ed5edc99 folded before Flop (didn't bet)
Seat 6: Hero folded before Flop (didn't bet)


Poker Hand #RC2075520950: Hold'em No Limit ($0.05/$0.1) - 2023/12/21 23:19:17
Table 'RushAndCash283819' 6-max Seat #1 is the button
Seat 1: Hero ($16.15 in chips)
Seat 2: 2d32f8f3 ($21.11 in chips)
Seat 3: e15317b3 ($20.15 in chips)
Seat 4: 77d5115b ($13.44 in chips)
Seat 5: 362f4bf3 ($15.87 in chips)
Seat 6: 36c8f3de ($11.42 in chips)
2d32f8f3: posts small blind $0.05
e15317b3: posts big blind $0.1
*** HOLE CARDS ***
Dealt to Hero [Qd As]
Dealt to 2d32f8f3 
Dealt to e15317b3 
Dealt to 77d5115b 
Dealt to 362f4bf3 
Dealt to 36c8f3de 
77d5115b: folds
362f4bf3: raises $0.1 to $0.2
36c8f3de: folds
Hero: raises $0.55 to $0.75
2d32f8f3: folds
e15317b3: raises $1.32 to $2.07
362f4bf3: folds
Hero: folds
Uncalled bet ($1.32) returned to e15317b3
*** SHOWDOWN ***
e15317b3 collected $1.67 from pot
*** SUMMARY ***
Total pot $1.75 | Rake $0.08 | Jackpot $0 | Bingo $0 | Fortune $0 | Tax $0
Seat 1: Hero (button) folded before Flop
Seat 2: 2d32f8f3 (small blind) folded before Flop
Seat 3: e15317b3 (big blind) collected ($1.67)
Seat 4: 77d5115b folded before Flop (didn't bet)
Seat 5: 362f4bf3 folded before Flop
Seat 6: 36c8f3de folded before Flop (didn't bet)


Poker Hand #RC2075520780: Hold'em No Limit ($0.05/$0.1) - 2023/12/21 23:19:09
Table 'RushAndCash283718' 6-max Seat #1 is the button
Seat 1: c3b054d5 ($4.89 in chips)
Seat 2: 387a6e45 ($9.32 in chips)
Seat 3: 91eb42eb ($10.93 in chips)
Seat 4: e027b096 ($7.83 in chips)
Seat 5: 41287b65 ($20.59 in chips)
Seat 6: Hero ($16 in chips)
387a6e45: posts small blind $0.05
91eb42eb: posts big blind $0.1
*** HOLE CARDS ***
Dealt to c3b054d5 
Dealt to 387a6e45 
Dealt to 91eb42eb 
Dealt to e027b096 
Dealt to 41287b65 
Dealt to Hero [9c Kc]
e027b096: folds
41287b65: folds
Hero: raises $0.1 to $0.2
c3b054d5: folds
387a6e45: folds
91eb42eb: folds
Uncalled bet ($0.1) returned to Hero
*** SHOWDOWN ***
Hero collected $0.25 from pot
*** SUMMARY ***
Total pot $0.25 | Rake $0 | Jackpot $0 | Bingo $0 | Fortune $0 | Tax $0
Seat 1: c3b054d5 (button) folded before Flop (didn't bet)
Seat 2: 387a6e45 (small blind) folded before Flop
Seat 3: 91eb42eb (big blind) folded before Flop
Seat 4: e027b096 folded before Flop (didn't bet)
Seat 5: 41287b65 folded before Flop (didn't bet)
Seat 6: Hero collected ($0.25)


Poker Hand #RC2075520658: Hold'em No Limit ($0.05/$0.1) - 2023/12/21 23:19:03
Table 'RushAndCash283648' 6-max Seat #1 is the button
Seat 1: 3b190206 ($10 in chips)
Seat 2: 238d1c04 ($10.97 in chips)
Seat 3: bda4ccd3 ($12 in chips)
Seat 4: 86e56a04 ($21.3 in chips)
Seat 5: 2bbb668e ($10.1 in chips)
Seat 6: Hero ($16 in chips)
238d1c04: posts small blind $0.05
bda4ccd3: posts big blind $0.1
*** HOLE CARDS ***
Dealt to 3b190206 
Dealt to 238d1c04 
Dealt to bda4ccd3 
Dealt to 86e56a04 
Dealt to 2bbb668e 
Dealt to Hero [Kh 7d]
86e56a04: folds
2bbb668e: folds
Hero: folds
3b190206: raises $0.15 to $0.25
238d1c04: raises $0.81 to $1.06
bda4ccd3: folds
3b190206: calls $0.81
*** FLOP *** [6s 4c 8h]
238d1c04: bets $0.74
3b190206: folds
Uncalled bet ($0.74) returned to 238d1c04
*** SHOWDOWN ***
238d1c04 collected $2.11 from pot
*** SUMMARY ***
Total pot $2.22 | Rake $0.11 | Jackpot $0 | Bingo $0 | Fortune $0 | Tax $0
Board [6s 4c 8h]
Seat 1: 3b190206 (button) folded on the Flop
Seat 2: 238d1c04 (small blind) won ($2.11)
Seat 3: bda4ccd3 (big blind) folded before Flop
Seat 4: 86e56a04 folded before Flop (didn't bet)
Seat 5: 2bbb668e folded before Flop (didn't bet)
Seat 6: Hero folded before Flop (didn't bet)


Poker Hand #RC2075520413: Hold'em No Limit ($0.05/$0.1) - 2023/12/21 23:18:52
Table 'RushAndCash283506' 6-max Seat #1 is the button
Seat 1: Hero ($15.85 in chips)
Seat 2: 1a822896 ($34.38 in chips)
Seat 3: 92d95b97 ($14.23 in chips)
Seat 4: 68807e0f ($9.69 in chips)
Seat 5: 621702f1 ($9.12 in chips)
Seat 6: 1a09d062 ($10 in chips)
1a822896: posts small blind $0.05
92d95b97: posts big blind $0.1
*** HOLE CARDS ***
Dealt to Hero [Js Ad]
Dealt to 1a822896 
Dealt to 92d95b97 
Dealt to 68807e0f 
Dealt to 621702f1 
Dealt to 1a09d062 
68807e0f: folds
621702f1: folds
1a09d062: folds
Hero: raises $0.15 to $0.25
1a822896: folds
92d95b97: folds
Uncalled bet ($0.15) returned to Hero
*** SHOWDOWN ***
Hero collected $0.25 from pot
*** SUMMARY ***
Total pot $0.25 | Rake $0 | Jackpot $0 | Bingo $0 | Fortune $0 | Tax $0
Seat 1: Hero (button) collected ($0.25)
Seat 2: 1a822896 (small blind) folded before Flop
Seat 3: 92d95b97 (big blind) folded before Flop
Seat 4: 68807e0f folded before Flop (didn't bet)
Seat 5: 621702f1 folded before Flop (didn't bet)
Seat 6: 1a09d062 folded before Flop (didn't bet)


Poker Hand #RC2075520214: Hold'em No Limit ($0.05/$0.1) - 2023/12/21 23:18:43
Table 'RushAndCash283389' 6-max Seat #1 is the button
Seat 1: 6c66779a ($16.71 in chips)
Seat 2: 68eb0b28 ($10.15 in chips)
Seat 3: Hero ($15.95 in chips)
Seat 4: ca7e4470 ($1.38 in chips)
Seat 5: b608f29 ($10.22 in chips)
Seat 6: 88882f24 ($15.27 in chips)
68eb0b28: posts small blind $0.05
Hero: posts big blind $0.1
*** HOLE CARDS ***
Dealt to 6c66779a 
Dealt to 68eb0b28 
Dealt to Hero [9d 7h]
Dealt to ca7e4470 
Dealt to b608f29 
Dealt to 88882f24 
ca7e4470: folds
b608f29: raises $0.1 to $0.2
88882f24: raises $0.35 to $0.55
6c66779a: folds
68eb0b28: folds
Hero: folds
b608f29: calls $0.35
*** FLOP *** [5h Ts 6c]
b608f29: checks
88882f24: bets $0.35
b608f29: calls $0.35
*** TURN *** [5h Ts 6c] [9h]
b608f29: checks
88882f24: bets $0.75
b608f29: calls $0.75
*** RIVER *** [5h Ts 6c 9h] [Js]
b608f29: checks
88882f24: bets $2
b608f29: folds
Uncalled bet ($2) returned to 88882f24
*** SHOWDOWN ***
88882f24 collected $3.14 from pot
*** SUMMARY ***
Total pot $3.45 | Rake $0.16 | Jackpot $0.15 | Bingo $0 | Fortune $0 | Tax $0
Board [5h Ts 6c 9h Js]
Seat 1: 6c66779a (button) folded before Flop (didn't bet)
Seat 2: 68eb0b28 (small blind) folded before Flop
Seat 3: Hero (big blind) folded before Flop
Seat 4: ca7e4470 folded before Flop (didn't bet)
Seat 5: b608f29 folded on the River
Seat 6: 88882f24 won ($3.14)


Poker Hand #RC2075520108: Hold'em No Limit ($0.05/$0.1) - 2023/12/21 23:18:39
Table 'RushAndCash283323' 6-max Seat #1 is the button
Seat 1: b8105230 ($13.99 in chips)
Seat 2: Hero ($16 in chips)
Seat 3: a9f5c071 ($35.89 in chips)
Seat 4: 73a214aa ($18.75 in chips)
Seat 5: 647b442f ($33.09 in chips)
Seat 6: 410c2bb8 ($10 in chips)
Hero: posts small blind $0.05
a9f5c071: posts big blind $0.1
*** HOLE CARDS ***
Dealt to b8105230 
Dealt to Hero [8d 9h]
Dealt to a9f5c071 
Dealt to 73a214aa 
Dealt to 647b442f 
Dealt to 410c2bb8 
73a214aa: raises $0.1 to $0.2
647b442f: folds
410c2bb8: raises $0.5 to $0.7
b8105230: folds
Hero: folds
a9f5c071: folds
73a214aa: calls $0.5
*** FLOP *** [4d 4c Td]
73a214aa: checks
410c2bb8: bets $0.52
73a214aa: calls $0.52
*** TURN *** [4d 4c Td] [3h]
73a214aa: checks
410c2bb8: checks
*** RIVER *** [4d 4c Td 3h] [7d]
73a214aa: checks
410c2bb8: checks
73a214aa: shows [4s 4h] (Four Fours)
410c2bb8: shows [Qs Ah] (Pair of Fours)
*** SHOWDOWN ***
73a214aa collected $2.46 from pot
*** SUMMARY ***
Total pot $2.59 | Rake $0.13 | Jackpot $0 | Bingo $0 | Fortune $0 | Tax $0
Board [4d 4c Td 3h 7d]
Seat 1: b8105230 (button) folded before Flop (didn't bet)
Seat 2: Hero (small blind) folded before Flop
Seat 3: a9f5c071 (big blind) folded before Flop
Seat 4: 73a214aa showed [4s 4h] and won ($2.46) with Four Fours
Seat 5: 647b442f folded before Flop (didn't bet)
Seat 6: 410c2bb8 showed [Qs Ah] and lost with Pair of Fours


Poker Hand #RC2075520014: Hold'em No Limit ($0.05/$0.1) - 2023/12/21 23:18:35
Table 'RushAndCash283266' 6-max Seat #1 is the button
Seat 1: f5b0a0e9 ($5.17 in chips)
Seat 2: 631999d4 ($33.25 in chips)
Seat 3: 553f03c9 ($15.33 in chips)
Seat 4: Hero ($16 in chips)
Seat 5: 6ff8dba9 ($10.58 in chips)
Seat 6: c6d97203 ($10.43 in chips)
631999d4: posts small blind $0.05
553f03c9: posts big blind $0.1
*** HOLE CARDS ***
Dealt to f5b0a0e9 
Dealt to 631999d4 
Dealt to 553f03c9 
Dealt to Hero [8d Ts]
Dealt to 6ff8dba9 
Dealt to c6d97203 
Hero: folds
6ff8dba9: raises $0.16 to $0.26
c6d97203: folds
f5b0a0e9: raises $0.66 to $0.92
631999d4: folds
553f03c9: folds
6ff8dba9: calls $0.66
*** FLOP *** [2d 5s 5d]
6ff8dba9: bets $1
f5b0a0e9: calls $1
*** TURN *** [2d 5s 5d] [3c]
6ff8dba9: bets $3
f5b0a0e9: folds
Uncalled bet ($3) returned to 6ff8dba9
*** SHOWDOWN ***
6ff8dba9 collected $3.65 from pot
*** SUMMARY ***
Total pot $3.99 | Rake $0.19 | Jackpot $0.15 | Bingo $0 | Fortune $0 | Tax $0
Board [2d 5s 5d 3c]
Seat 1: f5b0a0e9 (button) folded on the Turn
Seat 2: 631999d4 (small blind) folded before Flop
Seat 3: 553f03c9 (big blind) folded before Flop
Seat 4: Hero folded before Flop (didn't bet)
Seat 5: 6ff8dba9 won ($3.65)
Seat 6: c6d97203 folded before Flop (didn't bet)


Poker Hand #RC2075519859: Hold'em No Limit ($0.05/$0.1) - 2023/12/21 23:18:29
Table 'RushAndCash283175' 6-max Seat #1 is the button
Seat 1: c3c2420 ($22.87 in chips)
Seat 2: 55cfbad5 ($32.1 in chips)
Seat 3: 968686f2 ($14.04 in chips)
Seat 4: 6ed21051 ($14.96 in chips)
Seat 5: d712e513 ($28.39 in chips)
Seat 6: Hero ($16 in chips)
55cfbad5: posts small blind $0.05
968686f2: posts big blind $0.1
*** HOLE CARDS ***
Dealt to c3c2420 
Dealt to 55cfbad5 
Dealt to 968686f2 
Dealt to 6ed21051 
Dealt to d712e513 
Dealt to Hero [Jh 7h]
6ed21051: folds
d712e513: raises $0.1 to $0.2
Hero: folds
c3c2420: folds
55cfbad5: folds
968686f2: folds
Uncalled bet ($0.1) returned to d712e513
*** SHOWDOWN ***
d712e513 collected $0.25 from pot
*** SUMMARY ***
Total pot $0.25 | Rake $0 | Jackpot $0 | Bingo $0 | Fortune $0 | Tax $0
Seat 1: c3c2420 (button) folded before Flop (didn't bet)
Seat 2: 55cfbad5 (small blind) folded before Flop
Seat 3: 968686f2 (big blind) folded before Flop
Seat 4: 6ed21051 folded before Flop (didn't bet)
Seat 5: d712e513 collected ($0.25)
Seat 6: Hero folded before Flop (didn't bet)


Poker Hand #RC2075519745: Hold'em No Limit ($0.05/$0.1) - 2023/12/21 23:18:23
Table 'RushAndCash283108' 6-max Seat #1 is the button
Seat 1: 8c1f2bcb ($15.04 in chips)
Seat 2: bf05caa7 ($11.12 in chips)
Seat 3: 8a9d84cc ($18.59 in chips)
Seat 4: 91af566b ($11.16 in chips)
Seat 5: a0328120 ($12.03 in chips)
Seat 6: Hero ($16 in chips)
bf05caa7: posts small blind $0.05
8a9d84cc: posts big blind $0.1
*** HOLE CARDS ***
Dealt to 8c1f2bcb 
Dealt to bf05caa7 
Dealt to 8a9d84cc 
Dealt to 91af566b 
Dealt to a0328120 
Dealt to Hero [Qc 6s]
91af566b: folds
a0328120: folds
Hero: folds
8c1f2bcb: raises $0.15 to $0.25
bf05caa7: raises $0.48 to $0.73
8a9d84cc: folds
8c1f2bcb: calls $0.48
*** FLOP *** [4h 6h 2h]
bf05caa7: bets $0.36
8c1f2bcb: folds
Uncalled bet ($0.36) returned to bf05caa7
*** SHOWDOWN ***
bf05caa7 collected $1.49 from pot
*** SUMMARY ***
Total pot $1.56 | Rake $0.07 | Jackpot $0 | Bingo $0 | Fortune $0 | Tax $0
Board [4h 6h 2h]
Seat 1: 8c1f2bcb (button) folded on the Flop
Seat 2: bf05caa7 (small blind) won ($1.49)
Seat 3: 8a9d84cc (big blind) folded before Flop
Seat 4: 91af566b folded before Flop (didn't bet)
Seat 5: a0328120 folded before Flop (didn't bet)
Seat 6: Hero folded before Flop (didn't bet)


Poker Hand #RC2075519550: Hold'em No Limit ($0.05/$0.1) - 2023/12/21 23:18:15
Table 'RushAndCash282998' 6-max Seat #1 is the button
Seat 1: 4dd34145 ($10.72 in chips)
Seat 2: a015d585 ($13.48 in chips)
Seat 3: Hero ($16.1 in chips)
Seat 4: 18ea8a80 ($9.85 in chips)
Seat 5: 6f89d6d3 ($6.02 in chips)
Seat 6: 329a57d7 ($16.74 in chips)
a015d585: posts small blind $0.05
Hero: posts big blind $0.1
*** HOLE CARDS ***
Dealt to 4dd34145 
Dealt to a015d585 
Dealt to Hero [3d 2d]
Dealt to 18ea8a80 
Dealt to 6f89d6d3 
Dealt to 329a57d7 
18ea8a80: folds
6f89d6d3: folds
329a57d7: folds
4dd34145: folds
a015d585: raises $0.15 to $0.25
Hero: folds
Uncalled bet ($0.15) returned to a015d585
*** SHOWDOWN ***
a015d585 collected $0.2 from pot
*** SUMMARY ***
Total pot $0.2 | Rake $0 | Jackpot $0 | Bingo $0 | Fortune $0 | Tax $0
Seat 1: 4dd34145 (button) folded before Flop (didn't bet)
Seat 2: a015d585 (small blind) collected ($0.2)
Seat 3: Hero (big blind) folded before Flop
Seat 4: 18ea8a80 folded before Flop (didn't bet)
Seat 5: 6f89d6d3 folded before Flop (didn't bet)
Seat 6: 329a57d7 folded before Flop (didn't bet)


Poker Hand #RC2075519472: Hold'em No Limit ($0.05/$0.1) - 2023/12/21 23:18:12
Table 'RushAndCash282952' 6-max Seat #1 is the button
Seat 1: 5954c4a8 ($16.6 in chips)
Seat 2: Hero ($16.15 in chips)
Seat 3: c2fef3e8 ($10.7 in chips)
Seat 4: ec0c4bef ($20.11 in chips)
Seat 5: 593dd101 ($11.73 in chips)
Seat 6: 7ddc107 ($10.63 in chips)
Hero: posts small blind $0.05
c2fef3e8: posts big blind $0.1
*** HOLE CARDS ***
Dealt to 5954c4a8 
Dealt to Hero [Th 5c]
Dealt to c2fef3e8 
Dealt to ec0c4bef 
Dealt to 593dd101 
Dealt to 7ddc107 
ec0c4bef: raises $0.11 to $0.21
593dd101: calls $0.21
7ddc107: calls $0.21
5954c4a8: folds
Hero: folds
c2fef3e8: folds
*** FLOP *** [Ac Qc Kd]
ec0c4bef: checks
593dd101: checks
7ddc107: checks
*** TURN *** [Ac Qc Kd] [4s]
ec0c4bef: checks
593dd101: checks
7ddc107: bets $0.4
ec0c4bef: calls $0.4
593dd101: calls $0.4
*** RIVER *** [Ac Qc Kd 4s] [8h]
ec0c4bef: checks
593dd101: bets $1.29
7ddc107: calls $1.29
ec0c4bef: folds
593dd101: shows [6s As] (Pair of Aces)
7ddc107: shows [4h 4c] (Three Fours)
*** SHOWDOWN ***
7ddc107 collected $4.19 from pot
*** SUMMARY ***
Total pot $4.56 | Rake $0.22 | Jackpot $0.15 | Bingo $0 | Fortune $0 | Tax $0
Board [Ac Qc Kd 4s 8h]
Seat 1: 5954c4a8 (button) folded before Flop (didn't bet)
Seat 2: Hero (small blind) folded before Flop
Seat 3: c2fef3e8 (big blind) folded before Flop
Seat 4: ec0c4bef folded on the River
Seat 5: 593dd101 showed [6s As] and lost with Pair of Aces
Seat 6: 7ddc107 showed [4h 4c] and won ($4.19) with Three Fours


Poker Hand #RC2075518779: Hold'em No Limit ($0.05/$0.1) - 2023/12/21 23:17:40
Table 'RushAndCash282548' 6-max Seat #1 is the button
Seat 1: Hero ($16.14 in chips)
Seat 2: 856ea788 ($9.56 in chips)
Seat 3: cd66a58b ($14.25 in chips)
Seat 4: a5728e47 ($10 in chips)
Seat 5: 8cb1fe0a ($11.49 in chips)
Seat 6: 19d4d1e2 ($81.99 in chips)
856ea788: posts small blind $0.05
cd66a58b: posts big blind $0.1
*** HOLE CARDS ***
Dealt to Hero [Kd Ac]
Dealt to 856ea788 
Dealt to cd66a58b 
Dealt to a5728e47 
Dealt to 8cb1fe0a 
Dealt to 19d4d1e2 
a5728e47: folds
8cb1fe0a: folds
19d4d1e2: folds
Hero: raises $0.15 to $0.25
856ea788: folds
cd66a58b: calls $0.15
*** FLOP *** [Qs Qh 6h]
cd66a58b: checks
Hero: checks
*** TURN *** [Qs Qh 6h] [Qd]
cd66a58b: checks
Hero: checks
*** RIVER *** [Qs Qh 6h Qd] [Ad]
cd66a58b: bets $0.1
Hero: calls $0.1
cd66a58b: shows [6s Ah] (Queens Full over Aces)
Hero: shows [Kd Ac] (Queens Full over Aces)
*** SHOWDOWN ***
cd66a58b collected $0.37 from pot
Hero collected $0.36 from pot
*** SUMMARY ***
Total pot $0.75 | Rake $0.02 | Jackpot $0 | Bingo $0 | Fortune $0 | Tax $0
Board [Qs Qh 6h Qd Ad]
Seat 1: Hero (button) showed [Kd Ac] and won ($0.36) with Queens Full over Aces
Seat 2: 856ea788 (small blind) folded before Flop
Seat 3: cd66a58b (big blind) showed [6s Ah] and won ($0.37) with Queens Full over Aces
Seat 4: a5728e47 folded before Flop (didn't bet)
Seat 5: 8cb1fe0a folded before Flop (didn't bet)
Seat 6: 19d4d1e2 folded before Flop (didn't bet)


Poker Hand #RC2075518701: Hold'em No Limit ($0.05/$0.1) - 2023/12/21 23:17:37
Table 'RushAndCash282503' 6-max Seat #1 is the button
Seat 1: a9f5c071 ($35.95 in chips)
Seat 2: 4cf98abd ($6.23 in chips)
Seat 3: 2577764 ($19.19 in chips)
Seat 4: 883c82b8 ($35.09 in chips)
Seat 5: e784e513 ($11.61 in chips)
Seat 6: Hero ($16.14 in chips)
4cf98abd: posts small blind $0.05
2577764: posts big blind $0.1
*** HOLE CARDS ***
Dealt to a9f5c071 
Dealt to 4cf98abd 
Dealt to 2577764 
Dealt to 883c82b8 
Dealt to e784e513 
Dealt to Hero [3h 8d]
883c82b8: folds
e784e513: folds
Hero: folds
a9f5c071: folds
4cf98abd: raises $0.2 to $0.3
2577764: folds
Uncalled bet ($0.2) returned to 4cf98abd
*** SHOWDOWN ***
4cf98abd collected $0.2 from pot
*** SUMMARY ***
Total pot $0.2 | Rake $0 | Jackpot $0 | Bingo $0 | Fortune $0 | Tax $0
Seat 1: a9f5c071 (button) folded before Flop (didn't bet)
Seat 2: 4cf98abd (small blind) collected ($0.2)
Seat 3: 2577764 (big blind) folded before Flop
Seat 4: 883c82b8 folded before Flop (didn't bet)
Seat 5: e784e513 folded before Flop (didn't bet)
Seat 6: Hero folded before Flop (didn't bet)


Poker Hand #RC2075518628: Hold'em No Limit ($0.05/$0.1) - 2023/12/21 23:17:34
Table 'RushAndCash282461' 6-max Seat #1 is the button
Seat 1: d470eda6 ($10.92 in chips)
Seat 2: bfe2728a ($10.45 in chips)
Seat 3: cfe193ac ($15.39 in chips)
Seat 4: de3a296d ($8.89 in chips)
Seat 5: 817c3f99 ($19.45 in chips)
Seat 6: Hero ($16.14 in chips)
bfe2728a: posts small blind $0.05
cfe193ac: posts big blind $0.1
*** HOLE CARDS ***
Dealt to d470eda6 
Dealt to bfe2728a 
Dealt to cfe193ac 
Dealt to de3a296d 
Dealt to 817c3f99 
Dealt to Hero [As 6d]
de3a296d: raises $0.25 to $0.35
817c3f99: folds
Hero: folds
d470eda6: folds
bfe2728a: folds
cfe193ac: folds
Uncalled bet ($0.25) returned to de3a296d
*** SHOWDOWN ***
de3a296d collected $0.25 from pot
*** SUMMARY ***
Total pot $0.25 | Rake $0 | Jackpot $0 | Bingo $0 | Fortune $0 | Tax $0
Seat 1: d470eda6 (button) folded before Flop (didn't bet)
Seat 2: bfe2728a (small blind) folded before Flop
Seat 3: cfe193ac (big blind) folded before Flop
Seat 4: de3a296d collected ($0.25)
Seat 5: 817c3f99 folded before Flop (didn't bet)
Seat 6: Hero folded before Flop (didn't bet)


Poker Hand #RC2075518550: Hold'em No Limit ($0.05/$0.1) - 2023/12/21 23:17:31
Table 'RushAndCash282415' 6-max Seat #1 is the button
Seat 1: Hero ($16.14 in chips)
Seat 2: 696644e5 ($16.52 in chips)
Seat 3: 1770bc6d ($8.8 in chips)
Seat 4: 17568c3e ($10 in chips)
Seat 5: 872819d1 ($17.43 in chips)
Seat 6: 4a98b50f ($7.29 in chips)
696644e5: posts small blind $0.05
1770bc6d: posts big blind $0.1
*** HOLE CARDS ***
Dealt to Hero [2h Ts]
Dealt to 696644e5 
Dealt to 1770bc6d 
Dealt to 17568c3e 
Dealt to 872819d1 
Dealt to 4a98b50f 
17568c3e: folds
872819d1: raises $0.1 to $0.2
4a98b50f: folds
Hero: folds
696644e5: raises $0.75 to $0.95
1770bc6d: calls $0.85
872819d1: folds
*** FLOP *** [9d Td 4h]
696644e5: bets $0.7
1770bc6d: calls $0.7
*** TURN *** [9d Td 4h] [2d]
696644e5: checks
1770bc6d: bets $1.16
696644e5: calls $1.16
*** RIVER *** [9d Td 4h 2d] [Js]
696644e5: checks
1770bc6d: bets $5.99 and is all-in
696644e5: calls $5.99
1770bc6d: shows [Kd Jd] (King High Flush)
696644e5: shows [Jc Tc] (Pair of Jacks and Pair of Tens)
*** SHOWDOWN ***
1770bc6d collected $17.35 from pot
*** SUMMARY ***
Total pot $17.8 | Rake $0.3 | Jackpot $0.15 | Bingo $0 | Fortune $0 | Tax $0
Board [9d Td 4h 2d Js]
Seat 1: Hero (button) folded before Flop (didn't bet)
Seat 2: 696644e5 (small blind) showed [Jc Tc] and lost with Pair of Jacks and Pair of Tens
Seat 3: 1770bc6d (big blind) showed [Kd Jd] and won ($17.35) with King High Flush
Seat 4: 17568c3e folded before Flop (didn't bet)
Seat 5: 872819d1 folded before Flop
Seat 6: 4a98b50f folded before Flop (didn't bet)


Poker Hand #RC2075518475: Hold'em No Limit ($0.05/$0.1) - 2023/12/21 23:17:27
Table 'RushAndCash282372' 6-max Seat #1 is the button
Seat 1: 35f88a2c ($15.27 in chips)
Seat 2: b709b035 ($12.24 in chips)
Seat 3: Hero ($16.24 in chips)
Seat 4: 98881624 ($10.45 in chips)
Seat 5: 9c11fa0c ($10 in chips)
Seat 6: 6051bca8 ($10.51 in chips)
b709b035: posts small blind $0.05
Hero: posts big blind $0.1
*** HOLE CARDS ***
Dealt to 35f88a2c 
Dealt to b709b035 
Dealt to Hero [2s 3c]
Dealt to 98881624 
Dealt to 9c11fa0c 
Dealt to 6051bca8 
98881624: raises $0.15 to $0.25
9c11fa0c: folds
6051bca8: folds
35f88a2c: folds
b709b035: folds
Hero: folds
Uncalled bet ($0.15) returned to 98881624
*** SHOWDOWN ***
98881624 collected $0.25 from pot
*** SUMMARY ***
Total pot $0.25 | Rake $0 | Jackpot $0 | Bingo $0 | Fortune $0 | Tax $0
Seat 1: 35f88a2c (button) folded before Flop (didn't bet)
Seat 2: b709b035 (small blind) folded before Flop
Seat 3: Hero (big blind) folded before Flop
Seat 4: 98881624 collected ($0.25)
Seat 5: 9c11fa0c folded before Flop (didn't bet)
Seat 6: 6051bca8 folded before Flop (didn't bet)


Poker Hand #RC2075518352: Hold'em No Limit ($0.05/$0.1) - 2023/12/21 23:17:22
Table 'RushAndCash282305' 6-max Seat #1 is the button
Seat 1: 58a8861f ($24.09 in chips)
Seat 2: Hero ($16.29 in chips)
Seat 3: 7e432535 ($10.59 in chips)
Seat 4: a377dd30 ($11.5 in chips)
Seat 5: 66a07e5b ($9.3 in chips)
Seat 6: fc0a3af9 ($29.85 in chips)
Hero: posts small blind $0.05
7e432535: posts big blind $0.1
*** HOLE CARDS ***
Dealt to 58a8861f 
Dealt to Hero [2c 6d]
Dealt to 7e432535 
Dealt to a377dd30 
Dealt to 66a07e5b 
Dealt to fc0a3af9 
a377dd30: folds
66a07e5b: folds
fc0a3af9: folds
58a8861f: folds
Hero: folds
Uncalled bet ($0.05) returned to 7e432535
*** SHOWDOWN ***
7e432535 collected $0.1 from pot
*** SUMMARY ***
Total pot $0.1 | Rake $0 | Jackpot $0 | Bingo $0 | Fortune $0 | Tax $0
Seat 1: 58a8861f (button) folded before Flop (didn't bet)
Seat 2: Hero (small blind) folded before Flop
Seat 3: 7e432535 (big blind) collected ($0.1)
Seat 4: a377dd30 folded before Flop (didn't bet)
Seat 5: 66a07e5b folded before Flop (didn't bet)
Seat 6: fc0a3af9 folded before Flop (didn't bet)


Poker Hand #RC2075518232: Hold'em No Limit ($0.05/$0.1) - 2023/12/21 23:17:17
Table 'RushAndCash282234' 6-max Seat #1 is the button
Seat 1: 9cd45aea ($10.05 in chips)
Seat 2: a7faa182 ($11.44 in chips)
Seat 3: f5e3eb2a ($10.55 in chips)
Seat 4: f6f7c205 ($10 in chips)
Seat 5: Hero ($16.29 in chips)
Seat 6: e873eecf ($8.5 in chips)
a7faa182: posts small blind $0.05
f5e3eb2a: posts big blind $0.1
*** HOLE CARDS ***
Dealt to 9cd45aea 
Dealt to a7faa182 
Dealt to f5e3eb2a 
Dealt to f6f7c205 
Dealt to Hero [Qh 7d]
Dealt to e873eecf 
f6f7c205: folds
Hero: folds
e873eecf: raises $0.15 to $0.25
9cd45aea: folds
a7faa182: folds
f5e3eb2a: folds
Uncalled bet ($0.15) returned to e873eecf
*** SHOWDOWN ***
e873eecf collected $0.25 from pot
*** SUMMARY ***
Total pot $0.25 | Rake $0 | Jackpot $0 | Bingo $0 | Fortune $0 | Tax $0
Seat 1: 9cd45aea (button) folded before Flop (didn't bet)
Seat 2: a7faa182 (small blind) folded before Flop
Seat 3: f5e3eb2a (big blind) folded before Flop
Seat 4: f6f7c205 folded before Flop (didn't bet)
Seat 5: Hero folded before Flop (didn't bet)
Seat 6: e873eecf collected ($0.25)


Poker Hand #RC2075518123: Hold'em No Limit ($0.05/$0.1) - 2023/12/21 23:17:12
Table 'RushAndCash282170' 6-max Seat #1 is the button
Seat 1: e50ccad6 ($9.64 in chips)
Seat 2: 63cf109b ($12.56 in chips)
Seat 3: 561e331c ($15.45 in chips)
Seat 4: 13dbf08c ($11.54 in chips)
Seat 5: Hero ($16.29 in chips)
Seat 6: 3d9f8599 ($8.95 in chips)
63cf109b: posts small blind $0.05
561e331c: posts big blind $0.1
*** HOLE CARDS ***
Dealt to e50ccad6 
Dealt to 63cf109b 
Dealt to 561e331c 
Dealt to 13dbf08c 
Dealt to Hero [Qd 2c]
Dealt to 3d9f8599 
13dbf08c: folds
Hero: folds
3d9f8599: raises $0.13 to $0.23
e50ccad6: folds
63cf109b: folds
561e331c: folds
Uncalled bet ($0.13) returned to 3d9f8599
*** SHOWDOWN ***
3d9f8599 collected $0.25 from pot
*** SUMMARY ***
Total pot $0.25 | Rake $0 | Jackpot $0 | Bingo $0 | Fortune $0 | Tax $0
Seat 1: e50ccad6 (button) folded before Flop (didn't bet)
Seat 2: 63cf109b (small blind) folded before Flop
Seat 3: 561e331c (big blind) folded before Flop
Seat 4: 13dbf08c folded before Flop (didn't bet)
Seat 5: Hero folded before Flop (didn't bet)
Seat 6: 3d9f8599 collected ($0.25)


Poker Hand #RC2075517959: Hold'em No Limit ($0.05/$0.1) - 2023/12/21 23:17:04
Table 'RushAndCash282074' 6-max Seat #1 is the button
Seat 1: 1e74bd5 ($40.22 in chips)
Seat 2: 88f073aa ($10.48 in chips)
Seat 3: f7c771a0 ($11.98 in chips)
Seat 4: 56eaa298 ($5.68 in chips)
Seat 5: Hero ($16.29 in chips)
Seat 6: ec17075 ($17.04 in chips)
88f073aa: posts small blind $0.05
f7c771a0: posts big blind $0.1
*** HOLE CARDS ***
Dealt to 1e74bd5 
Dealt to 88f073aa 
Dealt to f7c771a0 
Dealt to 56eaa298 
Dealt to Hero [Ad 4h]
Dealt to ec17075 
56eaa298: raises $0.1 to $0.2
Hero: folds
ec17075: calls $0.2
1e74bd5: folds
88f073aa: folds
f7c771a0: folds
*** FLOP *** [5c 2c Js]
56eaa298: checks
ec17075: bets $0.42
56eaa298: calls $0.42
*** TURN *** [5c 2c Js] [8d]
56eaa298: bets $0.46
ec17075: folds
Uncalled bet ($0.46) returned to 56eaa298
*** SHOWDOWN ***
56eaa298 collected $1.31 from pot
*** SUMMARY ***
Total pot $1.39 | Rake $0.08 | Jackpot $0 | Bingo $0 | Fortune $0 | Tax $0
Board [5c 2c Js 8d]
Seat 1: 1e74bd5 (button) folded before Flop (didn't bet)
Seat 2: 88f073aa (small blind) folded before Flop
Seat 3: f7c771a0 (big blind) folded before Flop
Seat 4: 56eaa298 won ($1.31)
Seat 5: Hero folded before Flop (didn't bet)
Seat 6: ec17075 folded on the Turn


Poker Hand #RC2075517856: Hold'em No Limit ($0.05/$0.1) - 2023/12/21 23:17:00
Table 'RushAndCash282010' 6-max Seat #1 is the button
Seat 1: c9e6a055 ($9.26 in chips)
Seat 2: 29fdd8d7 ($10 in chips)
Seat 3: 2cfba3be ($16.38 in chips)
Seat 4: Hero ($16.29 in chips)
Seat 5: 7a42948d ($10.19 in chips)
Seat 6: ab50b0ef ($10.22 in chips)
29fdd8d7: posts small blind $0.05
2cfba3be: posts big blind $0.1
*** HOLE CARDS ***
Dealt to c9e6a055 
Dealt to 29fdd8d7 
Dealt to 2cfba3be 
Dealt to Hero [Ac 5s]
Dealt to 7a42948d 
Dealt to ab50b0ef 
Hero: folds
7a42948d: folds
ab50b0ef: folds
c9e6a055: raises $0.2 to $0.3
29fdd8d7: raises $1.05 to $1.35
2cfba3be: folds
c9e6a055: calls $1.05
*** FLOP *** [9c 9s 7s]
29fdd8d7: bets $0.95
c9e6a055: folds
Uncalled bet ($0.95) returned to 29fdd8d7
*** SHOWDOWN ***
29fdd8d7 collected $2.66 from pot
*** SUMMARY ***
Total pot $2.8 | Rake $0.14 | Jackpot $0 | Bingo $0 | Fortune $0 | Tax $0
Board [9c 9s 7s]
Seat 1: c9e6a055 (button) folded on the Flop
Seat 2: 29fdd8d7 (small blind) won ($2.66)
Seat 3: 2cfba3be (big blind) folded before Flop
Seat 4: Hero folded before Flop (didn't bet)
Seat 5: 7a42948d folded before Flop (didn't bet)
Seat 6: ab50b0ef folded before Flop (didn't bet)


Poker Hand #RC2075517690: Hold'em No Limit ($0.05/$0.1) - 2023/12/21 23:16:53
Table 'RushAndCash281911' 6-max Seat #1 is the button
Seat 1: e0ab7d9c ($14.46 in chips)
Seat 2: Hero ($16.34 in chips)
Seat 3: 8aacb5ae ($10.27 in chips)
Seat 4: 4c260c74 ($18.28 in chips)
Seat 5: b6cbda02 ($10.65 in chips)
Seat 6: 8c322ae2 ($11.1 in chips)
Hero: posts small blind $0.05
8aacb5ae: posts big blind $0.1
*** HOLE CARDS ***
Dealt to e0ab7d9c 
Dealt to Hero [Td 2d]
Dealt to 8aacb5ae 
Dealt to 4c260c74 
Dealt to b6cbda02 
Dealt to 8c322ae2 
4c260c74: folds
b6cbda02: folds
8c322ae2: raises $0.15 to $0.25
e0ab7d9c: raises $0.5 to $0.75
Hero: folds
8aacb5ae: folds
8c322ae2: folds
Uncalled bet ($0.5) returned to e0ab7d9c
*** SHOWDOWN ***
e0ab7d9c collected $0.62 from pot
*** SUMMARY ***
Total pot $0.65 | Rake $0.03 | Jackpot $0 | Bingo $0 | Fortune $0 | Tax $0
Seat 1: e0ab7d9c (button) collected ($0.62)
Seat 2: Hero (small blind) folded before Flop
Seat 3: 8aacb5ae (big blind) folded before Flop
Seat 4: 4c260c74 folded before Flop (didn't bet)
Seat 5: b6cbda02 folded before Flop (didn't bet)
Seat 6: 8c322ae2 folded before Flop


Poker Hand #RC2075516466: Hold'em No Limit ($0.05/$0.1) - 2023/12/21 23:15:59
Table 'RushAndCash281176' 6-max Seat #1 is the button
Seat 1: dab3b6e6 ($11.52 in chips)
Seat 2: 8280b779 ($11.04 in chips)
Seat 3: Hero ($12.19 in chips)
Seat 4: 8e85dc82 ($11.02 in chips)
Seat 5: 14c8200d ($11.3 in chips)
Seat 6: cd85353e ($9.09 in chips)
8280b779: posts small blind $0.05
Hero: posts big blind $0.1
*** HOLE CARDS ***
Dealt to dab3b6e6 
Dealt to 8280b779 
Dealt to Hero [6s 6c]
Dealt to 8e85dc82 
Dealt to 14c8200d 
Dealt to cd85353e 
8e85dc82: folds
14c8200d: raises $0.1 to $0.2
cd85353e: folds
dab3b6e6: folds
8280b779: calls $0.15
Hero: calls $0.1
*** FLOP *** [Ah 6h Ts]
8280b779: checks
Hero: checks
14c8200d: checks
*** TURN *** [Ah 6h Ts] [Js]
8280b779: checks
Hero: bets $0.3
14c8200d: raises $0.9 to $1.2
8280b779: folds
Hero: calls $0.9
*** RIVER *** [Ah 6h Ts Js] [Jc]
Hero: checks
14c8200d: bets $1.5
Hero: raises $1.5 to $3
14c8200d: calls $1.5
Hero: shows [6s 6c] (Sixes Full over Jacks)
14c8200d: shows [Kc Qh] (Aces-High Straight)
*** SHOWDOWN ***
Hero collected $8.55 from pot
*** SUMMARY ***
Total pot $9 | Rake $0.3 | Jackpot $0.15 | Bingo $0 | Fortune $0 | Tax $0
Board [Ah 6h Ts Js Jc]
Seat 1: dab3b6e6 (button) folded before Flop (didn't bet)
Seat 2: 8280b779 (small blind) folded on the Turn
Seat 3: Hero (big blind) showed [6s 6c] and won ($8.55) with Sixes Full over Jacks
Seat 4: 8e85dc82 folded before Flop (didn't bet)
Seat 5: 14c8200d showed [Kc Qh] and lost with Aces-High Straight
Seat 6: cd85353e folded before Flop (didn't bet)


Poker Hand #RC2075516377: Hold'em No Limit ($0.05/$0.1) - 2023/12/21 23:15:55
Table 'RushAndCash281125' 6-max Seat #1 is the button
Seat 1: Hero ($12.19 in chips)
Seat 2: 77d5115b ($12.77 in chips)
Seat 3: b67d1710 ($19.97 in chips)
Seat 4: 2b0be38a ($21.06 in chips)
Seat 5: 561e331c ($15.6 in chips)
Seat 6: b22fb319 ($9.1 in chips)
77d5115b: posts small blind $0.05
b67d1710: posts big blind $0.1
*** HOLE CARDS ***
Dealt to Hero [Kd 7h]
Dealt to 77d5115b 
Dealt to b67d1710 
Dealt to 2b0be38a 
Dealt to 561e331c 
Dealt to b22fb319 
2b0be38a: folds
561e331c: folds
b22fb319: folds
Hero: folds
77d5115b: raises $0.2 to $0.3
b67d1710: folds
Uncalled bet ($0.2) returned to 77d5115b
*** SHOWDOWN ***
77d5115b collected $0.2 from pot
*** SUMMARY ***
Total pot $0.2 | Rake $0 | Jackpot $0 | Bingo $0 | Fortune $0 | Tax $0
Seat 1: Hero (button) folded before Flop (didn't bet)
Seat 2: 77d5115b (small blind) collected ($0.2)
Seat 3: b67d1710 (big blind) folded before Flop
Seat 4: 2b0be38a folded before Flop (didn't bet)
Seat 5: 561e331c folded before Flop (didn't bet)
Seat 6: b22fb319 folded before Flop (didn't bet)


Poker Hand #RC2075516302: Hold'em No Limit ($0.05/$0.1) - 2023/12/21 23:15:52
Table 'RushAndCash281082' 6-max Seat #1 is the button
Seat 1: 88b4672a ($10.93 in chips)
Seat 2: e6ec727d ($10 in chips)
Seat 3: 4cf98abd ($6.29 in chips)
Seat 4: Hero ($12.19 in chips)
Seat 5: 62bf9f26 ($13.25 in chips)
Seat 6: f28e2f33 ($10.13 in chips)
e6ec727d: posts small blind $0.05
4cf98abd: posts big blind $0.1
*** HOLE CARDS ***
Dealt to 88b4672a 
Dealt to e6ec727d 
Dealt to 4cf98abd 
Dealt to Hero [9c Td]
Dealt to 62bf9f26 
Dealt to f28e2f33 
Hero: folds
62bf9f26: folds
f28e2f33: folds
88b4672a: raises $0.15 to $0.25
e6ec727d: folds
4cf98abd: folds
Uncalled bet ($0.15) returned to 88b4672a
*** SHOWDOWN ***
88b4672a collected $0.25 from pot
*** SUMMARY ***
Total pot $0.25 | Rake $0 | Jackpot $0 | Bingo $0 | Fortune $0 | Tax $0
Seat 1: 88b4672a (button) collected ($0.25)
Seat 2: e6ec727d (small blind) folded before Flop
Seat 3: 4cf98abd (big blind) folded before Flop
Seat 4: Hero folded before Flop (didn't bet)
Seat 5: 62bf9f26 folded before Flop (didn't bet)
Seat 6: f28e2f33 folded before Flop (didn't bet)


Poker Hand #RC2075516188: Hold'em No Limit ($0.05/$0.1) - 2023/12/21 23:15:47
Table 'RushAndCash281016' 6-max Seat #1 is the button
Seat 1: 988faf17 ($23.25 in chips)
Seat 2: d693b744 ($12.65 in chips)
Seat 3: 12ed0b3f ($17.62 in chips)
Seat 4: Hero ($12.19 in chips)
Seat 5: e31d093b ($10 in chips)
Seat 6: fc881f34 ($16.15 in chips)
d693b744: posts small blind $0.05
12ed0b3f: posts big blind $0.1
*** HOLE CARDS ***
Dealt to 988faf17 
Dealt to d693b744 
Dealt to 12ed0b3f 
Dealt to Hero [9h 4s]
Dealt to e31d093b 
Dealt to fc881f34 
Hero: folds
e31d093b: raises $0.1 to $0.2
fc881f34: folds
988faf17: folds
d693b744: calls $0.15
12ed0b3f: folds
*** FLOP *** [Jh 7h Qs]
d693b744: checks
e31d093b: checks
*** TURN *** [Jh 7h Qs] [3s]
d693b744: checks
e31d093b: checks
*** RIVER *** [Jh 7h Qs 3s] [Th]
d693b744: checks
e31d093b: checks
d693b744: shows [Td Ac] (Pair of Tens)
e31d093b: shows [2h 2d] (Pair of Twos)
*** SHOWDOWN ***
d693b744 collected $0.48 from pot
*** SUMMARY ***
Total pot $0.5 | Rake $0.02 | Jackpot $0 | Bingo $0 | Fortune $0 | Tax $0
Board [Jh 7h Qs 3s Th]
Seat 1: 988faf17 (button) folded before Flop (didn't bet)
Seat 2: d693b744 (small blind) showed [Td Ac] and won ($0.48) with Pair of Tens
Seat 3: 12ed0b3f (big blind) folded before Flop
Seat 4: Hero folded before Flop (didn't bet)
Seat 5: e31d093b showed [2h 2d] and lost with Pair of Twos
Seat 6: fc881f34 folded before Flop (didn't bet)


Poker Hand #RC2075515952: Hold'em No Limit ($0.05/$0.1) - 2023/12/21 23:15:36
Table 'RushAndCash280880' 6-max Seat #1 is the button
Seat 1: 30675df0 ($26.91 in chips)
Seat 2: 2ca8cd2b ($15.44 in chips)
Seat 3: dc18fbf1 ($13.28 in chips)
Seat 4: Hero ($12.19 in chips)
Seat 5: 6fe2a3f4 ($10.45 in chips)
Seat 6: 4d3be08a ($10.74 in chips)
2ca8cd2b: posts small blind $0.05
dc18fbf1: posts big blind $0.1
*** HOLE CARDS ***
Dealt to 30675df0 
Dealt to 2ca8cd2b 
Dealt to dc18fbf1 
Dealt to Hero [Ts Jc]
Dealt to 6fe2a3f4 
Dealt to 4d3be08a 
Hero: folds
6fe2a3f4: raises $0.15 to $0.25
4d3be08a: calls $0.25
30675df0: calls $0.25
2ca8cd2b: folds
dc18fbf1: calls $0.15
*** FLOP *** [6h 5c Kc]
dc18fbf1: checks
6fe2a3f4: bets $0.53
4d3be08a: folds
30675df0: folds
dc18fbf1: raises $0.97 to $1.5
6fe2a3f4: folds
Uncalled bet ($0.97) returned to dc18fbf1
*** SHOWDOWN ***
dc18fbf1 collected $2.01 from pot
*** SUMMARY ***
Total pot $2.11 | Rake $0.1 | Jackpot $0 | Bingo $0 | Fortune $0 | Tax $0
Board [6h 5c Kc]
Seat 1: 30675df0 (button) folded on the Flop
Seat 2: 2ca8cd2b (small blind) folded before Flop
Seat 3: dc18fbf1 (big blind) won ($2.01)
Seat 4: Hero folded before Flop (didn't bet)
Seat 5: 6fe2a3f4 folded on the Flop
Seat 6: 4d3be08a folded on the Flop


Poker Hand #RC2075515675: Hold'em No Limit ($0.05/$0.1) - 2023/12/21 23:15:24
Table 'RushAndCash280712' 6-max Seat #1 is the button
Seat 1: cbf9cbe2 ($47.16 in chips)
Seat 2: Hero ($12.24 in chips)
Seat 3: 143af99f ($11.33 in chips)
Seat 4: f2deab29 ($10 in chips)
Seat 5: b6cbda02 ($10.95 in chips)
Seat 6: 69b99c5e ($6.88 in chips)
Hero: posts small blind $0.05
143af99f: posts big blind $0.1
*** HOLE CARDS ***
Dealt to cbf9cbe2 
Dealt to Hero [7d Ks]
Dealt to 143af99f 
Dealt to f2deab29 
Dealt to b6cbda02 
Dealt to 69b99c5e 
f2deab29: folds
b6cbda02: folds
69b99c5e: folds
cbf9cbe2: folds
Hero: folds
Uncalled bet ($0.05) returned to 143af99f
*** SHOWDOWN ***
143af99f collected $0.1 from pot
*** SUMMARY ***
Total pot $0.1 | Rake $0 | Jackpot $0 | Bingo $0 | Fortune $0 | Tax $0
Seat 1: cbf9cbe2 (button) folded before Flop (didn't bet)
Seat 2: Hero (small blind) folded before Flop
Seat 3: 143af99f (big blind) collected ($0.1)
Seat 4: f2deab29 folded before Flop (didn't bet)
Seat 5: b6cbda02 folded before Flop (didn't bet)
Seat 6: 69b99c5e folded before Flop (didn't bet)


Poker Hand #RC2075514941: Hold'em No Limit ($0.05/$0.1) - 2023/12/21 23:14:50
Table 'RushAndCash280264' 6-max Seat #1 is the button
Seat 1: Hero ($11.59 in chips)
Seat 2: 9b7c3e15 ($9.9 in chips)
Seat 3: cbf9cbe2 ($47.83 in chips)
Seat 4: 4db72d80 ($10 in chips)
Seat 5: 273a60ae ($10 in chips)
Seat 6: 8aacb5ae ($10.19 in chips)
9b7c3e15: posts small blind $0.05
cbf9cbe2: posts big blind $0.1
*** HOLE CARDS ***
Dealt to Hero [Jc Jd]
Dealt to 9b7c3e15 
Dealt to cbf9cbe2 
Dealt to 4db72d80 
Dealt to 273a60ae 
Dealt to 8aacb5ae 
4db72d80: folds
273a60ae: folds
8aacb5ae: folds
Hero: raises $0.15 to $0.25
9b7c3e15: folds
cbf9cbe2: calls $0.15
*** FLOP *** [4h 5d 2h]
cbf9cbe2: checks
Hero: checks
*** TURN *** [4h 5d 2h] [9c]
cbf9cbe2: bets $0.42
Hero: raises $0.82 to $1.24
cbf9cbe2: folds
Uncalled bet ($0.82) returned to Hero
*** SHOWDOWN ***
Hero collected $1.32 from pot
*** SUMMARY ***
Total pot $1.39 | Rake $0.07 | Jackpot $0 | Bingo $0 | Fortune $0 | Tax $0
Board [4h 5d 2h 9c]
Seat 1: Hero (button) won ($1.32)
Seat 2: 9b7c3e15 (small blind) folded before Flop
Seat 3: cbf9cbe2 (big blind) folded on the Turn
Seat 4: 4db72d80 folded before Flop (didn't bet)
Seat 5: 273a60ae folded before Flop (didn't bet)
Seat 6: 8aacb5ae folded before Flop (didn't bet)


Poker Hand #RC2075504708: Hold'em No Limit ($0.05/$0.1) - 2023/12/21 23:14:39
Table 'RushAndCash280129' 6-max Seat #1 is the button
Seat 1: 15699fcc ($12.46 in chips)
Seat 2: 19439590 ($3.45 in chips)
Seat 3: Hero ($11.54 in chips)
Seat 4: f3e6b85d ($11.16 in chips)
Seat 5: aec020a3 ($10.1 in chips)
Seat 6: 30675df0 ($26.68 in chips)
19439590: posts small blind $0.05
Hero: posts big blind $0.1
*** HOLE CARDS ***
Dealt to 15699fcc 
Dealt to 19439590 
Dealt to Hero [8h 6h]
Dealt to f3e6b85d 
Dealt to aec020a3 
Dealt to 30675df0 
f3e6b85d: folds
aec020a3: folds
30675df0: folds
15699fcc: folds
19439590: folds
Uncalled bet ($0.05) returned to Hero
*** SHOWDOWN ***
Hero collected $0.1 from pot
*** SUMMARY ***
Total pot $0.1 | Rake $0 | Jackpot $0 | Bingo $0 | Fortune $0 | Tax $0
Seat 1: 15699fcc (button) folded before Flop (didn't bet)
Seat 2: 19439590 (small blind) folded before Flop
Seat 3: Hero (big blind) collected ($0.1)
Seat 4: f3e6b85d folded before Flop (didn't bet)
Seat 5: aec020a3 folded before Flop (didn't bet)
Seat 6: 30675df0 folded before Flop (didn't bet)


Poker Hand #RC2075504641: Hold'em No Limit ($0.05/$0.1) - 2023/12/21 23:14:35
Table 'RushAndCash280088' 6-max Seat #1 is the button
Seat 1: 5b4c162c ($19.37 in chips)
Seat 2: b0cce9fb ($4.26 in chips)
Seat 3: de9df32a ($6.94 in chips)
Seat 4: Hero ($11.54 in chips)
Seat 5: 19ab345f ($10.27 in chips)
Seat 6: a38504a2 ($18.94 in chips)
b0cce9fb: posts small blind $0.05
de9df32a: posts big blind $0.1
*** HOLE CARDS ***
Dealt to 5b4c162c 
Dealt to b0cce9fb 
Dealt to de9df32a 
Dealt to Hero [Ks Qc]
Dealt to 19ab345f 
Dealt to a38504a2 
Hero: folds
19ab345f: folds
a38504a2: folds
5b4c162c: folds
b0cce9fb: folds
Uncalled bet ($0.05) returned to de9df32a
*** SHOWDOWN ***
de9df32a collected $0.1 from pot
*** SUMMARY ***
Total pot $0.1 | Rake $0 | Jackpot $0 | Bingo $0 | Fortune $0 | Tax $0
Seat 1: 5b4c162c (button) folded before Flop (didn't bet)
Seat 2: b0cce9fb (small blind) folded before Flop
Seat 3: de9df32a (big blind) collected ($0.1)
Seat 4: Hero folded before Flop (didn't bet)
Seat 5: 19ab345f folded before Flop (didn't bet)
Seat 6: a38504a2 folded before Flop (didn't bet)


Poker Hand #RC2075504560: Hold'em No Limit ($0.05/$0.1) - 2023/12/21 23:14:32
Table 'RushAndCash280044' 6-max Seat #1 is the button
Seat 1: fbccf29c ($22.41 in chips)
Seat 2: 57cc773 ($3.24 in chips)
Seat 3: e2adffdd ($26.57 in chips)
Seat 4: f19a061c ($18.8 in chips)
Seat 5: dc1f42c2 ($45.27 in chips)
Seat 6: Hero ($11.54 in chips)
57cc773: posts small blind $0.05
e2adffdd: posts big blind $0.1
*** HOLE CARDS ***
Dealt to fbccf29c 
Dealt to 57cc773 
Dealt to e2adffdd 
Dealt to f19a061c 
Dealt to dc1f42c2 
Dealt to Hero [7s Qc]
f19a061c: folds
dc1f42c2: raises $0.12 to $0.22
Hero: folds
fbccf29c: folds
57cc773: folds
e2adffdd: calls $0.12
*** FLOP *** [Js Ad Ac]
e2adffdd: checks
dc1f42c2: bets $0.13
e2adffdd: calls $0.13
*** TURN *** [Js Ad Ac] [9c]
e2adffdd: checks
dc1f42c2: checks
*** RIVER *** [Js Ad Ac 9c] [8d]
e2adffdd: checks
dc1f42c2: checks
e2adffdd: shows [Ah Jc] (Aces Full over Jacks)
dc1f42c2: shows [Td Th] (Pair of Aces and Pair of Tens)
*** SHOWDOWN ***
e2adffdd collected $0.72 from pot
*** SUMMARY ***
Total pot $0.75 | Rake $0.03 | Jackpot $0 | Bingo $0 | Fortune $0 | Tax $0
Board [Js Ad Ac 9c 8d]
Seat 1: fbccf29c (button) folded before Flop (didn't bet)
Seat 2: 57cc773 (small blind) folded before Flop
Seat 3: e2adffdd (big blind) showed [Ah Jc] and won ($0.72) with Aces Full over Jacks
Seat 4: f19a061c folded before Flop (didn't bet)
Seat 5: dc1f42c2 showed [Td Th] and lost with Pair of Aces and Pair of Tens
Seat 6: Hero folded before Flop (didn't bet)


Poker Hand #RC2075504487: Hold'em No Limit ($0.05/$0.1) - 2023/12/21 23:14:29
Table 'RushAndCash280000' 6-max Seat #1 is the button
Seat 1: Hero ($11.54 in chips)
Seat 2: ea8afa ($27.75 in chips)
Seat 3: 2e53f43e ($10.25 in chips)
Seat 4: 88436705 ($14.2 in chips)
Seat 5: 5e8985b5 ($23.52 in chips)
Seat 6: 3b81c7a ($10.23 in chips)
ea8afa: posts small blind $0.05
2e53f43e: posts big blind $0.1
*** HOLE CARDS ***
Dealt to Hero [4c Jc]
Dealt to ea8afa 
Dealt to 2e53f43e 
Dealt to 88436705 
Dealt to 5e8985b5 
Dealt to 3b81c7a 
88436705: raises $0.15 to $0.25
5e8985b5: raises $0.49 to $0.74
3b81c7a: folds
Hero: folds
ea8afa: folds
2e53f43e: folds
88436705: raises $1.46 to $2.2
5e8985b5: calls $1.46
*** FLOP *** [Kh Ac 7c]
88436705: bets $2.3
5e8985b5: calls $2.3
*** TURN *** [Kh Ac 7c] [2s]
88436705: bets $3.05
5e8985b5: calls $3.05
*** RIVER *** [Kh Ac 7c 2s] [9c]
88436705: bets $6.65 and is all-in
5e8985b5: folds
Uncalled bet ($6.65) returned to 88436705
*** SHOWDOWN ***
88436705 collected $14.8 from pot
*** SUMMARY ***
Total pot $15.25 | Rake $0.3 | Jackpot $0.15 | Bingo $0 | Fortune $0 | Tax $0
Board [Kh Ac 7c 2s 9c]
Seat 1: Hero (button) folded before Flop (didn't bet)
Seat 2: ea8afa (small blind) folded before Flop
Seat 3: 2e53f43e (big blind) folded before Flop
Seat 4: 88436705 won ($14.8)
Seat 5: 5e8985b5 folded on the River
Seat 6: 3b81c7a folded before Flop (didn't bet)


Poker Hand #RC2075504177: Hold'em No Limit ($0.05/$0.1) - 2023/12/21 23:14:15
Table 'RushAndCash279829' 6-max Seat #1 is the button
Seat 1: e15317b3 ($21.12 in chips)
Seat 2: Hero ($11.44 in chips)
Seat 3: b445bdd1 ($26.7 in chips)
Seat 4: f19a061c ($18.75 in chips)
Seat 5: bff15b23 ($8.54 in chips)
Seat 6: a181e66d ($9.03 in chips)
Hero: posts small blind $0.05
b445bdd1: posts big blind $0.1
*** HOLE CARDS ***
Dealt to e15317b3 
Dealt to Hero [As 9s]
Dealt to b445bdd1 
Dealt to f19a061c 
Dealt to bff15b23 
Dealt to a181e66d 
f19a061c: folds
bff15b23: folds
a181e66d: folds
e15317b3: folds
Hero: raises $0.2 to $0.3
b445bdd1: folds
Uncalled bet ($0.2) returned to Hero
*** SHOWDOWN ***
Hero collected $0.2 from pot
*** SUMMARY ***
Total pot $0.2 | Rake $0 | Jackpot $0 | Bingo $0 | Fortune $0 | Tax $0
Seat 1: e15317b3 (button) folded before Flop (didn't bet)
Seat 2: Hero (small blind) collected ($0.2)
Seat 3: b445bdd1 (big blind) folded before Flop
Seat 4: f19a061c folded before Flop (didn't bet)
Seat 5: bff15b23 folded before Flop (didn't bet)
Seat 6: a181e66d folded before Flop (didn't bet)


Poker Hand #RC2075504087: Hold'em No Limit ($0.05/$0.1) - 2023/12/21 23:14:11
Table 'RushAndCash279778' 6-max Seat #1 is the button
Seat 1: cd6bdce7 ($11.72 in chips)
Seat 2: e027b096 ($9.76 in chips)
Seat 3: 27d2c161 ($10.15 in chips)
Seat 4: Hero ($11.44 in chips)
Seat 5: 24f3f1b4 ($3.65 in chips)
Seat 6: 85891fa5 ($10 in chips)
e027b096: posts small blind $0.05
27d2c161: posts big blind $0.1
*** HOLE CARDS ***
Dealt to cd6bdce7 
Dealt to e027b096 
Dealt to 27d2c161 
Dealt to Hero [6d 7d]
Dealt to 24f3f1b4 
Dealt to 85891fa5 
Hero: folds
24f3f1b4: folds
85891fa5: folds
cd6bdce7: raises $0.15 to $0.25
e027b096: folds
27d2c161: folds
Uncalled bet ($0.15) returned to cd6bdce7
*** SHOWDOWN ***
cd6bdce7 collected $0.25 from pot
*** SUMMARY ***
Total pot $0.25 | Rake $0 | Jackpot $0 | Bingo $0 | Fortune $0 | Tax $0
Seat 1: cd6bdce7 (button) collected ($0.25)
Seat 2: e027b096 (small blind) folded before Flop
Seat 3: 27d2c161 (big blind) folded before Flop
Seat 4: Hero folded before Flop (didn't bet)
Seat 5: 24f3f1b4 folded before Flop (didn't bet)
Seat 6: 85891fa5 folded before Flop (didn't bet)


Poker Hand #RC2075503984: Hold'em No Limit ($0.05/$0.1) - 2023/12/21 23:14:06
Table 'RushAndCash279721' 6-max Seat #1 is the button
Seat 1: 53c1d8d8 ($10.48 in chips)
Seat 2: f1d74368 ($10.05 in chips)
Seat 3: Hero ($11.54 in chips)
Seat 4: e9cb7359 ($40.77 in chips)
Seat 5: e7a2d540 ($24.39 in chips)
Seat 6: 15745ea2 ($9.7 in chips)
f1d74368: posts small blind $0.05
Hero: posts big blind $0.1
*** HOLE CARDS ***
Dealt to 53c1d8d8 
Dealt to f1d74368 
Dealt to Hero [8s Jd]
Dealt to e9cb7359 
Dealt to e7a2d540 
Dealt to 15745ea2 
e9cb7359: folds
e7a2d540: raises $0.15 to $0.25
15745ea2: folds
53c1d8d8: folds
f1d74368: folds
Hero: folds
Uncalled bet ($0.15) returned to e7a2d540
*** SHOWDOWN ***
e7a2d540 collected $0.25 from pot
*** SUMMARY ***
Total pot $0.25 | Rake $0 | Jackpot $0 | Bingo $0 | Fortune $0 | Tax $0
Seat 1: 53c1d8d8 (button) folded before Flop (didn't bet)
Seat 2: f1d74368 (small blind) folded before Flop
Seat 3: Hero (big blind) folded before Flop
Seat 4: e9cb7359 folded before Flop (didn't bet)
Seat 5: e7a2d540 collected ($0.25)
Seat 6: 15745ea2 folded before Flop (didn't bet)


Poker Hand #RC2075503265: Hold'em No Limit ($0.05/$0.1) - 2023/12/21 23:13:35
Table 'RushAndCash279292' 6-max Seat #1 is the button
Seat 1: 4ea304af ($15.19 in chips)
Seat 2: 98881624 ($10.34 in chips)
Seat 3: 77c638f2 ($10.15 in chips)
Seat 4: Hero ($11.21 in chips)
Seat 5: 1adb71b5 ($6.09 in chips)
Seat 6: e0ab7d9c ($13.36 in chips)
98881624: posts small blind $0.05
77c638f2: posts big blind $0.1
*** HOLE CARDS ***
Dealt to 4ea304af 
Dealt to 98881624 
Dealt to 77c638f2 
Dealt to Hero [Ah Qs]
Dealt to 1adb71b5 
Dealt to e0ab7d9c 
Hero: raises $0.1 to $0.2
1adb71b5: folds
e0ab7d9c: folds
4ea304af: calls $0.2
98881624: folds
77c638f2: folds
*** FLOP *** [Qd 8s 4s]
Hero: bets $0.2
4ea304af: folds
Uncalled bet ($0.2) returned to Hero
*** SHOWDOWN ***
Hero collected $0.53 from pot
*** SUMMARY ***
Total pot $0.55 | Rake $0.02 | Jackpot $0 | Bingo $0 | Fortune $0 | Tax $0
Board [Qd 8s 4s]
Seat 1: 4ea304af (button) folded on the Flop
Seat 2: 98881624 (small blind) folded before Flop
Seat 3: 77c638f2 (big blind) folded before Flop
Seat 4: Hero won ($0.53)
Seat 5: 1adb71b5 folded before Flop (didn't bet)
Seat 6: e0ab7d9c folded before Flop (didn't bet)


Poker Hand #RC2075503197: Hold'em No Limit ($0.05/$0.1) - 2023/12/21 23:13:32
Table 'RushAndCash279251' 6-max Seat #1 is the button
Seat 1: e9d3a02b ($10 in chips)
Seat 2: e5932e75 ($22.96 in chips)
Seat 3: 2adaa014 ($7.46 in chips)
Seat 4: 5681d7bf ($10.63 in chips)
Seat 5: Hero ($11.21 in chips)
Seat 6: 1080fc59 ($16.04 in chips)
e5932e75: posts small blind $0.05
2adaa014: posts big blind $0.1
*** HOLE CARDS ***
Dealt to e9d3a02b 
Dealt to e5932e75 
Dealt to 2adaa014 
Dealt to 5681d7bf 
Dealt to Hero [8s Ad]
Dealt to 1080fc59 
5681d7bf: folds
Hero: folds
1080fc59: raises $0.15 to $0.25
e9d3a02b: folds
e5932e75: folds
2adaa014: folds
Uncalled bet ($0.15) returned to 1080fc59
*** SHOWDOWN ***
1080fc59 collected $0.25 from pot
*** SUMMARY ***
Total pot $0.25 | Rake $0 | Jackpot $0 | Bingo $0 | Fortune $0 | Tax $0
Seat 1: e9d3a02b (button) folded before Flop (didn't bet)
Seat 2: e5932e75 (small blind) folded before Flop
Seat 3: 2adaa014 (big blind) folded before Flop
Seat 4: 5681d7bf folded before Flop (didn't bet)
Seat 5: Hero folded before Flop (didn't bet)
Seat 6: 1080fc59 collected ($0.25)


Poker Hand #RC2075503119: Hold'em No Limit ($0.05/$0.1) - 2023/12/21 23:13:29
Table 'RushAndCash279202' 6-max Seat #1 is the button
Seat 1: 3089b429 ($17.58 in chips)
Seat 2: 5e919d66 ($4.24 in chips)
Seat 3: 53dde893 ($19.95 in chips)
Seat 4: cbf9cbe2 ($48.03 in chips)
Seat 5: Hero ($11.21 in chips)
Seat 6: c2fef3e8 ($10.15 in chips)
5e919d66: posts small blind $0.05
53dde893: posts big blind $0.1
*** HOLE CARDS ***
Dealt to 3089b429 
Dealt to 5e919d66 
Dealt to 53dde893 
Dealt to cbf9cbe2 
Dealt to Hero [3s Ts]
Dealt to c2fef3e8 
cbf9cbe2: folds
Hero: folds
c2fef3e8: folds
3089b429: folds
5e919d66: folds
Uncalled bet ($0.05) returned to 53dde893
*** SHOWDOWN ***
53dde893 collected $0.1 from pot
*** SUMMARY ***
Total pot $0.1 | Rake $0 | Jackpot $0 | Bingo $0 | Fortune $0 | Tax $0
Seat 1: 3089b429 (button) folded before Flop (didn't bet)
Seat 2: 5e919d66 (small blind) folded before Flop
Seat 3: 53dde893 (big blind) collected ($0.1)
Seat 4: cbf9cbe2 folded before Flop (didn't bet)
Seat 5: Hero folded before Flop (didn't bet)
Seat 6: c2fef3e8 folded before Flop (didn't bet)


Poker Hand #RC2075502005: Hold'em No Limit ($0.05/$0.1) - 2023/12/21 23:12:39
Table 'RushAndCash278532' 6-max Seat #1 is the button
Seat 1: bd4374fe ($9.9 in chips)
Seat 2: Hero ($10 in chips)
Seat 3: cbf9cbe2 ($49.53 in chips)
Seat 4: 1080fc59 ($15.89 in chips)
Seat 5: a4c0cc7 ($10.14 in chips)
Seat 6: 36c8f3de ($10 in chips)
Hero: posts small blind $0.05
cbf9cbe2: posts big blind $0.1
*** HOLE CARDS ***
Dealt to bd4374fe 
Dealt to Hero [Kc Qd]
Dealt to cbf9cbe2 
Dealt to 1080fc59 
Dealt to a4c0cc7 
Dealt to 36c8f3de 
1080fc59: folds
a4c0cc7: folds
36c8f3de: folds
bd4374fe: folds
Hero: raises $0.2 to $0.3
cbf9cbe2: calls $0.2
*** FLOP *** [Ts 7h 2c]
Hero: checks
cbf9cbe2: bets $0.45
Hero: raises $0.75 to $1.2
cbf9cbe2: calls $0.75
*** TURN *** [Ts 7h 2c] [Js]
Hero: bets $1.5
cbf9cbe2: folds
Uncalled bet ($1.5) returned to Hero
*** SHOWDOWN ***
Hero collected $2.71 from pot
*** SUMMARY ***
Total pot $3 | Rake $0.14 | Jackpot $0.15 | Bingo $0 | Fortune $0 | Tax $0
Board [Ts 7h 2c Js]
Seat 1: bd4374fe (button) folded before Flop (didn't bet)
Seat 2: Hero (small blind) won ($2.71)
Seat 3: cbf9cbe2 (big blind) folded on the Turn
Seat 4: 1080fc59 folded before Flop (didn't bet)
Seat 5: a4c0cc7 folded before Flop (didn't bet)
Seat 6: 36c8f3de folded before Flop (didn't bet)


Poker Hand #RC2075501560: Hold'em No Limit ($0.05/$0.1) - 2023/12/21 23:12:18
Table 'RushAndCash278262' 6-max Seat #1 is the button
Seat 1: Hero ($10 in chips)
Seat 2: abed12f5 ($10 in chips)
Seat 3: fd721595 ($20.9 in chips)
Seat 4: 98191a40 ($3.38 in chips)
Seat 5: 36c8f3de ($10.05 in chips)
Seat 6: bd3b2870 ($16.8 in chips)
abed12f5: posts small blind $0.05
fd721595: posts big blind $0.1
*** HOLE CARDS ***
Dealt to Hero [7h 6h]
Dealt to abed12f5 
Dealt to fd721595 
Dealt to 98191a40 
Dealt to 36c8f3de 
Dealt to bd3b2870 
98191a40: folds
36c8f3de: folds
bd3b2870: raises $0.1 to $0.2
Hero: calls $0.2
abed12f5: raises $1 to $1.2
fd721595: folds
bd3b2870: folds
Hero: folds
Uncalled bet ($1) returned to abed12f5
*** SHOWDOWN ***
abed12f5 collected $0.67 from pot
*** SUMMARY ***
Total pot $0.7 | Rake $0.03 | Jackpot $0 | Bingo $0 | Fortune $0 | Tax $0
Seat 1: Hero (button) folded before Flop
Seat 2: abed12f5 (small blind) collected ($0.67)
Seat 3: fd721595 (big blind) folded before Flop
Seat 4: 98191a40 folded before Flop (didn't bet)
Seat 5: 36c8f3de folded before Flop (didn't bet)
Seat 6: bd3b2870 folded before Flop


Poker Hand #RC2075498587: Hold'em No Limit ($0.05/$0.1) - 2023/12/21 23:10:04
Table 'RushAndCash276428' 6-max Seat #1 is the button
Seat 1: 561e331c ($14.56 in chips)
Seat 2: 16e5f62 ($10.32 in chips)
Seat 3: Hero ($10 in chips)
Seat 4: d8f508bf ($26.68 in chips)
Seat 5: cb862e5f ($11.22 in chips)
Seat 6: d6740f69 ($10.21 in chips)
16e5f62: posts small blind $0.05
Hero: posts big blind $0.1
*** HOLE CARDS ***
Dealt to 561e331c 
Dealt to 16e5f62 
Dealt to Hero [Ac As]
Dealt to d8f508bf 
Dealt to cb862e5f 
Dealt to d6740f69 
d8f508bf: folds
cb862e5f: raises $0.15 to $0.25
d6740f69: folds
561e331c: folds
16e5f62: folds
Hero: raises $0.65 to $0.9
cb862e5f: calls $0.65
*** FLOP *** [2h 9h Qc]
Hero: bets $0.93
cb862e5f: calls $0.93
*** TURN *** [2h 9h Qc] [3h]
Hero: checks
cb862e5f: checks
*** RIVER *** [2h 9h Qc 3h] [4d]
Hero: bets $2.06
cb862e5f: raises $7.33 to $9.39 and is all-in
Hero: folds
Uncalled bet ($7.33) returned to cb862e5f
*** SHOWDOWN ***
cb862e5f collected $7.38 from pot
*** SUMMARY ***
Total pot $7.83 | Rake $0.3 | Jackpot $0.15 | Bingo $0 | Fortune $0 | Tax $0
Board [2h 9h Qc 3h 4d]
Seat 1: 561e331c (button) folded before Flop (didn't bet)
Seat 2: 16e5f62 (small blind) folded before Flop
Seat 3: Hero (big blind) folded on the River
Seat 4: d8f508bf folded before Flop (didn't bet)
Seat 5: cb862e5f won ($7.38)
Seat 6: d6740f69 folded before Flop (didn't bet)


Poker Hand #RC2075498469: Hold'em No Limit ($0.05/$0.1) - 2023/12/21 23:09:59
Table 'RushAndCash276353' 6-max Seat #1 is the button
Seat 1: 3f0dd201 ($7.24 in chips)
Seat 2: 7c51275 ($10.8 in chips)
Seat 3: 2c2c64b ($27.46 in chips)
Seat 4: 5d172986 ($17.13 in chips)
Seat 5: 256ff75e ($10 in chips)
Seat 6: Hero ($10 in chips)
7c51275: posts small blind $0.05
2c2c64b: posts big blind $0.1
*** HOLE CARDS ***
Dealt to 3f0dd201 
Dealt to 7c51275 
Dealt to 2c2c64b 
Dealt to 5d172986 
Dealt to 256ff75e 
Dealt to Hero [Ts 8d]
5d172986: folds
256ff75e: folds
Hero: folds
3f0dd201: folds
7c51275: folds
Uncalled bet ($0.05) returned to 2c2c64b
*** SHOWDOWN ***
2c2c64b collected $0.1 from pot
*** SUMMARY ***
Total pot $0.1 | Rake $0 | Jackpot $0 | Bingo $0 | Fortune $0 | Tax $0
Seat 1: 3f0dd201 (button) folded before Flop (didn't bet)
Seat 2: 7c51275 (small blind) folded before Flop
Seat 3: 2c2c64b (big blind) collected ($0.1)
Seat 4: 5d172986 folded before Flop (didn't bet)
Seat 5: 256ff75e folded before Flop (didn't bet)
Seat 6: Hero folded before Flop (didn't bet)


Poker Hand #RC2075498388: Hold'em No Limit ($0.05/$0.1) - 2023/12/21 23:09:55
Table 'RushAndCash276303' 6-max Seat #1 is the button
Seat 1: 4fcb93c1 ($10 in chips)
Seat 2: 9977c538 ($10.43 in chips)
Seat 3: d693b744 ($10 in chips)
Seat 4: 883c82b8 ($23.92 in chips)
Seat 5: Hero ($10 in chips)
Seat 6: bb0b62fd ($11.88 in chips)
9977c538: posts small blind $0.05
d693b744: posts big blind $0.1
*** HOLE CARDS ***
Dealt to 4fcb93c1 
Dealt to 9977c538 
Dealt to d693b744 
Dealt to 883c82b8 
Dealt to Hero [9s 6c]
Dealt to bb0b62fd 
883c82b8: folds
Hero: folds
bb0b62fd: folds
4fcb93c1: folds
9977c538: folds
Uncalled bet ($0.05) returned to d693b744
*** SHOWDOWN ***
d693b744 collected $0.1 from pot
*** SUMMARY ***
Total pot $0.1 | Rake $0 | Jackpot $0 | Bingo $0 | Fortune $0 | Tax $0
Seat 1: 4fcb93c1 (button) folded before Flop (didn't bet)
Seat 2: 9977c538 (small blind) folded before Flop
Seat 3: d693b744 (big blind) collected ($0.1)
Seat 4: 883c82b8 folded before Flop (didn't bet)
Seat 5: Hero folded before Flop (didn't bet)
Seat 6: bb0b62fd folded before Flop (didn't bet)


Poker Hand #RC2075498252: Hold'em No Limit ($0.05/$0.1) - 2023/12/21 23:09:49
Table 'RushAndCash276218' 6-max Seat #1 is the button
Seat 1: 980a33e9 ($13.09 in chips)
Seat 2: 3a58bcd9 ($14.25 in chips)
Seat 3: 4adae999 ($11.23 in chips)
Seat 4: 2fafb689 ($19.16 in chips)
Seat 5: 4c260c74 ($21.27 in chips)
Seat 6: Hero ($10 in chips)
3a58bcd9: posts small blind $0.05
4adae999: posts big blind $0.1
*** HOLE CARDS ***
Dealt to 980a33e9 
Dealt to 3a58bcd9 
Dealt to 4adae999 
Dealt to 2fafb689 
Dealt to 4c260c74 
Dealt to Hero [Jc 9d]
2fafb689: raises $0.15 to $0.25
4c260c74: folds
Hero: folds
980a33e9: folds
3a58bcd9: folds
4adae999: folds
Uncalled bet ($0.15) returned to 2fafb689
*** SHOWDOWN ***
2fafb689 collected $0.25 from pot
*** SUMMARY ***
Total pot $0.25 | Rake $0 | Jackpot $0 | Bingo $0 | Fortune $0 | Tax $0
Seat 1: 980a33e9 (button) folded before Flop (didn't bet)
Seat 2: 3a58bcd9 (small blind) folded before Flop
Seat 3: 4adae999 (big blind) folded before Flop
Seat 4: 2fafb689 collected ($0.25)
Seat 5: 4c260c74 folded before Flop (didn't bet)
Seat 6: Hero folded before Flop (didn't bet)


Poker Hand #RC2075498171: Hold'em No Limit ($0.05/$0.1) - 2023/12/21 23:09:45
Table 'RushAndCash276166' 6-max Seat #1 is the button
Seat 1: dc1f42c2 ($43.34 in chips)
Seat 2: e481851b ($23.08 in chips)
Seat 3: ab1fcb67 ($10 in chips)
Seat 4: Hero ($10 in chips)
Seat 5: 14d41046 ($11.68 in chips)
Seat 6: 6fe2a3f4 ($10 in chips)
e481851b: posts small blind $0.05
ab1fcb67: posts big blind $0.1
*** HOLE CARDS ***
Dealt to dc1f42c2 
Dealt to e481851b 
Dealt to ab1fcb67 
Dealt to Hero [5c Jc]
Dealt to 14d41046 
Dealt to 6fe2a3f4 
Hero: folds
14d41046: folds
6fe2a3f4: folds
dc1f42c2: raises $0.13 to $0.23
e481851b: folds
ab1fcb67: folds
Uncalled bet ($0.13) returned to dc1f42c2
*** SHOWDOWN ***
dc1f42c2 collected $0.25 from pot
*** SUMMARY ***
Total pot $0.25 | Rake $0 | Jackpot $0 | Bingo $0 | Fortune $0 | Tax $0
Seat 1: dc1f42c2 (button) collected ($0.25)
Seat 2: e481851b (small blind) folded before Flop
Seat 3: ab1fcb67 (big blind) folded before Flop
Seat 4: Hero folded before Flop (didn't bet)
Seat 5: 14d41046 folded before Flop (didn't bet)
Seat 6: 6fe2a3f4 folded before Flop (didn't bet)


Poker Hand #RC2075497957: Hold'em No Limit ($0.05/$0.1) - 2023/12/21 23:09:35
Table 'RushAndCash276027' 6-max Seat #1 is the button
Seat 1: afd0eb43 ($30.44 in chips)
Seat 2: Hero ($10 in chips)
Seat 3: b202b230 ($11.35 in chips)
Seat 4: f1b11151 ($21.4 in chips)
Seat 5: fa3498b3 ($10 in chips)
Seat 6: 5ab9056f ($11.25 in chips)
Hero: posts small blind $0.05
b202b230: posts big blind $0.1
*** HOLE CARDS ***
Dealt to afd0eb43 
Dealt to Hero [5d 9s]
Dealt to b202b230 
Dealt to f1b11151 
Dealt to fa3498b3 
Dealt to 5ab9056f 
f1b11151: raises $0.1 to $0.2
fa3498b3: folds
5ab9056f: folds
afd0eb43: folds
Hero: folds
b202b230: calls $0.1
*** FLOP *** [7c 6c 6d]
b202b230: checks
f1b11151: checks
*** TURN *** [7c 6c 6d] [7d]
b202b230: checks
f1b11151: checks
*** RIVER *** [7c 6c 6d 7d] [Js]
b202b230: checks
f1b11151: bets $0.45
b202b230: folds
Uncalled bet ($0.45) returned to f1b11151
*** SHOWDOWN ***
f1b11151 collected $0.43 from pot
*** SUMMARY ***
Total pot $0.45 | Rake $0.02 | Jackpot $0 | Bingo $0 | Fortune $0 | Tax $0
Board [7c 6c 6d 7d Js]
Seat 1: afd0eb43 (button) folded before Flop (didn't bet)
Seat 2: Hero (small blind) folded before Flop
Seat 3: b202b230 (big blind) folded on the River
Seat 4: f1b11151 won ($0.43)
Seat 5: fa3498b3 folded before Flop (didn't bet)
Seat 6: 5ab9056f folded before Flop (didn't bet)


Poker Hand #RC2075497880: Hold'em No Limit ($0.05/$0.1) - 2023/12/21 23:09:32
Table 'RushAndCash275978' 6-max Seat #1 is the button
Seat 1: 8ec03927 ($10.04 in chips)
Seat 2: dc18fbf1 ($11.65 in chips)
Seat 3: Hero ($10 in chips)
Seat 4: 2b8e7f74 ($10 in chips)
Seat 5: 65926727 ($12.5 in chips)
Seat 6: cbf9cbe2 ($50.89 in chips)
dc18fbf1: posts small blind $0.05
Hero: posts big blind $0.1
*** HOLE CARDS ***
Dealt to 8ec03927 
Dealt to dc18fbf1 
Dealt to Hero [Qh 7d]
Dealt to 2b8e7f74 
Dealt to 65926727 
Dealt to cbf9cbe2 
2b8e7f74: folds
65926727: folds
cbf9cbe2: raises $0.1 to $0.2
8ec03927: folds
dc18fbf1: calls $0.15
Hero: folds
*** FLOP *** [8c 3h 5h]
dc18fbf1: checks
cbf9cbe2: bets $0.38
dc18fbf1: calls $0.38
*** TURN *** [8c 3h 5h] [4h]
dc18fbf1: checks
cbf9cbe2: checks
*** RIVER *** [8c 3h 5h 4h] [Kd]
dc18fbf1: bets $1.26
cbf9cbe2: calls $1.26
dc18fbf1: shows [8h 8s] (Three Eights)
cbf9cbe2: shows [Ac Ad] (Pair of Aces)
*** SHOWDOWN ***
dc18fbf1 collected $3.45 from pot
*** SUMMARY ***
Total pot $3.78 | Rake $0.18 | Jackpot $0.15 | Bingo $0 | Fortune $0 | Tax $0
Board [8c 3h 5h 4h Kd]
Seat 1: 8ec03927 (button) folded before Flop (didn't bet)
Seat 2: dc18fbf1 (small blind) showed [8h 8s] and won ($3.45) with Three Eights
Seat 3: Hero (big blind) folded before Flop
Seat 4: 2b8e7f74 folded before Flop (didn't bet)
Seat 5: 65926727 folded before Flop (didn't bet)
Seat 6: cbf9cbe2 showed [Ac Ad] and lost with Pair of Aces


Poker Hand #RC2075496847: Hold'em No Limit ($0.05/$0.1) - 2023/12/21 23:08:46
Table 'RushAndCash275346' 6-max Seat #1 is the button
Seat 1: Hero ($10 in chips)
Seat 2: 5d172986 ($17.66 in chips)
Seat 3: 237fc596 ($11.39 in chips)
Seat 4: 3db6ac28 ($4.6 in chips)
Seat 5: 33d2b8fc ($10 in chips)
Seat 6: 8c322ae2 ($13.16 in chips)
5d172986: posts small blind $0.05
237fc596: posts big blind $0.1
*** HOLE CARDS ***
Dealt to Hero [9d Td]
Dealt to 5d172986 
Dealt to 237fc596 
Dealt to 3db6ac28 
Dealt to 33d2b8fc 
Dealt to 8c322ae2 
3db6ac28: folds
33d2b8fc: folds
8c322ae2: folds
Hero: raises $0.15 to $0.25
5d172986: calls $0.2
237fc596: calls $0.15
*** FLOP *** [7d 9c 7c]
5d172986: checks
237fc596: checks
Hero: checks
*** TURN *** [7d 9c 7c] [4d]
5d172986: checks
237fc596: bets $0.3
Hero: calls $0.3
5d172986: folds
*** RIVER *** [7d 9c 7c 4d] [As]
237fc596: bets $0.5
Hero: calls $0.5
237fc596: shows [7s 5c] (Three Sevens)
Hero: shows [9d Td] (Pair of Nines and Pair of Sevens)
*** SHOWDOWN ***
237fc596 collected $2.24 from pot
*** SUMMARY ***
Total pot $2.35 | Rake $0.11 | Jackpot $0 | Bingo $0 | Fortune $0 | Tax $0
Board [7d 9c 7c 4d As]
Seat 1: Hero (button) showed [9d Td] and lost with Pair of Nines and Pair of Sevens
Seat 2: 5d172986 (small blind) folded on the Turn
Seat 3: 237fc596 (big blind) showed [7s 5c] and won ($2.24) with Three Sevens
Seat 4: 3db6ac28 folded before Flop (didn't bet)
Seat 5: 33d2b8fc folded before Flop (didn't bet)
Seat 6: 8c322ae2 folded before Flop (didn't bet)


Poker Hand #RC2075496762: Hold'em No Limit ($0.05/$0.1) - 2023/12/21 23:08:42
Table 'RushAndCash275295' 6-max Seat #1 is the button
Seat 1: 387a6e45 ($10.73 in chips)
Seat 2: c528838f ($11.24 in chips)
Seat 3: 256ff75e ($10 in chips)
Seat 4: ff5dbe65 ($12.72 in chips)
Seat 5: 3d83b5d2 ($28.46 in chips)
Seat 6: Hero ($10 in chips)
c528838f: posts small blind $0.05
256ff75e: posts big blind $0.1
*** HOLE CARDS ***
Dealt to 387a6e45 
Dealt to c528838f 
Dealt to 256ff75e 
Dealt to ff5dbe65 
Dealt to 3d83b5d2 
Dealt to Hero [Ad 8h]
ff5dbe65: folds
3d83b5d2: folds
Hero: folds
387a6e45: folds
c528838f: folds
Uncalled bet ($0.05) returned to 256ff75e
*** SHOWDOWN ***
256ff75e collected $0.1 from pot
*** SUMMARY ***
Total pot $0.1 | Rake $0 | Jackpot $0 | Bingo $0 | Fortune $0 | Tax $0
Seat 1: 387a6e45 (button) folded before Flop (didn't bet)
Seat 2: c528838f (small blind) folded before Flop
Seat 3: 256ff75e (big blind) collected ($0.1)
Seat 4: ff5dbe65 folded before Flop (didn't bet)
Seat 5: 3d83b5d2 folded before Flop (didn't bet)
Seat 6: Hero folded before Flop (didn't bet)


Poker Hand #RC2075496661: Hold'em No Limit ($0.05/$0.1) - 2023/12/21 23:08:38
Table 'RushAndCash275230' 6-max Seat #1 is the button
Seat 1: c3b054d5 ($3.85 in chips)
Seat 2: c3c2420 ($19.83 in chips)
Seat 3: 46b22a80 ($22.44 in chips)
Seat 4: b57c5f80 ($6.34 in chips)
Seat 5: 3befad7e ($13.13 in chips)
Seat 6: Hero ($10 in chips)
c3c2420: posts small blind $0.05
46b22a80: posts big blind $0.1
*** HOLE CARDS ***
Dealt to c3b054d5 
Dealt to c3c2420 
Dealt to 46b22a80 
Dealt to b57c5f80 
Dealt to 3befad7e 
Dealt to Hero [8d 3h]
b57c5f80: folds
3befad7e: folds
Hero: folds
c3b054d5: raises $0.1 to $0.2
c3c2420: folds
46b22a80: folds
Uncalled bet ($0.1) returned to c3b054d5
*** SHOWDOWN ***
c3b054d5 collected $0.25 from pot
*** SUMMARY ***
Total pot $0.25 | Rake $0 | Jackpot $0 | Bingo $0 | Fortune $0 | Tax $0
Seat 1: c3b054d5 (button) collected ($0.25)
Seat 2: c3c2420 (small blind) folded before Flop
Seat 3: 46b22a80 (big blind) folded before Flop
Seat 4: b57c5f80 folded before Flop (didn't bet)
Seat 5: 3befad7e folded before Flop (didn't bet)
Seat 6: Hero folded before Flop (didn't bet)


Poker Hand #RC2075496563: Hold'em No Limit ($0.05/$0.1) - 2023/12/21 23:08:34
Table 'RushAndCash275168' 6-max Seat #1 is the button
Seat 1: c373bc25 ($12.38 in chips)
Seat 2: acc9bb00 ($11.23 in chips)
Seat 3: 9b8a916d ($13.03 in chips)
Seat 4: 7c895666 ($10.3 in chips)
Seat 5: 618fe6d4 ($13.57 in chips)
Seat 6: Hero ($10 in chips)
acc9bb00: posts small blind $0.05
9b8a916d: posts big blind $0.1
*** HOLE CARDS ***
Dealt to c373bc25 
Dealt to acc9bb00 
Dealt to 9b8a916d 
Dealt to 7c895666 
Dealt to 618fe6d4 
Dealt to Hero [6d Kc]
7c895666: folds
618fe6d4: raises $0.13 to $0.23
Hero: folds
c373bc25: folds
acc9bb00: folds
9b8a916d: folds
Uncalled bet ($0.13) returned to 618fe6d4
*** SHOWDOWN ***
618fe6d4 collected $0.25 from pot
*** SUMMARY ***
Total pot $0.25 | Rake $0 | Jackpot $0 | Bingo $0 | Fortune $0 | Tax $0
Seat 1: c373bc25 (button) folded before Flop (didn't bet)
Seat 2: acc9bb00 (small blind) folded before Flop
Seat 3: 9b8a916d (big blind) folded before Flop
Seat 4: 7c895666 folded before Flop (didn't bet)
Seat 5: 618fe6d4 collected ($0.25)
Seat 6: Hero folded before Flop (didn't bet)


Poker Hand #RC2075496108: Hold'em No Limit ($0.05/$0.1) - 2023/12/21 23:08:14
Table 'RushAndCash274895' 6-max Seat #1 is the button
Seat 1: 5dd9b81a ($11.58 in chips)
Seat 2: 9977c538 ($10.3 in chips)
Seat 3: Hero ($10.1 in chips)
Seat 4: 599a5534 ($11.69 in chips)
Seat 5: e46924d4 ($17.5 in chips)
Seat 6: f71c8183 ($13.62 in chips)
9977c538: posts small blind $0.05
Hero: posts big blind $0.1
*** HOLE CARDS ***
Dealt to 5dd9b81a 
Dealt to 9977c538 
Dealt to Hero [3d 8d]
Dealt to 599a5534 
Dealt to e46924d4 
Dealt to f71c8183 
599a5534: raises $0.2 to $0.3
e46924d4: folds
f71c8183: folds
5dd9b81a: folds
9977c538: folds
Hero: calls $0.2
*** FLOP *** [5s 5d 5c]
Hero: checks
599a5534: bets $0.33
Hero: folds
Uncalled bet ($0.33) returned to 599a5534
*** SHOWDOWN ***
599a5534 collected $0.62 from pot
*** SUMMARY ***
Total pot $0.65 | Rake $0.03 | Jackpot $0 | Bingo $0 | Fortune $0 | Tax $0
Board [5s 5d 5c]
Seat 1: 5dd9b81a (button) folded before Flop (didn't bet)
Seat 2: 9977c538 (small blind) folded before Flop
Seat 3: Hero (big blind) folded on the Flop
Seat 4: 599a5534 won ($0.62)
Seat 5: e46924d4 folded before Flop (didn't bet)
Seat 6: f71c8183 folded before Flop (didn't bet)


Poker Hand #RC2075496027: Hold'em No Limit ($0.05/$0.1) - 2023/12/21 23:08:11
Table 'RushAndCash274845' 6-max Seat #1 is the button
Seat 1: Hero ($10.1 in chips)
Seat 2: e6a866fd ($10 in chips)
Seat 3: 386f0ffa ($3.14 in chips)
Seat 4: bff71335 ($11.91 in chips)
Seat 5: 53b98456 ($21.12 in chips)
Seat 6: f6281abe ($16.75 in chips)
e6a866fd: posts small blind $0.05
386f0ffa: posts big blind $0.1
*** HOLE CARDS ***
Dealt to Hero [2d 8c]
Dealt to e6a866fd 
Dealt to 386f0ffa 
Dealt to bff71335 
Dealt to 53b98456 
Dealt to f6281abe 
bff71335: raises $0.15 to $0.25
53b98456: calls $0.25
f6281abe: folds
Hero: folds
e6a866fd: folds
386f0ffa: calls $0.15
*** FLOP *** [Kd 4c 9s]
386f0ffa: checks
bff71335: checks
53b98456: checks
*** TURN *** [Kd 4c 9s] [2h]
386f0ffa: bets $0.15
bff71335: calls $0.15
53b98456: calls $0.15
*** RIVER *** [Kd 4c 9s 2h] [7s]
386f0ffa: bets $0.94
bff71335: folds
53b98456: folds
Uncalled bet ($0.94) returned to 386f0ffa
*** SHOWDOWN ***
386f0ffa collected $1.19 from pot
*** SUMMARY ***
Total pot $1.25 | Rake $0.06 | Jackpot $0 | Bingo $0 | Fortune $0 | Tax $0
Board [Kd 4c 9s 2h 7s]
Seat 1: Hero (button) folded before Flop (didn't bet)
Seat 2: e6a866fd (small blind) folded before Flop
Seat 3: 386f0ffa (big blind) won ($1.19)
Seat 4: bff71335 folded on the River
Seat 5: 53b98456 folded on the River
Seat 6: f6281abe folded before Flop (didn't bet)


Poker Hand #RC2075495948: Hold'em No Limit ($0.05/$0.1) - 2023/12/21 23:08:07
Table 'RushAndCash274799' 6-max Seat #1 is the button
Seat 1: f7c771a0 ($10.32 in chips)
Seat 2: Hero ($10.15 in chips)
Seat 3: 4cf98abd ($10.65 in chips)
Seat 4: a38504a2 ($17.74 in chips)
Seat 5: a19dd626 ($10.87 in chips)
Seat 6: 9b87b673 ($14.91 in chips)
Hero: posts small blind $0.05
4cf98abd: posts big blind $0.1
*** HOLE CARDS ***
Dealt to f7c771a0 
Dealt to Hero [3c Js]
Dealt to 4cf98abd 
Dealt to a38504a2 
Dealt to a19dd626 
Dealt to 9b87b673 
a38504a2: raises $0.15 to $0.25
a19dd626: folds
9b87b673: folds
f7c771a0: folds
Hero: folds
4cf98abd: folds
Uncalled bet ($0.15) returned to a38504a2
*** SHOWDOWN ***
a38504a2 collected $0.25 from pot
*** SUMMARY ***
Total pot $0.25 | Rake $0 | Jackpot $0 | Bingo $0 | Fortune $0 | Tax $0
Seat 1: f7c771a0 (button) folded before Flop (didn't bet)
Seat 2: Hero (small blind) folded before Flop
Seat 3: 4cf98abd (big blind) folded before Flop
Seat 4: a38504a2 collected ($0.25)
Seat 5: a19dd626 folded before Flop (didn't bet)
Seat 6: 9b87b673 folded before Flop (didn't bet)


Poker Hand #RC2075495856: Hold'em No Limit ($0.05/$0.1) - 2023/12/21 23:08:03
Table 'RushAndCash274748' 6-max Seat #1 is the button
Seat 1: 6b09d30d ($12.23 in chips)
Seat 2: 2be34245 ($15.91 in chips)
Seat 3: 136044f2 ($22.42 in chips)
Seat 4: e2adffdd ($29.61 in chips)
Seat 5: Hero ($10.15 in chips)
Seat 6: cac79080 ($10 in chips)
2be34245: posts small blind $0.05
136044f2: posts big blind $0.1
*** HOLE CARDS ***
Dealt to 6b09d30d 
Dealt to 2be34245 
Dealt to 136044f2 
Dealt to e2adffdd 
Dealt to Hero [6h 7c]
Dealt to cac79080 
e2adffdd: folds
Hero: folds
cac79080: folds
6b09d30d: raises $0.15 to $0.25
2be34245: folds
136044f2: folds
Uncalled bet ($0.15) returned to 6b09d30d
*** SHOWDOWN ***
6b09d30d collected $0.25 from pot
*** SUMMARY ***
Total pot $0.25 | Rake $0 | Jackpot $0 | Bingo $0 | Fortune $0 | Tax $0
Seat 1: 6b09d30d (button) collected ($0.25)
Seat 2: 2be34245 (small blind) folded before Flop
Seat 3: 136044f2 (big blind) folded before Flop
Seat 4: e2adffdd folded before Flop (didn't bet)
Seat 5: Hero folded before Flop (didn't bet)
Seat 6: cac79080 folded before Flop (didn't bet)


Poker Hand #RC2075495656: Hold'em No Limit ($0.05/$0.1) - 2023/12/21 23:07:54
Table 'RushAndCash274636' 6-max Seat #1 is the button
Seat 1: 52c47287 ($10.15 in chips)
Seat 2: f306358e ($15.36 in chips)
Seat 3: 2186e729 ($10.52 in chips)
Seat 4: Hero ($10 in chips)
Seat 5: 86a73692 ($6.52 in chips)
Seat 6: ebd36a7c ($10 in chips)
f306358e: posts small blind $0.05
2186e729: posts big blind $0.1
*** HOLE CARDS ***
Dealt to 52c47287 
Dealt to f306358e 
Dealt to 2186e729 
Dealt to Hero [Ac 9c]
Dealt to 86a73692 
Dealt to ebd36a7c 
Hero: raises $0.1 to $0.2
86a73692: folds
ebd36a7c: folds
52c47287: folds
f306358e: folds
2186e729: folds
Uncalled bet ($0.1) returned to Hero
*** SHOWDOWN ***
Hero collected $0.25 from pot
*** SUMMARY ***
Total pot $0.25 | Rake $0 | Jackpot $0 | Bingo $0 | Fortune $0 | Tax $0
Seat 1: 52c47287 (button) folded before Flop (didn't bet)
Seat 2: f306358e (small blind) folded before Flop
Seat 3: 2186e729 (big blind) folded before Flop
Seat 4: Hero collected ($0.25)
Seat 5: 86a73692 folded before Flop (didn't bet)
Seat 6: ebd36a7c folded before Flop (didn't bet)


Poker Hand #RC2075495522: Hold'em No Limit ($0.05/$0.1) - 2023/12/21 23:07:48
Table 'RushAndCash274559' 6-max Seat #1 is the button
Seat 1: 31f984f ($10.61 in chips)
Seat 2: Hero ($10 in chips)
Seat 3: 86e56a04 ($21.74 in chips)
Seat 4: a4d488b5 ($9.85 in chips)
Seat 5: 8eeea9a5 ($40.9 in chips)
Seat 6: 167c47c6 ($11.3 in chips)
Hero: posts small blind $0.05
86e56a04: posts big blind $0.1
*** HOLE CARDS ***
Dealt to 31f984f 
Dealt to Hero [4h 7c]
Dealt to 86e56a04 
Dealt to a4d488b5 
Dealt to 8eeea9a5 
Dealt to 167c47c6 
a4d488b5: folds
8eeea9a5: folds
167c47c6: folds
31f984f: calls $0.1
Hero: folds
86e56a04: checks
*** FLOP *** [7d 3d 9c]
86e56a04: checks
31f984f: bets $0.19
86e56a04: folds
Uncalled bet ($0.19) returned to 31f984f
*** SHOWDOWN ***
31f984f collected $0.24 from pot
*** SUMMARY ***
Total pot $0.25 | Rake $0.01 | Jackpot $0 | Bingo $0 | Fortune $0 | Tax $0
Board [7d 3d 9c]
Seat 1: 31f984f (button) won ($0.24)
Seat 2: Hero (small blind) folded before Flop
Seat 3: 86e56a04 (big blind) folded on the Flop
Seat 4: a4d488b5 folded before Flop (didn't bet)
Seat 5: 8eeea9a5 folded before Flop (didn't bet)
Seat 6: 167c47c6 folded before Flop (didn't bet)


Poker Hand #RC2075495438: Hold'em No Limit ($0.05/$0.1) - 2023/12/21 23:07:45
Table 'RushAndCash274508' 6-max Seat #1 is the button
Seat 1: 4f93b70a ($10 in chips)
Seat 2: cac88962 ($10.05 in chips)
Seat 3: c7064c89 ($10.69 in chips)
Seat 4: a25b5ede ($10.15 in chips)
Seat 5: Hero ($10 in chips)
Seat 6: 3e2151ef ($10.73 in chips)
cac88962: posts small blind $0.05
c7064c89: posts big blind $0.1
*** HOLE CARDS ***
Dealt to 4f93b70a 
Dealt to cac88962 
Dealt to c7064c89 
Dealt to a25b5ede 
Dealt to Hero [7s 2h]
Dealt to 3e2151ef 
a25b5ede: raises $0.15 to $0.25
Hero: folds
3e2151ef: folds
4f93b70a: folds
cac88962: folds
c7064c89: folds
Uncalled bet ($0.15) returned to a25b5ede
*** SHOWDOWN ***
a25b5ede collected $0.25 from pot
*** SUMMARY ***
Total pot $0.25 | Rake $0 | Jackpot $0 | Bingo $0 | Fortune $0 | Tax $0
Seat 1: 4f93b70a (button) folded before Flop (didn't bet)
Seat 2: cac88962 (small blind) folded before Flop
Seat 3: c7064c89 (big blind) folded before Flop
Seat 4: a25b5ede collected ($0.25)
Seat 5: Hero folded before Flop (didn't bet)
Seat 6: 3e2151ef folded before Flop (didn't bet)


Poker Hand #RC2075495324: Hold'em No Limit ($0.05/$0.1) - 2023/12/21 23:07:40
Table 'RushAndCash274438' 6-max Seat #1 is the button
Seat 1: 3f0dd201 ($7.42 in chips)
Seat 2: 9ddc89d9 ($10 in chips)
Seat 3: Hero ($10 in chips)
Seat 4: 3dd2c0ed ($10.18 in chips)
Seat 5: 534d15d2 ($10.34 in chips)
Seat 6: a1316369 ($11.07 in chips)
9ddc89d9: posts small blind $0.05
Hero: posts big blind $0.1
*** HOLE CARDS ***
Dealt to 3f0dd201 
Dealt to 9ddc89d9 
Dealt to Hero [6h 7c]
Dealt to 3dd2c0ed 
Dealt to 534d15d2 
Dealt to a1316369 
3dd2c0ed: folds
534d15d2: folds
a1316369: folds
3f0dd201: calls $0.1
9ddc89d9: raises $0.25 to $0.35
Hero: folds
3f0dd201: calls $0.25
*** FLOP *** [2s 4c 6c]
9ddc89d9: bets $0.6
3f0dd201: folds
Uncalled bet ($0.6) returned to 9ddc89d9
*** SHOWDOWN ***
9ddc89d9 collected $0.76 from pot
*** SUMMARY ***
Total pot $0.8 | Rake $0.04 | Jackpot $0 | Bingo $0 | Fortune $0 | Tax $0
Board [2s 4c 6c]
Seat 1: 3f0dd201 (button) folded on the Flop
Seat 2: 9ddc89d9 (small blind) won ($0.76)
Seat 3: Hero (big blind) folded before Flop
Seat 4: 3dd2c0ed folded before Flop (didn't bet)
Seat 5: 534d15d2 folded before Flop (didn't bet)
Seat 6: a1316369 folded before Flop (didn't bet)


Poker Hand #RC2075495251: Hold'em No Limit ($0.05/$0.1) - 2023/12/21 23:07:36
Table 'RushAndCash274394' 6-max Seat #1 is the button
Seat 1: Hero ($10 in chips)
Seat 2: b80c627b ($10.05 in chips)
Seat 3: b14398ca ($20.11 in chips)
Seat 4: ac80d6ec ($11.1 in chips)
Seat 5: b8743ef5 ($3.09 in chips)
Seat 6: e65abf6f ($11.74 in chips)
b80c627b: posts small blind $0.05
b14398ca: posts big blind $0.1
*** HOLE CARDS ***
Dealt to Hero [Ac 3h]
Dealt to b80c627b 
Dealt to b14398ca 
Dealt to ac80d6ec 
Dealt to b8743ef5 
Dealt to e65abf6f 
ac80d6ec: folds
b8743ef5: raises $0.1 to $0.2
e65abf6f: folds
Hero: folds
b80c627b: folds
b14398ca: calls $0.1
*** FLOP *** [Qc 9h Jh]
b14398ca: checks
b8743ef5: bets $0.23
b14398ca: folds
Uncalled bet ($0.23) returned to b8743ef5
*** SHOWDOWN ***
b8743ef5 collected $0.43 from pot
*** SUMMARY ***
Total pot $0.45 | Rake $0.02 | Jackpot $0 | Bingo $0 | Fortune $0 | Tax $0
Board [Qc 9h Jh]
Seat 1: Hero (button) folded before Flop (didn't bet)
Seat 2: b80c627b (small blind) folded before Flop
Seat 3: b14398ca (big blind) folded on the Flop
Seat 4: ac80d6ec folded before Flop (didn't bet)
Seat 5: b8743ef5 won ($0.43)
Seat 6: e65abf6f folded before Flop (didn't bet)


Poker Hand #RC2075495170: Hold'em No Limit ($0.05/$0.1) - 2023/12/21 23:07:32
Table 'RushAndCash274344' 6-max Seat #1 is the button
Seat 1: 136044f2 ($22.47 in chips)
Seat 2: c657df87 ($49.17 in chips)
Seat 3: c8920770 ($16.71 in chips)
Seat 4: 197cd9e6 ($38.77 in chips)
Seat 5: 77d5115b ($10 in chips)
Seat 6: Hero ($10 in chips)
c657df87: posts small blind $0.05
c8920770: posts big blind $0.1
*** HOLE CARDS ***
Dealt to 136044f2 
Dealt to c657df87 
Dealt to c8920770 
Dealt to 197cd9e6 
Dealt to 77d5115b 
Dealt to Hero [Td 3h]
197cd9e6: folds
77d5115b: raises $0.15 to $0.25
Hero: folds
136044f2: folds
c657df87: folds
c8920770: folds
Uncalled bet ($0.15) returned to 77d5115b
*** SHOWDOWN ***
77d5115b collected $0.25 from pot
*** SUMMARY ***
Total pot $0.25 | Rake $0 | Jackpot $0 | Bingo $0 | Fortune $0 | Tax $0
Seat 1: 136044f2 (button) folded before Flop (didn't bet)
Seat 2: c657df87 (small blind) folded before Flop
Seat 3: c8920770 (big blind) folded before Flop
Seat 4: 197cd9e6 folded before Flop (didn't bet)
Seat 5: 77d5115b collected ($0.25)
Seat 6: Hero folded before Flop (didn't bet)


Poker Hand #RC2075495091: Hold'em No Limit ($0.05/$0.1) - 2023/12/21 23:07:29
Table 'RushAndCash274296' 6-max Seat #1 is the button
Seat 1: fbccf29c ($25.43 in chips)
Seat 2: 504a1554 ($11.18 in chips)
Seat 3: dc18fbf1 ($10.2 in chips)
Seat 4: 994dc520 ($8.75 in chips)
Seat 5: ba4adc22 ($13.92 in chips)
Seat 6: Hero ($10 in chips)
504a1554: posts small blind $0.05
dc18fbf1: posts big blind $0.1
*** HOLE CARDS ***
Dealt to fbccf29c 
Dealt to 504a1554 
Dealt to dc18fbf1 
Dealt to 994dc520 
Dealt to ba4adc22 
Dealt to Hero [5c 3c]
994dc520: folds
ba4adc22: folds
Hero: folds
fbccf29c: folds
504a1554: raises $0.2 to $0.3
dc18fbf1: folds
Uncalled bet ($0.2) returned to 504a1554
*** SHOWDOWN ***
504a1554 collected $0.2 from pot
*** SUMMARY ***
Total pot $0.2 | Rake $0 | Jackpot $0 | Bingo $0 | Fortune $0 | Tax $0
Seat 1: fbccf29c (button) folded before Flop (didn't bet)
Seat 2: 504a1554 (small blind) collected ($0.2)
Seat 3: dc18fbf1 (big blind) folded before Flop
Seat 4: 994dc520 folded before Flop (didn't bet)
Seat 5: ba4adc22 folded before Flop (didn't bet)
Seat 6: Hero folded before Flop (didn't bet)


Poker Hand #RC2075495008: Hold'em No Limit ($0.05/$0.1) - 2023/12/21 23:07:25
Table 'RushAndCash274243' 6-max Seat #1 is the button
Seat 1: Hero ($10 in chips)
Seat 2: 1f7a8ee9 ($14.14 in chips)
Seat 3: 92d95b97 ($16.26 in chips)
Seat 4: 883c82b8 ($23.89 in chips)
Seat 5: 2cfba3be ($22.61 in chips)
Seat 6: f27abeb7 ($17.15 in chips)
1f7a8ee9: posts small blind $0.05
92d95b97: posts big blind $0.1
*** HOLE CARDS ***
Dealt to Hero [Kd 5c]
Dealt to 1f7a8ee9 
Dealt to 92d95b97 
Dealt to 883c82b8 
Dealt to 2cfba3be 
Dealt to f27abeb7 
883c82b8: raises $0.15 to $0.25
2cfba3be: folds
f27abeb7: folds
Hero: folds
1f7a8ee9: folds
92d95b97: folds
Uncalled bet ($0.15) returned to 883c82b8
*** SHOWDOWN ***
883c82b8 collected $0.25 from pot
*** SUMMARY ***
Total pot $0.25 | Rake $0 | Jackpot $0 | Bingo $0 | Fortune $0 | Tax $0
Seat 1: Hero (button) folded before Flop (didn't bet)
Seat 2: 1f7a8ee9 (small blind) folded before Flop
Seat 3: 92d95b97 (big blind) folded before Flop
Seat 4: 883c82b8 collected ($0.25)
Seat 5: 2cfba3be folded before Flop (didn't bet)
Seat 6: f27abeb7 folded before Flop (didn't bet)


Poker Hand #RC2075494929: Hold'em No Limit ($0.05/$0.1) - 2023/12/21 23:07:21
Table 'RushAndCash274194' 6-max Seat #1 is the button
Seat 1: 757d46db ($11.83 in chips)
Seat 2: Hero ($10.05 in chips)
Seat 3: 1a33d07a ($16.68 in chips)
Seat 4: 1f7a8ee9 ($14.14 in chips)
Seat 5: b94ddca4 ($10 in chips)
Seat 6: e752a7fd ($14.61 in chips)
Hero: posts small blind $0.05
1a33d07a: posts big blind $0.1
*** HOLE CARDS ***
Dealt to 757d46db 
Dealt to Hero [Tc 7h]
Dealt to 1a33d07a 
Dealt to 1f7a8ee9 
Dealt to b94ddca4 
Dealt to e752a7fd 
1f7a8ee9: folds
b94ddca4: folds
e752a7fd: raises $0.11 to $0.21
757d46db: folds
Hero: folds
1a33d07a: folds
Uncalled bet ($0.11) returned to e752a7fd
*** SHOWDOWN ***
e752a7fd collected $0.25 from pot
*** SUMMARY ***
Total pot $0.25 | Rake $0 | Jackpot $0 | Bingo $0 | Fortune $0 | Tax $0
Seat 1: 757d46db (button) folded before Flop (didn't bet)
Seat 2: Hero (small blind) folded before Flop
Seat 3: 1a33d07a (big blind) folded before Flop
Seat 4: 1f7a8ee9 folded before Flop (didn't bet)
Seat 5: b94ddca4 folded before Flop (didn't bet)
Seat 6: e752a7fd collected ($0.25)


Poker Hand #RC2075474684: Hold'em No Limit ($0.05/$0.1) - 2023/12/21 23:07:10
Table 'RushAndCash274047' 6-max Seat #1 is the button
Seat 1: 6a3d4830 ($19.93 in chips)
Seat 2: a072bd38 ($13.16 in chips)
Seat 3: Hero ($10.15 in chips)
Seat 4: 9e200139 ($10.56 in chips)
Seat 5: b2788e30 ($16.91 in chips)
Seat 6: 71677e1b ($22.23 in chips)
Cash Drop to Pot : total $1 
a072bd38: posts small blind $0.05
Hero: posts big blind $0.1
*** HOLE CARDS ***
Dealt to 6a3d4830 
Dealt to a072bd38 
Dealt to Hero [3s 8h]
Dealt to 9e200139 
Dealt to b2788e30 
Dealt to 71677e1b 
9e200139: folds
b2788e30: folds
71677e1b: raises $22.13 to $22.23 and is all-in
6a3d4830: calls $19.93 and is all-in
a072bd38: folds
Hero: folds
Uncalled bet ($2.3) returned to 71677e1b
71677e1b: shows [Qs Ks]
6a3d4830: shows [9s 8s]
*** FLOP *** [7s 9d 2s]
*** TURN *** [7s 9d 2s] [As]
*** RIVER *** [7s 9d 2s As] [8c]
*** SHOWDOWN ***
71677e1b collected $40.56 from pot
*** SUMMARY ***
Total pot $41.01 | Rake $0.3 | Jackpot $0.15 | Bingo $0 | Fortune $0 | Tax $0
Board [7s 9d 2s As 8c]
Seat 1: 6a3d4830 (button) showed [9s 8s] and lost with Ace High Flush
Seat 2: a072bd38 (small blind) folded before Flop
Seat 3: Hero (big blind) folded before Flop
Seat 4: 9e200139 folded before Flop (didn't bet)
Seat 5: b2788e30 folded before Flop (didn't bet)
Seat 6: 71677e1b showed [Qs Ks] and won ($40.56) with Ace High Flush


Poker Hand #RC2075474455: Hold'em No Limit ($0.05/$0.1) - 2023/12/21 23:06:59
Table 'RushAndCash273908' 6-max Seat #1 is the button
Seat 1: e4b6fc6f ($26.52 in chips)
Seat 2: bc811ec9 ($11.47 in chips)
Seat 3: 6f70aff ($20.09 in chips)
Seat 4: Hero ($10.15 in chips)
Seat 5: ba4adc22 ($13.69 in chips)
Seat 6: 6a3d4830 ($19.98 in chips)
bc811ec9: posts small blind $0.05
6f70aff: posts big blind $0.1
*** HOLE CARDS ***
Dealt to e4b6fc6f 
Dealt to bc811ec9 
Dealt to 6f70aff 
Dealt to Hero [Js Kd]
Dealt to ba4adc22 
Dealt to 6a3d4830 
Hero: folds
ba4adc22: folds
6a3d4830: folds
e4b6fc6f: raises $0.2 to $0.3
bc811ec9: folds
6f70aff: folds
Uncalled bet ($0.2) returned to e4b6fc6f
*** SHOWDOWN ***
e4b6fc6f collected $0.25 from pot
*** SUMMARY ***
Total pot $0.25 | Rake $0 | Jackpot $0 | Bingo $0 | Fortune $0 | Tax $0
Seat 1: e4b6fc6f (button) collected ($0.25)
Seat 2: bc811ec9 (small blind) folded before Flop
Seat 3: 6f70aff (big blind) folded before Flop
Seat 4: Hero folded before Flop (didn't bet)
Seat 5: ba4adc22 folded before Flop (didn't bet)
Seat 6: 6a3d4830 folded before Flop (didn't bet)


Poker Hand #RC2075474365: Hold'em No Limit ($0.05/$0.1) - 2023/12/21 23:06:55
Table 'RushAndCash273854' 6-max Seat #1 is the button
Seat 1: 88b4672a ($9.02 in chips)
Seat 2: 243279ca ($14.69 in chips)
Seat 3: 6dde7fdf ($22.61 in chips)
Seat 4: Hero ($10.15 in chips)
Seat 5: a377dd30 ($10.29 in chips)
Seat 6: c5e4729d ($12.97 in chips)
243279ca: posts small blind $0.05
6dde7fdf: posts big blind $0.1
*** HOLE CARDS ***
Dealt to 88b4672a 
Dealt to 243279ca 
Dealt to 6dde7fdf 
Dealt to Hero [Ah 6c]
Dealt to a377dd30 
Dealt to c5e4729d 
Hero: folds
a377dd30: folds
c5e4729d: raises $0.1 to $0.2
88b4672a: folds
243279ca: folds
6dde7fdf: folds
Uncalled bet ($0.1) returned to c5e4729d
*** SHOWDOWN ***
c5e4729d collected $0.25 from pot
*** SUMMARY ***
Total pot $0.25 | Rake $0 | Jackpot $0 | Bingo $0 | Fortune $0 | Tax $0
Seat 1: 88b4672a (button) folded before Flop (didn't bet)
Seat 2: 243279ca (small blind) folded before Flop
Seat 3: 6dde7fdf (big blind) folded before Flop
Seat 4: Hero folded before Flop (didn't bet)
Seat 5: a377dd30 folded before Flop (didn't bet)
Seat 6: c5e4729d collected ($0.25)


Poker Hand #RC2075474290: Hold'em No Limit ($0.05/$0.1) - 2023/12/21 23:06:51
Table 'RushAndCash273810' 6-max Seat #1 is the button
Seat 1: c6e3721b ($10.16 in chips)
Seat 2: 6dde7fdf ($22.66 in chips)
Seat 3: 6e6fec39 ($17.87 in chips)
Seat 4: Hero ($10.15 in chips)
Seat 5: 55616f14 ($10.31 in chips)
Seat 6: 1e4a3d4c ($11.46 in chips)
6dde7fdf: posts small blind $0.05
6e6fec39: posts big blind $0.1
*** HOLE CARDS ***
Dealt to c6e3721b 
Dealt to 6dde7fdf 
Dealt to 6e6fec39 
Dealt to Hero [Jd Ac]
Dealt to 55616f14 
Dealt to 1e4a3d4c 
Hero: folds
55616f14: raises $0.15 to $0.25
1e4a3d4c: folds
c6e3721b: folds
6dde7fdf: folds
6e6fec39: folds
Uncalled bet ($0.15) returned to 55616f14
*** SHOWDOWN ***
55616f14 collected $0.25 from pot
*** SUMMARY ***
Total pot $0.25 | Rake $0 | Jackpot $0 | Bingo $0 | Fortune $0 | Tax $0
Seat 1: c6e3721b (button) folded before Flop (didn't bet)
Seat 2: 6dde7fdf (small blind) folded before Flop
Seat 3: 6e6fec39 (big blind) folded before Flop
Seat 4: Hero folded before Flop (didn't bet)
Seat 5: 55616f14 collected ($0.25)
Seat 6: 1e4a3d4c folded before Flop (didn't bet)


Poker Hand #RC2075473967: Hold'em No Limit ($0.05/$0.1) - 2023/12/21 23:06:37
Table 'RushAndCash273615' 6-max Seat #1 is the button
Seat 1: 8eae006e ($24.04 in chips)
Seat 2: 730b7858 ($19.72 in chips)
Seat 3: eb48a647 ($14.06 in chips)
Seat 4: 84010518 ($25.13 in chips)
Seat 5: Hero ($10 in chips)
Seat 6: ca694541 ($12.49 in chips)
730b7858: posts small blind $0.05
eb48a647: posts big blind $0.1
*** HOLE CARDS ***
Dealt to 8eae006e 
Dealt to 730b7858 
Dealt to eb48a647 
Dealt to 84010518 
Dealt to Hero [Qc Ac]
Dealt to ca694541 
84010518: folds
Hero: raises $0.1 to $0.2
ca694541: folds
8eae006e: folds
730b7858: folds
eb48a647: folds
Uncalled bet ($0.1) returned to Hero
*** SHOWDOWN ***
Hero collected $0.25 from pot
*** SUMMARY ***
Total pot $0.25 | Rake $0 | Jackpot $0 | Bingo $0 | Fortune $0 | Tax $0
Seat 1: 8eae006e (button) folded before Flop (didn't bet)
Seat 2: 730b7858 (small blind) folded before Flop
Seat 3: eb48a647 (big blind) folded before Flop
Seat 4: 84010518 folded before Flop (didn't bet)
Seat 5: Hero collected ($0.25)
Seat 6: ca694541 folded before Flop (didn't bet)


Poker Hand #RC2075473807: Hold'em No Limit ($0.05/$0.1) - 2023/12/21 23:06:30
Table 'RushAndCash273520' 6-max Seat #1 is the button
Seat 1: b8680ebe ($12.81 in chips)
Seat 2: Hero ($10 in chips)
Seat 3: ca733d1c ($11.48 in chips)
Seat 4: edb67d56 ($9.9 in chips)
Seat 5: f1bc364f ($7.52 in chips)
Seat 6: 9dfab98a ($10.47 in chips)
Hero: posts small blind $0.05
ca733d1c: posts big blind $0.1
*** HOLE CARDS ***
Dealt to b8680ebe 
Dealt to Hero [6c 4d]
Dealt to ca733d1c 
Dealt to edb67d56 
Dealt to f1bc364f 
Dealt to 9dfab98a 
edb67d56: folds
f1bc364f: folds
9dfab98a: folds
b8680ebe: folds
Hero: folds
Uncalled bet ($0.05) returned to ca733d1c
*** SHOWDOWN ***
ca733d1c collected $0.1 from pot
*** SUMMARY ***
Total pot $0.1 | Rake $0 | Jackpot $0 | Bingo $0 | Fortune $0 | Tax $0
Seat 1: b8680ebe (button) folded before Flop (didn't bet)
Seat 2: Hero (small blind) folded before Flop
Seat 3: ca733d1c (big blind) collected ($0.1)
Seat 4: edb67d56 folded before Flop (didn't bet)
Seat 5: f1bc364f folded before Flop (didn't bet)
Seat 6: 9dfab98a folded before Flop (didn't bet)


Poker Hand #RC2075473164: Hold'em No Limit ($0.05/$0.1) - 2023/12/21 23:06:01
Table 'RushAndCash273134' 6-max Seat #1 is the button
Seat 1: 3776edff ($13.63 in chips)
Seat 2: 8bffd3fd ($22.19 in chips)
Seat 3: Hero ($10 in chips)
Seat 4: 6a0f6434 ($44.47 in chips)
Seat 5: 2b8e7f74 ($10.28 in chips)
Seat 6: 42152589 ($9.11 in chips)
8bffd3fd: posts small blind $0.05
Hero: posts big blind $0.1
*** HOLE CARDS ***
Dealt to 3776edff 
Dealt to 8bffd3fd 
Dealt to Hero [5d 7d]
Dealt to 6a0f6434 
Dealt to 2b8e7f74 
Dealt to 42152589 
6a0f6434: folds
2b8e7f74: folds
42152589: raises $0.1 to $0.2
3776edff: folds
8bffd3fd: folds
Hero: calls $0.1
*** FLOP *** [Ac 8h Tc]
Hero: checks
42152589: bets $0.2
Hero: folds
Uncalled bet ($0.2) returned to 42152589
*** SHOWDOWN ***
42152589 collected $0.43 from pot
*** SUMMARY ***
Total pot $0.45 | Rake $0.02 | Jackpot $0 | Bingo $0 | Fortune $0 | Tax $0
Board [Ac 8h Tc]
Seat 1: 3776edff (button) folded before Flop (didn't bet)
Seat 2: 8bffd3fd (small blind) folded before Flop
Seat 3: Hero (big blind) folded on the Flop
Seat 4: 6a0f6434 folded before Flop (didn't bet)
Seat 5: 2b8e7f74 folded before Flop (didn't bet)
Seat 6: 42152589 won ($0.43)


Poker Hand #RC2075473087: Hold'em No Limit ($0.05/$0.1) - 2023/12/21 23:05:57
Table 'RushAndCash273087' 6-max Seat #1 is the button
Seat 1: Hero ($10 in chips)
Seat 2: b3d3f1ae ($7.21 in chips)
Seat 3: dcf2107 ($6.08 in chips)
Seat 4: dfe47311 ($28.02 in chips)
Seat 5: 84116fa5 ($7.37 in chips)
Seat 6: 92e35b8f ($12.28 in chips)
b3d3f1ae: posts small blind $0.05
dcf2107: posts big blind $0.1
*** HOLE CARDS ***
Dealt to Hero [4c 7s]
Dealt to b3d3f1ae 
Dealt to dcf2107 
Dealt to dfe47311 
Dealt to 84116fa5 
Dealt to 92e35b8f 
dfe47311: folds
84116fa5: folds
92e35b8f: folds
Hero: folds
b3d3f1ae: raises $0.2 to $0.3
dcf2107: raises $0.6 to $0.9
b3d3f1ae: raises $6.31 to $7.21 and is all-in
dcf2107: calls $5.18 and is all-in
Uncalled bet ($1.13) returned to b3d3f1ae
b3d3f1ae: shows [Jd Ah]
dcf2107: shows [Jc Tc]
*** FLOP *** [Qd As Kd]
*** TURN *** [Qd As Kd] [6h]
*** RIVER *** [Qd As Kd 6h] [7h]
*** SHOWDOWN ***
dcf2107 collected $11.71 from pot
*** SUMMARY ***
Total pot $12.16 | Rake $0.3 | Jackpot $0.15 | Bingo $0 | Fortune $0 | Tax $0
Board [Qd As Kd 6h 7h]
Seat 1: Hero (button) folded before Flop (didn't bet)
Seat 2: b3d3f1ae (small blind) showed [Jd Ah] and lost with Pair of Aces
Seat 3: dcf2107 (big blind) showed [Jc Tc] and won ($11.71) with Aces-High Straight
Seat 4: dfe47311 folded before Flop (didn't bet)
Seat 5: 84116fa5 folded before Flop (didn't bet)
Seat 6: 92e35b8f folded before Flop (didn't bet)


Poker Hand #RC2075472982: Hold'em No Limit ($0.05/$0.1) - 2023/12/21 23:05:52
Table 'RushAndCash273024' 6-max Seat #1 is the button
Seat 1: b695b6df ($12.97 in chips)
Seat 2: 28ee7c9 ($21 in chips)
Seat 3: df49bbb6 ($45.41 in chips)
Seat 4: 8c1f2bcb ($10.67 in chips)
Seat 5: Hero ($10 in chips)
Seat 6: 256ff75e ($10.2 in chips)
28ee7c9: posts small blind $0.05
df49bbb6: posts big blind $0.1
*** HOLE CARDS ***
Dealt to b695b6df 
Dealt to 28ee7c9 
Dealt to df49bbb6 
Dealt to 8c1f2bcb 
Dealt to Hero [5d 4s]
Dealt to 256ff75e 
8c1f2bcb: folds
Hero: folds
256ff75e: folds
b695b6df: folds
28ee7c9: folds
Uncalled bet ($0.05) returned to df49bbb6
*** SHOWDOWN ***
df49bbb6 collected $0.1 from pot
*** SUMMARY ***
Total pot $0.1 | Rake $0 | Jackpot $0 | Bingo $0 | Fortune $0 | Tax $0
Seat 1: b695b6df (button) folded before Flop (didn't bet)
Seat 2: 28ee7c9 (small blind) folded before Flop
Seat 3: df49bbb6 (big blind) collected ($0.1)
Seat 4: 8c1f2bcb folded before Flop (didn't bet)
Seat 5: Hero folded before Flop (didn't bet)
Seat 6: 256ff75e folded before Flop (didn't bet)


Poker Hand #RC2075472323: Hold'em No Limit ($0.05/$0.1) - 2023/12/21 23:05:24
Table 'RushAndCash272627' 6-max Seat #1 is the button
Seat 1: 1e29268 ($11.67 in chips)
Seat 2: a4bffd92 ($11.45 in chips)
Seat 3: 4fcb93c1 ($11.77 in chips)
Seat 4: 1a33d07a ($15.73 in chips)
Seat 5: 8eeea9a5 ($41.35 in chips)
Seat 6: Hero ($10 in chips)
a4bffd92: posts small blind $0.05
4fcb93c1: posts big blind $0.1
*** HOLE CARDS ***
Dealt to 1e29268 
Dealt to a4bffd92 
Dealt to 4fcb93c1 
Dealt to 1a33d07a 
Dealt to 8eeea9a5 
Dealt to Hero [2d 2s]
1a33d07a: raises $0.11 to $0.21
8eeea9a5: folds
Hero: calls $0.21
1e29268: folds
a4bffd92: folds
4fcb93c1: folds
*** FLOP *** [7d Jh 5h]
1a33d07a: bets $0.19
Hero: folds
Uncalled bet ($0.19) returned to 1a33d07a
*** SHOWDOWN ***
1a33d07a collected $0.55 from pot
*** SUMMARY ***
Total pot $0.57 | Rake $0.02 | Jackpot $0 | Bingo $0 | Fortune $0 | Tax $0
Board [7d Jh 5h]
Seat 1: 1e29268 (button) folded before Flop (didn't bet)
Seat 2: a4bffd92 (small blind) folded before Flop
Seat 3: 4fcb93c1 (big blind) folded before Flop
Seat 4: 1a33d07a won ($0.55)
Seat 5: 8eeea9a5 folded before Flop (didn't bet)
Seat 6: Hero folded on the Flop


Poker Hand #RC2075472221: Hold'em No Limit ($0.05/$0.1) - 2023/12/21 23:05:19
Table 'RushAndCash272563' 6-max Seat #1 is the button
Seat 1: 2859beab ($32.69 in chips)
Seat 2: 9ffe5b45 ($10.51 in chips)
Seat 3: 643461d5 ($10 in chips)
Seat 4: Hero ($10 in chips)
Seat 5: 55d59cfa ($13.38 in chips)
Seat 6: 74d3c46 ($16.15 in chips)
9ffe5b45: posts small blind $0.05
643461d5: posts big blind $0.1
*** HOLE CARDS ***
Dealt to 2859beab 
Dealt to 9ffe5b45 
Dealt to 643461d5 
Dealt to Hero [7s Qc]
Dealt to 55d59cfa 
Dealt to 74d3c46 
Hero: folds
55d59cfa: folds
74d3c46: raises $0.15 to $0.25
2859beab: folds
9ffe5b45: folds
643461d5: folds
Uncalled bet ($0.15) returned to 74d3c46
*** SHOWDOWN ***
74d3c46 collected $0.25 from pot
*** SUMMARY ***
Total pot $0.25 | Rake $0 | Jackpot $0 | Bingo $0 | Fortune $0 | Tax $0
Seat 1: 2859beab (button) folded before Flop (didn't bet)
Seat 2: 9ffe5b45 (small blind) folded before Flop
Seat 3: 643461d5 (big blind) folded before Flop
Seat 4: Hero folded before Flop (didn't bet)
Seat 5: 55d59cfa folded before Flop (didn't bet)
Seat 6: 74d3c46 collected ($0.25)


Poker Hand #RC2075471990: Hold'em No Limit ($0.05/$0.1) - 2023/12/21 23:05:08
Table 'RushAndCash272433' 6-max Seat #1 is the button
Seat 1: ba2eb0e7 ($11.57 in chips)
Seat 2: Hero ($9.9 in chips)
Seat 3: 6bd2232e ($10.75 in chips)
Seat 4: c824ca62 ($11.14 in chips)
Seat 5: fbe5db2d ($21.49 in chips)
Seat 6: 5b495a42 ($15.24 in chips)
Hero: posts small blind $0.05
6bd2232e: posts big blind $0.1
*** HOLE CARDS ***
Dealt to ba2eb0e7 
Dealt to Hero [Qd 7c]
Dealt to 6bd2232e 
Dealt to c824ca62 
Dealt to fbe5db2d 
Dealt to 5b495a42 
c824ca62: raises $0.15 to $0.25
fbe5db2d: raises $0.56 to $0.81
5b495a42: folds
ba2eb0e7: folds
Hero: folds
6bd2232e: folds
c824ca62: raises $1.33 to $2.14
fbe5db2d: folds
Uncalled bet ($1.33) returned to c824ca62
*** SHOWDOWN ***
c824ca62 collected $1.69 from pot
*** SUMMARY ***
Total pot $1.77 | Rake $0.08 | Jackpot $0 | Bingo $0 | Fortune $0 | Tax $0
Seat 1: ba2eb0e7 (button) folded before Flop (didn't bet)
Seat 2: Hero (small blind) folded before Flop
Seat 3: 6bd2232e (big blind) folded before Flop
Seat 4: c824ca62 collected ($1.69)
Seat 5: fbe5db2d folded before Flop
Seat 6: 5b495a42 folded before Flop (didn't bet)


Poker Hand #RC2075471773: Hold'em No Limit ($0.05/$0.1) - 2023/12/21 23:04:58
Table 'RushAndCash272311' 6-max Seat #1 is the button
Seat 1: dc18fbf1 ($10 in chips)
Seat 2: 65ea3ba9 ($15.62 in chips)
Seat 3: Hero ($10 in chips)
Seat 4: 835eed05 ($15.82 in chips)
Seat 5: ba6cec71 ($10.17 in chips)
Seat 6: ca39ef1 ($30.37 in chips)
65ea3ba9: posts small blind $0.05
Hero: posts big blind $0.1
*** HOLE CARDS ***
Dealt to dc18fbf1 
Dealt to 65ea3ba9 
Dealt to Hero [Ts 6c]
Dealt to 835eed05 
Dealt to ba6cec71 
Dealt to ca39ef1 
835eed05: folds
ba6cec71: raises $0.12 to $0.22
ca39ef1: calls $0.22
dc18fbf1: folds
65ea3ba9: raises $0.98 to $1.2
Hero: folds
ba6cec71: folds
ca39ef1: calls $0.98
*** FLOP *** [6h Kd 3d]
65ea3ba9: bets $1.36
ca39ef1: calls $1.36
*** TURN *** [6h Kd 3d] [7h]
65ea3ba9: checks
ca39ef1: bets $3.9
65ea3ba9: folds
Uncalled bet ($3.9) returned to ca39ef1
*** SHOWDOWN ***
ca39ef1 collected $5.03 from pot
*** SUMMARY ***
Total pot $5.44 | Rake $0.26 | Jackpot $0.15 | Bingo $0 | Fortune $0 | Tax $0
Board [6h Kd 3d 7h]
Seat 1: dc18fbf1 (button) folded before Flop (didn't bet)
Seat 2: 65ea3ba9 (small blind) folded on the Turn
Seat 3: Hero (big blind) folded before Flop
Seat 4: 835eed05 folded before Flop (didn't bet)
Seat 5: ba6cec71 folded before Flop
Seat 6: ca39ef1 won ($5.03)


Poker Hand #RC2075471642: Hold'em No Limit ($0.05/$0.1) - 2023/12/21 23:04:53
Table 'RushAndCash272235' 6-max Seat #1 is the button
Seat 1: Hero ($10 in chips)
Seat 2: ba9e35e3 ($13.51 in chips)
Seat 3: 8ce2ebbb ($10.42 in chips)
Seat 4: fd721595 ($20.98 in chips)
Seat 5: d8d6bf23 ($22.95 in chips)
Seat 6: a19487d2 ($10 in chips)
ba9e35e3: posts small blind $0.05
8ce2ebbb: posts big blind $0.1
*** HOLE CARDS ***
Dealt to Hero [Js 7d]
Dealt to ba9e35e3 
Dealt to 8ce2ebbb 
Dealt to fd721595 
Dealt to d8d6bf23 
Dealt to a19487d2 
fd721595: raises $0.11 to $0.21
d8d6bf23: folds
a19487d2: raises $0.43 to $0.64
Hero: folds
ba9e35e3: folds
8ce2ebbb: folds
fd721595: folds
Uncalled bet ($0.43) returned to a19487d2
*** SHOWDOWN ***
a19487d2 collected $0.55 from pot
*** SUMMARY ***
Total pot $0.57 | Rake $0.02 | Jackpot $0 | Bingo $0 | Fortune $0 | Tax $0
Seat 1: Hero (button) folded before Flop (didn't bet)
Seat 2: ba9e35e3 (small blind) folded before Flop
Seat 3: 8ce2ebbb (big blind) folded before Flop
Seat 4: fd721595 folded before Flop
Seat 5: d8d6bf23 folded before Flop (didn't bet)
Seat 6: a19487d2 collected ($0.55)


Poker Hand #RC2075471497: Hold'em No Limit ($0.05/$0.1) - 2023/12/21 23:04:46
Table 'RushAndCash272151' 6-max Seat #1 is the button
Seat 1: 2b0be38a ($21.37 in chips)
Seat 2: 95d2cdb7 ($34.85 in chips)
Seat 3: a015d585 ($12.84 in chips)
Seat 4: afd0eb43 ($34.49 in chips)
Seat 5: 6ed21051 ($13.89 in chips)
Seat 6: Hero ($10 in chips)
95d2cdb7: posts small blind $0.05
a015d585: posts big blind $0.1
*** HOLE CARDS ***
Dealt to 2b0be38a 
Dealt to 95d2cdb7 
Dealt to a015d585 
Dealt to afd0eb43 
Dealt to 6ed21051 
Dealt to Hero [8c 6c]
afd0eb43: folds
6ed21051: folds
Hero: folds
2b0be38a: folds
95d2cdb7: folds
Uncalled bet ($0.05) returned to a015d585
*** SHOWDOWN ***
a015d585 collected $0.1 from pot
*** SUMMARY ***
Total pot $0.1 | Rake $0 | Jackpot $0 | Bingo $0 | Fortune $0 | Tax $0
Seat 1: 2b0be38a (button) folded before Flop (didn't bet)
Seat 2: 95d2cdb7 (small blind) folded before Flop
Seat 3: a015d585 (big blind) collected ($0.1)
Seat 4: afd0eb43 folded before Flop (didn't bet)
Seat 5: 6ed21051 folded before Flop (didn't bet)
Seat 6: Hero folded before Flop (didn't bet)


Poker Hand #RC2075471423: Hold'em No Limit ($0.05/$0.1) - 2023/12/21 23:04:43
Table 'RushAndCash272106' 6-max Seat #1 is the button
Seat 1: 4a324856 ($18.12 in chips)
Seat 2: 53f4c122 ($5.8 in chips)
Seat 3: 90d784f ($11.7 in chips)
Seat 4: 237fc596 ($9.5 in chips)
Seat 5: Hero ($10 in chips)
Seat 6: 67a39c12 ($10.91 in chips)
53f4c122: posts small blind $0.05
90d784f: posts big blind $0.1
*** HOLE CARDS ***
Dealt to 4a324856 
Dealt to 53f4c122 
Dealt to 90d784f 
Dealt to 237fc596 
Dealt to Hero [9c Jd]
Dealt to 67a39c12 
237fc596: folds
Hero: folds
67a39c12: folds
4a324856: folds
53f4c122: folds
Uncalled bet ($0.05) returned to 90d784f
*** SHOWDOWN ***
90d784f collected $0.1 from pot
*** SUMMARY ***
Total pot $0.1 | Rake $0 | Jackpot $0 | Bingo $0 | Fortune $0 | Tax $0
Seat 1: 4a324856 (button) folded before Flop (didn't bet)
Seat 2: 53f4c122 (small blind) folded before Flop
Seat 3: 90d784f (big blind) collected ($0.1)
Seat 4: 237fc596 folded before Flop (didn't bet)
Seat 5: Hero folded before Flop (didn't bet)
Seat 6: 67a39c12 folded before Flop (didn't bet)


Poker Hand #RC2075470479: Hold'em No Limit ($0.05/$0.1) - 2023/12/21 23:04:01
Table 'RushAndCash271547' 6-max Seat #1 is the button
Seat 1: Hero ($10 in chips)
Seat 2: bc811ec9 ($10 in chips)
Seat 3: 3b3d52db ($10 in chips)
Seat 4: 5c72c784 ($5.92 in chips)
Seat 5: 802ea8ef ($10.25 in chips)
Seat 6: bb0b62fd ($11.59 in chips)
bc811ec9: posts small blind $0.05
3b3d52db: posts big blind $0.1
*** HOLE CARDS ***
Dealt to Hero [6s 6d]
Dealt to bc811ec9 
Dealt to 3b3d52db 
Dealt to 5c72c784 
Dealt to 802ea8ef 
Dealt to bb0b62fd 
5c72c784: raises $0.11 to $0.21
802ea8ef: folds
bb0b62fd: folds
Hero: calls $0.21
bc811ec9: folds
3b3d52db: folds
*** FLOP *** [Ac 5d 8c]
5c72c784: bets $0.19
Hero: calls $0.19
*** TURN *** [Ac 5d 8c] [Th]
5c72c784: checks
Hero: checks
*** RIVER *** [Ac 5d 8c Th] [5h]
5c72c784: checks
Hero: checks
5c72c784: shows [8h Jh] (Pair of Eights and Pair of Fives)
Hero: shows [6s 6d] (Pair of Sixes and Pair of Fives)
*** SHOWDOWN ***
5c72c784 collected $0.91 from pot
*** SUMMARY ***
Total pot $0.95 | Rake $0.04 | Jackpot $0 | Bingo $0 | Fortune $0 | Tax $0
Board [Ac 5d 8c Th 5h]
Seat 1: Hero (button) showed [6s 6d] and lost with Pair of Sixes and Pair of Fives
Seat 2: bc811ec9 (small blind) folded before Flop
Seat 3: 3b3d52db (big blind) folded before Flop
Seat 4: 5c72c784 showed [8h Jh] and won ($0.91) with Pair of Eights and Pair of Fives
Seat 5: 802ea8ef folded before Flop (didn't bet)
Seat 6: bb0b62fd folded before Flop (didn't bet)


Poker Hand #RC2075470395: Hold'em No Limit ($0.05/$0.1) - 2023/12/21 23:03:57
Table 'RushAndCash271497' 6-max Seat #1 is the button
Seat 1: 958e9f96 ($9.81 in chips)
Seat 2: Hero ($10 in chips)
Seat 3: 69b99c5e ($10.24 in chips)
Seat 4: 198ae68 ($44.12 in chips)
Seat 5: e15317b3 ($19.65 in chips)
Seat 6: 8eae006e ($24.4 in chips)
Hero: posts small blind $0.05
69b99c5e: posts big blind $0.1
*** HOLE CARDS ***
Dealt to 958e9f96 
Dealt to Hero [5c Qc]
Dealt to 69b99c5e 
Dealt to 198ae68 
Dealt to e15317b3 
Dealt to 8eae006e 
198ae68: folds
e15317b3: folds
8eae006e: folds
958e9f96: raises $0.1 to $0.2
Hero: folds
69b99c5e: folds
Uncalled bet ($0.1) returned to 958e9f96
*** SHOWDOWN ***
958e9f96 collected $0.25 from pot
*** SUMMARY ***
Total pot $0.25 | Rake $0 | Jackpot $0 | Bingo $0 | Fortune $0 | Tax $0
Seat 1: 958e9f96 (button) collected ($0.25)
Seat 2: Hero (small blind) folded before Flop
Seat 3: 69b99c5e (big blind) folded before Flop
Seat 4: 198ae68 folded before Flop (didn't bet)
Seat 5: e15317b3 folded before Flop (didn't bet)
Seat 6: 8eae006e folded before Flop (didn't bet)


Poker Hand #RC2075468846: Hold'em No Limit ($0.05/$0.1) - 2023/12/21 23:02:48
Table 'RushAndCash270612' 6-max Seat #1 is the button
Seat 1: a1f0eb17 ($8.93 in chips)
Seat 2: 87436cf6 ($10.05 in chips)
Seat 3: Hero ($10 in chips)
Seat 4: 5767ed55 ($19.21 in chips)
Seat 5: 28ee7c9 ($21.79 in chips)
Seat 6: fd6e25de ($10 in chips)
87436cf6: posts small blind $0.05
Hero: posts big blind $0.1
*** HOLE CARDS ***
Dealt to a1f0eb17 
Dealt to 87436cf6 
Dealt to Hero [4c Kc]
Dealt to 5767ed55 
Dealt to 28ee7c9 
Dealt to fd6e25de 
5767ed55: folds
28ee7c9: folds
fd6e25de: folds
a1f0eb17: raises $0.15 to $0.25
87436cf6: folds
Hero: calls $0.15
*** FLOP *** [9d 4d 3s]
Hero: checks
a1f0eb17: checks
*** TURN *** [9d 4d 3s] [Tc]
Hero: checks
a1f0eb17: bets $0.37
Hero: calls $0.37
*** RIVER *** [9d 4d 3s Tc] [Jc]
Hero: checks
a1f0eb17: checks
Hero: shows [4c Kc] (Pair of Fours)
a1f0eb17: shows [Th Qh] (Pair of Tens)
*** SHOWDOWN ***
a1f0eb17 collected $1.23 from pot
*** SUMMARY ***
Total pot $1.29 | Rake $0.06 | Jackpot $0 | Bingo $0 | Fortune $0 | Tax $0
Board [9d 4d 3s Tc Jc]
Seat 1: a1f0eb17 (button) showed [Th Qh] and won ($1.23) with Pair of Tens
Seat 2: 87436cf6 (small blind) folded before Flop
Seat 3: Hero (big blind) showed [4c Kc] and lost with Pair of Fours
Seat 4: 5767ed55 folded before Flop (didn't bet)
Seat 5: 28ee7c9 folded before Flop (didn't bet)
Seat 6: fd6e25de folded before Flop (didn't bet)


Poker Hand #RC2075468696: Hold'em No Limit ($0.05/$0.1) - 2023/12/21 23:02:41
Table 'RushAndCash270523' 6-max Seat #1 is the button
Seat 1: 159bca93 ($10.83 in chips)
Seat 2: 49b69c38 ($6.65 in chips)
Seat 3: e31d093b ($15.12 in chips)
Seat 4: af11633d ($14.58 in chips)
Seat 5: Hero ($10 in chips)
Seat 6: 24dad805 ($10 in chips)
49b69c38: posts small blind $0.05
e31d093b: posts big blind $0.1
*** HOLE CARDS ***
Dealt to 159bca93 
Dealt to 49b69c38 
Dealt to e31d093b 
Dealt to af11633d 
Dealt to Hero [4c 3c]
Dealt to 24dad805 
af11633d: folds
Hero: folds
24dad805: folds
159bca93: folds
49b69c38: raises $0.2 to $0.3
e31d093b: folds
Uncalled bet ($0.2) returned to 49b69c38
*** SHOWDOWN ***
49b69c38 collected $0.2 from pot
*** SUMMARY ***
Total pot $0.2 | Rake $0 | Jackpot $0 | Bingo $0 | Fortune $0 | Tax $0
Seat 1: 159bca93 (button) folded before Flop (didn't bet)
Seat 2: 49b69c38 (small blind) collected ($0.2)
Seat 3: e31d093b (big blind) folded before Flop
Seat 4: af11633d folded before Flop (didn't bet)
Seat 5: Hero folded before Flop (didn't bet)
Seat 6: 24dad805 folded before Flop (didn't bet)


Poker Hand #RC2075468553: Hold'em No Limit ($0.05/$0.1) - 2023/12/21 23:02:35
Table 'RushAndCash270441' 6-max Seat #1 is the button
Seat 1: 61685ef9 ($22.11 in chips)
Seat 2: c69b2e95 ($10.51 in chips)
Seat 3: 7ff9138c ($5.36 in chips)
Seat 4: Hero ($10 in chips)
Seat 5: 73ced8be ($27.52 in chips)
Seat 6: ff5dbe65 ($11.19 in chips)
c69b2e95: posts small blind $0.05
7ff9138c: posts big blind $0.1
*** HOLE CARDS ***
Dealt to 61685ef9 
Dealt to c69b2e95 
Dealt to 7ff9138c 
Dealt to Hero [Tc 4h]
Dealt to 73ced8be 
Dealt to ff5dbe65 
Hero: folds
73ced8be: folds
ff5dbe65: raises $0.15 to $0.25
61685ef9: folds
c69b2e95: folds
7ff9138c: folds
Uncalled bet ($0.15) returned to ff5dbe65
*** SHOWDOWN ***
ff5dbe65 collected $0.25 from pot
*** SUMMARY ***
Total pot $0.25 | Rake $0 | Jackpot $0 | Bingo $0 | Fortune $0 | Tax $0
Seat 1: 61685ef9 (button) folded before Flop (didn't bet)
Seat 2: c69b2e95 (small blind) folded before Flop
Seat 3: 7ff9138c (big blind) folded before Flop
Seat 4: Hero folded before Flop (didn't bet)
Seat 5: 73ced8be folded before Flop (didn't bet)
Seat 6: ff5dbe65 collected ($0.25)


Poker Hand #RC2075468461: Hold'em No Limit ($0.05/$0.1) - 2023/12/21 23:02:31
Table 'RushAndCash270390' 6-max Seat #1 is the button
Seat 1: 5b0ddb11 ($12.84 in chips)
Seat 2: 7146f77b ($17.91 in chips)
Seat 3: 44d5886a ($25.49 in chips)
Seat 4: a9f5c071 ($31.2 in chips)
Seat 5: Hero ($10 in chips)
Seat 6: 23c05970 ($10.22 in chips)
7146f77b: posts small blind $0.05
44d5886a: posts big blind $0.1
*** HOLE CARDS ***
Dealt to 5b0ddb11 
Dealt to 7146f77b 
Dealt to 44d5886a 
Dealt to a9f5c071 
Dealt to Hero [Ac 5h]
Dealt to 23c05970 
a9f5c071: folds
Hero: folds
23c05970: folds
5b0ddb11: folds
7146f77b: raises $0.2 to $0.3
44d5886a: folds
Uncalled bet ($0.2) returned to 7146f77b
*** SHOWDOWN ***
7146f77b collected $0.2 from pot
*** SUMMARY ***
Total pot $0.2 | Rake $0 | Jackpot $0 | Bingo $0 | Fortune $0 | Tax $0
Seat 1: 5b0ddb11 (button) folded before Flop (didn't bet)
Seat 2: 7146f77b (small blind) collected ($0.2)
Seat 3: 44d5886a (big blind) folded before Flop
Seat 4: a9f5c071 folded before Flop (didn't bet)
Seat 5: Hero folded before Flop (didn't bet)
Seat 6: 23c05970 folded before Flop (didn't bet)


Poker Hand #RC2075468379: Hold'em No Limit ($0.05/$0.1) - 2023/12/21 23:02:28
Table 'RushAndCash270346' 6-max Seat #1 is the button
Seat 1: 80892cda ($9.85 in chips)
Seat 2: ec0c4bef ($14.13 in chips)
Seat 3: b709b035 ($10.45 in chips)
Seat 4: Hero ($10 in chips)
Seat 5: 92e35b8f ($10 in chips)
Seat 6: 723d83eb ($25.9 in chips)
ec0c4bef: posts small blind $0.05
b709b035: posts big blind $0.1
*** HOLE CARDS ***
Dealt to 80892cda 
Dealt to ec0c4bef 
Dealt to b709b035 
Dealt to Hero [8h 5s]
Dealt to 92e35b8f 
Dealt to 723d83eb 
Hero: folds
92e35b8f: folds
723d83eb: folds
80892cda: folds
ec0c4bef: raises $0.15 to $0.25
b709b035: folds
Uncalled bet ($0.15) returned to ec0c4bef
*** SHOWDOWN ***
ec0c4bef collected $0.2 from pot
*** SUMMARY ***
Total pot $0.2 | Rake $0 | Jackpot $0 | Bingo $0 | Fortune $0 | Tax $0
Seat 1: 80892cda (button) folded before Flop (didn't bet)
Seat 2: ec0c4bef (small blind) collected ($0.2)
Seat 3: b709b035 (big blind) folded before Flop
Seat 4: Hero folded before Flop (didn't bet)
Seat 5: 92e35b8f folded before Flop (didn't bet)
Seat 6: 723d83eb folded before Flop (didn't bet)


Poker Hand #RC2075468173: Hold'em No Limit ($0.05/$0.1) - 2023/12/21 23:02:18
Table 'RushAndCash270233' 6-max Seat #1 is the button
Seat 1: Hero ($10 in chips)
Seat 2: d8d7dbd5 ($11.91 in chips)
Seat 3: 5b1f039d ($7.03 in chips)
Seat 4: 49b69c38 ($6.45 in chips)
Seat 5: 8cb1fe0a ($12.54 in chips)
Seat 6: ad33b1a1 ($10.17 in chips)
d8d7dbd5: posts small blind $0.05
5b1f039d: posts big blind $0.1
*** HOLE CARDS ***
Dealt to Hero [8h 6h]
Dealt to d8d7dbd5 
Dealt to 5b1f039d 
Dealt to 49b69c38 
Dealt to 8cb1fe0a 
Dealt to ad33b1a1 
49b69c38: folds
8cb1fe0a: folds
ad33b1a1: folds
Hero: folds
d8d7dbd5: folds
Uncalled bet ($0.05) returned to 5b1f039d
*** SHOWDOWN ***
5b1f039d collected $0.1 from pot
*** SUMMARY ***
Total pot $0.1 | Rake $0 | Jackpot $0 | Bingo $0 | Fortune $0 | Tax $0
Seat 1: Hero (button) folded before Flop (didn't bet)
Seat 2: d8d7dbd5 (small blind) folded before Flop
Seat 3: 5b1f039d (big blind) collected ($0.1)
Seat 4: 49b69c38 folded before Flop (didn't bet)
Seat 5: 8cb1fe0a folded before Flop (didn't bet)
Seat 6: ad33b1a1 folded before Flop (didn't bet)


Poker Hand #RC2075467972: Hold'em No Limit ($0.05/$0.1) - 2023/12/21 23:02:10
Table 'RushAndCash270122' 6-max Seat #1 is the button
Seat 1: e889978c ($23.83 in chips)
Seat 2: Hero ($10.05 in chips)
Seat 3: 3db6ac28 ($10.01 in chips)
Seat 4: 97e299d5 ($71.43 in chips)
Seat 5: 84116fa5 ($7.23 in chips)
Seat 6: a602cbad ($20.97 in chips)
Hero: posts small blind $0.05
3db6ac28: posts big blind $0.1
*** HOLE CARDS ***
Dealt to e889978c 
Dealt to Hero [Jc 8h]
Dealt to 3db6ac28 
Dealt to 97e299d5 
Dealt to 84116fa5 
Dealt to a602cbad 
97e299d5: raises $0.15 to $0.25
84116fa5: raises $0.52 to $0.77
a602cbad: folds
e889978c: folds
Hero: folds
3db6ac28: folds
97e299d5: calls $0.52
*** FLOP *** [Jd 6d As]
97e299d5: checks
84116fa5: bets $0.56
97e299d5: folds
Uncalled bet ($0.56) returned to 84116fa5
*** SHOWDOWN ***
84116fa5 collected $1.61 from pot
*** SUMMARY ***
Total pot $1.69 | Rake $0.08 | Jackpot $0 | Bingo $0 | Fortune $0 | Tax $0
Board [Jd 6d As]
Seat 1: e889978c (button) folded before Flop (didn't bet)
Seat 2: Hero (small blind) folded before Flop
Seat 3: 3db6ac28 (big blind) folded before Flop
Seat 4: 97e299d5 folded on the Flop
Seat 5: 84116fa5 won ($1.61)
Seat 6: a602cbad folded before Flop (didn't bet)


Poker Hand #RC2075467755: Hold'em No Limit ($0.05/$0.1) - 2023/12/21 23:02:00
Table 'RushAndCash270000' 6-max Seat #1 is the button
Seat 1: 969ab6b9 ($10.81 in chips)
Seat 2: bda4ccd3 ($10.74 in chips)
Seat 3: Hero ($10 in chips)
Seat 4: da62d8e8 ($11.5 in chips)
Seat 5: a4bffd92 ($10.53 in chips)
Seat 6: 8433291c ($18.18 in chips)
bda4ccd3: posts small blind $0.05
Hero: posts big blind $0.1
*** HOLE CARDS ***
Dealt to 969ab6b9 
Dealt to bda4ccd3 
Dealt to Hero [Qh 5d]
Dealt to da62d8e8 
Dealt to a4bffd92 
Dealt to 8433291c 
da62d8e8: folds
a4bffd92: folds
8433291c: folds
969ab6b9: folds
bda4ccd3: folds
Uncalled bet ($0.05) returned to Hero
*** SHOWDOWN ***
Hero collected $0.1 from pot
*** SUMMARY ***
Total pot $0.1 | Rake $0 | Jackpot $0 | Bingo $0 | Fortune $0 | Tax $0
Seat 1: 969ab6b9 (button) folded before Flop (didn't bet)
Seat 2: bda4ccd3 (small blind) folded before Flop
Seat 3: Hero (big blind) collected ($0.1)
Seat 4: da62d8e8 folded before Flop (didn't bet)
Seat 5: a4bffd92 folded before Flop (didn't bet)
Seat 6: 8433291c folded before Flop (didn't bet)


