Poker Hand #RC2078594041: Hold'em No Limit ($0.02/$0.05) - 2023/12/22 22:12:55
Table 'RushAndCash810866' 6-max Seat #1 is the button
Seat 1: 440a38cc ($3.75 in chips)
Seat 2: 5338582d ($2.09 in chips)
Seat 3: ff6f425f ($14.1 in chips)
Seat 4: Hero ($11.89 in chips)
Seat 5: 10c2c8d2 ($5.79 in chips)
Seat 6: 6787a4d2 ($5.92 in chips)
5338582d: posts small blind $0.02
ff6f425f: posts big blind $0.05
*** HOLE CARDS ***
Dealt to 440a38cc 
Dealt to 5338582d 
Dealt to ff6f425f 
Dealt to Hero [Ad 5s]
Dealt to 10c2c8d2 
Dealt to 6787a4d2 
Hero: folds
10c2c8d2: folds
6787a4d2: folds
440a38cc: folds
5338582d: folds
Uncalled bet ($0.03) returned to ff6f425f
*** SHOWDOWN ***
ff6f425f collected $0.04 from pot
*** SUMMARY ***
Total pot $0.04 | Rake $0 | Jackpot $0 | Bingo $0 | Fortune $0 | Tax $0
Seat 1: 440a38cc (button) folded before Flop (didn't bet)
Seat 2: 5338582d (small blind) folded before Flop
Seat 3: ff6f425f (big blind) collected ($0.04)
Seat 4: Hero folded before Flop (didn't bet)
Seat 5: 10c2c8d2 folded before Flop (didn't bet)
Seat 6: 6787a4d2 folded before Flop (didn't bet)


Poker Hand #RC2078593019: Hold'em No Limit ($0.02/$0.05) - 2023/12/22 22:11:58
Table 'RushAndCash810394' 6-max Seat #1 is the button
Seat 1: Hero ($12.28 in chips)
Seat 2: a2ebb3c7 ($5 in chips)
Seat 3: 5a7ccd94 ($5.4 in chips)
Seat 4: f94de4b0 ($7.3 in chips)
Seat 5: 24503504 ($7.3 in chips)
Seat 6: 440a38cc ($3.9 in chips)
a2ebb3c7: posts small blind $0.02
5a7ccd94: posts big blind $0.05
*** HOLE CARDS ***
Dealt to Hero [Ad Js]
Dealt to a2ebb3c7 
Dealt to 5a7ccd94 
Dealt to f94de4b0 
Dealt to 24503504 
Dealt to 440a38cc 
f94de4b0: folds
24503504: folds
440a38cc: raises $0.1 to $0.15
Hero: calls $0.15
a2ebb3c7: folds
5a7ccd94: calls $0.1
*** FLOP *** [4c 4h 2d]
5a7ccd94: checks
440a38cc: checks
Hero: checks
*** TURN *** [4c 4h 2d] [Ac]
5a7ccd94: bets $0.24
440a38cc: folds
Hero: calls $0.24
*** RIVER *** [4c 4h 2d Ac] [9h]
5a7ccd94: checks
Hero: checks
5a7ccd94: shows [Ah Qd] (Pair of Aces and Pair of Fours)
Hero: shows [Ad Js] (Pair of Aces and Pair of Fours)
*** SHOWDOWN ***
5a7ccd94 collected $0.91 from pot
*** SUMMARY ***
Total pot $0.95 | Rake $0.04 | Jackpot $0 | Bingo $0 | Fortune $0 | Tax $0
Board [4c 4h 2d Ac 9h]
Seat 1: Hero (button) showed [Ad Js] and lost with Pair of Aces and Pair of Fours
Seat 2: a2ebb3c7 (small blind) folded before Flop
Seat 3: 5a7ccd94 (big blind) showed [Ah Qd] and won ($0.91) with Pair of Aces and Pair of Fours
Seat 4: f94de4b0 folded before Flop (didn't bet)
Seat 5: 24503504 folded before Flop (didn't bet)
Seat 6: 440a38cc folded on the Turn


Poker Hand #RC2078592780: Hold'em No Limit ($0.02/$0.05) - 2023/12/22 22:11:44
Table 'RushAndCash810294' 6-max Seat #1 is the button
Seat 1: d132ea52 ($2.66 in chips)
Seat 2: Hero ($12.3 in chips)
Seat 3: 76ce83dc ($3.92 in chips)
Seat 4: 521feab9 ($5 in chips)
Seat 5: 3228da40 ($4.88 in chips)
Seat 6: 491e69f2 ($12.62 in chips)
Hero: posts small blind $0.02
76ce83dc: posts big blind $0.05
*** HOLE CARDS ***
Dealt to d132ea52 
Dealt to Hero [Kh 6d]
Dealt to 76ce83dc 
Dealt to 521feab9 
Dealt to 3228da40 
Dealt to 491e69f2 
521feab9: folds
3228da40: folds
491e69f2: raises $0.05 to $0.1
d132ea52: folds
Hero: folds
76ce83dc: calls $0.05
*** FLOP *** [Js Jh 5s]
76ce83dc: checks
491e69f2: checks
*** TURN *** [Js Jh 5s] [Kd]
76ce83dc: checks
491e69f2: bets $0.15
76ce83dc: folds
Uncalled bet ($0.15) returned to 491e69f2
*** SHOWDOWN ***
491e69f2 collected $0.21 from pot
*** SUMMARY ***
Total pot $0.22 | Rake $0.01 | Jackpot $0 | Bingo $0 | Fortune $0 | Tax $0
Board [Js Jh 5s Kd]
Seat 1: d132ea52 (button) folded before Flop (didn't bet)
Seat 2: Hero (small blind) folded before Flop
Seat 3: 76ce83dc (big blind) folded on the Turn
Seat 4: 521feab9 folded before Flop (didn't bet)
Seat 5: 3228da40 folded before Flop (didn't bet)
Seat 6: 491e69f2 won ($0.21)


Poker Hand #RC2078592542: Hold'em No Limit ($0.02/$0.05) - 2023/12/22 22:11:30
Table 'RushAndCash810188' 6-max Seat #1 is the button
Seat 1: 9601129f ($10.05 in chips)
Seat 2: 7385f3 ($4.95 in chips)
Seat 3: Hero ($12.28 in chips)
Seat 4: 90f6987a ($4.32 in chips)
Seat 5: 1c79ceea ($5 in chips)
Seat 6: c84db7d6 ($3.61 in chips)
7385f3: posts small blind $0.02
Hero: posts big blind $0.05
*** HOLE CARDS ***
Dealt to 9601129f 
Dealt to 7385f3 
Dealt to Hero [3h Tc]
Dealt to 90f6987a 
Dealt to 1c79ceea 
Dealt to c84db7d6 
90f6987a: folds
1c79ceea: folds
c84db7d6: folds
9601129f: folds
7385f3: raises $0.07 to $0.12
Hero: folds
Uncalled bet ($0.07) returned to 7385f3
*** SHOWDOWN ***
7385f3 collected $0.1 from pot
*** SUMMARY ***
Total pot $0.1 | Rake $0 | Jackpot $0 | Bingo $0 | Fortune $0 | Tax $0
Seat 1: 9601129f (button) folded before Flop (didn't bet)
Seat 2: 7385f3 (small blind) collected ($0.1)
Seat 3: Hero (big blind) folded before Flop
Seat 4: 90f6987a folded before Flop (didn't bet)
Seat 5: 1c79ceea folded before Flop (didn't bet)
Seat 6: c84db7d6 folded before Flop (didn't bet)


Poker Hand #RC2078592431: Hold'em No Limit ($0.02/$0.05) - 2023/12/22 22:11:23
Table 'RushAndCash810141' 6-max Seat #1 is the button
Seat 1: 306735ed ($5 in chips)
Seat 2: 725fcf25 ($14.65 in chips)
Seat 3: Hero ($12.33 in chips)
Seat 4: f5ffb37c ($5.18 in chips)
Seat 5: bc118b95 ($7.09 in chips)
Seat 6: d6363be2 ($5.5 in chips)
725fcf25: posts small blind $0.02
Hero: posts big blind $0.05
*** HOLE CARDS ***
Dealt to 306735ed 
Dealt to 725fcf25 
Dealt to Hero [Td 3s]
Dealt to f5ffb37c 
Dealt to bc118b95 
Dealt to d6363be2 
f5ffb37c: folds
bc118b95: folds
d6363be2: folds
306735ed: folds
725fcf25: folds
Uncalled bet ($0.03) returned to Hero
*** SHOWDOWN ***
Hero collected $0.04 from pot
*** SUMMARY ***
Total pot $0.04 | Rake $0 | Jackpot $0 | Bingo $0 | Fortune $0 | Tax $0
Seat 1: 306735ed (button) folded before Flop (didn't bet)
Seat 2: 725fcf25 (small blind) folded before Flop
Seat 3: Hero (big blind) collected ($0.04)
Seat 4: f5ffb37c folded before Flop (didn't bet)
Seat 5: bc118b95 folded before Flop (didn't bet)
Seat 6: d6363be2 folded before Flop (didn't bet)


Poker Hand #RC2078592369: Hold'em No Limit ($0.02/$0.05) - 2023/12/22 22:11:20
Table 'RushAndCash810111' 6-max Seat #1 is the button
Seat 1: 1c5ffeb9 ($5.45 in chips)
Seat 2: 2afe98d4 ($6.22 in chips)
Seat 3: f5067ee ($4.73 in chips)
Seat 4: Hero ($12.33 in chips)
Seat 5: beea6e5f ($9.06 in chips)
Seat 6: c0936c93 ($5.83 in chips)
2afe98d4: posts small blind $0.02
f5067ee: posts big blind $0.05
*** HOLE CARDS ***
Dealt to 1c5ffeb9 
Dealt to 2afe98d4 
Dealt to f5067ee 
Dealt to Hero [9h 2d]
Dealt to beea6e5f 
Dealt to c0936c93 
Hero: folds
beea6e5f: folds
c0936c93: folds
1c5ffeb9: raises $0.1 to $0.15
2afe98d4: folds
f5067ee: folds
Uncalled bet ($0.1) returned to 1c5ffeb9
*** SHOWDOWN ***
1c5ffeb9 collected $0.12 from pot
*** SUMMARY ***
Total pot $0.12 | Rake $0 | Jackpot $0 | Bingo $0 | Fortune $0 | Tax $0
Seat 1: 1c5ffeb9 (button) collected ($0.12)
Seat 2: 2afe98d4 (small blind) folded before Flop
Seat 3: f5067ee (big blind) folded before Flop
Seat 4: Hero folded before Flop (didn't bet)
Seat 5: beea6e5f folded before Flop (didn't bet)
Seat 6: c0936c93 folded before Flop (didn't bet)


Poker Hand #RC2078592309: Hold'em No Limit ($0.02/$0.05) - 2023/12/22 22:11:16
Table 'RushAndCash810083' 6-max Seat #1 is the button
Seat 1: Hero ($12.33 in chips)
Seat 2: 84572dc4 ($1.63 in chips)
Seat 3: b36e65db ($5.32 in chips)
Seat 4: 3bfed236 ($4.65 in chips)
Seat 5: 3f7ed7e8 ($6.14 in chips)
Seat 6: 3288926 ($15.6 in chips)
84572dc4: posts small blind $0.02
b36e65db: posts big blind $0.05
*** HOLE CARDS ***
Dealt to Hero [5d 3s]
Dealt to 84572dc4 
Dealt to b36e65db 
Dealt to 3bfed236 
Dealt to 3f7ed7e8 
Dealt to 3288926 
3bfed236: folds
3f7ed7e8: folds
3288926: raises $0.08 to $0.13
Hero: folds
84572dc4: folds
b36e65db: folds
Uncalled bet ($0.08) returned to 3288926
*** SHOWDOWN ***
3288926 collected $0.12 from pot
*** SUMMARY ***
Total pot $0.12 | Rake $0 | Jackpot $0 | Bingo $0 | Fortune $0 | Tax $0
Seat 1: Hero (button) folded before Flop (didn't bet)
Seat 2: 84572dc4 (small blind) folded before Flop
Seat 3: b36e65db (big blind) folded before Flop
Seat 4: 3bfed236 folded before Flop (didn't bet)
Seat 5: 3f7ed7e8 folded before Flop (didn't bet)
Seat 6: 3288926 collected ($0.12)


Poker Hand #RC2078591738: Hold'em No Limit ($0.02/$0.05) - 2023/12/22 22:10:42
Table 'RushAndCash809820' 6-max Seat #1 is the button
Seat 1: 31dd0354 ($5 in chips)
Seat 2: Hero ($12.06 in chips)
Seat 3: 3f7ed7e8 ($6.44 in chips)
Seat 4: 2c4b4ea7 ($5 in chips)
Seat 5: 859547f3 ($5.17 in chips)
Seat 6: 90f6987a ($4.25 in chips)
Hero: posts small blind $0.02
3f7ed7e8: posts big blind $0.05
*** HOLE CARDS ***
Dealt to 31dd0354 
Dealt to Hero [9h Th]
Dealt to 3f7ed7e8 
Dealt to 2c4b4ea7 
Dealt to 859547f3 
Dealt to 90f6987a 
2c4b4ea7: folds
859547f3: folds
90f6987a: folds
31dd0354: folds
Hero: raises $0.1 to $0.15
3f7ed7e8: calls $0.1
*** FLOP *** [9c Td 5c]
Hero: bets $0.15
3f7ed7e8: calls $0.15
*** TURN *** [9c Td 5c] [Js]
Hero: bets $0.3
3f7ed7e8: folds
Uncalled bet ($0.3) returned to Hero
*** SHOWDOWN ***
Hero collected $0.57 from pot
*** SUMMARY ***
Total pot $0.6 | Rake $0.03 | Jackpot $0 | Bingo $0 | Fortune $0 | Tax $0
Board [9c Td 5c Js]
Seat 1: 31dd0354 (button) folded before Flop (didn't bet)
Seat 2: Hero (small blind) won ($0.57)
Seat 3: 3f7ed7e8 (big blind) folded on the Turn
Seat 4: 2c4b4ea7 folded before Flop (didn't bet)
Seat 5: 859547f3 folded before Flop (didn't bet)
Seat 6: 90f6987a folded before Flop (didn't bet)


Poker Hand #RC2078591681: Hold'em No Limit ($0.02/$0.05) - 2023/12/22 22:10:39
Table 'RushAndCash809794' 6-max Seat #1 is the button
Seat 1: 947be4c8 ($4.47 in chips)
Seat 2: 5208eb88 ($5.78 in chips)
Seat 3: 1a943c52 ($3.84 in chips)
Seat 4: fcb65fa9 ($4.05 in chips)
Seat 5: Hero ($12.06 in chips)
Seat 6: 31dd0354 ($5 in chips)
5208eb88: posts small blind $0.02
1a943c52: posts big blind $0.05
*** HOLE CARDS ***
Dealt to 947be4c8 
Dealt to 5208eb88 
Dealt to 1a943c52 
Dealt to fcb65fa9 
Dealt to Hero [4s Th]
Dealt to 31dd0354 
fcb65fa9: folds
Hero: folds
31dd0354: folds
947be4c8: folds
5208eb88: folds
Uncalled bet ($0.03) returned to 1a943c52
*** SHOWDOWN ***
1a943c52 collected $0.04 from pot
*** SUMMARY ***
Total pot $0.04 | Rake $0 | Jackpot $0 | Bingo $0 | Fortune $0 | Tax $0
Seat 1: 947be4c8 (button) folded before Flop (didn't bet)
Seat 2: 5208eb88 (small blind) folded before Flop
Seat 3: 1a943c52 (big blind) collected ($0.04)
Seat 4: fcb65fa9 folded before Flop (didn't bet)
Seat 5: Hero folded before Flop (didn't bet)
Seat 6: 31dd0354 folded before Flop (didn't bet)


Poker Hand #RC2078591617: Hold'em No Limit ($0.02/$0.05) - 2023/12/22 22:10:35
Table 'RushAndCash809765' 6-max Seat #1 is the button
Seat 1: 57896c91 ($8.78 in chips)
Seat 2: 3f7ed7e8 ($6.46 in chips)
Seat 3: d32741ba ($5.07 in chips)
Seat 4: Hero ($12.06 in chips)
Seat 5: 36d4ab88 ($5 in chips)
Seat 6: a1442e96 ($5 in chips)
3f7ed7e8: posts small blind $0.02
d32741ba: posts big blind $0.05
*** HOLE CARDS ***
Dealt to 57896c91 
Dealt to 3f7ed7e8 
Dealt to d32741ba 
Dealt to Hero [Ks 8h]
Dealt to 36d4ab88 
Dealt to a1442e96 
Hero: folds
36d4ab88: folds
a1442e96: folds
57896c91: folds
3f7ed7e8: folds
Uncalled bet ($0.03) returned to d32741ba
*** SHOWDOWN ***
d32741ba collected $0.04 from pot
*** SUMMARY ***
Total pot $0.04 | Rake $0 | Jackpot $0 | Bingo $0 | Fortune $0 | Tax $0
Seat 1: 57896c91 (button) folded before Flop (didn't bet)
Seat 2: 3f7ed7e8 (small blind) folded before Flop
Seat 3: d32741ba (big blind) collected ($0.04)
Seat 4: Hero folded before Flop (didn't bet)
Seat 5: 36d4ab88 folded before Flop (didn't bet)
Seat 6: a1442e96 folded before Flop (didn't bet)


Poker Hand #RC2078591556: Hold'em No Limit ($0.02/$0.05) - 2023/12/22 22:10:32
Table 'RushAndCash809734' 6-max Seat #1 is the button
Seat 1: 62acde92 ($5 in chips)
Seat 2: b472acb8 ($5 in chips)
Seat 3: ac592e5c ($5 in chips)
Seat 4: 7a7585e4 ($4.57 in chips)
Seat 5: Hero ($12.06 in chips)
Seat 6: d4d7018e ($5.5 in chips)
b472acb8: posts small blind $0.02
ac592e5c: posts big blind $0.05
*** HOLE CARDS ***
Dealt to 62acde92 
Dealt to b472acb8 
Dealt to ac592e5c 
Dealt to 7a7585e4 
Dealt to Hero [6h 5s]
Dealt to d4d7018e 
7a7585e4: folds
Hero: folds
d4d7018e: raises $0.08 to $0.13
62acde92: calls $0.13
b472acb8: folds
ac592e5c: folds
*** FLOP *** [7h 9h Kd]
d4d7018e: checks
62acde92: checks
*** TURN *** [7h 9h Kd] [Ks]
d4d7018e: checks
62acde92: checks
*** RIVER *** [7h 9h Kd Ks] [6d]
d4d7018e: checks
62acde92: checks
d4d7018e: shows [Ah Jd] (Pair of Kings)
62acde92: shows [3s 3c] (Pair of Kings and Pair of Treys)
*** SHOWDOWN ***
62acde92 collected $0.32 from pot
*** SUMMARY ***
Total pot $0.33 | Rake $0.01 | Jackpot $0 | Bingo $0 | Fortune $0 | Tax $0
Board [7h 9h Kd Ks 6d]
Seat 1: 62acde92 (button) showed [3s 3c] and won ($0.32) with Pair of Kings and Pair of Treys
Seat 2: b472acb8 (small blind) folded before Flop
Seat 3: ac592e5c (big blind) folded before Flop
Seat 4: 7a7585e4 folded before Flop (didn't bet)
Seat 5: Hero folded before Flop (didn't bet)
Seat 6: d4d7018e showed [Ah Jd] and lost with Pair of Kings


Poker Hand #RC2078591470: Hold'em No Limit ($0.02/$0.05) - 2023/12/22 22:10:26
Table 'RushAndCash809694' 6-max Seat #1 is the button
Seat 1: 2310f034 ($6.76 in chips)
Seat 2: a833eac3 ($3.92 in chips)
Seat 3: 97e300ed ($7.89 in chips)
Seat 4: aa2421a5 ($3.61 in chips)
Seat 5: 42422ecf ($10.41 in chips)
Seat 6: Hero ($12.06 in chips)
a833eac3: posts small blind $0.02
97e300ed: posts big blind $0.05
*** HOLE CARDS ***
Dealt to 2310f034 
Dealt to a833eac3 
Dealt to 97e300ed 
Dealt to aa2421a5 
Dealt to 42422ecf 
Dealt to Hero [5h Kc]
aa2421a5: folds
42422ecf: folds
Hero: folds
2310f034: folds
a833eac3: folds
Uncalled bet ($0.03) returned to 97e300ed
*** SHOWDOWN ***
97e300ed collected $0.04 from pot
*** SUMMARY ***
Total pot $0.04 | Rake $0 | Jackpot $0 | Bingo $0 | Fortune $0 | Tax $0
Seat 1: 2310f034 (button) folded before Flop (didn't bet)
Seat 2: a833eac3 (small blind) folded before Flop
Seat 3: 97e300ed (big blind) collected ($0.04)
Seat 4: aa2421a5 folded before Flop (didn't bet)
Seat 5: 42422ecf folded before Flop (didn't bet)
Seat 6: Hero folded before Flop (didn't bet)


Poker Hand #RC2078590899: Hold'em No Limit ($0.02/$0.05) - 2023/12/22 22:09:54
Table 'RushAndCash809436' 6-max Seat #1 is the button
Seat 1: 3933d58 ($5.55 in chips)
Seat 2: Hero ($11.92 in chips)
Seat 3: aa2421a5 ($3.76 in chips)
Seat 4: c8c17adc ($6.68 in chips)
Seat 5: b36e65db ($5.4 in chips)
Seat 6: ee1f67f7 ($5.14 in chips)
Hero: posts small blind $0.02
aa2421a5: posts big blind $0.05
*** HOLE CARDS ***
Dealt to 3933d58 
Dealt to Hero [4h 3h]
Dealt to aa2421a5 
Dealt to c8c17adc 
Dealt to b36e65db 
Dealt to ee1f67f7 
c8c17adc: folds
b36e65db: folds
ee1f67f7: folds
3933d58: folds
Hero: raises $0.1 to $0.15
aa2421a5: calls $0.1
*** FLOP *** [Ts 3s Kd]
Hero: bets $0.15
aa2421a5: folds
Uncalled bet ($0.15) returned to Hero
*** SHOWDOWN ***
Hero collected $0.29 from pot
*** SUMMARY ***
Total pot $0.3 | Rake $0.01 | Jackpot $0 | Bingo $0 | Fortune $0 | Tax $0
Board [Ts 3s Kd]
Seat 1: 3933d58 (button) folded before Flop (didn't bet)
Seat 2: Hero (small blind) won ($0.29)
Seat 3: aa2421a5 (big blind) folded on the Flop
Seat 4: c8c17adc folded before Flop (didn't bet)
Seat 5: b36e65db folded before Flop (didn't bet)
Seat 6: ee1f67f7 folded before Flop (didn't bet)


Poker Hand #RC2078590843: Hold'em No Limit ($0.02/$0.05) - 2023/12/22 22:09:50
Table 'RushAndCash809411' 6-max Seat #1 is the button
Seat 1: 9134f24d ($5.1 in chips)
Seat 2: d99b747b ($5 in chips)
Seat 3: 459d0f5c ($6.63 in chips)
Seat 4: 3933d58 ($5.55 in chips)
Seat 5: 57eb4842 ($5.39 in chips)
Seat 6: Hero ($11.92 in chips)
d99b747b: posts small blind $0.02
459d0f5c: posts big blind $0.05
*** HOLE CARDS ***
Dealt to 9134f24d 
Dealt to d99b747b 
Dealt to 459d0f5c 
Dealt to 3933d58 
Dealt to 57eb4842 
Dealt to Hero [5h Td]
3933d58: folds
57eb4842: folds
Hero: folds
9134f24d: raises $0.08 to $0.13
d99b747b: folds
459d0f5c: folds
Uncalled bet ($0.08) returned to 9134f24d
*** SHOWDOWN ***
9134f24d collected $0.12 from pot
*** SUMMARY ***
Total pot $0.12 | Rake $0 | Jackpot $0 | Bingo $0 | Fortune $0 | Tax $0
Seat 1: 9134f24d (button) collected ($0.12)
Seat 2: d99b747b (small blind) folded before Flop
Seat 3: 459d0f5c (big blind) folded before Flop
Seat 4: 3933d58 folded before Flop (didn't bet)
Seat 5: 57eb4842 folded before Flop (didn't bet)
Seat 6: Hero folded before Flop (didn't bet)


Poker Hand #RC2078590495: Hold'em No Limit ($0.02/$0.05) - 2023/12/22 22:09:31
Table 'RushAndCash809253' 6-max Seat #1 is the button
Seat 1: 521feab9 ($5 in chips)
Seat 2: 45ce1aed ($8.16 in chips)
Seat 3: Hero ($11.97 in chips)
Seat 4: 6d679d40 ($6.89 in chips)
Seat 5: 886872c9 ($7.33 in chips)
Seat 6: 8d188907 ($5 in chips)
45ce1aed: posts small blind $0.02
Hero: posts big blind $0.05
*** HOLE CARDS ***
Dealt to 521feab9 
Dealt to 45ce1aed 
Dealt to Hero [7d 6d]
Dealt to 6d679d40 
Dealt to 886872c9 
Dealt to 8d188907 
6d679d40: folds
886872c9: raises $0.05 to $0.1
8d188907: folds
521feab9: raises $0.3 to $0.4
45ce1aed: folds
Hero: folds
886872c9: folds
Uncalled bet ($0.3) returned to 521feab9
*** SHOWDOWN ***
521feab9 collected $0.26 from pot
*** SUMMARY ***
Total pot $0.27 | Rake $0.01 | Jackpot $0 | Bingo $0 | Fortune $0 | Tax $0
Seat 1: 521feab9 (button) collected ($0.26)
Seat 2: 45ce1aed (small blind) folded before Flop
Seat 3: Hero (big blind) folded before Flop
Seat 4: 6d679d40 folded before Flop (didn't bet)
Seat 5: 886872c9 folded before Flop
Seat 6: 8d188907 folded before Flop (didn't bet)


Poker Hand #RC2078590428: Hold'em No Limit ($0.02/$0.05) - 2023/12/22 22:09:26
Table 'RushAndCash809221' 6-max Seat #1 is the button
Seat 1: Hero ($11.97 in chips)
Seat 2: 6fc982d6 ($4.59 in chips)
Seat 3: 376e9d31 ($5.23 in chips)
Seat 4: bd5964be ($5.19 in chips)
Seat 5: 4a6135fa ($5.09 in chips)
Seat 6: 1e6e058c ($12.34 in chips)
6fc982d6: posts small blind $0.02
376e9d31: posts big blind $0.05
*** HOLE CARDS ***
Dealt to Hero [Tc 3h]
Dealt to 6fc982d6 
Dealt to 376e9d31 
Dealt to bd5964be 
Dealt to 4a6135fa 
Dealt to 1e6e058c 
bd5964be: folds
4a6135fa: folds
1e6e058c: folds
Hero: folds
6fc982d6: folds
Uncalled bet ($0.03) returned to 376e9d31
*** SHOWDOWN ***
376e9d31 collected $0.04 from pot
*** SUMMARY ***
Total pot $0.04 | Rake $0 | Jackpot $0 | Bingo $0 | Fortune $0 | Tax $0
Seat 1: Hero (button) folded before Flop (didn't bet)
Seat 2: 6fc982d6 (small blind) folded before Flop
Seat 3: 376e9d31 (big blind) collected ($0.04)
Seat 4: bd5964be folded before Flop (didn't bet)
Seat 5: 4a6135fa folded before Flop (didn't bet)
Seat 6: 1e6e058c folded before Flop (didn't bet)


Poker Hand #RC2078590355: Hold'em No Limit ($0.02/$0.05) - 2023/12/22 22:09:22
Table 'RushAndCash809188' 6-max Seat #1 is the button
Seat 1: 1259a422 ($8.03 in chips)
Seat 2: 50e2e09e ($5 in chips)
Seat 3: be313987 ($5.35 in chips)
Seat 4: 3a0bc175 ($5.05 in chips)
Seat 5: 130f7150 ($8.62 in chips)
Seat 6: Hero ($11.97 in chips)
50e2e09e: posts small blind $0.02
be313987: posts big blind $0.05
*** HOLE CARDS ***
Dealt to 1259a422 
Dealt to 50e2e09e 
Dealt to be313987 
Dealt to 3a0bc175 
Dealt to 130f7150 
Dealt to Hero [4c 9h]
3a0bc175: folds
130f7150: raises $0.05 to $0.1
Hero: folds
1259a422: folds
50e2e09e: folds
be313987: calls $0.05
*** FLOP *** [Ks 8h Kd]
be313987: checks
130f7150: bets $0.11
be313987: raises $0.25 to $0.36
130f7150: calls $0.25
*** TURN *** [Ks 8h Kd] [Jh]
be313987: bets $0.47
130f7150: calls $0.47
*** RIVER *** [Ks 8h Kd Jh] [4h]
be313987: checks
130f7150: checks
be313987: shows [Jc Qh] (Pair of Kings and Pair of Jacks)
130f7150: shows [Kh 5c] (Three Kings)
*** SHOWDOWN ***
130f7150 collected $1.72 from pot
*** SUMMARY ***
Total pot $1.88 | Rake $0.09 | Jackpot $0.07 | Bingo $0 | Fortune $0 | Tax $0
Board [Ks 8h Kd Jh 4h]
Seat 1: 1259a422 (button) folded before Flop (didn't bet)
Seat 2: 50e2e09e (small blind) folded before Flop
Seat 3: be313987 (big blind) showed [Jc Qh] and lost with Pair of Kings and Pair of Jacks
Seat 4: 3a0bc175 folded before Flop (didn't bet)
Seat 5: 130f7150 showed [Kh 5c] and won ($1.72) with Three Kings
Seat 6: Hero folded before Flop (didn't bet)


Poker Hand #RC2078589663: Hold'em No Limit ($0.02/$0.05) - 2023/12/22 22:08:43
Table 'RushAndCash808877' 6-max Seat #1 is the button
Seat 1: be313987 ($5.14 in chips)
Seat 2: d42ee966 ($6.4 in chips)
Seat 3: Hero ($12.18 in chips)
Seat 4: 4879e77e ($7.05 in chips)
Seat 5: c8c17adc ($6.9 in chips)
Seat 6: 315ed7bc ($3.22 in chips)
d42ee966: posts small blind $0.02
Hero: posts big blind $0.05
*** HOLE CARDS ***
Dealt to be313987 
Dealt to d42ee966 
Dealt to Hero [Kd Qc]
Dealt to 4879e77e 
Dealt to c8c17adc 
Dealt to 315ed7bc 
4879e77e: folds
c8c17adc: folds
315ed7bc: folds
be313987: raises $0.08 to $0.13
d42ee966: folds
Hero: calls $0.08
*** FLOP *** [Td 5d Ts]
Hero: checks
be313987: bets $0.08
Hero: calls $0.08
*** TURN *** [Td 5d Ts] [3d]
Hero: checks
be313987: checks
*** RIVER *** [Td 5d Ts 3d] [9h]
Hero: checks
be313987: bets $0.11
Hero: folds
Uncalled bet ($0.11) returned to be313987
*** SHOWDOWN ***
be313987 collected $0.42 from pot
*** SUMMARY ***
Total pot $0.44 | Rake $0.02 | Jackpot $0 | Bingo $0 | Fortune $0 | Tax $0
Board [Td 5d Ts 3d 9h]
Seat 1: be313987 (button) won ($0.42)
Seat 2: d42ee966 (small blind) folded before Flop
Seat 3: Hero (big blind) folded on the River
Seat 4: 4879e77e folded before Flop (didn't bet)
Seat 5: c8c17adc folded before Flop (didn't bet)
Seat 6: 315ed7bc folded before Flop (didn't bet)


Poker Hand #RC2078589565: Hold'em No Limit ($0.02/$0.05) - 2023/12/22 22:08:38
Table 'RushAndCash808829' 6-max Seat #1 is the button
Seat 1: 80af7fe3 ($8.17 in chips)
Seat 2: 3487746e ($5.4 in chips)
Seat 3: 8d188907 ($5 in chips)
Seat 4: 78c7aa39 ($5.62 in chips)
Seat 5: Hero ($12.18 in chips)
Seat 6: 7a7585e4 ($5.23 in chips)
3487746e: posts small blind $0.02
8d188907: posts big blind $0.05
*** HOLE CARDS ***
Dealt to 80af7fe3 
Dealt to 3487746e 
Dealt to 8d188907 
Dealt to 78c7aa39 
Dealt to Hero [2s Ad]
Dealt to 7a7585e4 
78c7aa39: folds
Hero: folds
7a7585e4: folds
80af7fe3: folds
3487746e: raises $0.1 to $0.15
8d188907: folds
Uncalled bet ($0.1) returned to 3487746e
*** SHOWDOWN ***
3487746e collected $0.1 from pot
*** SUMMARY ***
Total pot $0.1 | Rake $0 | Jackpot $0 | Bingo $0 | Fortune $0 | Tax $0
Seat 1: 80af7fe3 (button) folded before Flop (didn't bet)
Seat 2: 3487746e (small blind) collected ($0.1)
Seat 3: 8d188907 (big blind) folded before Flop
Seat 4: 78c7aa39 folded before Flop (didn't bet)
Seat 5: Hero folded before Flop (didn't bet)
Seat 6: 7a7585e4 folded before Flop (didn't bet)


Poker Hand #RC2078589413: Hold'em No Limit ($0.02/$0.05) - 2023/12/22 22:08:29
Table 'RushAndCash808756' 6-max Seat #1 is the button
Seat 1: f2927765 ($6.49 in chips)
Seat 2: Hero ($12.2 in chips)
Seat 3: 28985ec8 ($13.15 in chips)
Seat 4: d9ec3117 ($5 in chips)
Seat 5: 81b93a4 ($5.2 in chips)
Seat 6: 834fcc3f ($8.8 in chips)
Hero: posts small blind $0.02
28985ec8: posts big blind $0.05
*** HOLE CARDS ***
Dealt to f2927765 
Dealt to Hero [Kc 9s]
Dealt to 28985ec8 
Dealt to d9ec3117 
Dealt to 81b93a4 
Dealt to 834fcc3f 
d9ec3117: folds
81b93a4: folds
834fcc3f: folds
f2927765: folds
Hero: folds
Uncalled bet ($0.03) returned to 28985ec8
*** SHOWDOWN ***
28985ec8 collected $0.04 from pot
*** SUMMARY ***
Total pot $0.04 | Rake $0 | Jackpot $0 | Bingo $0 | Fortune $0 | Tax $0
Seat 1: f2927765 (button) folded before Flop (didn't bet)
Seat 2: Hero (small blind) folded before Flop
Seat 3: 28985ec8 (big blind) collected ($0.04)
Seat 4: d9ec3117 folded before Flop (didn't bet)
Seat 5: 81b93a4 folded before Flop (didn't bet)
Seat 6: 834fcc3f folded before Flop (didn't bet)


Poker Hand #RC2078589326: Hold'em No Limit ($0.02/$0.05) - 2023/12/22 22:08:24
Table 'RushAndCash808716' 6-max Seat #1 is the button
Seat 1: 3f7ed7e8 ($6.73 in chips)
Seat 2: 3e86bdc7 ($5.29 in chips)
Seat 3: 73f9c9d7 ($5 in chips)
Seat 4: Hero ($12.2 in chips)
Seat 5: 1e6e058c ($12.47 in chips)
Seat 6: 4b46876e ($8.86 in chips)
3e86bdc7: posts small blind $0.02
73f9c9d7: posts big blind $0.05
*** HOLE CARDS ***
Dealt to 3f7ed7e8 
Dealt to 3e86bdc7 
Dealt to 73f9c9d7 
Dealt to Hero [5d 8c]
Dealt to 1e6e058c 
Dealt to 4b46876e 
Hero: folds
1e6e058c: raises $0.06 to $0.11
4b46876e: folds
3f7ed7e8: folds
3e86bdc7: folds
73f9c9d7: folds
Uncalled bet ($0.06) returned to 1e6e058c
*** SHOWDOWN ***
1e6e058c collected $0.12 from pot
*** SUMMARY ***
Total pot $0.12 | Rake $0 | Jackpot $0 | Bingo $0 | Fortune $0 | Tax $0
Seat 1: 3f7ed7e8 (button) folded before Flop (didn't bet)
Seat 2: 3e86bdc7 (small blind) folded before Flop
Seat 3: 73f9c9d7 (big blind) folded before Flop
Seat 4: Hero folded before Flop (didn't bet)
Seat 5: 1e6e058c collected ($0.12)
Seat 6: 4b46876e folded before Flop (didn't bet)


Poker Hand #RC2078589262: Hold'em No Limit ($0.02/$0.05) - 2023/12/22 22:08:20
Table 'RushAndCash808686' 6-max Seat #1 is the button
Seat 1: Hero ($12.2 in chips)
Seat 2: fc58b670 ($6.05 in chips)
Seat 3: 8e806d22 ($5.04 in chips)
Seat 4: 7732abf7 ($12.29 in chips)
Seat 5: f6b5f68e ($5.84 in chips)
Seat 6: e09c6cf5 ($5.97 in chips)
fc58b670: posts small blind $0.02
8e806d22: posts big blind $0.05
*** HOLE CARDS ***
Dealt to Hero [3d 6h]
Dealt to fc58b670 
Dealt to 8e806d22 
Dealt to 7732abf7 
Dealt to f6b5f68e 
Dealt to e09c6cf5 
7732abf7: folds
f6b5f68e: folds
e09c6cf5: folds
Hero: folds
fc58b670: raises $0.1 to $0.15
8e806d22: calls $0.1
*** FLOP *** [2s Ad 7h]
fc58b670: checks
8e806d22: checks
*** TURN *** [2s Ad 7h] [Kh]
fc58b670: bets $0.15
8e806d22: folds
Uncalled bet ($0.15) returned to fc58b670
*** SHOWDOWN ***
fc58b670 collected $0.29 from pot
*** SUMMARY ***
Total pot $0.3 | Rake $0.01 | Jackpot $0 | Bingo $0 | Fortune $0 | Tax $0
Board [2s Ad 7h Kh]
Seat 1: Hero (button) folded before Flop (didn't bet)
Seat 2: fc58b670 (small blind) won ($0.29)
Seat 3: 8e806d22 (big blind) folded on the Turn
Seat 4: 7732abf7 folded before Flop (didn't bet)
Seat 5: f6b5f68e folded before Flop (didn't bet)
Seat 6: e09c6cf5 folded before Flop (didn't bet)


Poker Hand #RC2078588991: Hold'em No Limit ($0.02/$0.05) - 2023/12/22 22:08:04
Table 'RushAndCash808567' 6-max Seat #1 is the button
Seat 1: 29045822 ($5 in chips)
Seat 2: e65ad772 ($18.96 in chips)
Seat 3: 73557c98 ($5 in chips)
Seat 4: 610bd7fc ($16.83 in chips)
Seat 5: Hero ($12.13 in chips)
Seat 6: ed26e80a ($11.41 in chips)
e65ad772: posts small blind $0.02
73557c98: posts big blind $0.05
*** HOLE CARDS ***
Dealt to 29045822 
Dealt to e65ad772 
Dealt to 73557c98 
Dealt to 610bd7fc 
Dealt to Hero [3d Ad]
Dealt to ed26e80a 
610bd7fc: folds
Hero: raises $0.05 to $0.1
ed26e80a: folds
29045822: folds
e65ad772: folds
73557c98: folds
Uncalled bet ($0.05) returned to Hero
*** SHOWDOWN ***
Hero collected $0.12 from pot
*** SUMMARY ***
Total pot $0.12 | Rake $0 | Jackpot $0 | Bingo $0 | Fortune $0 | Tax $0
Seat 1: 29045822 (button) folded before Flop (didn't bet)
Seat 2: e65ad772 (small blind) folded before Flop
Seat 3: 73557c98 (big blind) folded before Flop
Seat 4: 610bd7fc folded before Flop (didn't bet)
Seat 5: Hero collected ($0.12)
Seat 6: ed26e80a folded before Flop (didn't bet)


Poker Hand #RC2078588790: Hold'em No Limit ($0.02/$0.05) - 2023/12/22 22:07:52
Table 'RushAndCash808471' 6-max Seat #1 is the button
Seat 1: 52eb7b3d ($12.56 in chips)
Seat 2: a7f7b0f3 ($5 in chips)
Seat 3: Hero ($12.18 in chips)
Seat 4: cc8bc606 ($5.25 in chips)
Seat 5: 584b7eb7 ($10.01 in chips)
Seat 6: 21a497ff ($5 in chips)
a7f7b0f3: posts small blind $0.02
Hero: posts big blind $0.05
*** HOLE CARDS ***
Dealt to 52eb7b3d 
Dealt to a7f7b0f3 
Dealt to Hero [6c Js]
Dealt to cc8bc606 
Dealt to 584b7eb7 
Dealt to 21a497ff 
cc8bc606: raises $0.05 to $0.1
584b7eb7: folds
21a497ff: calls $0.1
52eb7b3d: folds
a7f7b0f3: folds
Hero: folds
*** FLOP *** [7c 2s 3d]
cc8bc606: checks
21a497ff: checks
*** TURN *** [7c 2s 3d] [9h]
cc8bc606: bets $0.18
21a497ff: folds
Uncalled bet ($0.18) returned to cc8bc606
*** SHOWDOWN ***
cc8bc606 collected $0.26 from pot
*** SUMMARY ***
Total pot $0.27 | Rake $0.01 | Jackpot $0 | Bingo $0 | Fortune $0 | Tax $0
Board [7c 2s 3d 9h]
Seat 1: 52eb7b3d (button) folded before Flop (didn't bet)
Seat 2: a7f7b0f3 (small blind) folded before Flop
Seat 3: Hero (big blind) folded before Flop
Seat 4: cc8bc606 won ($0.26)
Seat 5: 584b7eb7 folded before Flop (didn't bet)
Seat 6: 21a497ff folded on the Turn


Poker Hand #RC2078588729: Hold'em No Limit ($0.02/$0.05) - 2023/12/22 22:07:49
Table 'RushAndCash808440' 6-max Seat #1 is the button
Seat 1: Hero ($12.18 in chips)
Seat 2: c444ec1 ($9.34 in chips)
Seat 3: 9ffc9c0 ($3.74 in chips)
Seat 4: 449c8d9b ($5 in chips)
Seat 5: 8f266bd0 ($5.19 in chips)
Seat 6: 44ded10d ($5 in chips)
c444ec1: posts small blind $0.02
9ffc9c0: posts big blind $0.05
*** HOLE CARDS ***
Dealt to Hero [3h Js]
Dealt to c444ec1 
Dealt to 9ffc9c0 
Dealt to 449c8d9b 
Dealt to 8f266bd0 
Dealt to 44ded10d 
449c8d9b: folds
8f266bd0: folds
44ded10d: folds
Hero: folds
c444ec1: folds
Uncalled bet ($0.03) returned to 9ffc9c0
*** SHOWDOWN ***
9ffc9c0 collected $0.04 from pot
*** SUMMARY ***
Total pot $0.04 | Rake $0 | Jackpot $0 | Bingo $0 | Fortune $0 | Tax $0
Seat 1: Hero (button) folded before Flop (didn't bet)
Seat 2: c444ec1 (small blind) folded before Flop
Seat 3: 9ffc9c0 (big blind) collected ($0.04)
Seat 4: 449c8d9b folded before Flop (didn't bet)
Seat 5: 8f266bd0 folded before Flop (didn't bet)
Seat 6: 44ded10d folded before Flop (didn't bet)


Poker Hand #RC2078588667: Hold'em No Limit ($0.02/$0.05) - 2023/12/22 22:07:45
Table 'RushAndCash808413' 6-max Seat #1 is the button
Seat 1: 2bd4532c ($4.23 in chips)
Seat 2: ee19881a ($5.38 in chips)
Seat 3: 71e11b53 ($5 in chips)
Seat 4: 587c07c3 ($5.66 in chips)
Seat 5: 89eda93b ($5 in chips)
Seat 6: Hero ($12.18 in chips)
ee19881a: posts small blind $0.02
71e11b53: posts big blind $0.05
*** HOLE CARDS ***
Dealt to 2bd4532c 
Dealt to ee19881a 
Dealt to 71e11b53 
Dealt to 587c07c3 
Dealt to 89eda93b 
Dealt to Hero [8h As]
587c07c3: folds
89eda93b: raises $0.06 to $0.11
Hero: folds
2bd4532c: calls $0.11
ee19881a: folds
71e11b53: folds
*** FLOP *** [Js Ah 9h]
89eda93b: checks
2bd4532c: bets $0.15
89eda93b: calls $0.15
*** TURN *** [Js Ah 9h] [4h]
89eda93b: checks
2bd4532c: bets $0.3
89eda93b: folds
Uncalled bet ($0.3) returned to 2bd4532c
*** SHOWDOWN ***
2bd4532c collected $0.56 from pot
*** SUMMARY ***
Total pot $0.59 | Rake $0.03 | Jackpot $0 | Bingo $0 | Fortune $0 | Tax $0
Board [Js Ah 9h 4h]
Seat 1: 2bd4532c (button) won ($0.56)
Seat 2: ee19881a (small blind) folded before Flop
Seat 3: 71e11b53 (big blind) folded before Flop
Seat 4: 587c07c3 folded before Flop (didn't bet)
Seat 5: 89eda93b folded on the Turn
Seat 6: Hero folded before Flop (didn't bet)


Poker Hand #RC2078588504: Hold'em No Limit ($0.02/$0.05) - 2023/12/22 22:07:35
Table 'RushAndCash808341' 6-max Seat #1 is the button
Seat 1: 4520f334 ($8.81 in chips)
Seat 2: Hero ($12.2 in chips)
Seat 3: 21a497ff ($5 in chips)
Seat 4: 190cd877 ($6.33 in chips)
Seat 5: 1a943c52 ($4.93 in chips)
Seat 6: e6f6623d ($4.98 in chips)
Hero: posts small blind $0.02
21a497ff: posts big blind $0.05
*** HOLE CARDS ***
Dealt to 4520f334 
Dealt to Hero [Ah 6s]
Dealt to 21a497ff 
Dealt to 190cd877 
Dealt to 1a943c52 
Dealt to e6f6623d 
190cd877: folds
1a943c52: raises $0.07 to $0.12
e6f6623d: folds
4520f334: raises $0.24 to $0.36
Hero: folds
21a497ff: folds
1a943c52: calls $0.24
*** FLOP *** [7d Jd Qd]
1a943c52: checks
4520f334: bets $0.28
1a943c52: calls $0.28
*** TURN *** [7d Jd Qd] [Jh]
1a943c52: checks
4520f334: checks
*** RIVER *** [7d Jd Qd Jh] [3d]
1a943c52: checks
4520f334: bets $1.02
1a943c52: calls $1.02
4520f334: shows [Kd Kc] (King High Flush)
1a943c52: shows [As Js] (Three Jacks)
*** SHOWDOWN ***
4520f334 collected $3.17 from pot
*** SUMMARY ***
Total pot $3.39 | Rake $0.15 | Jackpot $0.07 | Bingo $0 | Fortune $0 | Tax $0
Board [7d Jd Qd Jh 3d]
Seat 1: 4520f334 (button) showed [Kd Kc] and won ($3.17) with King High Flush
Seat 2: Hero (small blind) folded before Flop
Seat 3: 21a497ff (big blind) folded before Flop
Seat 4: 190cd877 folded before Flop (didn't bet)
Seat 5: 1a943c52 showed [As Js] and lost with Three Jacks
Seat 6: e6f6623d folded before Flop (didn't bet)


Poker Hand #RC2078588436: Hold'em No Limit ($0.02/$0.05) - 2023/12/22 22:07:31
Table 'RushAndCash808309' 6-max Seat #1 is the button
Seat 1: b8432f9c ($2.04 in chips)
Seat 2: 360d3b25 ($8.73 in chips)
Seat 3: 1b4a662e ($6.12 in chips)
Seat 4: Hero ($12.2 in chips)
Seat 5: fa93749b ($8.17 in chips)
Seat 6: 47ffe1d8 ($4.66 in chips)
360d3b25: posts small blind $0.02
1b4a662e: posts big blind $0.05
*** HOLE CARDS ***
Dealt to b8432f9c 
Dealt to 360d3b25 
Dealt to 1b4a662e 
Dealt to Hero [Kh 5s]
Dealt to fa93749b 
Dealt to 47ffe1d8 
Hero: folds
fa93749b: folds
47ffe1d8: raises $0.05 to $0.1
b8432f9c: calls $0.1
360d3b25: calls $0.08
1b4a662e: folds
*** FLOP *** [4h 7h 5h]
360d3b25: checks
47ffe1d8: checks
b8432f9c: checks
*** TURN *** [4h 7h 5h] [6h]
360d3b25: checks
47ffe1d8: checks
b8432f9c: checks
*** RIVER *** [4h 7h 5h 6h] [7d]
360d3b25: checks
47ffe1d8: checks
b8432f9c: checks
360d3b25: shows [Ac 9c] (Pair of Sevens)
47ffe1d8: shows [Kd Kc] (Pair of Kings and Pair of Sevens)
b8432f9c: shows [9d Ad] (Pair of Sevens)
*** SHOWDOWN ***
47ffe1d8 collected $0.34 from pot
*** SUMMARY ***
Total pot $0.35 | Rake $0.01 | Jackpot $0 | Bingo $0 | Fortune $0 | Tax $0
Board [4h 7h 5h 6h 7d]
Seat 1: b8432f9c (button) showed [9d Ad] and lost with Pair of Sevens
Seat 2: 360d3b25 (small blind) showed [Ac 9c] and lost with Pair of Sevens
Seat 3: 1b4a662e (big blind) folded before Flop
Seat 4: Hero folded before Flop (didn't bet)
Seat 5: fa93749b folded before Flop (didn't bet)
Seat 6: 47ffe1d8 showed [Kd Kc] and won ($0.34) with Pair of Kings and Pair of Sevens


Poker Hand #RC2078588196: Hold'em No Limit ($0.02/$0.05) - 2023/12/22 22:07:17
Table 'RushAndCash808199' 6-max Seat #1 is the button
Seat 1: 78624e82 ($6.01 in chips)
Seat 2: 337c0520 ($5.11 in chips)
Seat 3: 36d4ab88 ($5 in chips)
Seat 4: 37951557 ($5 in chips)
Seat 5: def6b062 ($6.15 in chips)
Seat 6: Hero ($12.13 in chips)
337c0520: posts small blind $0.02
36d4ab88: posts big blind $0.05
*** HOLE CARDS ***
Dealt to 78624e82 
Dealt to 337c0520 
Dealt to 36d4ab88 
Dealt to 37951557 
Dealt to def6b062 
Dealt to Hero [9c Ac]
37951557: folds
def6b062: folds
Hero: raises $0.05 to $0.1
78624e82: folds
337c0520: folds
36d4ab88: folds
Uncalled bet ($0.05) returned to Hero
*** SHOWDOWN ***
Hero collected $0.12 from pot
*** SUMMARY ***
Total pot $0.12 | Rake $0 | Jackpot $0 | Bingo $0 | Fortune $0 | Tax $0
Seat 1: 78624e82 (button) folded before Flop (didn't bet)
Seat 2: 337c0520 (small blind) folded before Flop
Seat 3: 36d4ab88 (big blind) folded before Flop
Seat 4: 37951557 folded before Flop (didn't bet)
Seat 5: def6b062 folded before Flop (didn't bet)
Seat 6: Hero collected ($0.12)


Poker Hand #RC2078588126: Hold'em No Limit ($0.02/$0.05) - 2023/12/22 22:07:13
Table 'RushAndCash808166' 6-max Seat #1 is the button
Seat 1: 5126c2bf ($5.05 in chips)
Seat 2: 5e7b343a ($2.55 in chips)
Seat 3: a5d2dfd ($5.49 in chips)
Seat 4: a20c0bea ($6.86 in chips)
Seat 5: Hero ($12.13 in chips)
Seat 6: 129846c0 ($5.3 in chips)
5e7b343a: posts small blind $0.02
a5d2dfd: posts big blind $0.05
*** HOLE CARDS ***
Dealt to 5126c2bf 
Dealt to 5e7b343a 
Dealt to a5d2dfd 
Dealt to a20c0bea 
Dealt to Hero [2d Tc]
Dealt to 129846c0 
a20c0bea: folds
Hero: folds
129846c0: folds
5126c2bf: raises $0.1 to $0.15
5e7b343a: calls $0.13
a5d2dfd: folds
*** FLOP *** [6h Ad 8h]
5e7b343a: bets $0.18
5126c2bf: raises $0.18 to $0.36
5e7b343a: calls $0.18
*** TURN *** [6h Ad 8h] [4d]
5e7b343a: bets $0.36
5126c2bf: raises $4.18 to $4.54 and is all-in
5e7b343a: folds
Uncalled bet ($4.18) returned to 5126c2bf
*** SHOWDOWN ***
5126c2bf collected $1.64 from pot
*** SUMMARY ***
Total pot $1.79 | Rake $0.08 | Jackpot $0.07 | Bingo $0 | Fortune $0 | Tax $0
Board [6h Ad 8h 4d]
Seat 1: 5126c2bf (button) won ($1.64)
Seat 2: 5e7b343a (small blind) folded on the Turn
Seat 3: a5d2dfd (big blind) folded before Flop
Seat 4: a20c0bea folded before Flop (didn't bet)
Seat 5: Hero folded before Flop (didn't bet)
Seat 6: 129846c0 folded before Flop (didn't bet)


Poker Hand #RC2078587953: Hold'em No Limit ($0.02/$0.05) - 2023/12/22 22:07:03
Table 'RushAndCash808090' 6-max Seat #1 is the button
Seat 1: Hero ($12.13 in chips)
Seat 2: cf8a8e96 ($12.3 in chips)
Seat 3: 35d3ab0e ($4.91 in chips)
Seat 4: 62acde92 ($5.19 in chips)
Seat 5: 3a9b3c34 ($2.83 in chips)
Seat 6: 4cce9bd4 ($5 in chips)
cf8a8e96: posts small blind $0.02
35d3ab0e: posts big blind $0.05
*** HOLE CARDS ***
Dealt to Hero [Qc 8c]
Dealt to cf8a8e96 
Dealt to 35d3ab0e 
Dealt to 62acde92 
Dealt to 3a9b3c34 
Dealt to 4cce9bd4 
62acde92: folds
3a9b3c34: raises $0.07 to $0.12
4cce9bd4: folds
Hero: folds
cf8a8e96: folds
35d3ab0e: calls $0.07
*** FLOP *** [9d Ks 7d]
35d3ab0e: checks
3a9b3c34: bets $0.09
35d3ab0e: calls $0.09
*** TURN *** [9d Ks 7d] [Qh]
35d3ab0e: checks
3a9b3c34: bets $0.22
35d3ab0e: folds
Uncalled bet ($0.22) returned to 3a9b3c34
*** SHOWDOWN ***
3a9b3c34 collected $0.42 from pot
*** SUMMARY ***
Total pot $0.44 | Rake $0.02 | Jackpot $0 | Bingo $0 | Fortune $0 | Tax $0
Board [9d Ks 7d Qh]
Seat 1: Hero (button) folded before Flop (didn't bet)
Seat 2: cf8a8e96 (small blind) folded before Flop
Seat 3: 35d3ab0e (big blind) folded on the Turn
Seat 4: 62acde92 folded before Flop (didn't bet)
Seat 5: 3a9b3c34 won ($0.42)
Seat 6: 4cce9bd4 folded before Flop (didn't bet)


Poker Hand #RC2078587842: Hold'em No Limit ($0.02/$0.05) - 2023/12/22 22:06:57
Table 'RushAndCash808043' 6-max Seat #1 is the button
Seat 1: bcb60fa0 ($2 in chips)
Seat 2: 102e4185 ($7.29 in chips)
Seat 3: 97e300ed ($7.03 in chips)
Seat 4: b49c4561 ($2.25 in chips)
Seat 5: c444ec1 ($9.23 in chips)
Seat 6: Hero ($12.13 in chips)
102e4185: posts small blind $0.02
97e300ed: posts big blind $0.05
*** HOLE CARDS ***
Dealt to bcb60fa0 
Dealt to 102e4185 
Dealt to 97e300ed 
Dealt to b49c4561 
Dealt to c444ec1 
Dealt to Hero [9s 6d]
b49c4561: folds
c444ec1: folds
Hero: folds
bcb60fa0: folds
102e4185: raises $0.08 to $0.13
97e300ed: calls $0.08
*** FLOP *** [6c 9d Qs]
102e4185: checks
97e300ed: bets $0.13
102e4185: calls $0.13
*** TURN *** [6c 9d Qs] [7d]
102e4185: checks
97e300ed: checks
*** RIVER *** [6c 9d Qs 7d] [Qd]
102e4185: checks
97e300ed: bets $0.39
102e4185: folds
Uncalled bet ($0.39) returned to 97e300ed
*** SHOWDOWN ***
97e300ed collected $0.5 from pot
*** SUMMARY ***
Total pot $0.52 | Rake $0.02 | Jackpot $0 | Bingo $0 | Fortune $0 | Tax $0
Board [6c 9d Qs 7d Qd]
Seat 1: bcb60fa0 (button) folded before Flop (didn't bet)
Seat 2: 102e4185 (small blind) folded on the River
Seat 3: 97e300ed (big blind) won ($0.5)
Seat 4: b49c4561 folded before Flop (didn't bet)
Seat 5: c444ec1 folded before Flop (didn't bet)
Seat 6: Hero folded before Flop (didn't bet)


Poker Hand #RC2078587672: Hold'em No Limit ($0.02/$0.05) - 2023/12/22 22:06:48
Table 'RushAndCash807966' 6-max Seat #1 is the button
Seat 1: 2486bc4b ($26.26 in chips)
Seat 2: Hero ($12.15 in chips)
Seat 3: 3d582dec ($5.5 in chips)
Seat 4: 6aa0a400 ($6.32 in chips)
Seat 5: 801c157f ($26.9 in chips)
Seat 6: 45ce1aed ($5.89 in chips)
Hero: posts small blind $0.02
3d582dec: posts big blind $0.05
*** HOLE CARDS ***
Dealt to 2486bc4b 
Dealt to Hero [4h 9c]
Dealt to 3d582dec 
Dealt to 6aa0a400 
Dealt to 801c157f 
Dealt to 45ce1aed 
6aa0a400: raises $0.08 to $0.13
801c157f: folds
45ce1aed: folds
2486bc4b: folds
Hero: folds
3d582dec: folds
Uncalled bet ($0.08) returned to 6aa0a400
*** SHOWDOWN ***
6aa0a400 collected $0.12 from pot
*** SUMMARY ***
Total pot $0.12 | Rake $0 | Jackpot $0 | Bingo $0 | Fortune $0 | Tax $0
Seat 1: 2486bc4b (button) folded before Flop (didn't bet)
Seat 2: Hero (small blind) folded before Flop
Seat 3: 3d582dec (big blind) folded before Flop
Seat 4: 6aa0a400 collected ($0.12)
Seat 5: 801c157f folded before Flop (didn't bet)
Seat 6: 45ce1aed folded before Flop (didn't bet)


Poker Hand #RC2078587597: Hold'em No Limit ($0.02/$0.05) - 2023/12/22 22:06:44
Table 'RushAndCash807929' 6-max Seat #1 is the button
Seat 1: be313987 ($5.01 in chips)
Seat 2: ad189083 ($2.02 in chips)
Seat 3: d7e518f2 ($4.8 in chips)
Seat 4: Hero ($12.15 in chips)
Seat 5: 17e936 ($7.04 in chips)
Seat 6: 52eb7b3d ($12.56 in chips)
ad189083: posts small blind $0.02
d7e518f2: posts big blind $0.05
*** HOLE CARDS ***
Dealt to be313987 
Dealt to ad189083 
Dealt to d7e518f2 
Dealt to Hero [4c 8d]
Dealt to 17e936 
Dealt to 52eb7b3d 
Hero: folds
17e936: folds
52eb7b3d: folds
be313987: raises $0.08 to $0.13
ad189083: folds
d7e518f2: folds
Uncalled bet ($0.08) returned to be313987
*** SHOWDOWN ***
be313987 collected $0.12 from pot
*** SUMMARY ***
Total pot $0.12 | Rake $0 | Jackpot $0 | Bingo $0 | Fortune $0 | Tax $0
Seat 1: be313987 (button) collected ($0.12)
Seat 2: ad189083 (small blind) folded before Flop
Seat 3: d7e518f2 (big blind) folded before Flop
Seat 4: Hero folded before Flop (didn't bet)
Seat 5: 17e936 folded before Flop (didn't bet)
Seat 6: 52eb7b3d folded before Flop (didn't bet)


Poker Hand #RC2078587534: Hold'em No Limit ($0.02/$0.05) - 2023/12/22 22:06:40
Table 'RushAndCash807899' 6-max Seat #1 is the button
Seat 1: 756c67e1 ($5.73 in chips)
Seat 2: 1d497d4f ($5.11 in chips)
Seat 3: ad189083 ($2.07 in chips)
Seat 4: Hero ($12.15 in chips)
Seat 5: 4a7d05b1 ($7.05 in chips)
Seat 6: 28218a38 ($3.66 in chips)
1d497d4f: posts small blind $0.02
ad189083: posts big blind $0.05
*** HOLE CARDS ***
Dealt to 756c67e1 
Dealt to 1d497d4f 
Dealt to ad189083 
Dealt to Hero [Kh 5d]
Dealt to 4a7d05b1 
Dealt to 28218a38 
Hero: folds
4a7d05b1: raises $0.05 to $0.1
28218a38: folds
756c67e1: folds
1d497d4f: calls $0.08
ad189083: folds
*** FLOP *** [6d 4h 7d]
1d497d4f: checks
4a7d05b1: checks
*** TURN *** [6d 4h 7d] [6c]
1d497d4f: bets $0.13
4a7d05b1: calls $0.13
*** RIVER *** [6d 4h 7d 6c] [9c]
1d497d4f: bets $0.37
4a7d05b1: calls $0.37
1d497d4f: shows [7c 7h] (Sevens Full over Sixes)
4a7d05b1: shows [5c Ac] (Pair of Sixes)
*** SHOWDOWN ***
1d497d4f collected $1.19 from pot
*** SUMMARY ***
Total pot $1.25 | Rake $0.06 | Jackpot $0 | Bingo $0 | Fortune $0 | Tax $0
Board [6d 4h 7d 6c 9c]
Seat 1: 756c67e1 (button) folded before Flop (didn't bet)
Seat 2: 1d497d4f (small blind) showed [7c 7h] and won ($1.19) with Sevens Full over Sixes
Seat 3: ad189083 (big blind) folded before Flop
Seat 4: Hero folded before Flop (didn't bet)
Seat 5: 4a7d05b1 showed [5c Ac] and lost with Pair of Sixes
Seat 6: 28218a38 folded before Flop (didn't bet)


Poker Hand #RC2078587081: Hold'em No Limit ($0.02/$0.05) - 2023/12/22 22:06:14
Table 'RushAndCash807690' 6-max Seat #1 is the button
Seat 1: 57ecfe0 ($2.91 in chips)
Seat 2: 756c67e1 ($5.63 in chips)
Seat 3: Hero ($12.26 in chips)
Seat 4: deb19c7 ($10.84 in chips)
Seat 5: 459d0f5c ($6.78 in chips)
Seat 6: 517da49 ($10.75 in chips)
756c67e1: posts small blind $0.02
Hero: posts big blind $0.05
*** HOLE CARDS ***
Dealt to 57ecfe0 
Dealt to 756c67e1 
Dealt to Hero [8h Ah]
Dealt to deb19c7 
Dealt to 459d0f5c 
Dealt to 517da49 
deb19c7: folds
459d0f5c: folds
517da49: folds
57ecfe0: folds
756c67e1: raises $0.06 to $0.11
Hero: calls $0.06
*** FLOP *** [3d 2c Td]
756c67e1: bets $0.11
Hero: folds
Uncalled bet ($0.11) returned to 756c67e1
*** SHOWDOWN ***
756c67e1 collected $0.21 from pot
*** SUMMARY ***
Total pot $0.22 | Rake $0.01 | Jackpot $0 | Bingo $0 | Fortune $0 | Tax $0
Board [3d 2c Td]
Seat 1: 57ecfe0 (button) folded before Flop (didn't bet)
Seat 2: 756c67e1 (small blind) won ($0.21)
Seat 3: Hero (big blind) folded on the Flop
Seat 4: deb19c7 folded before Flop (didn't bet)
Seat 5: 459d0f5c folded before Flop (didn't bet)
Seat 6: 517da49 folded before Flop (didn't bet)


Poker Hand #RC2078586171: Hold'em No Limit ($0.02/$0.05) - 2023/12/22 22:05:21
Table 'RushAndCash807265' 6-max Seat #1 is the button
Seat 1: a532da42 ($5.53 in chips)
Seat 2: 57ecfe0 ($2.65 in chips)
Seat 3: a4441de9 ($5.65 in chips)
Seat 4: b472acb8 ($5 in chips)
Seat 5: Hero ($12.49 in chips)
Seat 6: 5f9f6e5e ($5.26 in chips)
57ecfe0: posts small blind $0.02
a4441de9: posts big blind $0.05
*** HOLE CARDS ***
Dealt to a532da42 
Dealt to 57ecfe0 
Dealt to a4441de9 
Dealt to b472acb8 
Dealt to Hero [Qs Js]
Dealt to 5f9f6e5e 
b472acb8: folds
Hero: raises $0.05 to $0.1
5f9f6e5e: folds
a532da42: folds
57ecfe0: calls $0.08
a4441de9: folds
*** FLOP *** [6h 7s 7h]
57ecfe0: checks
Hero: bets $0.13
57ecfe0: calls $0.13
*** TURN *** [6h 7s 7h] [4c]
57ecfe0: checks
Hero: checks
*** RIVER *** [6h 7s 7h 4c] [8s]
57ecfe0: bets $0.26
Hero: folds
Uncalled bet ($0.26) returned to 57ecfe0
*** SHOWDOWN ***
57ecfe0 collected $0.49 from pot
*** SUMMARY ***
Total pot $0.51 | Rake $0.02 | Jackpot $0 | Bingo $0 | Fortune $0 | Tax $0
Board [6h 7s 7h 4c 8s]
Seat 1: a532da42 (button) folded before Flop (didn't bet)
Seat 2: 57ecfe0 (small blind) won ($0.49)
Seat 3: a4441de9 (big blind) folded before Flop
Seat 4: b472acb8 folded before Flop (didn't bet)
Seat 5: Hero folded on the River
Seat 6: 5f9f6e5e folded before Flop (didn't bet)


Poker Hand #RC2078585993: Hold'em No Limit ($0.02/$0.05) - 2023/12/22 22:05:11
Table 'RushAndCash807185' 6-max Seat #1 is the button
Seat 1: cd7afddd ($5.86 in chips)
Seat 2: 765e7e9d ($8.96 in chips)
Seat 3: Hero ($12.54 in chips)
Seat 4: c8adf5d ($7.05 in chips)
Seat 5: d6c4e270 ($3.24 in chips)
Seat 6: e62ff290 ($5.78 in chips)
765e7e9d: posts small blind $0.02
Hero: posts big blind $0.05
*** HOLE CARDS ***
Dealt to cd7afddd 
Dealt to 765e7e9d 
Dealt to Hero [Qh 2h]
Dealt to c8adf5d 
Dealt to d6c4e270 
Dealt to e62ff290 
c8adf5d: folds
d6c4e270: folds
e62ff290: folds
cd7afddd: raises $0.1 to $0.15
765e7e9d: folds
Hero: folds
Uncalled bet ($0.1) returned to cd7afddd
*** SHOWDOWN ***
cd7afddd collected $0.12 from pot
*** SUMMARY ***
Total pot $0.12 | Rake $0 | Jackpot $0 | Bingo $0 | Fortune $0 | Tax $0
Seat 1: cd7afddd (button) collected ($0.12)
Seat 2: 765e7e9d (small blind) folded before Flop
Seat 3: Hero (big blind) folded before Flop
Seat 4: c8adf5d folded before Flop (didn't bet)
Seat 5: d6c4e270 folded before Flop (didn't bet)
Seat 6: e62ff290 folded before Flop (didn't bet)


Poker Hand #RC2078585245: Hold'em No Limit ($0.02/$0.05) - 2023/12/22 22:04:26
Table 'RushAndCash806835' 6-max Seat #1 is the button
Seat 1: Hero ($12.64 in chips)
Seat 2: a72a08c6 ($5 in chips)
Seat 3: e8d24af1 ($5.35 in chips)
Seat 4: 48b86f00 ($6.35 in chips)
Seat 5: 1fc1f571 ($18.47 in chips)
Seat 6: 3a20c3a ($10.2 in chips)
a72a08c6: posts small blind $0.02
e8d24af1: posts big blind $0.05
*** HOLE CARDS ***
Dealt to Hero [Jh Jc]
Dealt to a72a08c6 
Dealt to e8d24af1 
Dealt to 48b86f00 
Dealt to 1fc1f571 
Dealt to 3a20c3a 
48b86f00: folds
1fc1f571: folds
3a20c3a: folds
Hero: raises $0.05 to $0.1
a72a08c6: raises $0.4 to $0.5
e8d24af1: raises $4.85 to $5.35 and is all-in
Hero: folds
a72a08c6: calls $4.5 and is all-in
Uncalled bet ($0.35) returned to e8d24af1
e8d24af1: shows [Ks Ah]
a72a08c6: shows [Kd Kh]
*** FIRST FLOP *** [5c 8h Qd]
*** FIRST TURN *** [5c 8h Qd] [Ac]
*** FIRST RIVER *** [5c 8h Qd Ac] [2c]
*** SECOND FLOP *** [Qs Js 3d]
*** SECOND TURN *** [Qs Js 3d] [Ts]
*** SECOND RIVER *** [Qs Js 3d Ts] [4h]
*** FIRST SHOWDOWN ***
e8d24af1 collected $4.95 from pot
*** SECOND SHOWDOWN ***
e8d24af1 collected $4.94 from pot
*** SUMMARY ***
Total pot $10.1 | Rake $0.14 | Jackpot $0.07 | Bingo $0 | Fortune $0 | Tax $0
Hand was run two times
FIRST Board [5c 8h Qd Ac 2c]
SECOND Board [Qs Js 3d Ts 4h]
Seat 1: Hero (button) folded before Flop
Seat 2: a72a08c6 (small blind) showed [Kd Kh] and lost with Pair of Kings, and lost with Pair of Kings
Seat 3: e8d24af1 (big blind) showed [Ks Ah] and won ($4.95) with Pair of Aces, and won ($4.94) with Aces-High Straight
Seat 4: 48b86f00 folded before Flop (didn't bet)
Seat 5: 1fc1f571 folded before Flop (didn't bet)
Seat 6: 3a20c3a folded before Flop (didn't bet)


Poker Hand #RC2078585112: Hold'em No Limit ($0.02/$0.05) - 2023/12/22 22:04:18
Table 'RushAndCash806775' 6-max Seat #1 is the button
Seat 1: 81ecaac5 ($4.53 in chips)
Seat 2: Hero ($12.66 in chips)
Seat 3: d71ab80c ($5.59 in chips)
Seat 4: df439f39 ($5.31 in chips)
Seat 5: 404f9df4 ($5.98 in chips)
Seat 6: deb19c7 ($10.37 in chips)
Hero: posts small blind $0.02
d71ab80c: posts big blind $0.05
*** HOLE CARDS ***
Dealt to 81ecaac5 
Dealt to Hero [6s Ts]
Dealt to d71ab80c 
Dealt to df439f39 
Dealt to 404f9df4 
Dealt to deb19c7 
df439f39: folds
404f9df4: raises $0.05 to $0.1
deb19c7: folds
81ecaac5: folds
Hero: folds
d71ab80c: folds
Uncalled bet ($0.05) returned to 404f9df4
*** SHOWDOWN ***
404f9df4 collected $0.12 from pot
*** SUMMARY ***
Total pot $0.12 | Rake $0 | Jackpot $0 | Bingo $0 | Fortune $0 | Tax $0
Seat 1: 81ecaac5 (button) folded before Flop (didn't bet)
Seat 2: Hero (small blind) folded before Flop
Seat 3: d71ab80c (big blind) folded before Flop
Seat 4: df439f39 folded before Flop (didn't bet)
Seat 5: 404f9df4 collected ($0.12)
Seat 6: deb19c7 folded before Flop (didn't bet)


Poker Hand #RC2078584221: Hold'em No Limit ($0.02/$0.05) - 2023/12/22 22:03:25
Table 'RushAndCash806368' 6-max Seat #1 is the button
Seat 1: 84572dc4 ($1.14 in chips)
Seat 2: 250fdb1e ($0.9 in chips)
Seat 3: 697fb04a ($41.12 in chips)
Seat 4: Hero ($12.85 in chips)
Seat 5: 31a55fda ($5 in chips)
Seat 6: 5e7b343a ($3.63 in chips)
250fdb1e: posts small blind $0.02
697fb04a: posts big blind $0.05
*** HOLE CARDS ***
Dealt to 84572dc4 
Dealt to 250fdb1e 
Dealt to 697fb04a 
Dealt to Hero [4d 4h]
Dealt to 31a55fda 
Dealt to 5e7b343a 
Hero: raises $0.05 to $0.1
31a55fda: folds
5e7b343a: calls $0.1
84572dc4: folds
250fdb1e: folds
697fb04a: folds
*** FLOP *** [9h 7d Ks]
Hero: checks
5e7b343a: bets $0.09
Hero: calls $0.09
*** TURN *** [9h 7d Ks] [5c]
Hero: checks
5e7b343a: checks
*** RIVER *** [9h 7d Ks 5c] [6c]
Hero: checks
5e7b343a: bets $0.34
Hero: folds
Uncalled bet ($0.34) returned to 5e7b343a
*** SHOWDOWN ***
5e7b343a collected $0.43 from pot
*** SUMMARY ***
Total pot $0.45 | Rake $0.02 | Jackpot $0 | Bingo $0 | Fortune $0 | Tax $0
Board [9h 7d Ks 5c 6c]
Seat 1: 84572dc4 (button) folded before Flop (didn't bet)
Seat 2: 250fdb1e (small blind) folded before Flop
Seat 3: 697fb04a (big blind) folded before Flop
Seat 4: Hero folded on the River
Seat 5: 31a55fda folded before Flop (didn't bet)
Seat 6: 5e7b343a won ($0.43)


Poker Hand #RC2078584107: Hold'em No Limit ($0.02/$0.05) - 2023/12/22 22:03:18
Table 'RushAndCash806316' 6-max Seat #1 is the button
Seat 1: ab218bfa ($3.26 in chips)
Seat 2: fa7bd554 ($10.19 in chips)
Seat 3: 45ce1aed ($5.76 in chips)
Seat 4: e99cedcc ($11.12 in chips)
Seat 5: Hero ($12.85 in chips)
Seat 6: d63b428e ($7.98 in chips)
fa7bd554: posts small blind $0.02
45ce1aed: posts big blind $0.05
*** HOLE CARDS ***
Dealt to ab218bfa 
Dealt to fa7bd554 
Dealt to 45ce1aed 
Dealt to e99cedcc 
Dealt to Hero [2s 2d]
Dealt to d63b428e 
e99cedcc: folds
Hero: folds
d63b428e: folds
ab218bfa: folds
fa7bd554: folds
Uncalled bet ($0.03) returned to 45ce1aed
*** SHOWDOWN ***
45ce1aed collected $0.04 from pot
*** SUMMARY ***
Total pot $0.04 | Rake $0 | Jackpot $0 | Bingo $0 | Fortune $0 | Tax $0
Seat 1: ab218bfa (button) folded before Flop (didn't bet)
Seat 2: fa7bd554 (small blind) folded before Flop
Seat 3: 45ce1aed (big blind) collected ($0.04)
Seat 4: e99cedcc folded before Flop (didn't bet)
Seat 5: Hero folded before Flop (didn't bet)
Seat 6: d63b428e folded before Flop (didn't bet)


Poker Hand #RC2078584009: Hold'em No Limit ($0.02/$0.05) - 2023/12/22 22:03:12
Table 'RushAndCash806270' 6-max Seat #1 is the button
Seat 1: Hero ($12.85 in chips)
Seat 2: 41270a9a ($5.43 in chips)
Seat 3: bd5964be ($5.79 in chips)
Seat 4: e7562cd9 ($8.13 in chips)
Seat 5: 846054b0 ($8.91 in chips)
Seat 6: 5f11c3da ($16.39 in chips)
41270a9a: posts small blind $0.02
bd5964be: posts big blind $0.05
*** HOLE CARDS ***
Dealt to Hero [4h Js]
Dealt to 41270a9a 
Dealt to bd5964be 
Dealt to e7562cd9 
Dealt to 846054b0 
Dealt to 5f11c3da 
e7562cd9: folds
846054b0: folds
5f11c3da: raises $0.08 to $0.13
Hero: folds
41270a9a: folds
bd5964be: folds
Uncalled bet ($0.08) returned to 5f11c3da
*** SHOWDOWN ***
5f11c3da collected $0.12 from pot
*** SUMMARY ***
Total pot $0.12 | Rake $0 | Jackpot $0 | Bingo $0 | Fortune $0 | Tax $0
Seat 1: Hero (button) folded before Flop (didn't bet)
Seat 2: 41270a9a (small blind) folded before Flop
Seat 3: bd5964be (big blind) folded before Flop
Seat 4: e7562cd9 folded before Flop (didn't bet)
Seat 5: 846054b0 folded before Flop (didn't bet)
Seat 6: 5f11c3da collected ($0.12)


Poker Hand #RC2078583749: Hold'em No Limit ($0.02/$0.05) - 2023/12/22 22:02:58
Table 'RushAndCash806145' 6-max Seat #1 is the button
Seat 1: 37a644bb ($6.79 in chips)
Seat 2: Hero ($12.87 in chips)
Seat 3: b2b4173f ($2.25 in chips)
Seat 4: 21a497ff ($5.37 in chips)
Seat 5: 4b46876e ($9.01 in chips)
Seat 6: fc58b670 ($5 in chips)
Hero: posts small blind $0.02
b2b4173f: posts big blind $0.05
*** HOLE CARDS ***
Dealt to 37a644bb 
Dealt to Hero [6d Ts]
Dealt to b2b4173f 
Dealt to 21a497ff 
Dealt to 4b46876e 
Dealt to fc58b670 
21a497ff: folds
4b46876e: folds
fc58b670: folds
37a644bb: folds
Hero: folds
Uncalled bet ($0.03) returned to b2b4173f
*** SHOWDOWN ***
b2b4173f collected $0.04 from pot
*** SUMMARY ***
Total pot $0.04 | Rake $0 | Jackpot $0 | Bingo $0 | Fortune $0 | Tax $0
Seat 1: 37a644bb (button) folded before Flop (didn't bet)
Seat 2: Hero (small blind) folded before Flop
Seat 3: b2b4173f (big blind) collected ($0.04)
Seat 4: 21a497ff folded before Flop (didn't bet)
Seat 5: 4b46876e folded before Flop (didn't bet)
Seat 6: fc58b670 folded before Flop (didn't bet)


Poker Hand #RC2078583558: Hold'em No Limit ($0.02/$0.05) - 2023/12/22 22:02:47
Table 'RushAndCash806053' 6-max Seat #1 is the button
Seat 1: c2b1be0f ($4.4 in chips)
Seat 2: c8adf5d ($7.56 in chips)
Seat 3: Hero ($12.92 in chips)
Seat 4: 39932550 ($5.04 in chips)
Seat 5: 56a3a769 ($5.02 in chips)
Seat 6: 8e4ad426 ($6.82 in chips)
c8adf5d: posts small blind $0.02
Hero: posts big blind $0.05
*** HOLE CARDS ***
Dealt to c2b1be0f 
Dealt to c8adf5d 
Dealt to Hero [3d 2s]
Dealt to 39932550 
Dealt to 56a3a769 
Dealt to 8e4ad426 
39932550: raises $0.05 to $0.1
56a3a769: folds
8e4ad426: folds
c2b1be0f: folds
c8adf5d: folds
Hero: folds
Uncalled bet ($0.05) returned to 39932550
*** SHOWDOWN ***
39932550 collected $0.12 from pot
*** SUMMARY ***
Total pot $0.12 | Rake $0 | Jackpot $0 | Bingo $0 | Fortune $0 | Tax $0
Seat 1: c2b1be0f (button) folded before Flop (didn't bet)
Seat 2: c8adf5d (small blind) folded before Flop
Seat 3: Hero (big blind) folded before Flop
Seat 4: 39932550 collected ($0.12)
Seat 5: 56a3a769 folded before Flop (didn't bet)
Seat 6: 8e4ad426 folded before Flop (didn't bet)


Poker Hand #RC2078583488: Hold'em No Limit ($0.02/$0.05) - 2023/12/22 22:02:43
Table 'RushAndCash806018' 6-max Seat #1 is the button
Seat 1: 3bf3ab5a ($3.2 in chips)
Seat 2: 4a196974 ($6.42 in chips)
Seat 3: fafe49aa ($7.15 in chips)
Seat 4: 9128c206 ($7.18 in chips)
Seat 5: 4e925dd0 ($10.13 in chips)
Seat 6: Hero ($12.92 in chips)
4a196974: posts small blind $0.02
fafe49aa: posts big blind $0.05
*** HOLE CARDS ***
Dealt to 3bf3ab5a 
Dealt to 4a196974 
Dealt to fafe49aa 
Dealt to 9128c206 
Dealt to 4e925dd0 
Dealt to Hero [5d Js]
9128c206: folds
4e925dd0: folds
Hero: folds
3bf3ab5a: folds
4a196974: raises $0.1 to $0.15
fafe49aa: folds
Uncalled bet ($0.1) returned to 4a196974
*** SHOWDOWN ***
4a196974 collected $0.1 from pot
*** SUMMARY ***
Total pot $0.1 | Rake $0 | Jackpot $0 | Bingo $0 | Fortune $0 | Tax $0
Seat 1: 3bf3ab5a (button) folded before Flop (didn't bet)
Seat 2: 4a196974 (small blind) collected ($0.1)
Seat 3: fafe49aa (big blind) folded before Flop
Seat 4: 9128c206 folded before Flop (didn't bet)
Seat 5: 4e925dd0 folded before Flop (didn't bet)
Seat 6: Hero folded before Flop (didn't bet)


Poker Hand #RC2078583426: Hold'em No Limit ($0.02/$0.05) - 2023/12/22 22:02:39
Table 'RushAndCash805991' 6-max Seat #1 is the button
Seat 1: 7d137087 ($7.95 in chips)
Seat 2: 13461cbc ($5.11 in chips)
Seat 3: b0755516 ($5.07 in chips)
Seat 4: 1e89bda1 ($7.47 in chips)
Seat 5: Hero ($12.92 in chips)
Seat 6: f2927765 ($5.92 in chips)
13461cbc: posts small blind $0.02
b0755516: posts big blind $0.05
*** HOLE CARDS ***
Dealt to 7d137087 
Dealt to 13461cbc 
Dealt to b0755516 
Dealt to 1e89bda1 
Dealt to Hero [8d 2s]
Dealt to f2927765 
1e89bda1: folds
Hero: folds
f2927765: folds
7d137087: folds
13461cbc: folds
Uncalled bet ($0.03) returned to b0755516
*** SHOWDOWN ***
b0755516 collected $0.04 from pot
*** SUMMARY ***
Total pot $0.04 | Rake $0 | Jackpot $0 | Bingo $0 | Fortune $0 | Tax $0
Seat 1: 7d137087 (button) folded before Flop (didn't bet)
Seat 2: 13461cbc (small blind) folded before Flop
Seat 3: b0755516 (big blind) collected ($0.04)
Seat 4: 1e89bda1 folded before Flop (didn't bet)
Seat 5: Hero folded before Flop (didn't bet)
Seat 6: f2927765 folded before Flop (didn't bet)


Poker Hand #RC2078582831: Hold'em No Limit ($0.02/$0.05) - 2023/12/22 22:02:05
Table 'RushAndCash805710' 6-max Seat #1 is the button
Seat 1: eeb37e34 ($9.06 in chips)
Seat 2: 2e44f78e ($8.56 in chips)
Seat 3: 13461cbc ($5 in chips)
Seat 4: 3bf3ab5a ($3.3 in chips)
Seat 5: Hero ($13.02 in chips)
Seat 6: bfc64a4a ($10.15 in chips)
2e44f78e: posts small blind $0.02
13461cbc: posts big blind $0.05
*** HOLE CARDS ***
Dealt to eeb37e34 
Dealt to 2e44f78e 
Dealt to 13461cbc 
Dealt to 3bf3ab5a 
Dealt to Hero [3d Ad]
Dealt to bfc64a4a 
3bf3ab5a: folds
Hero: raises $0.05 to $0.1
bfc64a4a: folds
eeb37e34: folds
2e44f78e: folds
13461cbc: calls $0.05
*** FLOP *** [8h Js 5c]
13461cbc: checks
Hero: checks
*** TURN *** [8h Js 5c] [Jc]
13461cbc: bets $0.14
Hero: folds
Uncalled bet ($0.14) returned to 13461cbc
*** SHOWDOWN ***
13461cbc collected $0.21 from pot
*** SUMMARY ***
Total pot $0.22 | Rake $0.01 | Jackpot $0 | Bingo $0 | Fortune $0 | Tax $0
Board [8h Js 5c Jc]
Seat 1: eeb37e34 (button) folded before Flop (didn't bet)
Seat 2: 2e44f78e (small blind) folded before Flop
Seat 3: 13461cbc (big blind) won ($0.21)
Seat 4: 3bf3ab5a folded before Flop (didn't bet)
Seat 5: Hero folded on the Turn
Seat 6: bfc64a4a folded before Flop (didn't bet)


Poker Hand #RC2078581768: Hold'em No Limit ($0.02/$0.05) - 2023/12/22 22:01:03
Table 'RushAndCash805228' 6-max Seat #1 is the button
Seat 1: 8927103f ($7.09 in chips)
Seat 2: 5df9a842 ($8.09 in chips)
Seat 3: bb8cf690 ($5.19 in chips)
Seat 4: f5ffb37c ($5.79 in chips)
Seat 5: 834fcc3f ($10.52 in chips)
Seat 6: Hero ($11.27 in chips)
5df9a842: posts small blind $0.02
bb8cf690: posts big blind $0.05
*** HOLE CARDS ***
Dealt to 8927103f 
Dealt to 5df9a842 
Dealt to bb8cf690 
Dealt to f5ffb37c 
Dealt to 834fcc3f 
Dealt to Hero [Ts Qs]
f5ffb37c: folds
834fcc3f: folds
Hero: raises $0.05 to $0.1
8927103f: folds
5df9a842: folds
bb8cf690: calls $0.05
*** FLOP *** [Qc 8c Qh]
bb8cf690: checks
Hero: bets $0.11
bb8cf690: raises $0.22 to $0.33
Hero: calls $0.22
*** TURN *** [Qc 8c Qh] [5c]
bb8cf690: checks
Hero: checks
*** RIVER *** [Qc 8c Qh 5c] [Th]
bb8cf690: bets $0.66
Hero: raises $0.86 to $1.52
bb8cf690: calls $0.86
Hero: shows [Ts Qs] (Queens Full over Tens)
bb8cf690: shows [7c Ac] (Ace High Flush)
*** SHOWDOWN ***
Hero collected $3.7 from pot
*** SUMMARY ***
Total pot $3.92 | Rake $0.15 | Jackpot $0.07 | Bingo $0 | Fortune $0 | Tax $0
Board [Qc 8c Qh 5c Th]
Seat 1: 8927103f (button) folded before Flop (didn't bet)
Seat 2: 5df9a842 (small blind) folded before Flop
Seat 3: bb8cf690 (big blind) showed [7c Ac] and lost with Ace High Flush
Seat 4: f5ffb37c folded before Flop (didn't bet)
Seat 5: 834fcc3f folded before Flop (didn't bet)
Seat 6: Hero showed [Ts Qs] and won ($3.7) with Queens Full over Tens


Poker Hand #RC2078581690: Hold'em No Limit ($0.02/$0.05) - 2023/12/22 22:00:58
Table 'RushAndCash805192' 6-max Seat #1 is the button
Seat 1: Hero ($11.27 in chips)
Seat 2: 7732abf7 ($15.05 in chips)
Seat 3: b77cfdca ($6.62 in chips)
Seat 4: d50b3b7c ($6.37 in chips)
Seat 5: 5896c682 ($4.23 in chips)
Seat 6: 2e44f78e ($8.76 in chips)
7732abf7: posts small blind $0.02
b77cfdca: posts big blind $0.05
*** HOLE CARDS ***
Dealt to Hero [Ah 4d]
Dealt to 7732abf7 
Dealt to b77cfdca 
Dealt to d50b3b7c 
Dealt to 5896c682 
Dealt to 2e44f78e 
d50b3b7c: folds
5896c682: folds
2e44f78e: raises $0.07 to $0.12
Hero: folds
7732abf7: folds
b77cfdca: folds
Uncalled bet ($0.07) returned to 2e44f78e
*** SHOWDOWN ***
2e44f78e collected $0.12 from pot
*** SUMMARY ***
Total pot $0.12 | Rake $0 | Jackpot $0 | Bingo $0 | Fortune $0 | Tax $0
Seat 1: Hero (button) folded before Flop (didn't bet)
Seat 2: 7732abf7 (small blind) folded before Flop
Seat 3: b77cfdca (big blind) folded before Flop
Seat 4: d50b3b7c folded before Flop (didn't bet)
Seat 5: 5896c682 folded before Flop (didn't bet)
Seat 6: 2e44f78e collected ($0.12)


Poker Hand #RC2078581507: Hold'em No Limit ($0.02/$0.05) - 2023/12/22 22:00:47
Table 'RushAndCash805101' 6-max Seat #1 is the button
Seat 1: 35a2a674 ($1.93 in chips)
Seat 2: 2520bab9 ($5 in chips)
Seat 3: Hero ($11.25 in chips)
Seat 4: ea88c4e3 ($5.09 in chips)
Seat 5: 7736e9f3 ($5.13 in chips)
Seat 6: fc7e8623 ($24.51 in chips)
2520bab9: posts small blind $0.02
Hero: posts big blind $0.05
*** HOLE CARDS ***
Dealt to 35a2a674 
Dealt to 2520bab9 
Dealt to Hero [6c 5h]
Dealt to ea88c4e3 
Dealt to 7736e9f3 
Dealt to fc7e8623 
ea88c4e3: folds
7736e9f3: folds
fc7e8623: folds
35a2a674: folds
2520bab9: folds
Uncalled bet ($0.03) returned to Hero
*** SHOWDOWN ***
Hero collected $0.04 from pot
*** SUMMARY ***
Total pot $0.04 | Rake $0 | Jackpot $0 | Bingo $0 | Fortune $0 | Tax $0
Seat 1: 35a2a674 (button) folded before Flop (didn't bet)
Seat 2: 2520bab9 (small blind) folded before Flop
Seat 3: Hero (big blind) collected ($0.04)
Seat 4: ea88c4e3 folded before Flop (didn't bet)
Seat 5: 7736e9f3 folded before Flop (didn't bet)
Seat 6: fc7e8623 folded before Flop (didn't bet)


Poker Hand #RC2078581320: Hold'em No Limit ($0.02/$0.05) - 2023/12/22 22:00:37
Table 'RushAndCash805009' 6-max Seat #1 is the button
Seat 1: 6c75362e ($11.33 in chips)
Seat 2: Hero ($11.27 in chips)
Seat 3: d23c04d ($10.94 in chips)
Seat 4: 5fb95e0d ($4.63 in chips)
Seat 5: f71b25e9 ($7.63 in chips)
Seat 6: 6fadee13 ($5.02 in chips)
Hero: posts small blind $0.02
d23c04d: posts big blind $0.05
*** HOLE CARDS ***
Dealt to 6c75362e 
Dealt to Hero [2c As]
Dealt to d23c04d 
Dealt to 5fb95e0d 
Dealt to f71b25e9 
Dealt to 6fadee13 
5fb95e0d: raises $0.05 to $0.1
f71b25e9: folds
6fadee13: folds
6c75362e: folds
Hero: folds
d23c04d: calls $0.05
*** FLOP *** [3c 7h 2d]
d23c04d: checks
5fb95e0d: checks
*** TURN *** [3c 7h 2d] [Qc]
d23c04d: checks
5fb95e0d: bets $0.17
d23c04d: raises $0.33 to $0.5
5fb95e0d: folds
Uncalled bet ($0.33) returned to d23c04d
*** SHOWDOWN ***
d23c04d collected $0.54 from pot
*** SUMMARY ***
Total pot $0.56 | Rake $0.02 | Jackpot $0 | Bingo $0 | Fortune $0 | Tax $0
Board [3c 7h 2d Qc]
Seat 1: 6c75362e (button) folded before Flop (didn't bet)
Seat 2: Hero (small blind) folded before Flop
Seat 3: d23c04d (big blind) won ($0.54)
Seat 4: 5fb95e0d folded on the Turn
Seat 5: f71b25e9 folded before Flop (didn't bet)
Seat 6: 6fadee13 folded before Flop (didn't bet)


Poker Hand #RC2078581089: Hold'em No Limit ($0.02/$0.05) - 2023/12/22 22:00:24
Table 'RushAndCash804901' 6-max Seat #1 is the button
Seat 1: 7093f460 ($4.99 in chips)
Seat 2: 89f19970 ($5.24 in chips)
Seat 3: 418df7c3 ($3.89 in chips)
Seat 4: 7d137087 ($7.64 in chips)
Seat 5: f6b5f68e ($6.55 in chips)
Seat 6: Hero ($11.2 in chips)
89f19970: posts small blind $0.02
418df7c3: posts big blind $0.05
*** HOLE CARDS ***
Dealt to 7093f460 
Dealt to 89f19970 
Dealt to 418df7c3 
Dealt to 7d137087 
Dealt to f6b5f68e 
Dealt to Hero [Qs 9s]
7d137087: folds
f6b5f68e: folds
Hero: raises $0.05 to $0.1
7093f460: folds
89f19970: folds
418df7c3: folds
Uncalled bet ($0.05) returned to Hero
*** SHOWDOWN ***
Hero collected $0.12 from pot
*** SUMMARY ***
Total pot $0.12 | Rake $0 | Jackpot $0 | Bingo $0 | Fortune $0 | Tax $0
Seat 1: 7093f460 (button) folded before Flop (didn't bet)
Seat 2: 89f19970 (small blind) folded before Flop
Seat 3: 418df7c3 (big blind) folded before Flop
Seat 4: 7d137087 folded before Flop (didn't bet)
Seat 5: f6b5f68e folded before Flop (didn't bet)
Seat 6: Hero collected ($0.12)


Poker Hand #RC2078580831: Hold'em No Limit ($0.02/$0.05) - 2023/12/22 22:00:09
Table 'RushAndCash804785' 6-max Seat #1 is the button
Seat 1: c84db7d6 ($5.17 in chips)
Seat 2: Hero ($11.15 in chips)
Seat 3: e0e4307b ($6.43 in chips)
Seat 4: 834fcc3f ($11 in chips)
Seat 5: 39932550 ($4.28 in chips)
Seat 6: 2b3cf2e3 ($3.43 in chips)
Hero: posts small blind $0.02
e0e4307b: posts big blind $0.05
*** HOLE CARDS ***
Dealt to c84db7d6 
Dealt to Hero [Ad 2s]
Dealt to e0e4307b 
Dealt to 834fcc3f 
Dealt to 39932550 
Dealt to 2b3cf2e3 
834fcc3f: folds
39932550: folds
2b3cf2e3: folds
c84db7d6: folds
Hero: raises $0.1 to $0.15
e0e4307b: folds
Uncalled bet ($0.1) returned to Hero
*** SHOWDOWN ***
Hero collected $0.1 from pot
*** SUMMARY ***
Total pot $0.1 | Rake $0 | Jackpot $0 | Bingo $0 | Fortune $0 | Tax $0
Seat 1: c84db7d6 (button) folded before Flop (didn't bet)
Seat 2: Hero (small blind) collected ($0.1)
Seat 3: e0e4307b (big blind) folded before Flop
Seat 4: 834fcc3f folded before Flop (didn't bet)
Seat 5: 39932550 folded before Flop (didn't bet)
Seat 6: 2b3cf2e3 folded before Flop (didn't bet)


Poker Hand #RC2078580596: Hold'em No Limit ($0.02/$0.05) - 2023/12/22 21:59:55
Table 'RushAndCash804684' 6-max Seat #1 is the button
Seat 1: Hero ($11.08 in chips)
Seat 2: 40a1742d ($5 in chips)
Seat 3: d42ee966 ($5.47 in chips)
Seat 4: ff34c3d1 ($11.7 in chips)
Seat 5: f57c6794 ($5 in chips)
Seat 6: 17e936 ($5.14 in chips)
40a1742d: posts small blind $0.02
d42ee966: posts big blind $0.05
*** HOLE CARDS ***
Dealt to Hero [5s Ks]
Dealt to 40a1742d 
Dealt to d42ee966 
Dealt to ff34c3d1 
Dealt to f57c6794 
Dealt to 17e936 
ff34c3d1: folds
f57c6794: folds
17e936: folds
Hero: raises $0.08 to $0.13
40a1742d: folds
d42ee966: folds
Uncalled bet ($0.08) returned to Hero
*** SHOWDOWN ***
Hero collected $0.12 from pot
*** SUMMARY ***
Total pot $0.12 | Rake $0 | Jackpot $0 | Bingo $0 | Fortune $0 | Tax $0
Seat 1: Hero (button) collected ($0.12)
Seat 2: 40a1742d (small blind) folded before Flop
Seat 3: d42ee966 (big blind) folded before Flop
Seat 4: ff34c3d1 folded before Flop (didn't bet)
Seat 5: f57c6794 folded before Flop (didn't bet)
Seat 6: 17e936 folded before Flop (didn't bet)


Poker Hand #RC2078580495: Hold'em No Limit ($0.02/$0.05) - 2023/12/22 21:59:49
Table 'RushAndCash804638' 6-max Seat #1 is the button
Seat 1: aae3e1cd ($5.11 in chips)
Seat 2: 4cd2ab9f ($5.71 in chips)
Seat 3: d23c04d ($10.96 in chips)
Seat 4: e49e39a2 ($12.87 in chips)
Seat 5: Hero ($11.08 in chips)
Seat 6: 5df9a842 ($8.02 in chips)
4cd2ab9f: posts small blind $0.02
d23c04d: posts big blind $0.05
*** HOLE CARDS ***
Dealt to aae3e1cd 
Dealt to 4cd2ab9f 
Dealt to d23c04d 
Dealt to e49e39a2 
Dealt to Hero [2s 6h]
Dealt to 5df9a842 
e49e39a2: folds
Hero: folds
5df9a842: raises $0.05 to $0.1
aae3e1cd: folds
4cd2ab9f: folds
d23c04d: folds
Uncalled bet ($0.05) returned to 5df9a842
*** SHOWDOWN ***
5df9a842 collected $0.12 from pot
*** SUMMARY ***
Total pot $0.12 | Rake $0 | Jackpot $0 | Bingo $0 | Fortune $0 | Tax $0
Seat 1: aae3e1cd (button) folded before Flop (didn't bet)
Seat 2: 4cd2ab9f (small blind) folded before Flop
Seat 3: d23c04d (big blind) folded before Flop
Seat 4: e49e39a2 folded before Flop (didn't bet)
Seat 5: Hero folded before Flop (didn't bet)
Seat 6: 5df9a842 collected ($0.12)


Poker Hand #RC2078580411: Hold'em No Limit ($0.02/$0.05) - 2023/12/22 21:59:45
Table 'RushAndCash804599' 6-max Seat #1 is the button
Seat 1: aaeab039 ($5.31 in chips)
Seat 2: dc29a28e ($6.51 in chips)
Seat 3: eeb37e34 ($8.94 in chips)
Seat 4: 891938bf ($6.9 in chips)
Seat 5: 21a497ff ($5 in chips)
Seat 6: Hero ($11.08 in chips)
dc29a28e: posts small blind $0.02
eeb37e34: posts big blind $0.05
*** HOLE CARDS ***
Dealt to aaeab039 
Dealt to dc29a28e 
Dealt to eeb37e34 
Dealt to 891938bf 
Dealt to 21a497ff 
Dealt to Hero [6d 8h]
891938bf: folds
21a497ff: raises $0.08 to $0.13
Hero: folds
aaeab039: folds
dc29a28e: folds
eeb37e34: folds
Uncalled bet ($0.08) returned to 21a497ff
*** SHOWDOWN ***
21a497ff collected $0.12 from pot
*** SUMMARY ***
Total pot $0.12 | Rake $0 | Jackpot $0 | Bingo $0 | Fortune $0 | Tax $0
Seat 1: aaeab039 (button) folded before Flop (didn't bet)
Seat 2: dc29a28e (small blind) folded before Flop
Seat 3: eeb37e34 (big blind) folded before Flop
Seat 4: 891938bf folded before Flop (didn't bet)
Seat 5: 21a497ff collected ($0.12)
Seat 6: Hero folded before Flop (didn't bet)


Poker Hand #RC2078580315: Hold'em No Limit ($0.02/$0.05) - 2023/12/22 21:59:39
Table 'RushAndCash804556' 6-max Seat #1 is the button
Seat 1: b0755516 ($5.2 in chips)
Seat 2: fafe49aa ($7.49 in chips)
Seat 3: 7d137087 ($7.29 in chips)
Seat 4: 2d4acc60 ($6.41 in chips)
Seat 5: Hero ($11.08 in chips)
Seat 6: bfc64a4a ($10.36 in chips)
fafe49aa: posts small blind $0.02
7d137087: posts big blind $0.05
*** HOLE CARDS ***
Dealt to b0755516 
Dealt to fafe49aa 
Dealt to 7d137087 
Dealt to 2d4acc60 
Dealt to Hero [5h 8s]
Dealt to bfc64a4a 
2d4acc60: raises $0.05 to $0.1
Hero: folds
bfc64a4a: calls $0.1
b0755516: folds
fafe49aa: folds
7d137087: calls $0.05
*** FLOP *** [2h 2d Qh]
7d137087: checks
2d4acc60: checks
bfc64a4a: bets $0.16
7d137087: raises $0.29 to $0.45
2d4acc60: folds
bfc64a4a: folds
Uncalled bet ($0.29) returned to 7d137087
*** SHOWDOWN ***
7d137087 collected $0.61 from pot
*** SUMMARY ***
Total pot $0.64 | Rake $0.03 | Jackpot $0 | Bingo $0 | Fortune $0 | Tax $0
Board [2h 2d Qh]
Seat 1: b0755516 (button) folded before Flop (didn't bet)
Seat 2: fafe49aa (small blind) folded before Flop
Seat 3: 7d137087 (big blind) won ($0.61)
Seat 4: 2d4acc60 folded on the Flop
Seat 5: Hero folded before Flop (didn't bet)
Seat 6: bfc64a4a folded on the Flop


Poker Hand #RC2078580105: Hold'em No Limit ($0.02/$0.05) - 2023/12/22 21:59:26
Table 'RushAndCash804456' 6-max Seat #1 is the button
Seat 1: 851fc2ef ($10.12 in chips)
Seat 2: 1475b478 ($5.04 in chips)
Seat 3: Hero ($11.06 in chips)
Seat 4: 641aff0 ($13.29 in chips)
Seat 5: 777bac87 ($6.33 in chips)
Seat 6: bb8cf690 ($5 in chips)
1475b478: posts small blind $0.02
Hero: posts big blind $0.05
*** HOLE CARDS ***
Dealt to 851fc2ef 
Dealt to 1475b478 
Dealt to Hero [Jh 8d]
Dealt to 641aff0 
Dealt to 777bac87 
Dealt to bb8cf690 
641aff0: folds
777bac87: folds
bb8cf690: folds
851fc2ef: folds
1475b478: folds
Uncalled bet ($0.03) returned to Hero
*** SHOWDOWN ***
Hero collected $0.04 from pot
*** SUMMARY ***
Total pot $0.04 | Rake $0 | Jackpot $0 | Bingo $0 | Fortune $0 | Tax $0
Seat 1: 851fc2ef (button) folded before Flop (didn't bet)
Seat 2: 1475b478 (small blind) folded before Flop
Seat 3: Hero (big blind) collected ($0.04)
Seat 4: 641aff0 folded before Flop (didn't bet)
Seat 5: 777bac87 folded before Flop (didn't bet)
Seat 6: bb8cf690 folded before Flop (didn't bet)


Poker Hand #RC2078580017: Hold'em No Limit ($0.02/$0.05) - 2023/12/22 21:59:21
Table 'RushAndCash804413' 6-max Seat #1 is the button
Seat 1: f702b95b ($9.83 in chips)
Seat 2: 2bb677ff ($9.44 in chips)
Seat 3: 6ea11ecf ($7.65 in chips)
Seat 4: Hero ($11.06 in chips)
Seat 5: 5144e66c ($5.03 in chips)
Seat 6: c883264a ($8.99 in chips)
2bb677ff: posts small blind $0.02
6ea11ecf: posts big blind $0.05
*** HOLE CARDS ***
Dealt to f702b95b 
Dealt to 2bb677ff 
Dealt to 6ea11ecf 
Dealt to Hero [Qh 4d]
Dealt to 5144e66c 
Dealt to c883264a 
Hero: folds
5144e66c: folds
c883264a: folds
f702b95b: raises $0.05 to $0.1
2bb677ff: raises $0.35 to $0.45
6ea11ecf: raises $0.6 to $1.05
f702b95b: folds
2bb677ff: calls $0.6
*** FLOP *** [3c 7c 3s]
2bb677ff: checks
6ea11ecf: bets $1.1
2bb677ff: folds
Uncalled bet ($1.1) returned to 6ea11ecf
*** SHOWDOWN ***
6ea11ecf collected $2.03 from pot
*** SUMMARY ***
Total pot $2.2 | Rake $0.1 | Jackpot $0.07 | Bingo $0 | Fortune $0 | Tax $0
Board [3c 7c 3s]
Seat 1: f702b95b (button) folded before Flop
Seat 2: 2bb677ff (small blind) folded on the Flop
Seat 3: 6ea11ecf (big blind) won ($2.03)
Seat 4: Hero folded before Flop (didn't bet)
Seat 5: 5144e66c folded before Flop (didn't bet)
Seat 6: c883264a folded before Flop (didn't bet)


Poker Hand #RC2078579409: Hold'em No Limit ($0.02/$0.05) - 2023/12/22 21:58:48
Table 'RushAndCash804131' 6-max Seat #1 is the button
Seat 1: 6d50e434 ($2.61 in chips)
Seat 2: 8e74fca6 ($13.22 in chips)
Seat 3: 2bb677ff ($9.54 in chips)
Seat 4: 9d93c43e ($5.74 in chips)
Seat 5: Hero ($10.85 in chips)
Seat 6: ad8e25d4 ($2.23 in chips)
8e74fca6: posts small blind $0.02
2bb677ff: posts big blind $0.05
*** HOLE CARDS ***
Dealt to 6d50e434 
Dealt to 8e74fca6 
Dealt to 2bb677ff 
Dealt to 9d93c43e 
Dealt to Hero [As Ah]
Dealt to ad8e25d4 
9d93c43e: folds
Hero: raises $0.05 to $0.1
ad8e25d4: calls $0.1
6d50e434: folds
8e74fca6: folds
2bb677ff: calls $0.05
*** FLOP *** [Qc 3d 4s]
2bb677ff: checks
Hero: bets $0.16
ad8e25d4: folds
2bb677ff: folds
Uncalled bet ($0.16) returned to Hero
*** SHOWDOWN ***
Hero collected $0.31 from pot
*** SUMMARY ***
Total pot $0.32 | Rake $0.01 | Jackpot $0 | Bingo $0 | Fortune $0 | Tax $0
Board [Qc 3d 4s]
Seat 1: 6d50e434 (button) folded before Flop (didn't bet)
Seat 2: 8e74fca6 (small blind) folded before Flop
Seat 3: 2bb677ff (big blind) folded on the Flop
Seat 4: 9d93c43e folded before Flop (didn't bet)
Seat 5: Hero won ($0.31)
Seat 6: ad8e25d4 folded on the Flop


Poker Hand #RC2078579275: Hold'em No Limit ($0.02/$0.05) - 2023/12/22 21:58:40
Table 'RushAndCash804069' 6-max Seat #1 is the button
Seat 1: 4ab8a557 ($6.73 in chips)
Seat 2: 89dad04f ($14.34 in chips)
Seat 3: Hero ($10.83 in chips)
Seat 4: c550b71c ($5.33 in chips)
Seat 5: 68c6c5e7 ($26.7 in chips)
Seat 6: ee19881a ($5 in chips)
89dad04f: posts small blind $0.02
Hero: posts big blind $0.05
*** HOLE CARDS ***
Dealt to 4ab8a557 
Dealt to 89dad04f 
Dealt to Hero [9h 3c]
Dealt to c550b71c 
Dealt to 68c6c5e7 
Dealt to ee19881a 
c550b71c: folds
68c6c5e7: folds
ee19881a: folds
4ab8a557: folds
89dad04f: folds
Uncalled bet ($0.03) returned to Hero
*** SHOWDOWN ***
Hero collected $0.04 from pot
*** SUMMARY ***
Total pot $0.04 | Rake $0 | Jackpot $0 | Bingo $0 | Fortune $0 | Tax $0
Seat 1: 4ab8a557 (button) folded before Flop (didn't bet)
Seat 2: 89dad04f (small blind) folded before Flop
Seat 3: Hero (big blind) collected ($0.04)
Seat 4: c550b71c folded before Flop (didn't bet)
Seat 5: 68c6c5e7 folded before Flop (didn't bet)
Seat 6: ee19881a folded before Flop (didn't bet)


Poker Hand #RC2078578294: Hold'em No Limit ($0.02/$0.05) - 2023/12/22 21:57:44
Table 'RushAndCash803617' 6-max Seat #1 is the button
Seat 1: 3910f1b8 ($3.46 in chips)
Seat 2: acefe839 ($14.73 in chips)
Seat 3: 8d94440d ($5.22 in chips)
Seat 4: 89dad04f ($12.03 in chips)
Seat 5: d132ea52 ($3.82 in chips)
Seat 6: Hero ($13.29 in chips)
acefe839: posts small blind $0.02
8d94440d: posts big blind $0.05
*** HOLE CARDS ***
Dealt to 3910f1b8 
Dealt to acefe839 
Dealt to 8d94440d 
Dealt to 89dad04f 
Dealt to d132ea52 
Dealt to Hero [Qd Qc]
89dad04f: raises $0.08 to $0.13
d132ea52: folds
Hero: raises $0.33 to $0.46
3910f1b8: folds
acefe839: folds
8d94440d: folds
89dad04f: calls $0.33
*** FLOP *** [7h 2h Js]
89dad04f: checks
Hero: bets $0.5
89dad04f: calls $0.5
*** TURN *** [7h 2h Js] [7d]
89dad04f: checks
Hero: checks
*** RIVER *** [7h 2h Js 7d] [5h]
89dad04f: bets $1.5
Hero: calls $1.5
89dad04f: shows [Ah Qh] (Ace High Flush)
Hero: shows [Qd Qc] (Pair of Queens and Pair of Sevens)
*** SHOWDOWN ***
89dad04f collected $4.77 from pot
*** SUMMARY ***
Total pot $4.99 | Rake $0.15 | Jackpot $0.07 | Bingo $0 | Fortune $0 | Tax $0
Board [7h 2h Js 7d 5h]
Seat 1: 3910f1b8 (button) folded before Flop (didn't bet)
Seat 2: acefe839 (small blind) folded before Flop
Seat 3: 8d94440d (big blind) folded before Flop
Seat 4: 89dad04f showed [Ah Qh] and won ($4.77) with Ace High Flush
Seat 5: d132ea52 folded before Flop (didn't bet)
Seat 6: Hero showed [Qd Qc] and lost with Pair of Queens and Pair of Sevens


Poker Hand #RC2078578230: Hold'em No Limit ($0.02/$0.05) - 2023/12/22 21:57:40
Table 'RushAndCash803587' 6-max Seat #1 is the button
Seat 1: Hero ($13.29 in chips)
Seat 2: 8d94440d ($5.24 in chips)
Seat 3: 8003c1db ($5.9 in chips)
Seat 4: 1a6eef5 ($3.91 in chips)
Seat 5: 177da66b ($12.47 in chips)
Seat 6: 7961accb ($5.75 in chips)
8d94440d: posts small blind $0.02
8003c1db: posts big blind $0.05
*** HOLE CARDS ***
Dealt to Hero [3s 8h]
Dealt to 8d94440d 
Dealt to 8003c1db 
Dealt to 1a6eef5 
Dealt to 177da66b 
Dealt to 7961accb 
1a6eef5: folds
177da66b: raises $0.08 to $0.13
7961accb: folds
Hero: folds
8d94440d: folds
8003c1db: folds
Uncalled bet ($0.08) returned to 177da66b
*** SHOWDOWN ***
177da66b collected $0.12 from pot
*** SUMMARY ***
Total pot $0.12 | Rake $0 | Jackpot $0 | Bingo $0 | Fortune $0 | Tax $0
Seat 1: Hero (button) folded before Flop (didn't bet)
Seat 2: 8d94440d (small blind) folded before Flop
Seat 3: 8003c1db (big blind) folded before Flop
Seat 4: 1a6eef5 folded before Flop (didn't bet)
Seat 5: 177da66b collected ($0.12)
Seat 6: 7961accb folded before Flop (didn't bet)


Poker Hand #RC2078578040: Hold'em No Limit ($0.02/$0.05) - 2023/12/22 21:57:30
Table 'RushAndCash803497' 6-max Seat #1 is the button
Seat 1: 6d679d40 ($5.14 in chips)
Seat 2: Hero ($13.31 in chips)
Seat 3: 3b055a50 ($14.05 in chips)
Seat 4: 7b8defcb ($4.03 in chips)
Seat 5: d132ea52 ($3.75 in chips)
Seat 6: 8c3b130b ($0.25 in chips)
Hero: posts small blind $0.02
3b055a50: posts big blind $0.05
*** HOLE CARDS ***
Dealt to 6d679d40 
Dealt to Hero [3h Jd]
Dealt to 3b055a50 
Dealt to 7b8defcb 
Dealt to d132ea52 
Dealt to 8c3b130b 
7b8defcb: folds
d132ea52: raises $0.1 to $0.15
8c3b130b: folds
6d679d40: folds
Hero: folds
3b055a50: folds
Uncalled bet ($0.1) returned to d132ea52
*** SHOWDOWN ***
d132ea52 collected $0.12 from pot
*** SUMMARY ***
Total pot $0.12 | Rake $0 | Jackpot $0 | Bingo $0 | Fortune $0 | Tax $0
Seat 1: 6d679d40 (button) folded before Flop (didn't bet)
Seat 2: Hero (small blind) folded before Flop
Seat 3: 3b055a50 (big blind) folded before Flop
Seat 4: 7b8defcb folded before Flop (didn't bet)
Seat 5: d132ea52 collected ($0.12)
Seat 6: 8c3b130b folded before Flop (didn't bet)


Poker Hand #RC2078577937: Hold'em No Limit ($0.02/$0.05) - 2023/12/22 21:57:24
Table 'RushAndCash803447' 6-max Seat #1 is the button
Seat 1: 3a20c3a ($10.37 in chips)
Seat 2: dc851cb6 ($9.78 in chips)
Seat 3: c8adf5d ($7.08 in chips)
Seat 4: 1e3d103d ($9.03 in chips)
Seat 5: Hero ($13.31 in chips)
Seat 6: 48b86f00 ($4.86 in chips)
dc851cb6: posts small blind $0.02
c8adf5d: posts big blind $0.05
*** HOLE CARDS ***
Dealt to 3a20c3a 
Dealt to dc851cb6 
Dealt to c8adf5d 
Dealt to 1e3d103d 
Dealt to Hero [6h Ad]
Dealt to 48b86f00 
1e3d103d: folds
Hero: folds
48b86f00: folds
3a20c3a: folds
dc851cb6: folds
Uncalled bet ($0.03) returned to c8adf5d
*** SHOWDOWN ***
c8adf5d collected $0.04 from pot
*** SUMMARY ***
Total pot $0.04 | Rake $0 | Jackpot $0 | Bingo $0 | Fortune $0 | Tax $0
Seat 1: 3a20c3a (button) folded before Flop (didn't bet)
Seat 2: dc851cb6 (small blind) folded before Flop
Seat 3: c8adf5d (big blind) collected ($0.04)
Seat 4: 1e3d103d folded before Flop (didn't bet)
Seat 5: Hero folded before Flop (didn't bet)
Seat 6: 48b86f00 folded before Flop (didn't bet)


Poker Hand #RC2078577882: Hold'em No Limit ($0.02/$0.05) - 2023/12/22 21:57:20
Table 'RushAndCash803421' 6-max Seat #1 is the button
Seat 1: 9220db62 ($6.79 in chips)
Seat 2: 59846dec ($7.3 in chips)
Seat 3: 17da2929 ($5.26 in chips)
Seat 4: Hero ($13.31 in chips)
Seat 5: 14f02886 ($5.13 in chips)
Seat 6: 53025835 ($5 in chips)
59846dec: posts small blind $0.02
17da2929: posts big blind $0.05
*** HOLE CARDS ***
Dealt to 9220db62 
Dealt to 59846dec 
Dealt to 17da2929 
Dealt to Hero [3c Ah]
Dealt to 14f02886 
Dealt to 53025835 
Hero: folds
14f02886: folds
53025835: folds
9220db62: raises $0.1 to $0.15
59846dec: raises $0.35 to $0.5
17da2929: folds
9220db62: folds
Uncalled bet ($0.35) returned to 59846dec
*** SHOWDOWN ***
59846dec collected $0.34 from pot
*** SUMMARY ***
Total pot $0.35 | Rake $0.01 | Jackpot $0 | Bingo $0 | Fortune $0 | Tax $0
Seat 1: 9220db62 (button) folded before Flop
Seat 2: 59846dec (small blind) collected ($0.34)
Seat 3: 17da2929 (big blind) folded before Flop
Seat 4: Hero folded before Flop (didn't bet)
Seat 5: 14f02886 folded before Flop (didn't bet)
Seat 6: 53025835 folded before Flop (didn't bet)


Poker Hand #RC2078577780: Hold'em No Limit ($0.02/$0.05) - 2023/12/22 21:57:15
Table 'RushAndCash803371' 6-max Seat #1 is the button
Seat 1: Hero ($13.31 in chips)
Seat 2: 52eb7b3d ($10.68 in chips)
Seat 3: b49c4561 ($3.04 in chips)
Seat 4: 921e997e ($5 in chips)
Seat 5: 2df55086 ($9.24 in chips)
Seat 6: 59846dec ($7.3 in chips)
52eb7b3d: posts small blind $0.02
b49c4561: posts big blind $0.05
*** HOLE CARDS ***
Dealt to Hero [4d Qc]
Dealt to 52eb7b3d 
Dealt to b49c4561 
Dealt to 921e997e 
Dealt to 2df55086 
Dealt to 59846dec 
921e997e: folds
2df55086: folds
59846dec: folds
Hero: folds
52eb7b3d: calls $0.03
b49c4561: checks
*** FLOP *** [8c Jd Ah]
52eb7b3d: bets $0.05
b49c4561: folds
Uncalled bet ($0.05) returned to 52eb7b3d
*** SHOWDOWN ***
52eb7b3d collected $0.1 from pot
*** SUMMARY ***
Total pot $0.1 | Rake $0 | Jackpot $0 | Bingo $0 | Fortune $0 | Tax $0
Board [8c Jd Ah]
Seat 1: Hero (button) folded before Flop (didn't bet)
Seat 2: 52eb7b3d (small blind) won ($0.1)
Seat 3: b49c4561 (big blind) folded on the Flop
Seat 4: 921e997e folded before Flop (didn't bet)
Seat 5: 2df55086 folded before Flop (didn't bet)
Seat 6: 59846dec folded before Flop (didn't bet)


Poker Hand #RC2078577632: Hold'em No Limit ($0.02/$0.05) - 2023/12/22 21:57:06
Table 'RushAndCash803303' 6-max Seat #1 is the button
Seat 1: 5c1bba30 ($5.24 in chips)
Seat 2: Hero ($13.33 in chips)
Seat 3: cd02a153 ($6.04 in chips)
Seat 4: 5761cd5e ($5.07 in chips)
Seat 5: fa93749b ($8.77 in chips)
Seat 6: c8aa0ffb ($3.75 in chips)
Hero: posts small blind $0.02
cd02a153: posts big blind $0.05
*** HOLE CARDS ***
Dealt to 5c1bba30 
Dealt to Hero [Jd 4c]
Dealt to cd02a153 
Dealt to 5761cd5e 
Dealt to fa93749b 
Dealt to c8aa0ffb 
5761cd5e: folds
fa93749b: folds
c8aa0ffb: raises $0.1 to $0.15
5c1bba30: folds
Hero: folds
cd02a153: folds
Uncalled bet ($0.1) returned to c8aa0ffb
*** SHOWDOWN ***
c8aa0ffb collected $0.12 from pot
*** SUMMARY ***
Total pot $0.12 | Rake $0 | Jackpot $0 | Bingo $0 | Fortune $0 | Tax $0
Seat 1: 5c1bba30 (button) folded before Flop (didn't bet)
Seat 2: Hero (small blind) folded before Flop
Seat 3: cd02a153 (big blind) folded before Flop
Seat 4: 5761cd5e folded before Flop (didn't bet)
Seat 5: fa93749b folded before Flop (didn't bet)
Seat 6: c8aa0ffb collected ($0.12)


Poker Hand #RC2078577473: Hold'em No Limit ($0.02/$0.05) - 2023/12/22 21:56:57
Table 'RushAndCash803231' 6-max Seat #1 is the button
Seat 1: a09c3cfc ($3.5 in chips)
Seat 2: d8c6faef ($4.16 in chips)
Seat 3: Hero ($13.31 in chips)
Seat 4: f93190a6 ($7.85 in chips)
Seat 5: 763c5a4e ($5.05 in chips)
Seat 6: dded80af ($5 in chips)
d8c6faef: posts small blind $0.02
Hero: posts big blind $0.05
*** HOLE CARDS ***
Dealt to a09c3cfc 
Dealt to d8c6faef 
Dealt to Hero [5d 4d]
Dealt to f93190a6 
Dealt to 763c5a4e 
Dealt to dded80af 
f93190a6: folds
763c5a4e: folds
dded80af: folds
a09c3cfc: folds
d8c6faef: folds
Uncalled bet ($0.03) returned to Hero
*** SHOWDOWN ***
Hero collected $0.04 from pot
*** SUMMARY ***
Total pot $0.04 | Rake $0 | Jackpot $0 | Bingo $0 | Fortune $0 | Tax $0
Seat 1: a09c3cfc (button) folded before Flop (didn't bet)
Seat 2: d8c6faef (small blind) folded before Flop
Seat 3: Hero (big blind) collected ($0.04)
Seat 4: f93190a6 folded before Flop (didn't bet)
Seat 5: 763c5a4e folded before Flop (didn't bet)
Seat 6: dded80af folded before Flop (didn't bet)


Poker Hand #RC2078577264: Hold'em No Limit ($0.02/$0.05) - 2023/12/22 21:56:44
Table 'RushAndCash803139' 6-max Seat #1 is the button
Seat 1: b257878a ($5.47 in chips)
Seat 2: 9128c206 ($8 in chips)
Seat 3: 1e89bda1 ($5.91 in chips)
Seat 4: b75c858f ($5.75 in chips)
Seat 5: bba39737 ($6.31 in chips)
Seat 6: Hero ($13.31 in chips)
9128c206: posts small blind $0.02
1e89bda1: posts big blind $0.05
*** HOLE CARDS ***
Dealt to b257878a 
Dealt to 9128c206 
Dealt to 1e89bda1 
Dealt to b75c858f 
Dealt to bba39737 
Dealt to Hero [Kd 8d]
b75c858f: folds
bba39737: raises $0.05 to $0.1
Hero: folds
b257878a: folds
9128c206: folds
1e89bda1: folds
Uncalled bet ($0.05) returned to bba39737
*** SHOWDOWN ***
bba39737 collected $0.12 from pot
*** SUMMARY ***
Total pot $0.12 | Rake $0 | Jackpot $0 | Bingo $0 | Fortune $0 | Tax $0
Seat 1: b257878a (button) folded before Flop (didn't bet)
Seat 2: 9128c206 (small blind) folded before Flop
Seat 3: 1e89bda1 (big blind) folded before Flop
Seat 4: b75c858f folded before Flop (didn't bet)
Seat 5: bba39737 collected ($0.12)
Seat 6: Hero folded before Flop (didn't bet)


Poker Hand #RC2078577166: Hold'em No Limit ($0.02/$0.05) - 2023/12/22 21:56:39
Table 'RushAndCash803094' 6-max Seat #1 is the button
Seat 1: Hero ($13.31 in chips)
Seat 2: c25f57d6 ($0.9 in chips)
Seat 3: 5a7ccd94 ($4.85 in chips)
Seat 4: 7c2eba4e ($16.82 in chips)
Seat 5: 24503504 ($6.73 in chips)
Seat 6: 84dda8d8 ($5.23 in chips)
c25f57d6: posts small blind $0.02
5a7ccd94: posts big blind $0.05
*** HOLE CARDS ***
Dealt to Hero [8h 3h]
Dealt to c25f57d6 
Dealt to 5a7ccd94 
Dealt to 7c2eba4e 
Dealt to 24503504 
Dealt to 84dda8d8 
7c2eba4e: raises $0.1 to $0.15
24503504: folds
84dda8d8: folds
Hero: folds
c25f57d6: calls $0.13
5a7ccd94: folds
*** FLOP *** [8s 6h 5d]
c25f57d6: checks
7c2eba4e: bets $0.25
c25f57d6: folds
Uncalled bet ($0.25) returned to 7c2eba4e
*** SHOWDOWN ***
7c2eba4e collected $0.34 from pot
*** SUMMARY ***
Total pot $0.35 | Rake $0.01 | Jackpot $0 | Bingo $0 | Fortune $0 | Tax $0
Board [8s 6h 5d]
Seat 1: Hero (button) folded before Flop (didn't bet)
Seat 2: c25f57d6 (small blind) folded on the Flop
Seat 3: 5a7ccd94 (big blind) folded before Flop
Seat 4: 7c2eba4e won ($0.34)
Seat 5: 24503504 folded before Flop (didn't bet)
Seat 6: 84dda8d8 folded before Flop (didn't bet)


Poker Hand #RC2078577011: Hold'em No Limit ($0.02/$0.05) - 2023/12/22 21:56:30
Table 'RushAndCash803019' 6-max Seat #1 is the button
Seat 1: 987954e ($9.36 in chips)
Seat 2: Hero ($13.33 in chips)
Seat 3: 2b3cf2e3 ($3.44 in chips)
Seat 4: 8f80311 ($6.34 in chips)
Seat 5: ab8d3eb5 ($5.48 in chips)
Seat 6: c7d7813b ($5 in chips)
Hero: posts small blind $0.02
2b3cf2e3: posts big blind $0.05
*** HOLE CARDS ***
Dealt to 987954e 
Dealt to Hero [Th 6c]
Dealt to 2b3cf2e3 
Dealt to 8f80311 
Dealt to ab8d3eb5 
Dealt to c7d7813b 
8f80311: folds
ab8d3eb5: folds
c7d7813b: folds
987954e: folds
Hero: folds
Uncalled bet ($0.03) returned to 2b3cf2e3
*** SHOWDOWN ***
2b3cf2e3 collected $0.04 from pot
*** SUMMARY ***
Total pot $0.04 | Rake $0 | Jackpot $0 | Bingo $0 | Fortune $0 | Tax $0
Seat 1: 987954e (button) folded before Flop (didn't bet)
Seat 2: Hero (small blind) folded before Flop
Seat 3: 2b3cf2e3 (big blind) collected ($0.04)
Seat 4: 8f80311 folded before Flop (didn't bet)
Seat 5: ab8d3eb5 folded before Flop (didn't bet)
Seat 6: c7d7813b folded before Flop (didn't bet)


Poker Hand #RC2078576918: Hold'em No Limit ($0.02/$0.05) - 2023/12/22 21:56:24
Table 'RushAndCash802973' 6-max Seat #1 is the button
Seat 1: 3b322324 ($5.7 in chips)
Seat 2: 62b0eed9 ($10 in chips)
Seat 3: fab544c8 ($8.34 in chips)
Seat 4: Hero ($13.33 in chips)
Seat 5: 8626eae9 ($5 in chips)
Seat 6: 6d50e434 ($3.55 in chips)
62b0eed9: posts small blind $0.02
fab544c8: posts big blind $0.05
*** HOLE CARDS ***
Dealt to 3b322324 
Dealt to 62b0eed9 
Dealt to fab544c8 
Dealt to Hero [5h 4c]
Dealt to 8626eae9 
Dealt to 6d50e434 
Hero: folds
8626eae9: folds
6d50e434: folds
3b322324: raises $0.1 to $0.15
62b0eed9: folds
fab544c8: calls $0.1
*** FLOP *** [2s Kc 5s]
fab544c8: checks
3b322324: checks
*** TURN *** [2s Kc 5s] [9s]
fab544c8: checks
3b322324: checks
*** RIVER *** [2s Kc 5s 9s] [Th]
fab544c8: bets $0.32
3b322324: folds
Uncalled bet ($0.32) returned to fab544c8
*** SHOWDOWN ***
fab544c8 collected $0.31 from pot
*** SUMMARY ***
Total pot $0.32 | Rake $0.01 | Jackpot $0 | Bingo $0 | Fortune $0 | Tax $0
Board [2s Kc 5s 9s Th]
Seat 1: 3b322324 (button) folded on the River
Seat 2: 62b0eed9 (small blind) folded before Flop
Seat 3: fab544c8 (big blind) won ($0.31)
Seat 4: Hero folded before Flop (didn't bet)
Seat 5: 8626eae9 folded before Flop (didn't bet)
Seat 6: 6d50e434 folded before Flop (didn't bet)


Poker Hand #RC2078576811: Hold'em No Limit ($0.02/$0.05) - 2023/12/22 21:56:18
Table 'RushAndCash802925' 6-max Seat #1 is the button
Seat 1: 50a0bc08 ($5.71 in chips)
Seat 2: 22e89a1b ($7.34 in chips)
Seat 3: 4e73adeb ($5 in chips)
Seat 4: b257878a ($5.45 in chips)
Seat 5: Hero ($13.33 in chips)
Seat 6: 6ded132b ($11.74 in chips)
22e89a1b: posts small blind $0.02
4e73adeb: posts big blind $0.05
*** HOLE CARDS ***
Dealt to 50a0bc08 
Dealt to 22e89a1b 
Dealt to 4e73adeb 
Dealt to b257878a 
Dealt to Hero [4c 2c]
Dealt to 6ded132b 
b257878a: folds
Hero: folds
6ded132b: folds
50a0bc08: folds
22e89a1b: raises $0.1 to $0.15
4e73adeb: folds
Uncalled bet ($0.1) returned to 22e89a1b
*** SHOWDOWN ***
22e89a1b collected $0.1 from pot
*** SUMMARY ***
Total pot $0.1 | Rake $0 | Jackpot $0 | Bingo $0 | Fortune $0 | Tax $0
Seat 1: 50a0bc08 (button) folded before Flop (didn't bet)
Seat 2: 22e89a1b (small blind) collected ($0.1)
Seat 3: 4e73adeb (big blind) folded before Flop
Seat 4: b257878a folded before Flop (didn't bet)
Seat 5: Hero folded before Flop (didn't bet)
Seat 6: 6ded132b folded before Flop (didn't bet)


Poker Hand #RC2078576628: Hold'em No Limit ($0.02/$0.05) - 2023/12/22 21:56:07
Table 'RushAndCash802841' 6-max Seat #1 is the button
Seat 1: c7726580 ($5 in chips)
Seat 2: bf2eeb85 ($2.74 in chips)
Seat 3: Hero ($13.38 in chips)
Seat 4: 777bac87 ($5 in chips)
Seat 5: c0936c93 ($5.7 in chips)
Seat 6: 88e57a08 ($14.63 in chips)
bf2eeb85: posts small blind $0.02
Hero: posts big blind $0.05
*** HOLE CARDS ***
Dealt to c7726580 
Dealt to bf2eeb85 
Dealt to Hero [8s Kd]
Dealt to 777bac87 
Dealt to c0936c93 
Dealt to 88e57a08 
777bac87: folds
c0936c93: raises $0.1 to $0.15
88e57a08: folds
c7726580: folds
bf2eeb85: folds
Hero: folds
Uncalled bet ($0.1) returned to c0936c93
*** SHOWDOWN ***
c0936c93 collected $0.12 from pot
*** SUMMARY ***
Total pot $0.12 | Rake $0 | Jackpot $0 | Bingo $0 | Fortune $0 | Tax $0
Seat 1: c7726580 (button) folded before Flop (didn't bet)
Seat 2: bf2eeb85 (small blind) folded before Flop
Seat 3: Hero (big blind) folded before Flop
Seat 4: 777bac87 folded before Flop (didn't bet)
Seat 5: c0936c93 collected ($0.12)
Seat 6: 88e57a08 folded before Flop (didn't bet)


Poker Hand #RC2078576551: Hold'em No Limit ($0.02/$0.05) - 2023/12/22 21:56:02
Table 'RushAndCash802803' 6-max Seat #1 is the button
Seat 1: 6d679d40 ($6.36 in chips)
Seat 2: d132ea52 ($3.48 in chips)
Seat 3: c53293cf ($8.89 in chips)
Seat 4: 3e9a8d8c ($4.98 in chips)
Seat 5: Hero ($13.38 in chips)
Seat 6: 87684dd4 ($3.07 in chips)
d132ea52: posts small blind $0.02
c53293cf: posts big blind $0.05
*** HOLE CARDS ***
Dealt to 6d679d40 
Dealt to d132ea52 
Dealt to c53293cf 
Dealt to 3e9a8d8c 
Dealt to Hero [9d 5c]
Dealt to 87684dd4 
3e9a8d8c: folds
Hero: folds
87684dd4: folds
6d679d40: folds
d132ea52: raises $0.07 to $0.12
c53293cf: folds
Uncalled bet ($0.07) returned to d132ea52
*** SHOWDOWN ***
d132ea52 collected $0.1 from pot
*** SUMMARY ***
Total pot $0.1 | Rake $0 | Jackpot $0 | Bingo $0 | Fortune $0 | Tax $0
Seat 1: 6d679d40 (button) folded before Flop (didn't bet)
Seat 2: d132ea52 (small blind) collected ($0.1)
Seat 3: c53293cf (big blind) folded before Flop
Seat 4: 3e9a8d8c folded before Flop (didn't bet)
Seat 5: Hero folded before Flop (didn't bet)
Seat 6: 87684dd4 folded before Flop (didn't bet)


Poker Hand #RC2078575907: Hold'em No Limit ($0.02/$0.05) - 2023/12/22 21:55:22
Table 'RushAndCash802519' 6-max Seat #1 is the button
Seat 1: f0e3b048 ($4.75 in chips)
Seat 2: 5c59e6a6 ($5.83 in chips)
Seat 3: Hero ($13.58 in chips)
Seat 4: e1423689 ($5 in chips)
Seat 5: 98347374 ($16.55 in chips)
Seat 6: a4441de9 ($5 in chips)
5c59e6a6: posts small blind $0.02
Hero: posts big blind $0.05
*** HOLE CARDS ***
Dealt to f0e3b048 
Dealt to 5c59e6a6 
Dealt to Hero [6h 6c]
Dealt to e1423689 
Dealt to 98347374 
Dealt to a4441de9 
e1423689: raises $0.15 to $0.2
98347374: folds
a4441de9: folds
f0e3b048: calls $0.2
5c59e6a6: folds
Hero: calls $0.15
*** FLOP *** [Js Ad 2d]
Hero: checks
e1423689: bets $1.09
f0e3b048: folds
Hero: folds
Uncalled bet ($1.09) returned to e1423689
*** SHOWDOWN ***
e1423689 collected $0.59 from pot
*** SUMMARY ***
Total pot $0.62 | Rake $0.03 | Jackpot $0 | Bingo $0 | Fortune $0 | Tax $0
Board [Js Ad 2d]
Seat 1: f0e3b048 (button) folded on the Flop
Seat 2: 5c59e6a6 (small blind) folded before Flop
Seat 3: Hero (big blind) folded on the Flop
Seat 4: e1423689 won ($0.59)
Seat 5: 98347374 folded before Flop (didn't bet)
Seat 6: a4441de9 folded before Flop (didn't bet)


Poker Hand #RC2078575849: Hold'em No Limit ($0.02/$0.05) - 2023/12/22 21:55:18
Table 'RushAndCash802493' 6-max Seat #1 is the button
Seat 1: 8ad5eb6 ($9.48 in chips)
Seat 2: 3d929f9f ($9.12 in chips)
Seat 3: bf2eeb85 ($2.5 in chips)
Seat 4: cb16bb03 ($12.28 in chips)
Seat 5: Hero ($13.58 in chips)
Seat 6: 500558b3 ($5.27 in chips)
3d929f9f: posts small blind $0.02
bf2eeb85: posts big blind $0.05
*** HOLE CARDS ***
Dealt to 8ad5eb6 
Dealt to 3d929f9f 
Dealt to bf2eeb85 
Dealt to cb16bb03 
Dealt to Hero [Tc 6d]
Dealt to 500558b3 
cb16bb03: folds
Hero: folds
500558b3: folds
8ad5eb6: raises $0.05 to $0.1
3d929f9f: folds
bf2eeb85: raises $0.22 to $0.32
8ad5eb6: calls $0.22
*** FLOP *** [2d 4h Ad]
bf2eeb85: bets $0.33
8ad5eb6: folds
Uncalled bet ($0.33) returned to bf2eeb85
*** SHOWDOWN ***
bf2eeb85 collected $0.63 from pot
*** SUMMARY ***
Total pot $0.66 | Rake $0.03 | Jackpot $0 | Bingo $0 | Fortune $0 | Tax $0
Board [2d 4h Ad]
Seat 1: 8ad5eb6 (button) folded on the Flop
Seat 2: 3d929f9f (small blind) folded before Flop
Seat 3: bf2eeb85 (big blind) won ($0.63)
Seat 4: cb16bb03 folded before Flop (didn't bet)
Seat 5: Hero folded before Flop (didn't bet)
Seat 6: 500558b3 folded before Flop (didn't bet)


Poker Hand #RC2078575738: Hold'em No Limit ($0.02/$0.05) - 2023/12/22 21:55:12
Table 'RushAndCash802440' 6-max Seat #1 is the button
Seat 1: 3288926 ($7.05 in chips)
Seat 2: 6ef00a1b ($14.46 in chips)
Seat 3: 71fd2b18 ($12.83 in chips)
Seat 4: c6813ed5 ($7.66 in chips)
Seat 5: Hero ($13.58 in chips)
Seat 6: 661ba238 ($5.07 in chips)
6ef00a1b: posts small blind $0.02
71fd2b18: posts big blind $0.05
*** HOLE CARDS ***
Dealt to 3288926 
Dealt to 6ef00a1b 
Dealt to 71fd2b18 
Dealt to c6813ed5 
Dealt to Hero [Td Qs]
Dealt to 661ba238 
c6813ed5: folds
Hero: folds
661ba238: folds
3288926: raises $0.08 to $0.13
6ef00a1b: folds
71fd2b18: calls $0.08
*** FLOP *** [6h Ts Qh]
71fd2b18: checks
3288926: bets $0.1
71fd2b18: folds
Uncalled bet ($0.1) returned to 3288926
*** SHOWDOWN ***
3288926 collected $0.27 from pot
*** SUMMARY ***
Total pot $0.28 | Rake $0.01 | Jackpot $0 | Bingo $0 | Fortune $0 | Tax $0
Board [6h Ts Qh]
Seat 1: 3288926 (button) won ($0.27)
Seat 2: 6ef00a1b (small blind) folded before Flop
Seat 3: 71fd2b18 (big blind) folded on the Flop
Seat 4: c6813ed5 folded before Flop (didn't bet)
Seat 5: Hero folded before Flop (didn't bet)
Seat 6: 661ba238 folded before Flop (didn't bet)


Poker Hand #RC2078575588: Hold'em No Limit ($0.02/$0.05) - 2023/12/22 21:55:03
Table 'RushAndCash802365' 6-max Seat #1 is the button
Seat 1: 7e84e7dc ($14.06 in chips)
Seat 2: Hero ($13.6 in chips)
Seat 3: ee1691f8 ($7.99 in chips)
Seat 4: a96e6457 ($9.59 in chips)
Seat 5: 16665786 ($5 in chips)
Seat 6: a51bf3f3 ($3.44 in chips)
Hero: posts small blind $0.02
ee1691f8: posts big blind $0.05
*** HOLE CARDS ***
Dealt to 7e84e7dc 
Dealt to Hero [3c 5s]
Dealt to ee1691f8 
Dealt to a96e6457 
Dealt to 16665786 
Dealt to a51bf3f3 
a96e6457: calls $0.05
16665786: folds
a51bf3f3: folds
7e84e7dc: folds
Hero: folds
ee1691f8: checks
*** FLOP *** [Ac 4h As]
ee1691f8: checks
a96e6457: checks
*** TURN *** [Ac 4h As] [5c]
ee1691f8: checks
a96e6457: bets $0.12
ee1691f8: folds
Uncalled bet ($0.12) returned to a96e6457
*** SHOWDOWN ***
a96e6457 collected $0.12 from pot
*** SUMMARY ***
Total pot $0.12 | Rake $0 | Jackpot $0 | Bingo $0 | Fortune $0 | Tax $0
Board [Ac 4h As 5c]
Seat 1: 7e84e7dc (button) folded before Flop (didn't bet)
Seat 2: Hero (small blind) folded before Flop
Seat 3: ee1691f8 (big blind) folded on the Turn
Seat 4: a96e6457 won ($0.12)
Seat 5: 16665786 folded before Flop (didn't bet)
Seat 6: a51bf3f3 folded before Flop (didn't bet)


Poker Hand #RC2078575526: Hold'em No Limit ($0.02/$0.05) - 2023/12/22 21:55:00
Table 'RushAndCash802332' 6-max Seat #1 is the button
Seat 1: Hero ($13.6 in chips)
Seat 2: 4520f334 ($3.9 in chips)
Seat 3: 4d74ad6d ($5.86 in chips)
Seat 4: 10def899 ($5.4 in chips)
Seat 5: c883264a ($11.87 in chips)
Seat 6: 4ab8a557 ($7.49 in chips)
4520f334: posts small blind $0.02
4d74ad6d: posts big blind $0.05
*** HOLE CARDS ***
Dealt to Hero [8s 2d]
Dealt to 4520f334 
Dealt to 4d74ad6d 
Dealt to 10def899 
Dealt to c883264a 
Dealt to 4ab8a557 
10def899: folds
c883264a: folds
4ab8a557: raises $0.06 to $0.11
Hero: folds
4520f334: folds
4d74ad6d: raises $0.33 to $0.44
4ab8a557: calls $0.33
*** FLOP *** [3h Kh 8d]
4d74ad6d: checks
4ab8a557: checks
*** TURN *** [3h Kh 8d] [9h]
4d74ad6d: bets $0.45
4ab8a557: calls $0.45
*** RIVER *** [3h Kh 8d 9h] [Qc]
4d74ad6d: checks
4ab8a557: bets $0.56
4d74ad6d: calls $0.56
4ab8a557: shows [4h Ah] (Ace High Flush)
4d74ad6d: shows [Kc Ks] (Three Kings)
*** SHOWDOWN ***
4ab8a557 collected $2.71 from pot
*** SUMMARY ***
Total pot $2.92 | Rake $0.14 | Jackpot $0.07 | Bingo $0 | Fortune $0 | Tax $0
Board [3h Kh 8d 9h Qc]
Seat 1: Hero (button) folded before Flop (didn't bet)
Seat 2: 4520f334 (small blind) folded before Flop
Seat 3: 4d74ad6d (big blind) showed [Kc Ks] and lost with Three Kings
Seat 4: 10def899 folded before Flop (didn't bet)
Seat 5: c883264a folded before Flop (didn't bet)
Seat 6: 4ab8a557 showed [4h Ah] and won ($2.71) with Ace High Flush


Poker Hand #RC2078575462: Hold'em No Limit ($0.02/$0.05) - 2023/12/22 21:54:56
Table 'RushAndCash802301' 6-max Seat #1 is the button
Seat 1: 404f9df4 ($5.14 in chips)
Seat 2: 4cfc823 ($5 in chips)
Seat 3: 6d3488f1 ($8.38 in chips)
Seat 4: ec5f3643 ($4.49 in chips)
Seat 5: 610bd7fc ($8.43 in chips)
Seat 6: Hero ($13.6 in chips)
4cfc823: posts small blind $0.02
6d3488f1: posts big blind $0.05
*** HOLE CARDS ***
Dealt to 404f9df4 
Dealt to 4cfc823 
Dealt to 6d3488f1 
Dealt to ec5f3643 
Dealt to 610bd7fc 
Dealt to Hero [2c Qc]
ec5f3643: folds
610bd7fc: folds
Hero: folds
404f9df4: folds
4cfc823: folds
Uncalled bet ($0.03) returned to 6d3488f1
*** SHOWDOWN ***
6d3488f1 collected $0.04 from pot
*** SUMMARY ***
Total pot $0.04 | Rake $0 | Jackpot $0 | Bingo $0 | Fortune $0 | Tax $0
Seat 1: 404f9df4 (button) folded before Flop (didn't bet)
Seat 2: 4cfc823 (small blind) folded before Flop
Seat 3: 6d3488f1 (big blind) collected ($0.04)
Seat 4: ec5f3643 folded before Flop (didn't bet)
Seat 5: 610bd7fc folded before Flop (didn't bet)
Seat 6: Hero folded before Flop (didn't bet)


Poker Hand #RC2078575359: Hold'em No Limit ($0.02/$0.05) - 2023/12/22 21:54:50
Table 'RushAndCash802251' 6-max Seat #1 is the button
Seat 1: 5d55167a ($11.44 in chips)
Seat 2: 235741f1 ($8.65 in chips)
Seat 3: d71ab80c ($5.54 in chips)
Seat 4: f9df797f ($5 in chips)
Seat 5: Hero ($13.6 in chips)
Seat 6: ba0591c5 ($5 in chips)
235741f1: posts small blind $0.02
d71ab80c: posts big blind $0.05
*** HOLE CARDS ***
Dealt to 5d55167a 
Dealt to 235741f1 
Dealt to d71ab80c 
Dealt to f9df797f 
Dealt to Hero [8d 9s]
Dealt to ba0591c5 
f9df797f: raises $0.1 to $0.15
Hero: folds
ba0591c5: folds
5d55167a: calls $0.15
235741f1: folds
d71ab80c: folds
*** FLOP *** [3d 2s 6h]
f9df797f: bets $0.19
5d55167a: folds
Uncalled bet ($0.19) returned to f9df797f
*** SHOWDOWN ***
f9df797f collected $0.36 from pot
*** SUMMARY ***
Total pot $0.37 | Rake $0.01 | Jackpot $0 | Bingo $0 | Fortune $0 | Tax $0
Board [3d 2s 6h]
Seat 1: 5d55167a (button) folded on the Flop
Seat 2: 235741f1 (small blind) folded before Flop
Seat 3: d71ab80c (big blind) folded before Flop
Seat 4: f9df797f won ($0.36)
Seat 5: Hero folded before Flop (didn't bet)
Seat 6: ba0591c5 folded before Flop (didn't bet)


Poker Hand #RC2078575285: Hold'em No Limit ($0.02/$0.05) - 2023/12/22 21:54:46
Table 'RushAndCash802214' 6-max Seat #1 is the button
Seat 1: 6db75c19 ($12.16 in chips)
Seat 2: 6d3488f1 ($8.4 in chips)
Seat 3: 57689caa ($5 in chips)
Seat 4: Hero ($13.6 in chips)
Seat 5: edac6d16 ($5 in chips)
Seat 6: 86ac6ff5 ($4.41 in chips)
6d3488f1: posts small blind $0.02
57689caa: posts big blind $0.05
*** HOLE CARDS ***
Dealt to 6db75c19 
Dealt to 6d3488f1 
Dealt to 57689caa 
Dealt to Hero [8d 6d]
Dealt to edac6d16 
Dealt to 86ac6ff5 
Hero: folds
edac6d16: folds
86ac6ff5: folds
6db75c19: raises $0.08 to $0.13
6d3488f1: folds
57689caa: folds
Uncalled bet ($0.08) returned to 6db75c19
*** SHOWDOWN ***
6db75c19 collected $0.12 from pot
*** SUMMARY ***
Total pot $0.12 | Rake $0 | Jackpot $0 | Bingo $0 | Fortune $0 | Tax $0
Seat 1: 6db75c19 (button) collected ($0.12)
Seat 2: 6d3488f1 (small blind) folded before Flop
Seat 3: 57689caa (big blind) folded before Flop
Seat 4: Hero folded before Flop (didn't bet)
Seat 5: edac6d16 folded before Flop (didn't bet)
Seat 6: 86ac6ff5 folded before Flop (didn't bet)


Poker Hand #RC2078575115: Hold'em No Limit ($0.02/$0.05) - 2023/12/22 21:54:37
Table 'RushAndCash802132' 6-max Seat #1 is the button
Seat 1: 1c1fc2a1 ($9.3 in chips)
Seat 2: c4c1c89a ($8.12 in chips)
Seat 3: 25a36e51 ($1.13 in chips)
Seat 4: 777bac87 ($5.39 in chips)
Seat 5: be88ed77 ($4.44 in chips)
Seat 6: Hero ($13.6 in chips)
c4c1c89a: posts small blind $0.02
25a36e51: posts big blind $0.05
*** HOLE CARDS ***
Dealt to 1c1fc2a1 
Dealt to c4c1c89a 
Dealt to 25a36e51 
Dealt to 777bac87 
Dealt to be88ed77 
Dealt to Hero [Kh Tc]
777bac87: raises $0.07 to $0.12
be88ed77: calls $0.12
Hero: folds
1c1fc2a1: raises $0.33 to $0.45
c4c1c89a: folds
25a36e51: folds
777bac87: raises $0.73 to $1.18
be88ed77: folds
1c1fc2a1: calls $0.73
*** FLOP *** [Jd 6h 9h]
777bac87: bets $0.6
1c1fc2a1: calls $0.6
*** TURN *** [Jd 6h 9h] [6c]
777bac87: checks
1c1fc2a1: bets $7.52 and is all-in
777bac87: calls $3.61 and is all-in
Uncalled bet ($3.91) returned to 1c1fc2a1
1c1fc2a1: shows [Ah Ac] (Pair of Aces and Pair of Sixes)
777bac87: shows [Th Ts] (Pair of Tens and Pair of Sixes)
*** RIVER *** [Jd 6h 9h 6c] [8d]
*** SHOWDOWN ***
1c1fc2a1 collected $10.75 from pot
*** SUMMARY ***
Total pot $10.97 | Rake $0.15 | Jackpot $0.07 | Bingo $0 | Fortune $0 | Tax $0
Board [Jd 6h 9h 6c 8d]
Seat 1: 1c1fc2a1 (button) showed [Ah Ac] and won ($10.75) with Pair of Aces and Pair of Sixes
Seat 2: c4c1c89a (small blind) folded before Flop
Seat 3: 25a36e51 (big blind) folded before Flop
Seat 4: 777bac87 showed [Th Ts] and lost with Pair of Tens and Pair of Sixes
Seat 5: be88ed77 folded before Flop
Seat 6: Hero folded before Flop (didn't bet)


Poker Hand #RC2078575027: Hold'em No Limit ($0.02/$0.05) - 2023/12/22 21:54:32
Table 'RushAndCash802088' 6-max Seat #1 is the button
Seat 1: c2881b52 ($8.27 in chips)
Seat 2: 48b86f00 ($4.78 in chips)
Seat 3: 645d1c61 ($0.25 in chips)
Seat 4: Hero ($13.6 in chips)
Seat 5: 2afe98d4 ($4.69 in chips)
Seat 6: 22e89a1b ($5.8 in chips)
48b86f00: posts small blind $0.02
645d1c61: posts big blind $0.05
*** HOLE CARDS ***
Dealt to c2881b52 
Dealt to 48b86f00 
Dealt to 645d1c61 
Dealt to Hero [Jc 2h]
Dealt to 2afe98d4 
Dealt to 22e89a1b 
Hero: folds
2afe98d4: folds
22e89a1b: raises $0.08 to $0.13
c2881b52: folds
48b86f00: folds
645d1c61: calls $0.08
*** FLOP *** [Qh 7c Th]
645d1c61: checks
22e89a1b: bets $0.14
645d1c61: folds
Uncalled bet ($0.14) returned to 22e89a1b
*** SHOWDOWN ***
22e89a1b collected $0.27 from pot
*** SUMMARY ***
Total pot $0.28 | Rake $0.01 | Jackpot $0 | Bingo $0 | Fortune $0 | Tax $0
Board [Qh 7c Th]
Seat 1: c2881b52 (button) folded before Flop (didn't bet)
Seat 2: 48b86f00 (small blind) folded before Flop
Seat 3: 645d1c61 (big blind) folded on the Flop
Seat 4: Hero folded before Flop (didn't bet)
Seat 5: 2afe98d4 folded before Flop (didn't bet)
Seat 6: 22e89a1b won ($0.27)


Poker Hand #RC2078574754: Hold'em No Limit ($0.02/$0.05) - 2023/12/22 21:54:17
Table 'RushAndCash801950' 6-max Seat #1 is the button
Seat 1: 800589cd ($5.07 in chips)
Seat 2: f43dd94b ($5.11 in chips)
Seat 3: Hero ($13.65 in chips)
Seat 4: 1d81a4c5 ($9.02 in chips)
Seat 5: eadbd152 ($5.32 in chips)
Seat 6: 7faa6e20 ($7.28 in chips)
f43dd94b: posts small blind $0.02
Hero: posts big blind $0.05
*** HOLE CARDS ***
Dealt to 800589cd 
Dealt to f43dd94b 
Dealt to Hero [2c 9d]
Dealt to 1d81a4c5 
Dealt to eadbd152 
Dealt to 7faa6e20 
1d81a4c5: folds
eadbd152: folds
7faa6e20: raises $0.05 to $0.1
800589cd: folds
f43dd94b: folds
Hero: folds
Uncalled bet ($0.05) returned to 7faa6e20
*** SHOWDOWN ***
7faa6e20 collected $0.12 from pot
*** SUMMARY ***
Total pot $0.12 | Rake $0 | Jackpot $0 | Bingo $0 | Fortune $0 | Tax $0
Seat 1: 800589cd (button) folded before Flop (didn't bet)
Seat 2: f43dd94b (small blind) folded before Flop
Seat 3: Hero (big blind) folded before Flop
Seat 4: 1d81a4c5 folded before Flop (didn't bet)
Seat 5: eadbd152 folded before Flop (didn't bet)
Seat 6: 7faa6e20 collected ($0.12)


Poker Hand #RC2078544522: Hold'em No Limit ($0.02/$0.05) - 2023/12/22 21:54:03
Table 'RushAndCash801841' 6-max Seat #1 is the button
Seat 1: f6b5f68e ($6 in chips)
Seat 2: Hero ($13.6 in chips)
Seat 3: e3e578eb ($5 in chips)
Seat 4: 725fcf25 ($5.43 in chips)
Seat 5: 739da512 ($5 in chips)
Seat 6: 610bd7fc ($8.5 in chips)
Hero: posts small blind $0.02
e3e578eb: posts big blind $0.05
*** HOLE CARDS ***
Dealt to f6b5f68e 
Dealt to Hero [4s 5d]
Dealt to e3e578eb 
Dealt to 725fcf25 
Dealt to 739da512 
Dealt to 610bd7fc 
725fcf25: folds
739da512: folds
610bd7fc: folds
f6b5f68e: folds
Hero: folds
Uncalled bet ($0.03) returned to e3e578eb
*** SHOWDOWN ***
e3e578eb collected $0.04 from pot
*** SUMMARY ***
Total pot $0.04 | Rake $0 | Jackpot $0 | Bingo $0 | Fortune $0 | Tax $0
Seat 1: f6b5f68e (button) folded before Flop (didn't bet)
Seat 2: Hero (small blind) folded before Flop
Seat 3: e3e578eb (big blind) collected ($0.04)
Seat 4: 725fcf25 folded before Flop (didn't bet)
Seat 5: 739da512 folded before Flop (didn't bet)
Seat 6: 610bd7fc folded before Flop (didn't bet)


Poker Hand #RC2078544462: Hold'em No Limit ($0.02/$0.05) - 2023/12/22 21:54:00
Table 'RushAndCash801814' 6-max Seat #1 is the button
Seat 1: ea9bed4a ($6.58 in chips)
Seat 2: 8d94440d ($6.03 in chips)
Seat 3: 5f11c3da ($14.78 in chips)
Seat 4: 39956d46 ($5 in chips)
Seat 5: 28e8fd4 ($10.96 in chips)
Seat 6: Hero ($13.6 in chips)
8d94440d: posts small blind $0.02
5f11c3da: posts big blind $0.05
*** HOLE CARDS ***
Dealt to ea9bed4a 
Dealt to 8d94440d 
Dealt to 5f11c3da 
Dealt to 39956d46 
Dealt to 28e8fd4 
Dealt to Hero [2c Kh]
39956d46: folds
28e8fd4: folds
Hero: folds
ea9bed4a: folds
8d94440d: folds
Uncalled bet ($0.03) returned to 5f11c3da
*** SHOWDOWN ***
5f11c3da collected $0.04 from pot
*** SUMMARY ***
Total pot $0.04 | Rake $0 | Jackpot $0 | Bingo $0 | Fortune $0 | Tax $0
Seat 1: ea9bed4a (button) folded before Flop (didn't bet)
Seat 2: 8d94440d (small blind) folded before Flop
Seat 3: 5f11c3da (big blind) collected ($0.04)
Seat 4: 39956d46 folded before Flop (didn't bet)
Seat 5: 28e8fd4 folded before Flop (didn't bet)
Seat 6: Hero folded before Flop (didn't bet)


Poker Hand #RC2078544398: Hold'em No Limit ($0.02/$0.05) - 2023/12/22 21:53:56
Table 'RushAndCash801784' 6-max Seat #1 is the button
Seat 1: Hero ($13.6 in chips)
Seat 2: 90b5844 ($4.93 in chips)
Seat 3: 41270a9a ($5.07 in chips)
Seat 4: 57ecfe0 ($5.16 in chips)
Seat 5: 517da49 ($10.39 in chips)
Seat 6: 6d3323f ($16.62 in chips)
90b5844: posts small blind $0.02
41270a9a: posts big blind $0.05
*** HOLE CARDS ***
Dealt to Hero [3c Ks]
Dealt to 90b5844 
Dealt to 41270a9a 
Dealt to 57ecfe0 
Dealt to 517da49 
Dealt to 6d3323f 
57ecfe0: raises $0.05 to $0.1
517da49: calls $0.1
6d3323f: folds
Hero: folds
90b5844: folds
41270a9a: calls $0.05
*** FLOP *** [Kd 6h Qc]
41270a9a: checks
57ecfe0: checks
517da49: checks
*** TURN *** [Kd 6h Qc] [Ad]
41270a9a: checks
57ecfe0: bets $0.24
517da49: calls $0.24
41270a9a: calls $0.24
*** RIVER *** [Kd 6h Qc Ad] [7h]
41270a9a: checks
57ecfe0: checks
517da49: checks
41270a9a: shows [Js Ah] (Pair of Aces)
57ecfe0: shows [7s 5s] (Pair of Sevens)
517da49: shows [As 9h] (Pair of Aces)
*** SHOWDOWN ***
41270a9a collected $0.99 from pot
*** SUMMARY ***
Total pot $1.04 | Rake $0.05 | Jackpot $0 | Bingo $0 | Fortune $0 | Tax $0
Board [Kd 6h Qc Ad 7h]
Seat 1: Hero (button) folded before Flop (didn't bet)
Seat 2: 90b5844 (small blind) folded before Flop
Seat 3: 41270a9a (big blind) showed [Js Ah] and won ($0.99) with Pair of Aces
Seat 4: 57ecfe0 showed [7s 5s] and lost with Pair of Sevens
Seat 5: 517da49 showed [As 9h] and lost with Pair of Aces
Seat 6: 6d3323f folded before Flop (didn't bet)


Poker Hand #RC2078544269: Hold'em No Limit ($0.02/$0.05) - 2023/12/22 21:53:50
Table 'RushAndCash801719' 6-max Seat #1 is the button
Seat 1: c90c0909 ($5 in chips)
Seat 2: Hero ($13.62 in chips)
Seat 3: db264244 ($5.88 in chips)
Seat 4: f71b25e9 ($8.93 in chips)
Seat 5: 2d4acc60 ($3.46 in chips)
Seat 6: 19d300cc ($9.29 in chips)
Hero: posts small blind $0.02
db264244: posts big blind $0.05
*** HOLE CARDS ***
Dealt to c90c0909 
Dealt to Hero [9h 6h]
Dealt to db264244 
Dealt to f71b25e9 
Dealt to 2d4acc60 
Dealt to 19d300cc 
f71b25e9: raises $0.05 to $0.1
2d4acc60: folds
19d300cc: folds
c90c0909: folds
Hero: folds
db264244: folds
Uncalled bet ($0.05) returned to f71b25e9
*** SHOWDOWN ***
f71b25e9 collected $0.12 from pot
*** SUMMARY ***
Total pot $0.12 | Rake $0 | Jackpot $0 | Bingo $0 | Fortune $0 | Tax $0
Seat 1: c90c0909 (button) folded before Flop (didn't bet)
Seat 2: Hero (small blind) folded before Flop
Seat 3: db264244 (big blind) folded before Flop
Seat 4: f71b25e9 collected ($0.12)
Seat 5: 2d4acc60 folded before Flop (didn't bet)
Seat 6: 19d300cc folded before Flop (didn't bet)


Poker Hand #RC2078544200: Hold'em No Limit ($0.02/$0.05) - 2023/12/22 21:53:45
Table 'RushAndCash801682' 6-max Seat #1 is the button
Seat 1: c3c9a58d ($8.88 in chips)
Seat 2: 521feab9 ($5.68 in chips)
Seat 3: Hero ($13.67 in chips)
Seat 4: e1423689 ($5.23 in chips)
Seat 5: b6dafb38 ($5.08 in chips)
Seat 6: 30035928 ($4.62 in chips)
521feab9: posts small blind $0.02
Hero: posts big blind $0.05
*** HOLE CARDS ***
Dealt to c3c9a58d 
Dealt to 521feab9 
Dealt to Hero [Js 6d]
Dealt to e1423689 
Dealt to b6dafb38 
Dealt to 30035928 
e1423689: folds
b6dafb38: folds
30035928: folds
c3c9a58d: folds
521feab9: folds
Uncalled bet ($0.03) returned to Hero
*** SHOWDOWN ***
Hero collected $0.04 from pot
*** SUMMARY ***
Total pot $0.04 | Rake $0 | Jackpot $0 | Bingo $0 | Fortune $0 | Tax $0
Seat 1: c3c9a58d (button) folded before Flop (didn't bet)
Seat 2: 521feab9 (small blind) folded before Flop
Seat 3: Hero (big blind) collected ($0.04)
Seat 4: e1423689 folded before Flop (didn't bet)
Seat 5: b6dafb38 folded before Flop (didn't bet)
Seat 6: 30035928 folded before Flop (didn't bet)


Poker Hand #RC2078544107: Hold'em No Limit ($0.02/$0.05) - 2023/12/22 21:53:40
Table 'RushAndCash801638' 6-max Seat #1 is the button
Seat 1: 6db75c19 ($12.02 in chips)
Seat 2: fcb65fa9 ($2.86 in chips)
Seat 3: b0755516 ($5.19 in chips)
Seat 4: 9e4b1c03 ($7.48 in chips)
Seat 5: Hero ($13.67 in chips)
Seat 6: 4f704fa2 ($5.3 in chips)
fcb65fa9: posts small blind $0.02
b0755516: posts big blind $0.05
*** HOLE CARDS ***
Dealt to 6db75c19 
Dealt to fcb65fa9 
Dealt to b0755516 
Dealt to 9e4b1c03 
Dealt to Hero [4h 3s]
Dealt to 4f704fa2 
9e4b1c03: folds
Hero: folds
4f704fa2: folds
6db75c19: raises $0.08 to $0.13
fcb65fa9: folds
b0755516: calls $0.08
*** FLOP *** [5h Kd As]
b0755516: checks
6db75c19: bets $0.07
b0755516: folds
Uncalled bet ($0.07) returned to 6db75c19
*** SHOWDOWN ***
6db75c19 collected $0.27 from pot
*** SUMMARY ***
Total pot $0.28 | Rake $0.01 | Jackpot $0 | Bingo $0 | Fortune $0 | Tax $0
Board [5h Kd As]
Seat 1: 6db75c19 (button) won ($0.27)
Seat 2: fcb65fa9 (small blind) folded before Flop
Seat 3: b0755516 (big blind) folded on the Flop
Seat 4: 9e4b1c03 folded before Flop (didn't bet)
Seat 5: Hero folded before Flop (didn't bet)
Seat 6: 4f704fa2 folded before Flop (didn't bet)


Poker Hand #RC2078543903: Hold'em No Limit ($0.02/$0.05) - 2023/12/22 21:53:28
Table 'RushAndCash801545' 6-max Seat #1 is the button
Seat 1: Hero ($13.67 in chips)
Seat 2: 2f2fbc2 ($2.43 in chips)
Seat 3: 4e73adeb ($5 in chips)
Seat 4: c53293cf ($6.62 in chips)
Seat 5: 9dcfc86d ($4.46 in chips)
Seat 6: 177da66b ($7.86 in chips)
2f2fbc2: posts small blind $0.02
4e73adeb: posts big blind $0.05
*** HOLE CARDS ***
Dealt to Hero [Qc Ts]
Dealt to 2f2fbc2 
Dealt to 4e73adeb 
Dealt to c53293cf 
Dealt to 9dcfc86d 
Dealt to 177da66b 
c53293cf: folds
9dcfc86d: raises $0.05 to $0.1
177da66b: folds
Hero: folds
2f2fbc2: folds
4e73adeb: folds
Uncalled bet ($0.05) returned to 9dcfc86d
*** SHOWDOWN ***
9dcfc86d collected $0.12 from pot
*** SUMMARY ***
Total pot $0.12 | Rake $0 | Jackpot $0 | Bingo $0 | Fortune $0 | Tax $0
Seat 1: Hero (button) folded before Flop (didn't bet)
Seat 2: 2f2fbc2 (small blind) folded before Flop
Seat 3: 4e73adeb (big blind) folded before Flop
Seat 4: c53293cf folded before Flop (didn't bet)
Seat 5: 9dcfc86d collected ($0.12)
Seat 6: 177da66b folded before Flop (didn't bet)


Poker Hand #RC2078543843: Hold'em No Limit ($0.02/$0.05) - 2023/12/22 21:53:25
Table 'RushAndCash801516' 6-max Seat #1 is the button
Seat 1: 8a8eafe4 ($3.82 in chips)
Seat 2: fab544c8 ($6.22 in chips)
Seat 3: a556b687 ($4.68 in chips)
Seat 4: 50868c5b ($1.69 in chips)
Seat 5: Hero ($13.67 in chips)
Seat 6: 2f2fbc2 ($2.43 in chips)
fab544c8: posts small blind $0.02
a556b687: posts big blind $0.05
*** HOLE CARDS ***
Dealt to 8a8eafe4 
Dealt to fab544c8 
Dealt to a556b687 
Dealt to 50868c5b 
Dealt to Hero [6d Jc]
Dealt to 2f2fbc2 
50868c5b: folds
Hero: folds
2f2fbc2: folds
8a8eafe4: folds
fab544c8: folds
Uncalled bet ($0.03) returned to a556b687
*** SHOWDOWN ***
a556b687 collected $0.04 from pot
*** SUMMARY ***
Total pot $0.04 | Rake $0 | Jackpot $0 | Bingo $0 | Fortune $0 | Tax $0
Seat 1: 8a8eafe4 (button) folded before Flop (didn't bet)
Seat 2: fab544c8 (small blind) folded before Flop
Seat 3: a556b687 (big blind) collected ($0.04)
Seat 4: 50868c5b folded before Flop (didn't bet)
Seat 5: Hero folded before Flop (didn't bet)
Seat 6: 2f2fbc2 folded before Flop (didn't bet)


Poker Hand #RC2078543087: Hold'em No Limit ($0.02/$0.05) - 2023/12/22 21:52:39
Table 'RushAndCash801169' 6-max Seat #1 is the button
Seat 1: Hero ($13.17 in chips)
Seat 2: 525db62f ($5.92 in chips)
Seat 3: 4eb22595 ($8.89 in chips)
Seat 4: 7f067c94 ($41.99 in chips)
Seat 5: 9a9a6ce2 ($5.09 in chips)
Seat 6: eb32f25a ($5.31 in chips)
525db62f: posts small blind $0.02
4eb22595: posts big blind $0.05
*** HOLE CARDS ***
Dealt to Hero [Ks Jc]
Dealt to 525db62f 
Dealt to 4eb22595 
Dealt to 7f067c94 
Dealt to 9a9a6ce2 
Dealt to eb32f25a 
7f067c94: folds
9a9a6ce2: folds
eb32f25a: folds
Hero: raises $0.08 to $0.13
525db62f: folds
4eb22595: calls $0.08
*** FLOP *** [Tc Qd 9h]
4eb22595: checks
Hero: checks
*** TURN *** [Tc Qd 9h] [5h]
4eb22595: bets $0.1
Hero: raises $0.3 to $0.4
4eb22595: calls $0.3
*** RIVER *** [Tc Qd 9h 5h] [7h]
4eb22595: checks
Hero: bets $0.54
4eb22595: folds
Uncalled bet ($0.54) returned to Hero
*** SHOWDOWN ***
Hero collected $1.03 from pot
*** SUMMARY ***
Total pot $1.08 | Rake $0.05 | Jackpot $0 | Bingo $0 | Fortune $0 | Tax $0
Board [Tc Qd 9h 5h 7h]
Seat 1: Hero (button) won ($1.03)
Seat 2: 525db62f (small blind) folded before Flop
Seat 3: 4eb22595 (big blind) folded on the River
Seat 4: 7f067c94 folded before Flop (didn't bet)
Seat 5: 9a9a6ce2 folded before Flop (didn't bet)
Seat 6: eb32f25a folded before Flop (didn't bet)


Poker Hand #RC2078543023: Hold'em No Limit ($0.02/$0.05) - 2023/12/22 21:52:36
Table 'RushAndCash801142' 6-max Seat #1 is the button
Seat 1: ca0b098f ($5 in chips)
Seat 2: d9ec3117 ($5.17 in chips)
Seat 3: 4d43d419 ($5.51 in chips)
Seat 4: 22e89a1b ($5.17 in chips)
Seat 5: Hero ($13.17 in chips)
Seat 6: aeeb0181 ($11.11 in chips)
d9ec3117: posts small blind $0.02
4d43d419: posts big blind $0.05
*** HOLE CARDS ***
Dealt to ca0b098f 
Dealt to d9ec3117 
Dealt to 4d43d419 
Dealt to 22e89a1b 
Dealt to Hero [Qd 9h]
Dealt to aeeb0181 
22e89a1b: folds
Hero: folds
aeeb0181: folds
ca0b098f: folds
d9ec3117: folds
Uncalled bet ($0.03) returned to 4d43d419
*** SHOWDOWN ***
4d43d419 collected $0.04 from pot
*** SUMMARY ***
Total pot $0.04 | Rake $0 | Jackpot $0 | Bingo $0 | Fortune $0 | Tax $0
Seat 1: ca0b098f (button) folded before Flop (didn't bet)
Seat 2: d9ec3117 (small blind) folded before Flop
Seat 3: 4d43d419 (big blind) collected ($0.04)
Seat 4: 22e89a1b folded before Flop (didn't bet)
Seat 5: Hero folded before Flop (didn't bet)
Seat 6: aeeb0181 folded before Flop (didn't bet)


Poker Hand #RC2078542809: Hold'em No Limit ($0.02/$0.05) - 2023/12/22 21:52:23
Table 'RushAndCash801045' 6-max Seat #1 is the button
Seat 1: 851fc2ef ($10.35 in chips)
Seat 2: e8e3d92 ($5.09 in chips)
Seat 3: Hero ($13.22 in chips)
Seat 4: 4cfc823 ($5.61 in chips)
Seat 5: 566b7ee3 ($5.59 in chips)
Seat 6: acefe839 ($14.35 in chips)
e8e3d92: posts small blind $0.02
Hero: posts big blind $0.05
*** HOLE CARDS ***
Dealt to 851fc2ef 
Dealt to e8e3d92 
Dealt to Hero [8c Qh]
Dealt to 4cfc823 
Dealt to 566b7ee3 
Dealt to acefe839 
4cfc823: folds
566b7ee3: folds
acefe839: raises $0.07 to $0.12
851fc2ef: folds
e8e3d92: folds
Hero: folds
Uncalled bet ($0.07) returned to acefe839
*** SHOWDOWN ***
acefe839 collected $0.12 from pot
*** SUMMARY ***
Total pot $0.12 | Rake $0 | Jackpot $0 | Bingo $0 | Fortune $0 | Tax $0
Seat 1: 851fc2ef (button) folded before Flop (didn't bet)
Seat 2: e8e3d92 (small blind) folded before Flop
Seat 3: Hero (big blind) folded before Flop
Seat 4: 4cfc823 folded before Flop (didn't bet)
Seat 5: 566b7ee3 folded before Flop (didn't bet)
Seat 6: acefe839 collected ($0.12)


Poker Hand #RC2078542751: Hold'em No Limit ($0.02/$0.05) - 2023/12/22 21:52:20
Table 'RushAndCash801021' 6-max Seat #1 is the button
Seat 1: 725fcf25 ($5.46 in chips)
Seat 2: f7ea1894 ($7.09 in chips)
Seat 3: 58d49a14 ($4.86 in chips)
Seat 4: Hero ($13.22 in chips)
Seat 5: 2fb7c647 ($2.45 in chips)
Seat 6: 4c0d7324 ($6.48 in chips)
f7ea1894: posts small blind $0.02
58d49a14: posts big blind $0.05
*** HOLE CARDS ***
Dealt to 725fcf25 
Dealt to f7ea1894 
Dealt to 58d49a14 
Dealt to Hero [Jc 9s]
Dealt to 2fb7c647 
Dealt to 4c0d7324 
Hero: folds
2fb7c647: folds
4c0d7324: raises $0.1 to $0.15
725fcf25: calls $0.15
f7ea1894: folds
58d49a14: calls $0.1
*** FLOP *** [3d 3c Ac]
58d49a14: checks
4c0d7324: bets $0.36
725fcf25: folds
58d49a14: folds
Uncalled bet ($0.36) returned to 4c0d7324
*** SHOWDOWN ***
4c0d7324 collected $0.45 from pot
*** SUMMARY ***
Total pot $0.47 | Rake $0.02 | Jackpot $0 | Bingo $0 | Fortune $0 | Tax $0
Board [3d 3c Ac]
Seat 1: 725fcf25 (button) folded on the Flop
Seat 2: f7ea1894 (small blind) folded before Flop
Seat 3: 58d49a14 (big blind) folded on the Flop
Seat 4: Hero folded before Flop (didn't bet)
Seat 5: 2fb7c647 folded before Flop (didn't bet)
Seat 6: 4c0d7324 won ($0.45)


Poker Hand #RC2078541907: Hold'em No Limit ($0.02/$0.05) - 2023/12/22 21:51:33
Table 'RushAndCash800607' 6-max Seat #1 is the button
Seat 1: 7faa6e20 ($7.84 in chips)
Seat 2: Hero ($7.99 in chips)
Seat 3: b75c858f ($5.45 in chips)
Seat 4: bf8416dc ($2.76 in chips)
Seat 5: d4f131dd ($5 in chips)
Seat 6: e0e4307b ($5.95 in chips)
Hero: posts small blind $0.02
b75c858f: posts big blind $0.05
*** HOLE CARDS ***
Dealt to 7faa6e20 
Dealt to Hero [Kd Kc]
Dealt to b75c858f 
Dealt to bf8416dc 
Dealt to d4f131dd 
Dealt to e0e4307b 
bf8416dc: folds
d4f131dd: folds
e0e4307b: folds
7faa6e20: folds
Hero: raises $0.1 to $0.15
b75c858f: raises $0.3 to $0.45
Hero: raises $7.54 to $7.99 and is all-in
b75c858f: calls $5 and is all-in
Uncalled bet ($2.54) returned to Hero
Hero: shows [Kd Kc]
b75c858f: shows [Jc Jh]
*** FLOP *** [4c 6d Ad]
*** TURN *** [4c 6d Ad] [Qd]
*** RIVER *** [4c 6d Ad Qd] [Ah]
*** SHOWDOWN ***
Hero collected $10.68 from pot
*** SUMMARY ***
Total pot $10.9 | Rake $0.15 | Jackpot $0.07 | Bingo $0 | Fortune $0 | Tax $0
Board [4c 6d Ad Qd Ah]
Seat 1: 7faa6e20 (button) folded before Flop (didn't bet)
Seat 2: Hero (small blind) showed [Kd Kc] and won ($10.68) with Pair of Aces and Pair of Kings
Seat 3: b75c858f (big blind) showed [Jc Jh] and lost with Pair of Aces and Pair of Jacks
Seat 4: bf8416dc folded before Flop (didn't bet)
Seat 5: d4f131dd folded before Flop (didn't bet)
Seat 6: e0e4307b folded before Flop (didn't bet)


Poker Hand #RC2078541583: Hold'em No Limit ($0.02/$0.05) - 2023/12/22 21:51:14
Table 'RushAndCash800446' 6-max Seat #1 is the button
Seat 1: 846054b0 ($10.92 in chips)
Seat 2: d0f6c873 ($6.56 in chips)
Seat 3: 8f80311 ($7.22 in chips)
Seat 4: 2486bc4b ($5.12 in chips)
Seat 5: 8a8eafe4 ($5.89 in chips)
Seat 6: Hero ($7.99 in chips)
d0f6c873: posts small blind $0.02
8f80311: posts big blind $0.05
*** HOLE CARDS ***
Dealt to 846054b0 
Dealt to d0f6c873 
Dealt to 8f80311 
Dealt to 2486bc4b 
Dealt to 8a8eafe4 
Dealt to Hero [9s 7s]
2486bc4b: folds
8a8eafe4: folds
Hero: folds
846054b0: folds
d0f6c873: raises $0.08 to $0.13
8f80311: calls $0.08
*** FLOP *** [Td 4c Qs]
d0f6c873: bets $0.09
8f80311: calls $0.09
*** TURN *** [Td 4c Qs] [2h]
d0f6c873: bets $0.1
8f80311: calls $0.1
*** RIVER *** [Td 4c Qs 2h] [3d]
d0f6c873: bets $0.64
8f80311: folds
Uncalled bet ($0.64) returned to d0f6c873
*** SHOWDOWN ***
d0f6c873 collected $0.61 from pot
*** SUMMARY ***
Total pot $0.64 | Rake $0.03 | Jackpot $0 | Bingo $0 | Fortune $0 | Tax $0
Board [Td 4c Qs 2h 3d]
Seat 1: 846054b0 (button) folded before Flop (didn't bet)
Seat 2: d0f6c873 (small blind) won ($0.61)
Seat 3: 8f80311 (big blind) folded on the River
Seat 4: 2486bc4b folded before Flop (didn't bet)
Seat 5: 8a8eafe4 folded before Flop (didn't bet)
Seat 6: Hero folded before Flop (didn't bet)


Poker Hand #RC2078540964: Hold'em No Limit ($0.02/$0.05) - 2023/12/22 21:50:37
Table 'RushAndCash800149' 6-max Seat #1 is the button
Seat 1: Hero ($7.78 in chips)
Seat 2: 987954e ($5.02 in chips)
Seat 3: ce05a1d5 ($4.98 in chips)
Seat 4: 8f80311 ($7.37 in chips)
Seat 5: b4aaf9de ($9.83 in chips)
Seat 6: 9d93c43e ($5.08 in chips)
987954e: posts small blind $0.02
ce05a1d5: posts big blind $0.05
*** HOLE CARDS ***
Dealt to Hero [7s 7c]
Dealt to 987954e 
Dealt to ce05a1d5 
Dealt to 8f80311 
Dealt to b4aaf9de 
Dealt to 9d93c43e 
8f80311: raises $0.1 to $0.15
b4aaf9de: folds
9d93c43e: folds
Hero: calls $0.15
987954e: folds
ce05a1d5: folds
*** FLOP *** [6s 9s 9c]
8f80311: checks
Hero: checks
*** TURN *** [6s 9s 9c] [4h]
8f80311: checks
Hero: checks
*** RIVER *** [6s 9s 9c 4h] [3h]
8f80311: checks
Hero: checks
8f80311: shows [8d Kd] (Pair of Nines)
Hero: shows [7s 7c] (Pair of Nines and Pair of Sevens)
*** SHOWDOWN ***
Hero collected $0.36 from pot
*** SUMMARY ***
Total pot $0.37 | Rake $0.01 | Jackpot $0 | Bingo $0 | Fortune $0 | Tax $0
Board [6s 9s 9c 4h 3h]
Seat 1: Hero (button) showed [7s 7c] and won ($0.36) with Pair of Nines and Pair of Sevens
Seat 2: 987954e (small blind) folded before Flop
Seat 3: ce05a1d5 (big blind) folded before Flop
Seat 4: 8f80311 showed [8d Kd] and lost with Pair of Nines
Seat 5: b4aaf9de folded before Flop (didn't bet)
Seat 6: 9d93c43e folded before Flop (didn't bet)


Poker Hand #RC2078540899: Hold'em No Limit ($0.02/$0.05) - 2023/12/22 21:50:34
Table 'RushAndCash800120' 6-max Seat #1 is the button
Seat 1: efbf8ee8 ($6.24 in chips)
Seat 2: 3a20c3a ($5 in chips)
Seat 3: 3056048f ($5.7 in chips)
Seat 4: Hero ($7.78 in chips)
Seat 5: c71b7029 ($9.91 in chips)
Seat 6: 2f2fbc2 ($2.39 in chips)
3a20c3a: posts small blind $0.02
3056048f: posts big blind $0.05
*** HOLE CARDS ***
Dealt to efbf8ee8 
Dealt to 3a20c3a 
Dealt to 3056048f 
Dealt to Hero [9s Kc]
Dealt to c71b7029 
Dealt to 2f2fbc2 
Hero: folds
c71b7029: folds
2f2fbc2: raises $0.06 to $0.11
efbf8ee8: folds
3a20c3a: folds
3056048f: calls $0.06
*** FLOP *** [2d 9d 8h]
3056048f: checks
2f2fbc2: bets $0.12
3056048f: folds
Uncalled bet ($0.12) returned to 2f2fbc2
*** SHOWDOWN ***
2f2fbc2 collected $0.23 from pot
*** SUMMARY ***
Total pot $0.24 | Rake $0.01 | Jackpot $0 | Bingo $0 | Fortune $0 | Tax $0
Board [2d 9d 8h]
Seat 1: efbf8ee8 (button) folded before Flop (didn't bet)
Seat 2: 3a20c3a (small blind) folded before Flop
Seat 3: 3056048f (big blind) folded on the Flop
Seat 4: Hero folded before Flop (didn't bet)
Seat 5: c71b7029 folded before Flop (didn't bet)
Seat 6: 2f2fbc2 won ($0.23)


Poker Hand #RC2078540728: Hold'em No Limit ($0.02/$0.05) - 2023/12/22 21:50:24
Table 'RushAndCash800037' 6-max Seat #1 is the button
Seat 1: 92c87aad ($5.02 in chips)
Seat 2: 3af04913 ($3.67 in chips)
Seat 3: Hero ($7.83 in chips)
Seat 4: 5a946c5b ($5.27 in chips)
Seat 5: b9aa0c94 ($30.12 in chips)
Seat 6: 42b297d3 ($1.97 in chips)
3af04913: posts small blind $0.02
Hero: posts big blind $0.05
*** HOLE CARDS ***
Dealt to 92c87aad 
Dealt to 3af04913 
Dealt to Hero [Kh 3s]
Dealt to 5a946c5b 
Dealt to b9aa0c94 
Dealt to 42b297d3 
5a946c5b: folds
b9aa0c94: raises $0.05 to $0.1
42b297d3: raises $0.14 to $0.24
92c87aad: folds
3af04913: folds
Hero: folds
b9aa0c94: raises $29.88 to $30.12 and is all-in
42b297d3: calls $1.73 and is all-in
Uncalled bet ($28.15) returned to b9aa0c94
b9aa0c94: shows [Tc Th]
42b297d3: shows [9c 7c]
*** FLOP *** [Jd 3c Js]
*** TURN *** [Jd 3c Js] [2d]
*** RIVER *** [Jd 3c Js 2d] [6d]
*** SHOWDOWN ***
b9aa0c94 collected $3.79 from pot
*** SUMMARY ***
Total pot $4.01 | Rake $0.15 | Jackpot $0.07 | Bingo $0 | Fortune $0 | Tax $0
Board [Jd 3c Js 2d 6d]
Seat 1: 92c87aad (button) folded before Flop (didn't bet)
Seat 2: 3af04913 (small blind) folded before Flop
Seat 3: Hero (big blind) folded before Flop
Seat 4: 5a946c5b folded before Flop (didn't bet)
Seat 5: b9aa0c94 showed [Tc Th] and won ($3.79) with Pair of Jacks and Pair of Tens
Seat 6: 42b297d3 showed [9c 7c] and lost with Pair of Jacks


Poker Hand #RC2078540446: Hold'em No Limit ($0.02/$0.05) - 2023/12/22 21:50:09
Table 'RushAndCash799895' 6-max Seat #1 is the button
Seat 1: 6da90cdc ($5 in chips)
Seat 2: Hero ($7.78 in chips)
Seat 3: 2588276e ($11.31 in chips)
Seat 4: 7f067c94 ($42.17 in chips)
Seat 5: e65ad772 ($17.03 in chips)
Seat 6: 7016689e ($5.53 in chips)
Hero: posts small blind $0.02
2588276e: posts big blind $0.05
*** HOLE CARDS ***
Dealt to 6da90cdc 
Dealt to Hero [9c As]
Dealt to 2588276e 
Dealt to 7f067c94 
Dealt to e65ad772 
Dealt to 7016689e 
7f067c94: folds
e65ad772: folds
7016689e: folds
6da90cdc: folds
Hero: raises $0.1 to $0.15
2588276e: folds
Uncalled bet ($0.1) returned to Hero
*** SHOWDOWN ***
Hero collected $0.1 from pot
*** SUMMARY ***
Total pot $0.1 | Rake $0 | Jackpot $0 | Bingo $0 | Fortune $0 | Tax $0
Seat 1: 6da90cdc (button) folded before Flop (didn't bet)
Seat 2: Hero (small blind) collected ($0.1)
Seat 3: 2588276e (big blind) folded before Flop
Seat 4: 7f067c94 folded before Flop (didn't bet)
Seat 5: e65ad772 folded before Flop (didn't bet)
Seat 6: 7016689e folded before Flop (didn't bet)


Poker Hand #RC2078540384: Hold'em No Limit ($0.02/$0.05) - 2023/12/22 21:50:05
Table 'RushAndCash799862' 6-max Seat #1 is the button
Seat 1: 111c92ae ($5.2 in chips)
Seat 2: bc118b95 ($5.54 in chips)
Seat 3: 424d372d ($9.19 in chips)
Seat 4: 7f067c94 ($42.17 in chips)
Seat 5: Hero ($7.78 in chips)
Seat 6: e91020c6 ($5.51 in chips)
bc118b95: posts small blind $0.02
424d372d: posts big blind $0.05
*** HOLE CARDS ***
Dealt to 111c92ae 
Dealt to bc118b95 
Dealt to 424d372d 
Dealt to 7f067c94 
Dealt to Hero [5d Ac]
Dealt to e91020c6 
7f067c94: folds
Hero: folds
e91020c6: raises $0.07 to $0.12
111c92ae: folds
bc118b95: folds
424d372d: calls $0.07
*** FLOP *** [8s 7c 9d]
424d372d: checks
e91020c6: bets $0.14
424d372d: folds
Uncalled bet ($0.14) returned to e91020c6
*** SHOWDOWN ***
e91020c6 collected $0.25 from pot
*** SUMMARY ***
Total pot $0.26 | Rake $0.01 | Jackpot $0 | Bingo $0 | Fortune $0 | Tax $0
Board [8s 7c 9d]
Seat 1: 111c92ae (button) folded before Flop (didn't bet)
Seat 2: bc118b95 (small blind) folded before Flop
Seat 3: 424d372d (big blind) folded on the Flop
Seat 4: 7f067c94 folded before Flop (didn't bet)
Seat 5: Hero folded before Flop (didn't bet)
Seat 6: e91020c6 won ($0.25)


Poker Hand #RC2078540324: Hold'em No Limit ($0.02/$0.05) - 2023/12/22 21:50:01
Table 'RushAndCash799831' 6-max Seat #1 is the button
Seat 1: 71fd2b18 ($5.97 in chips)
Seat 2: 6da90cdc ($5 in chips)
Seat 3: 373bc096 ($7.2 in chips)
Seat 4: 424d372d ($9.19 in chips)
Seat 5: Hero ($7.78 in chips)
Seat 6: 90511c4f ($5.35 in chips)
6da90cdc: posts small blind $0.02
373bc096: posts big blind $0.05
*** HOLE CARDS ***
Dealt to 71fd2b18 
Dealt to 6da90cdc 
Dealt to 373bc096 
Dealt to 424d372d 
Dealt to Hero [5h 4h]
Dealt to 90511c4f 
424d372d: folds
Hero: folds
90511c4f: folds
71fd2b18: raises $0.05 to $0.1
6da90cdc: folds
373bc096: folds
Uncalled bet ($0.05) returned to 71fd2b18
*** SHOWDOWN ***
71fd2b18 collected $0.12 from pot
*** SUMMARY ***
Total pot $0.12 | Rake $0 | Jackpot $0 | Bingo $0 | Fortune $0 | Tax $0
Seat 1: 71fd2b18 (button) collected ($0.12)
Seat 2: 6da90cdc (small blind) folded before Flop
Seat 3: 373bc096 (big blind) folded before Flop
Seat 4: 424d372d folded before Flop (didn't bet)
Seat 5: Hero folded before Flop (didn't bet)
Seat 6: 90511c4f folded before Flop (didn't bet)


Poker Hand #RC2078540196: Hold'em No Limit ($0.02/$0.05) - 2023/12/22 21:49:54
Table 'RushAndCash799769' 6-max Seat #1 is the button
Seat 1: 661ba238 ($5.18 in chips)
Seat 2: 5a946c5b ($5.34 in chips)
Seat 3: 90a9fad4 ($52.69 in chips)
Seat 4: 5c59e6a6 ($5.14 in chips)
Seat 5: Hero ($7.71 in chips)
Seat 6: bf955ffb ($5 in chips)
5a946c5b: posts small blind $0.02
90a9fad4: posts big blind $0.05
*** HOLE CARDS ***
Dealt to 661ba238 
Dealt to 5a946c5b 
Dealt to 90a9fad4 
Dealt to 5c59e6a6 
Dealt to Hero [As Ac]
Dealt to bf955ffb 
5c59e6a6: folds
Hero: raises $0.05 to $0.1
bf955ffb: folds
661ba238: folds
5a946c5b: folds
90a9fad4: folds
Uncalled bet ($0.05) returned to Hero
*** SHOWDOWN ***
Hero collected $0.12 from pot
*** SUMMARY ***
Total pot $0.12 | Rake $0 | Jackpot $0 | Bingo $0 | Fortune $0 | Tax $0
Seat 1: 661ba238 (button) folded before Flop (didn't bet)
Seat 2: 5a946c5b (small blind) folded before Flop
Seat 3: 90a9fad4 (big blind) folded before Flop
Seat 4: 5c59e6a6 folded before Flop (didn't bet)
Seat 5: Hero collected ($0.12)
Seat 6: bf955ffb folded before Flop (didn't bet)


Poker Hand #RC2078539446: Hold'em No Limit ($0.02/$0.05) - 2023/12/22 21:49:10
Table 'RushAndCash799424' 6-max Seat #1 is the button
Seat 1: 90b5844 ($6.14 in chips)
Seat 2: 6c75362e ($11.67 in chips)
Seat 3: Hero ($7.44 in chips)
Seat 4: 3402e890 ($9.22 in chips)
Seat 5: 777bac87 ($7.18 in chips)
Seat 6: f9adeea ($5.12 in chips)
6c75362e: posts small blind $0.02
Hero: posts big blind $0.05
*** HOLE CARDS ***
Dealt to 90b5844 
Dealt to 6c75362e 
Dealt to Hero [5h As]
Dealt to 3402e890 
Dealt to 777bac87 
Dealt to f9adeea 
3402e890: folds
777bac87: folds
f9adeea: folds
90b5844: folds
6c75362e: raises $0.1 to $0.15
Hero: calls $0.1
*** FLOP *** [6h Ac 7c]
6c75362e: bets $0.15
Hero: calls $0.15
*** TURN *** [6h Ac 7c] [Ts]
6c75362e: checks
Hero: checks
*** RIVER *** [6h Ac 7c Ts] [7d]
6c75362e: checks
Hero: checks
6c75362e: shows [8c 8s] (Pair of Eights and Pair of Sevens)
Hero: shows [5h As] (Pair of Aces and Pair of Sevens)
*** SHOWDOWN ***
Hero collected $0.57 from pot
*** SUMMARY ***
Total pot $0.6 | Rake $0.03 | Jackpot $0 | Bingo $0 | Fortune $0 | Tax $0
Board [6h Ac 7c Ts 7d]
Seat 1: 90b5844 (button) folded before Flop (didn't bet)
Seat 2: 6c75362e (small blind) showed [8c 8s] and lost with Pair of Eights and Pair of Sevens
Seat 3: Hero (big blind) showed [5h As] and won ($0.57) with Pair of Aces and Pair of Sevens
Seat 4: 3402e890 folded before Flop (didn't bet)
Seat 5: 777bac87 folded before Flop (didn't bet)
Seat 6: f9adeea folded before Flop (didn't bet)


Poker Hand #RC2078539379: Hold'em No Limit ($0.02/$0.05) - 2023/12/22 21:49:06
Table 'RushAndCash799392' 6-max Seat #1 is the button
Seat 1: cfacbec5 ($5.3 in chips)
Seat 2: 81f9a1e6 ($15.63 in chips)
Seat 3: 4542d7e7 ($4.88 in chips)
Seat 4: 10def899 ($5.66 in chips)
Seat 5: Hero ($7.44 in chips)
Seat 6: 8f1a23de ($5.5 in chips)
81f9a1e6: posts small blind $0.02
4542d7e7: posts big blind $0.05
*** HOLE CARDS ***
Dealt to cfacbec5 
Dealt to 81f9a1e6 
Dealt to 4542d7e7 
Dealt to 10def899 
Dealt to Hero [7s 2h]
Dealt to 8f1a23de 
10def899: raises $0.05 to $0.1
Hero: folds
8f1a23de: calls $0.1
cfacbec5: folds
81f9a1e6: folds
4542d7e7: folds
*** FLOP *** [As Jd 6h]
10def899: bets $0.1
8f1a23de: folds
Uncalled bet ($0.1) returned to 10def899
*** SHOWDOWN ***
10def899 collected $0.26 from pot
*** SUMMARY ***
Total pot $0.27 | Rake $0.01 | Jackpot $0 | Bingo $0 | Fortune $0 | Tax $0
Board [As Jd 6h]
Seat 1: cfacbec5 (button) folded before Flop (didn't bet)
Seat 2: 81f9a1e6 (small blind) folded before Flop
Seat 3: 4542d7e7 (big blind) folded before Flop
Seat 4: 10def899 won ($0.26)
Seat 5: Hero folded before Flop (didn't bet)
Seat 6: 8f1a23de folded on the Flop


Poker Hand #RC2078539237: Hold'em No Limit ($0.02/$0.05) - 2023/12/22 21:48:58
Table 'RushAndCash799321' 6-max Seat #1 is the button
Seat 1: 20a35d2e ($17.78 in chips)
Seat 2: Hero ($7.46 in chips)
Seat 3: 8d7ce5c2 ($5.1 in chips)
Seat 4: 3b055a50 ($13.26 in chips)
Seat 5: 1a2ba0b4 ($5.16 in chips)
Seat 6: 4542d7e7 ($4.88 in chips)
Hero: posts small blind $0.02
8d7ce5c2: posts big blind $0.05
*** HOLE CARDS ***
Dealt to 20a35d2e 
Dealt to Hero [Tc 8s]
Dealt to 8d7ce5c2 
Dealt to 3b055a50 
Dealt to 1a2ba0b4 
Dealt to 4542d7e7 
3b055a50: folds
1a2ba0b4: folds
4542d7e7: folds
20a35d2e: raises $0.1 to $0.15
Hero: folds
8d7ce5c2: folds
Uncalled bet ($0.1) returned to 20a35d2e
*** SHOWDOWN ***
20a35d2e collected $0.12 from pot
*** SUMMARY ***
Total pot $0.12 | Rake $0 | Jackpot $0 | Bingo $0 | Fortune $0 | Tax $0
Seat 1: 20a35d2e (button) collected ($0.12)
Seat 2: Hero (small blind) folded before Flop
Seat 3: 8d7ce5c2 (big blind) folded before Flop
Seat 4: 3b055a50 folded before Flop (didn't bet)
Seat 5: 1a2ba0b4 folded before Flop (didn't bet)
Seat 6: 4542d7e7 folded before Flop (didn't bet)


Poker Hand #RC2078539161: Hold'em No Limit ($0.02/$0.05) - 2023/12/22 21:48:54
Table 'RushAndCash799284' 6-max Seat #1 is the button
Seat 1: Hero ($7.46 in chips)
Seat 2: d42ee966 ($6.83 in chips)
Seat 3: 2c331229 ($2.13 in chips)
Seat 4: e24a2fed ($10.1 in chips)
Seat 5: a615a9f6 ($8.9 in chips)
Seat 6: 32c92a7b ($5.07 in chips)
d42ee966: posts small blind $0.02
2c331229: posts big blind $0.05
*** HOLE CARDS ***
Dealt to Hero [4s Th]
Dealt to d42ee966 
Dealt to 2c331229 
Dealt to e24a2fed 
Dealt to a615a9f6 
Dealt to 32c92a7b 
e24a2fed: folds
a615a9f6: folds
32c92a7b: raises $0.08 to $0.13
Hero: folds
d42ee966: folds
2c331229: calls $0.08
*** FLOP *** [2d 5h Qs]
2c331229: checks
32c92a7b: bets $0.14
2c331229: folds
Uncalled bet ($0.14) returned to 32c92a7b
*** SHOWDOWN ***
32c92a7b collected $0.27 from pot
*** SUMMARY ***
Total pot $0.28 | Rake $0.01 | Jackpot $0 | Bingo $0 | Fortune $0 | Tax $0
Board [2d 5h Qs]
Seat 1: Hero (button) folded before Flop (didn't bet)
Seat 2: d42ee966 (small blind) folded before Flop
Seat 3: 2c331229 (big blind) folded on the Flop
Seat 4: e24a2fed folded before Flop (didn't bet)
Seat 5: a615a9f6 folded before Flop (didn't bet)
Seat 6: 32c92a7b won ($0.27)


Poker Hand #RC2078539094: Hold'em No Limit ($0.02/$0.05) - 2023/12/22 21:48:50
Table 'RushAndCash799252' 6-max Seat #1 is the button
Seat 1: Hero ($7.46 in chips)
Seat 2: 2c331229 ($2.15 in chips)
Seat 3: d2e52b8d ($33.99 in chips)
Seat 4: 77f8786f ($6.43 in chips)
Seat 5: 987954e ($5 in chips)
Seat 6: c4382072 ($8.9 in chips)
2c331229: posts small blind $0.02
d2e52b8d: posts big blind $0.05
*** HOLE CARDS ***
Dealt to Hero [Ac 8d]
Dealt to 2c331229 
Dealt to d2e52b8d 
Dealt to 77f8786f 
Dealt to 987954e 
Dealt to c4382072 
77f8786f: folds
987954e: raises $0.07 to $0.12
c4382072: folds
Hero: folds
2c331229: folds
d2e52b8d: folds
Uncalled bet ($0.07) returned to 987954e
*** SHOWDOWN ***
987954e collected $0.12 from pot
*** SUMMARY ***
Total pot $0.12 | Rake $0 | Jackpot $0 | Bingo $0 | Fortune $0 | Tax $0
Seat 1: Hero (button) folded before Flop (didn't bet)
Seat 2: 2c331229 (small blind) folded before Flop
Seat 3: d2e52b8d (big blind) folded before Flop
Seat 4: 77f8786f folded before Flop (didn't bet)
Seat 5: 987954e collected ($0.12)
Seat 6: c4382072 folded before Flop (didn't bet)


Poker Hand #RC2078539036: Hold'em No Limit ($0.02/$0.05) - 2023/12/22 21:48:47
Table 'RushAndCash799224' 6-max Seat #1 is the button
Seat 1: c4382072 ($8.9 in chips)
Seat 2: Hero ($7.48 in chips)
Seat 3: 3a9b3c34 ($3.65 in chips)
Seat 4: 62357227 ($5.4 in chips)
Seat 5: 641aff0 ($9.19 in chips)
Seat 6: 1e3d103d ($9.38 in chips)
Hero: posts small blind $0.02
3a9b3c34: posts big blind $0.05
*** HOLE CARDS ***
Dealt to c4382072 
Dealt to Hero [3s 4c]
Dealt to 3a9b3c34 
Dealt to 62357227 
Dealt to 641aff0 
Dealt to 1e3d103d 
62357227: folds
641aff0: raises $0.1 to $0.15
1e3d103d: folds
c4382072: folds
Hero: folds
3a9b3c34: folds
Uncalled bet ($0.1) returned to 641aff0
*** SHOWDOWN ***
641aff0 collected $0.12 from pot
*** SUMMARY ***
Total pot $0.12 | Rake $0 | Jackpot $0 | Bingo $0 | Fortune $0 | Tax $0
Seat 1: c4382072 (button) folded before Flop (didn't bet)
Seat 2: Hero (small blind) folded before Flop
Seat 3: 3a9b3c34 (big blind) folded before Flop
Seat 4: 62357227 folded before Flop (didn't bet)
Seat 5: 641aff0 collected ($0.12)
Seat 6: 1e3d103d folded before Flop (didn't bet)


Poker Hand #RC2078538969: Hold'em No Limit ($0.02/$0.05) - 2023/12/22 21:48:43
Table 'RushAndCash799192' 6-max Seat #1 is the button
Seat 1: 4520f334 ($6.29 in chips)
Seat 2: d6dcfaa3 ($5.14 in chips)
Seat 3: cbc963b8 ($5.5 in chips)
Seat 4: Hero ($7.48 in chips)
Seat 5: df439f39 ($5 in chips)
Seat 6: e8d24af1 ($5.26 in chips)
d6dcfaa3: posts small blind $0.02
cbc963b8: posts big blind $0.05
*** HOLE CARDS ***
Dealt to 4520f334 
Dealt to d6dcfaa3 
Dealt to cbc963b8 
Dealt to Hero [3c 2c]
Dealt to df439f39 
Dealt to e8d24af1 
Hero: folds
df439f39: folds
e8d24af1: folds
4520f334: folds
d6dcfaa3: raises $0.08 to $0.13
cbc963b8: calls $0.08
*** FLOP *** [Ts 9h Ah]
d6dcfaa3: checks
cbc963b8: bets $0.13
d6dcfaa3: calls $0.13
*** TURN *** [Ts 9h Ah] [Kc]
d6dcfaa3: checks
cbc963b8: bets $0.26
d6dcfaa3: folds
Uncalled bet ($0.26) returned to cbc963b8
*** SHOWDOWN ***
cbc963b8 collected $0.5 from pot
*** SUMMARY ***
Total pot $0.52 | Rake $0.02 | Jackpot $0 | Bingo $0 | Fortune $0 | Tax $0
Board [Ts 9h Ah Kc]
Seat 1: 4520f334 (button) folded before Flop (didn't bet)
Seat 2: d6dcfaa3 (small blind) folded on the Turn
Seat 3: cbc963b8 (big blind) won ($0.5)
Seat 4: Hero folded before Flop (didn't bet)
Seat 5: df439f39 folded before Flop (didn't bet)
Seat 6: e8d24af1 folded before Flop (didn't bet)


Poker Hand #RC2078538764: Hold'em No Limit ($0.02/$0.05) - 2023/12/22 21:48:31
Table 'RushAndCash799089' 6-max Seat #1 is the button
Seat 1: fcb65fa9 ($2.54 in chips)
Seat 2: bba39737 ($5.02 in chips)
Seat 3: d25e9ff3 ($5.56 in chips)
Seat 4: 3160ff3c ($15.31 in chips)
Seat 5: Hero ($7.48 in chips)
Seat 6: 4e20b85a ($5 in chips)
bba39737: posts small blind $0.02
d25e9ff3: posts big blind $0.05
*** HOLE CARDS ***
Dealt to fcb65fa9 
Dealt to bba39737 
Dealt to d25e9ff3 
Dealt to 3160ff3c 
Dealt to Hero [8s Kd]
Dealt to 4e20b85a 
3160ff3c: folds
Hero: folds
4e20b85a: folds
fcb65fa9: folds
bba39737: folds
Uncalled bet ($0.03) returned to d25e9ff3
*** SHOWDOWN ***
d25e9ff3 collected $0.04 from pot
*** SUMMARY ***
Total pot $0.04 | Rake $0 | Jackpot $0 | Bingo $0 | Fortune $0 | Tax $0
Seat 1: fcb65fa9 (button) folded before Flop (didn't bet)
Seat 2: bba39737 (small blind) folded before Flop
Seat 3: d25e9ff3 (big blind) collected ($0.04)
Seat 4: 3160ff3c folded before Flop (didn't bet)
Seat 5: Hero folded before Flop (didn't bet)
Seat 6: 4e20b85a folded before Flop (didn't bet)


Poker Hand #RC2078538700: Hold'em No Limit ($0.02/$0.05) - 2023/12/22 21:48:27
Table 'RushAndCash799060' 6-max Seat #1 is the button
Seat 1: 64f7e138 ($14.03 in chips)
Seat 2: 566b7ee3 ($5.07 in chips)
Seat 3: eeb37e34 ($10.12 in chips)
Seat 4: ed26e80a ($12.91 in chips)
Seat 5: 8a9decd1 ($9.27 in chips)
Seat 6: Hero ($7.48 in chips)
566b7ee3: posts small blind $0.02
eeb37e34: posts big blind $0.05
*** HOLE CARDS ***
Dealt to 64f7e138 
Dealt to 566b7ee3 
Dealt to eeb37e34 
Dealt to ed26e80a 
Dealt to 8a9decd1 
Dealt to Hero [Jc 2c]
ed26e80a: folds
8a9decd1: folds
Hero: folds
64f7e138: raises $0.07 to $0.12
566b7ee3: folds
eeb37e34: calls $0.07
*** FLOP *** [3c 8d 9c]
eeb37e34: checks
64f7e138: checks
*** TURN *** [3c 8d 9c] [9d]
eeb37e34: bets $0.09
64f7e138: calls $0.09
*** RIVER *** [3c 8d 9c 9d] [4d]
eeb37e34: bets $0.15
64f7e138: folds
Uncalled bet ($0.15) returned to eeb37e34
*** SHOWDOWN ***
eeb37e34 collected $0.42 from pot
*** SUMMARY ***
Total pot $0.44 | Rake $0.02 | Jackpot $0 | Bingo $0 | Fortune $0 | Tax $0
Board [3c 8d 9c 9d 4d]
Seat 1: 64f7e138 (button) folded on the River
Seat 2: 566b7ee3 (small blind) folded before Flop
Seat 3: eeb37e34 (big blind) won ($0.42)
Seat 4: ed26e80a folded before Flop (didn't bet)
Seat 5: 8a9decd1 folded before Flop (didn't bet)
Seat 6: Hero folded before Flop (didn't bet)


Poker Hand #RC2078538633: Hold'em No Limit ($0.02/$0.05) - 2023/12/22 21:48:24
Table 'RushAndCash799029' 6-max Seat #1 is the button
Seat 1: 3f112fc ($3.74 in chips)
Seat 2: 1826138f ($5.04 in chips)
Seat 3: d31038ce ($8.84 in chips)
Seat 4: Hero ($7.48 in chips)
Seat 5: 56a5ef7f ($6.51 in chips)
Seat 6: 14f02886 ($5.16 in chips)
1826138f: posts small blind $0.02
d31038ce: posts big blind $0.05
*** HOLE CARDS ***
Dealt to 3f112fc 
Dealt to 1826138f 
Dealt to d31038ce 
Dealt to Hero [Ks 7h]
Dealt to 56a5ef7f 
Dealt to 14f02886 
Hero: folds
56a5ef7f: raises $0.08 to $0.13
14f02886: folds
3f112fc: folds
1826138f: calls $0.11
d31038ce: folds
*** FLOP *** [Kd 8h 5s]
1826138f: checks
56a5ef7f: bets $0.16
1826138f: raises $0.29 to $0.45
56a5ef7f: folds
Uncalled bet ($0.29) returned to 1826138f
*** SHOWDOWN ***
1826138f collected $0.6 from pot
*** SUMMARY ***
Total pot $0.63 | Rake $0.03 | Jackpot $0 | Bingo $0 | Fortune $0 | Tax $0
Board [Kd 8h 5s]
Seat 1: 3f112fc (button) folded before Flop (didn't bet)
Seat 2: 1826138f (small blind) won ($0.6)
Seat 3: d31038ce (big blind) folded before Flop
Seat 4: Hero folded before Flop (didn't bet)
Seat 5: 56a5ef7f folded on the Flop
Seat 6: 14f02886 folded before Flop (didn't bet)


Poker Hand #RC2078538061: Hold'em No Limit ($0.02/$0.05) - 2023/12/22 21:47:49
Table 'RushAndCash798741' 6-max Seat #1 is the button
Seat 1: 14f02886 ($5.31 in chips)
Seat 2: 2c331229 ($2.23 in chips)
Seat 3: Hero ($7.2 in chips)
Seat 4: 2f2fbc2 ($0.84 in chips)
Seat 5: 34ce5e3 ($5.07 in chips)
Seat 6: bf955ffb ($5.39 in chips)
2c331229: posts small blind $0.02
Hero: posts big blind $0.05
*** HOLE CARDS ***
Dealt to 14f02886 
Dealt to 2c331229 
Dealt to Hero [5c 4c]
Dealt to 2f2fbc2 
Dealt to 34ce5e3 
Dealt to bf955ffb 
2f2fbc2: folds
34ce5e3: folds
bf955ffb: folds
14f02886: raises $0.1 to $0.15
2c331229: calls $0.13
Hero: calls $0.1
*** FLOP *** [3c 2d Qc]
2c331229: checks
Hero: bets $0.23
14f02886: folds
2c331229: folds
Uncalled bet ($0.23) returned to Hero
*** SHOWDOWN ***
Hero collected $0.43 from pot
*** SUMMARY ***
Total pot $0.45 | Rake $0.02 | Jackpot $0 | Bingo $0 | Fortune $0 | Tax $0
Board [3c 2d Qc]
Seat 1: 14f02886 (button) folded on the Flop
Seat 2: 2c331229 (small blind) folded on the Flop
Seat 3: Hero (big blind) won ($0.43)
Seat 4: 2f2fbc2 folded before Flop (didn't bet)
Seat 5: 34ce5e3 folded before Flop (didn't bet)
Seat 6: bf955ffb folded before Flop (didn't bet)


Poker Hand #RC2078538008: Hold'em No Limit ($0.02/$0.05) - 2023/12/22 21:47:46
Table 'RushAndCash798715' 6-max Seat #1 is the button
Seat 1: 3d929f9f ($9.53 in chips)
Seat 2: 8cbe8ff5 ($2.91 in chips)
Seat 3: f9c8784e ($11.94 in chips)
Seat 4: Hero ($7.2 in chips)
Seat 5: 6fadee13 ($5.39 in chips)
Seat 6: 8a6d1b ($10.26 in chips)
8cbe8ff5: posts small blind $0.02
f9c8784e: posts big blind $0.05
*** HOLE CARDS ***
Dealt to 3d929f9f 
Dealt to 8cbe8ff5 
Dealt to f9c8784e 
Dealt to Hero [3d Ah]
Dealt to 6fadee13 
Dealt to 8a6d1b 
Hero: folds
6fadee13: folds
8a6d1b: folds
3d929f9f: raises $0.1 to $0.15
8cbe8ff5: folds
f9c8784e: folds
Uncalled bet ($0.1) returned to 3d929f9f
*** SHOWDOWN ***
3d929f9f collected $0.12 from pot
*** SUMMARY ***
Total pot $0.12 | Rake $0 | Jackpot $0 | Bingo $0 | Fortune $0 | Tax $0
Seat 1: 3d929f9f (button) collected ($0.12)
Seat 2: 8cbe8ff5 (small blind) folded before Flop
Seat 3: f9c8784e (big blind) folded before Flop
Seat 4: Hero folded before Flop (didn't bet)
Seat 5: 6fadee13 folded before Flop (didn't bet)
Seat 6: 8a6d1b folded before Flop (didn't bet)


Poker Hand #RC2078537403: Hold'em No Limit ($0.02/$0.05) - 2023/12/22 21:47:06
Table 'RushAndCash798415' 6-max Seat #1 is the button
Seat 1: 17f16016 ($5.13 in chips)
Seat 2: f9c8784e ($12.04 in chips)
Seat 3: edf930b1 ($5 in chips)
Seat 4: 963f3a1f ($2.35 in chips)
Seat 5: Hero ($7.06 in chips)
Seat 6: 37863cfe ($5.7 in chips)
f9c8784e: posts small blind $0.02
edf930b1: posts big blind $0.05
*** HOLE CARDS ***
Dealt to 17f16016 
Dealt to f9c8784e 
Dealt to edf930b1 
Dealt to 963f3a1f 
Dealt to Hero [Jh Qh]
Dealt to 37863cfe 
963f3a1f: folds
Hero: raises $0.05 to $0.1
37863cfe: folds
17f16016: folds
f9c8784e: calls $0.08
edf930b1: folds
*** FLOP *** [4s 8d 7c]
f9c8784e: checks
Hero: checks
*** TURN *** [4s 8d 7c] [2c]
f9c8784e: checks
Hero: checks
*** RIVER *** [4s 8d 7c 2c] [Jc]
f9c8784e: checks
Hero: checks
f9c8784e: shows [3h 3s] (Pair of Treys)
Hero: shows [Jh Qh] (Pair of Jacks)
*** SHOWDOWN ***
Hero collected $0.24 from pot
*** SUMMARY ***
Total pot $0.25 | Rake $0.01 | Jackpot $0 | Bingo $0 | Fortune $0 | Tax $0
Board [4s 8d 7c 2c Jc]
Seat 1: 17f16016 (button) folded before Flop (didn't bet)
Seat 2: f9c8784e (small blind) showed [3h 3s] and lost with Pair of Treys
Seat 3: edf930b1 (big blind) folded before Flop
Seat 4: 963f3a1f folded before Flop (didn't bet)
Seat 5: Hero showed [Jh Qh] and won ($0.24) with Pair of Jacks
Seat 6: 37863cfe folded before Flop (didn't bet)


Poker Hand #RC2078537193: Hold'em No Limit ($0.02/$0.05) - 2023/12/22 21:46:53
Table 'RushAndCash798316' 6-max Seat #1 is the button
Seat 1: f704f14d ($2.34 in chips)
Seat 2: Hero ($7.01 in chips)
Seat 3: a20c0bea ($5.33 in chips)
Seat 4: 6fadee13 ($5.53 in chips)
Seat 5: 35939716 ($5 in chips)
Seat 6: 3f112fc ($5.22 in chips)
Hero: posts small blind $0.02
a20c0bea: posts big blind $0.05
*** HOLE CARDS ***
Dealt to f704f14d 
Dealt to Hero [9s 5s]
Dealt to a20c0bea 
Dealt to 6fadee13 
Dealt to 35939716 
Dealt to 3f112fc 
6fadee13: folds
35939716: folds
3f112fc: folds
f704f14d: folds
Hero: raises $0.1 to $0.15
a20c0bea: folds
Uncalled bet ($0.1) returned to Hero
*** SHOWDOWN ***
Hero collected $0.1 from pot
*** SUMMARY ***
Total pot $0.1 | Rake $0 | Jackpot $0 | Bingo $0 | Fortune $0 | Tax $0
Seat 1: f704f14d (button) folded before Flop (didn't bet)
Seat 2: Hero (small blind) collected ($0.1)
Seat 3: a20c0bea (big blind) folded before Flop
Seat 4: 6fadee13 folded before Flop (didn't bet)
Seat 5: 35939716 folded before Flop (didn't bet)
Seat 6: 3f112fc folded before Flop (didn't bet)


Poker Hand #RC2078537116: Hold'em No Limit ($0.02/$0.05) - 2023/12/22 21:46:49
Table 'RushAndCash798278' 6-max Seat #1 is the button
Seat 1: Hero ($7.01 in chips)
Seat 2: 102e4185 ($8.44 in chips)
Seat 3: 8626eae9 ($7.23 in chips)
Seat 4: cb9a7609 ($5.05 in chips)
Seat 5: 4df86067 ($5.89 in chips)
Seat 6: 35f7fbd3 ($9.48 in chips)
102e4185: posts small blind $0.02
8626eae9: posts big blind $0.05
*** HOLE CARDS ***
Dealt to Hero [8c Js]
Dealt to 102e4185 
Dealt to 8626eae9 
Dealt to cb9a7609 
Dealt to 4df86067 
Dealt to 35f7fbd3 
cb9a7609: raises $0.06 to $0.11
4df86067: folds
35f7fbd3: folds
Hero: folds
102e4185: folds
8626eae9: folds
Uncalled bet ($0.06) returned to cb9a7609
*** SHOWDOWN ***
cb9a7609 collected $0.12 from pot
*** SUMMARY ***
Total pot $0.12 | Rake $0 | Jackpot $0 | Bingo $0 | Fortune $0 | Tax $0
Seat 1: Hero (button) folded before Flop (didn't bet)
Seat 2: 102e4185 (small blind) folded before Flop
Seat 3: 8626eae9 (big blind) folded before Flop
Seat 4: cb9a7609 collected ($0.12)
Seat 5: 4df86067 folded before Flop (didn't bet)
Seat 6: 35f7fbd3 folded before Flop (didn't bet)


Poker Hand #RC2078536904: Hold'em No Limit ($0.02/$0.05) - 2023/12/22 21:46:36
Table 'RushAndCash798173' 6-max Seat #1 is the button
Seat 1: 7f067c94 ($41.93 in chips)
Seat 2: c8c17adc ($5.73 in chips)
Seat 3: Hero ($7.06 in chips)
Seat 4: fc58b670 ($5.37 in chips)
Seat 5: 8a94bd25 ($5.7 in chips)
Seat 6: 2df1781e ($5.05 in chips)
c8c17adc: posts small blind $0.02
Hero: posts big blind $0.05
*** HOLE CARDS ***
Dealt to 7f067c94 
Dealt to c8c17adc 
Dealt to Hero [4s 6d]
Dealt to fc58b670 
Dealt to 8a94bd25 
Dealt to 2df1781e 
fc58b670: folds
8a94bd25: folds
2df1781e: folds
7f067c94: raises $0.05 to $0.1
c8c17adc: folds
Hero: folds
Uncalled bet ($0.05) returned to 7f067c94
*** SHOWDOWN ***
7f067c94 collected $0.12 from pot
*** SUMMARY ***
Total pot $0.12 | Rake $0 | Jackpot $0 | Bingo $0 | Fortune $0 | Tax $0
Seat 1: 7f067c94 (button) collected ($0.12)
Seat 2: c8c17adc (small blind) folded before Flop
Seat 3: Hero (big blind) folded before Flop
Seat 4: fc58b670 folded before Flop (didn't bet)
Seat 5: 8a94bd25 folded before Flop (didn't bet)
Seat 6: 2df1781e folded before Flop (didn't bet)


Poker Hand #RC2078536840: Hold'em No Limit ($0.02/$0.05) - 2023/12/22 21:46:32
Table 'RushAndCash798142' 6-max Seat #1 is the button
Seat 1: ad0bb92a ($4.62 in chips)
Seat 2: 5d17419b ($6.37 in chips)
Seat 3: 35939716 ($5 in chips)
Seat 4: Hero ($7.06 in chips)
Seat 5: 6ded132b ($13.61 in chips)
Seat 6: 34ea495f ($6.39 in chips)
5d17419b: posts small blind $0.02
35939716: posts big blind $0.05
*** HOLE CARDS ***
Dealt to ad0bb92a 
Dealt to 5d17419b 
Dealt to 35939716 
Dealt to Hero [9c 4h]
Dealt to 6ded132b 
Dealt to 34ea495f 
Hero: folds
6ded132b: folds
34ea495f: folds
ad0bb92a: raises $0.05 to $0.1
5d17419b: folds
35939716: folds
Uncalled bet ($0.05) returned to ad0bb92a
*** SHOWDOWN ***
ad0bb92a collected $0.12 from pot
*** SUMMARY ***
Total pot $0.12 | Rake $0 | Jackpot $0 | Bingo $0 | Fortune $0 | Tax $0
Seat 1: ad0bb92a (button) collected ($0.12)
Seat 2: 5d17419b (small blind) folded before Flop
Seat 3: 35939716 (big blind) folded before Flop
Seat 4: Hero folded before Flop (didn't bet)
Seat 5: 6ded132b folded before Flop (didn't bet)
Seat 6: 34ea495f folded before Flop (didn't bet)


Poker Hand #RC2078536756: Hold'em No Limit ($0.02/$0.05) - 2023/12/22 21:46:28
Table 'RushAndCash798104' 6-max Seat #1 is the button
Seat 1: f0e3b048 ($4.98 in chips)
Seat 2: a774641b ($5 in chips)
Seat 3: dee599cb ($4.84 in chips)
Seat 4: Hero ($7.06 in chips)
Seat 5: 1e6e058c ($6.11 in chips)
Seat 6: e46f04df ($8.85 in chips)
a774641b: posts small blind $0.02
dee599cb: posts big blind $0.05
*** HOLE CARDS ***
Dealt to f0e3b048 
Dealt to a774641b 
Dealt to dee599cb 
Dealt to Hero [3c Ah]
Dealt to 1e6e058c 
Dealt to e46f04df 
Hero: folds
1e6e058c: raises $0.05 to $0.1
e46f04df: folds
f0e3b048: folds
a774641b: folds
dee599cb: folds
Uncalled bet ($0.05) returned to 1e6e058c
*** SHOWDOWN ***
1e6e058c collected $0.12 from pot
*** SUMMARY ***
Total pot $0.12 | Rake $0 | Jackpot $0 | Bingo $0 | Fortune $0 | Tax $0
Seat 1: f0e3b048 (button) folded before Flop (didn't bet)
Seat 2: a774641b (small blind) folded before Flop
Seat 3: dee599cb (big blind) folded before Flop
Seat 4: Hero folded before Flop (didn't bet)
Seat 5: 1e6e058c collected ($0.12)
Seat 6: e46f04df folded before Flop (didn't bet)


Poker Hand #RC2078536670: Hold'em No Limit ($0.02/$0.05) - 2023/12/22 21:46:23
Table 'RushAndCash798062' 6-max Seat #1 is the button
Seat 1: Hero ($7.06 in chips)
Seat 2: 3910f1b8 ($4.95 in chips)
Seat 3: 521feab9 ($5 in chips)
Seat 4: 49a9584 ($5.56 in chips)
Seat 5: e46f04df ($8.85 in chips)
Seat 6: f4e201f0 ($10.5 in chips)
3910f1b8: posts small blind $0.02
521feab9: posts big blind $0.05
*** HOLE CARDS ***
Dealt to Hero [9h 6d]
Dealt to 3910f1b8 
Dealt to 521feab9 
Dealt to 49a9584 
Dealt to e46f04df 
Dealt to f4e201f0 
49a9584: folds
e46f04df: folds
f4e201f0: folds
Hero: folds
3910f1b8: folds
Uncalled bet ($0.03) returned to 521feab9
*** SHOWDOWN ***
521feab9 collected $0.04 from pot
*** SUMMARY ***
Total pot $0.04 | Rake $0 | Jackpot $0 | Bingo $0 | Fortune $0 | Tax $0
Seat 1: Hero (button) folded before Flop (didn't bet)
Seat 2: 3910f1b8 (small blind) folded before Flop
Seat 3: 521feab9 (big blind) collected ($0.04)
Seat 4: 49a9584 folded before Flop (didn't bet)
Seat 5: e46f04df folded before Flop (didn't bet)
Seat 6: f4e201f0 folded before Flop (didn't bet)


Poker Hand #RC2078536284: Hold'em No Limit ($0.02/$0.05) - 2023/12/22 21:46:00
Table 'RushAndCash797878' 6-max Seat #1 is the button
Seat 1: 34886d8c ($5.19 in chips)
Seat 2: Hero ($7.08 in chips)
Seat 3: 5cb14769 ($8.77 in chips)
Seat 4: 232af02c ($5 in chips)
Seat 5: 271c38e0 ($5 in chips)
Seat 6: b36a4d43 ($6 in chips)
Hero: posts small blind $0.02
5cb14769: posts big blind $0.05
*** HOLE CARDS ***
Dealt to 34886d8c 
Dealt to Hero [2c Ac]
Dealt to 5cb14769 
Dealt to 232af02c 
Dealt to 271c38e0 
Dealt to b36a4d43 
232af02c: folds
271c38e0: folds
b36a4d43: raises $0.09 to $0.14
34886d8c: folds
Hero: folds
5cb14769: folds
Uncalled bet ($0.09) returned to b36a4d43
*** SHOWDOWN ***
b36a4d43 collected $0.12 from pot
*** SUMMARY ***
Total pot $0.12 | Rake $0 | Jackpot $0 | Bingo $0 | Fortune $0 | Tax $0
Seat 1: 34886d8c (button) folded before Flop (didn't bet)
Seat 2: Hero (small blind) folded before Flop
Seat 3: 5cb14769 (big blind) folded before Flop
Seat 4: 232af02c folded before Flop (didn't bet)
Seat 5: 271c38e0 folded before Flop (didn't bet)
Seat 6: b36a4d43 collected ($0.12)


Poker Hand #RC2078536127: Hold'em No Limit ($0.02/$0.05) - 2023/12/22 21:45:51
Table 'RushAndCash797800' 6-max Seat #1 is the button
Seat 1: ddbe951e ($16.43 in chips)
Seat 2: d71ab80c ($5 in chips)
Seat 3: Hero ($7.06 in chips)
Seat 4: 6969351a ($8.96 in chips)
Seat 5: 39956d46 ($8.64 in chips)
Seat 6: fc7e8623 ($15.06 in chips)
d71ab80c: posts small blind $0.02
Hero: posts big blind $0.05
*** HOLE CARDS ***
Dealt to ddbe951e 
Dealt to d71ab80c 
Dealt to Hero [Jd Kh]
Dealt to 6969351a 
Dealt to 39956d46 
Dealt to fc7e8623 
6969351a: folds
39956d46: folds
fc7e8623: folds
ddbe951e: folds
d71ab80c: folds
Uncalled bet ($0.03) returned to Hero
*** SHOWDOWN ***
Hero collected $0.04 from pot
*** SUMMARY ***
Total pot $0.04 | Rake $0 | Jackpot $0 | Bingo $0 | Fortune $0 | Tax $0
Seat 1: ddbe951e (button) folded before Flop (didn't bet)
Seat 2: d71ab80c (small blind) folded before Flop
Seat 3: Hero (big blind) collected ($0.04)
Seat 4: 6969351a folded before Flop (didn't bet)
Seat 5: 39956d46 folded before Flop (didn't bet)
Seat 6: fc7e8623 folded before Flop (didn't bet)


Poker Hand #RC2078536067: Hold'em No Limit ($0.02/$0.05) - 2023/12/22 21:45:48
Table 'RushAndCash797770' 6-max Seat #1 is the button
Seat 1: 2fb7c647 ($2.15 in chips)
Seat 2: ea94f4a8 ($4.77 in chips)
Seat 3: a2346b7c ($4.57 in chips)
Seat 4: 7c2eba4e ($9.76 in chips)
Seat 5: a4441de9 ($6.26 in chips)
Seat 6: Hero ($7.06 in chips)
ea94f4a8: posts small blind $0.02
a2346b7c: posts big blind $0.05
*** HOLE CARDS ***
Dealt to 2fb7c647 
Dealt to ea94f4a8 
Dealt to a2346b7c 
Dealt to 7c2eba4e 
Dealt to a4441de9 
Dealt to Hero [5c 9s]
7c2eba4e: folds
a4441de9: folds
Hero: folds
2fb7c647: raises $0.05 to $0.1
ea94f4a8: folds
a2346b7c: calls $0.05
*** FLOP *** [Kd Ad Jd]
a2346b7c: checks
2fb7c647: bets $0.11
a2346b7c: calls $0.11
*** TURN *** [Kd Ad Jd] [4c]
a2346b7c: checks
2fb7c647: bets $1.94 and is all-in
a2346b7c: folds
Uncalled bet ($1.94) returned to 2fb7c647
*** SHOWDOWN ***
2fb7c647 collected $0.42 from pot
*** SUMMARY ***
Total pot $0.44 | Rake $0.02 | Jackpot $0 | Bingo $0 | Fortune $0 | Tax $0
Board [Kd Ad Jd 4c]
Seat 1: 2fb7c647 (button) won ($0.42)
Seat 2: ea94f4a8 (small blind) folded before Flop
Seat 3: a2346b7c (big blind) folded on the Turn
Seat 4: 7c2eba4e folded before Flop (didn't bet)
Seat 5: a4441de9 folded before Flop (didn't bet)
Seat 6: Hero folded before Flop (didn't bet)


Poker Hand #RC2078536005: Hold'em No Limit ($0.02/$0.05) - 2023/12/22 21:45:44
Table 'RushAndCash797739' 6-max Seat #1 is the button
Seat 1: a8629ffc ($3.05 in chips)
Seat 2: 987954e ($5 in chips)
Seat 3: d960fc1d ($4.83 in chips)
Seat 4: Hero ($7.06 in chips)
Seat 5: fc7e8623 ($15.06 in chips)
Seat 6: 459d0f5c ($5.02 in chips)
987954e: posts small blind $0.02
d960fc1d: posts big blind $0.05
*** HOLE CARDS ***
Dealt to a8629ffc 
Dealt to 987954e 
Dealt to d960fc1d 
Dealt to Hero [Ks 2c]
Dealt to fc7e8623 
Dealt to 459d0f5c 
Hero: folds
fc7e8623: folds
459d0f5c: raises $0.1 to $0.15
a8629ffc: folds
987954e: folds
d960fc1d: folds
Uncalled bet ($0.1) returned to 459d0f5c
*** SHOWDOWN ***
459d0f5c collected $0.12 from pot
*** SUMMARY ***
Total pot $0.12 | Rake $0 | Jackpot $0 | Bingo $0 | Fortune $0 | Tax $0
Seat 1: a8629ffc (button) folded before Flop (didn't bet)
Seat 2: 987954e (small blind) folded before Flop
Seat 3: d960fc1d (big blind) folded before Flop
Seat 4: Hero folded before Flop (didn't bet)
Seat 5: fc7e8623 folded before Flop (didn't bet)
Seat 6: 459d0f5c collected ($0.12)


Poker Hand #RC2078535893: Hold'em No Limit ($0.02/$0.05) - 2023/12/22 21:45:38
Table 'RushAndCash797687' 6-max Seat #1 is the button
Seat 1: f43dd94b ($5.02 in chips)
Seat 2: b77cfdca ($5 in chips)
Seat 3: 998574b7 ($5.7 in chips)
Seat 4: a1dfe2ad ($4.95 in chips)
Seat 5: Hero ($7.06 in chips)
Seat 6: 84043875 ($5.72 in chips)
b77cfdca: posts small blind $0.02
998574b7: posts big blind $0.05
*** HOLE CARDS ***
Dealt to f43dd94b 
Dealt to b77cfdca 
Dealt to 998574b7 
Dealt to a1dfe2ad 
Dealt to Hero [5s 9c]
Dealt to 84043875 
a1dfe2ad: folds
Hero: folds
84043875: folds
f43dd94b: folds
b77cfdca: folds
Uncalled bet ($0.03) returned to 998574b7
*** SHOWDOWN ***
998574b7 collected $0.04 from pot
*** SUMMARY ***
Total pot $0.04 | Rake $0 | Jackpot $0 | Bingo $0 | Fortune $0 | Tax $0
Seat 1: f43dd94b (button) folded before Flop (didn't bet)
Seat 2: b77cfdca (small blind) folded before Flop
Seat 3: 998574b7 (big blind) collected ($0.04)
Seat 4: a1dfe2ad folded before Flop (didn't bet)
Seat 5: Hero folded before Flop (didn't bet)
Seat 6: 84043875 folded before Flop (didn't bet)


Poker Hand #RC2078535816: Hold'em No Limit ($0.02/$0.05) - 2023/12/22 21:45:34
Table 'RushAndCash797648' 6-max Seat #1 is the button
Seat 1: Hero ($7.06 in chips)
Seat 2: 50e4a888 ($7.55 in chips)
Seat 3: f9c8784e ($11.85 in chips)
Seat 4: 6a898db1 ($4.9 in chips)
Seat 5: 2f160a64 ($5.48 in chips)
Seat 6: 998574b7 ($5.7 in chips)
50e4a888: posts small blind $0.02
f9c8784e: posts big blind $0.05
*** HOLE CARDS ***
Dealt to Hero [Qh 6c]
Dealt to 50e4a888 
Dealt to f9c8784e 
Dealt to 6a898db1 
Dealt to 2f160a64 
Dealt to 998574b7 
6a898db1: folds
2f160a64: folds
998574b7: folds
Hero: folds
50e4a888: folds
Uncalled bet ($0.03) returned to f9c8784e
*** SHOWDOWN ***
f9c8784e collected $0.04 from pot
*** SUMMARY ***
Total pot $0.04 | Rake $0 | Jackpot $0 | Bingo $0 | Fortune $0 | Tax $0
Seat 1: Hero (button) folded before Flop (didn't bet)
Seat 2: 50e4a888 (small blind) folded before Flop
Seat 3: f9c8784e (big blind) collected ($0.04)
Seat 4: 6a898db1 folded before Flop (didn't bet)
Seat 5: 2f160a64 folded before Flop (didn't bet)
Seat 6: 998574b7 folded before Flop (didn't bet)


Poker Hand #RC2078535711: Hold'em No Limit ($0.02/$0.05) - 2023/12/22 21:45:28
Table 'RushAndCash797596' 6-max Seat #1 is the button
Seat 1: 61343ab7 ($5.29 in chips)
Seat 2: 308f9422 ($7.65 in chips)
Seat 3: bba39737 ($5.19 in chips)
Seat 4: 6dc2bdd ($3.84 in chips)
Seat 5: b179aebd ($6.09 in chips)
Seat 6: Hero ($7.06 in chips)
308f9422: posts small blind $0.02
bba39737: posts big blind $0.05
*** HOLE CARDS ***
Dealt to 61343ab7 
Dealt to 308f9422 
Dealt to bba39737 
Dealt to 6dc2bdd 
Dealt to b179aebd 
Dealt to Hero [2h 6c]
6dc2bdd: folds
b179aebd: folds
Hero: folds
61343ab7: raises $0.07 to $0.12
308f9422: folds
bba39737: folds
Uncalled bet ($0.07) returned to 61343ab7
*** SHOWDOWN ***
61343ab7 collected $0.12 from pot
*** SUMMARY ***
Total pot $0.12 | Rake $0 | Jackpot $0 | Bingo $0 | Fortune $0 | Tax $0
Seat 1: 61343ab7 (button) collected ($0.12)
Seat 2: 308f9422 (small blind) folded before Flop
Seat 3: bba39737 (big blind) folded before Flop
Seat 4: 6dc2bdd folded before Flop (didn't bet)
Seat 5: b179aebd folded before Flop (didn't bet)
Seat 6: Hero folded before Flop (didn't bet)


Poker Hand #RC2078535412: Hold'em No Limit ($0.02/$0.05) - 2023/12/22 21:45:12
Table 'RushAndCash797450' 6-max Seat #1 is the button
Seat 1: 86f62bb0 ($10.23 in chips)
Seat 2: Hero ($7.08 in chips)
Seat 3: d42ee966 ($8.84 in chips)
Seat 4: 4e20b85a ($6.32 in chips)
Seat 5: 891938bf ($5.9 in chips)
Seat 6: d21cc812 ($6.47 in chips)
Hero: posts small blind $0.02
d42ee966: posts big blind $0.05
*** HOLE CARDS ***
Dealt to 86f62bb0 
Dealt to Hero [Js Kd]
Dealt to d42ee966 
Dealt to 4e20b85a 
Dealt to 891938bf 
Dealt to d21cc812 
4e20b85a: folds
891938bf: folds
d21cc812: folds
86f62bb0: folds
Hero: folds
Uncalled bet ($0.03) returned to d42ee966
*** SHOWDOWN ***
d42ee966 collected $0.04 from pot
*** SUMMARY ***
Total pot $0.04 | Rake $0 | Jackpot $0 | Bingo $0 | Fortune $0 | Tax $0
Seat 1: 86f62bb0 (button) folded before Flop (didn't bet)
Seat 2: Hero (small blind) folded before Flop
Seat 3: d42ee966 (big blind) collected ($0.04)
Seat 4: 4e20b85a folded before Flop (didn't bet)
Seat 5: 891938bf folded before Flop (didn't bet)
Seat 6: d21cc812 folded before Flop (didn't bet)


Poker Hand #RC2078535210: Hold'em No Limit ($0.02/$0.05) - 2023/12/22 21:45:01
Table 'RushAndCash797354' 6-max Seat #1 is the button
Seat 1: e194bfc6 ($15.78 in chips)
Seat 2: 52f74b76 ($5.98 in chips)
Seat 3: Hero ($7.13 in chips)
Seat 4: 3402e890 ($9.92 in chips)
Seat 5: 4810f2d7 ($5.87 in chips)
Seat 6: 765e7e9d ($7.24 in chips)
52f74b76: posts small blind $0.02
Hero: posts big blind $0.05
*** HOLE CARDS ***
Dealt to e194bfc6 
Dealt to 52f74b76 
Dealt to Hero [6c 2d]
Dealt to 3402e890 
Dealt to 4810f2d7 
Dealt to 765e7e9d 
3402e890: folds
4810f2d7: folds
765e7e9d: folds
e194bfc6: raises $0.06 to $0.11
52f74b76: folds
Hero: folds
Uncalled bet ($0.06) returned to e194bfc6
*** SHOWDOWN ***
e194bfc6 collected $0.12 from pot
*** SUMMARY ***
Total pot $0.12 | Rake $0 | Jackpot $0 | Bingo $0 | Fortune $0 | Tax $0
Seat 1: e194bfc6 (button) collected ($0.12)
Seat 2: 52f74b76 (small blind) folded before Flop
Seat 3: Hero (big blind) folded before Flop
Seat 4: 3402e890 folded before Flop (didn't bet)
Seat 5: 4810f2d7 folded before Flop (didn't bet)
Seat 6: 765e7e9d folded before Flop (didn't bet)


Poker Hand #RC2078535138: Hold'em No Limit ($0.02/$0.05) - 2023/12/22 21:44:58
Table 'RushAndCash797320' 6-max Seat #1 is the button
Seat 1: e19dee32 ($8.66 in chips)
Seat 2: 2afe98d4 ($5.03 in chips)
Seat 3: c9414c7d ($10.04 in chips)
Seat 4: Hero ($7.13 in chips)
Seat 5: dc29a28e ($6 in chips)
Seat 6: 6c94c615 ($5.13 in chips)
2afe98d4: posts small blind $0.02
c9414c7d: posts big blind $0.05
*** HOLE CARDS ***
Dealt to e19dee32 
Dealt to 2afe98d4 
Dealt to c9414c7d 
Dealt to Hero [9s Ad]
Dealt to dc29a28e 
Dealt to 6c94c615 
Hero: folds
dc29a28e: folds
6c94c615: raises $0.08 to $0.13
e19dee32: folds
2afe98d4: folds
c9414c7d: folds
Uncalled bet ($0.08) returned to 6c94c615
*** SHOWDOWN ***
6c94c615 collected $0.12 from pot
*** SUMMARY ***
Total pot $0.12 | Rake $0 | Jackpot $0 | Bingo $0 | Fortune $0 | Tax $0
Seat 1: e19dee32 (button) folded before Flop (didn't bet)
Seat 2: 2afe98d4 (small blind) folded before Flop
Seat 3: c9414c7d (big blind) folded before Flop
Seat 4: Hero folded before Flop (didn't bet)
Seat 5: dc29a28e folded before Flop (didn't bet)
Seat 6: 6c94c615 collected ($0.12)


Poker Hand #RC2078524214: Hold'em No Limit ($0.02/$0.05) - 2023/12/22 21:44:05
Table 'RushAndCash796861' 6-max Seat #1 is the button
Seat 1: e4d2f8b7 ($9.99 in chips)
Seat 2: 893f08ec ($5.88 in chips)
Seat 3: e6f6623d ($4.53 in chips)
Seat 4: Hero ($6.97 in chips)
Seat 5: dc29a28e ($6.1 in chips)
Seat 6: 8f1a23de ($5 in chips)
893f08ec: posts small blind $0.02
e6f6623d: posts big blind $0.05
*** HOLE CARDS ***
Dealt to e4d2f8b7 
Dealt to 893f08ec 
Dealt to e6f6623d 
Dealt to Hero [5c Ac]
Dealt to dc29a28e 
Dealt to 8f1a23de 
Hero: raises $0.05 to $0.1
dc29a28e: calls $0.1
8f1a23de: folds
e4d2f8b7: folds
893f08ec: folds
e6f6623d: folds
*** FLOP *** [8d Ah 2d]
Hero: checks
dc29a28e: checks
*** TURN *** [8d Ah 2d] [3c]
Hero: checks
dc29a28e: checks
*** RIVER *** [8d Ah 2d 3c] [5d]
Hero: bets $0.14
dc29a28e: folds
Uncalled bet ($0.14) returned to Hero
*** SHOWDOWN ***
Hero collected $0.26 from pot
*** SUMMARY ***
Total pot $0.27 | Rake $0.01 | Jackpot $0 | Bingo $0 | Fortune $0 | Tax $0
Board [8d Ah 2d 3c 5d]
Seat 1: e4d2f8b7 (button) folded before Flop (didn't bet)
Seat 2: 893f08ec (small blind) folded before Flop
Seat 3: e6f6623d (big blind) folded before Flop
Seat 4: Hero won ($0.26)
Seat 5: dc29a28e folded on the River
Seat 6: 8f1a23de folded before Flop (didn't bet)


Poker Hand #RC2078524061: Hold'em No Limit ($0.02/$0.05) - 2023/12/22 21:43:56
Table 'RushAndCash796786' 6-max Seat #1 is the button
Seat 1: 42e18915 ($6.92 in chips)
Seat 2: Hero ($6.99 in chips)
Seat 3: 56d0ca9d ($6.32 in chips)
Seat 4: 52956fa5 ($5.04 in chips)
Seat 5: d6c4e270 ($2.35 in chips)
Seat 6: d6d8d23b ($9.43 in chips)
Hero: posts small blind $0.02
56d0ca9d: posts big blind $0.05
*** HOLE CARDS ***
Dealt to 42e18915 
Dealt to Hero [3s 8d]
Dealt to 56d0ca9d 
Dealt to 52956fa5 
Dealt to d6c4e270 
Dealt to d6d8d23b 
52956fa5: raises $0.05 to $0.1
d6c4e270: calls $0.1
d6d8d23b: folds
42e18915: folds
Hero: folds
56d0ca9d: folds
*** FLOP *** [4s Qh 9d]
52956fa5: checks
d6c4e270: bets $0.09
52956fa5: folds
Uncalled bet ($0.09) returned to d6c4e270
*** SHOWDOWN ***
d6c4e270 collected $0.26 from pot
*** SUMMARY ***
Total pot $0.27 | Rake $0.01 | Jackpot $0 | Bingo $0 | Fortune $0 | Tax $0
Board [4s Qh 9d]
Seat 1: 42e18915 (button) folded before Flop (didn't bet)
Seat 2: Hero (small blind) folded before Flop
Seat 3: 56d0ca9d (big blind) folded before Flop
Seat 4: 52956fa5 folded on the Flop
Seat 5: d6c4e270 won ($0.26)
Seat 6: d6d8d23b folded before Flop (didn't bet)


Poker Hand #RC2078523984: Hold'em No Limit ($0.02/$0.05) - 2023/12/22 21:43:52
Table 'RushAndCash796748' 6-max Seat #1 is the button
Seat 1: bba39737 ($4.93 in chips)
Seat 2: dc29a28e ($6.12 in chips)
Seat 3: 3c3b8bf8 ($5 in chips)
Seat 4: 2d19d9d1 ($5.83 in chips)
Seat 5: 6c75362e ($10.65 in chips)
Seat 6: Hero ($6.99 in chips)
dc29a28e: posts small blind $0.02
3c3b8bf8: posts big blind $0.05
*** HOLE CARDS ***
Dealt to bba39737 
Dealt to dc29a28e 
Dealt to 3c3b8bf8 
Dealt to 2d19d9d1 
Dealt to 6c75362e 
Dealt to Hero [2h 4d]
2d19d9d1: raises $0.08 to $0.13
6c75362e: calls $0.13
Hero: folds
bba39737: folds
dc29a28e: folds
3c3b8bf8: folds
*** FLOP *** [8c 6c 6d]
2d19d9d1: checks
6c75362e: bets $0.17
2d19d9d1: folds
Uncalled bet ($0.17) returned to 6c75362e
*** SHOWDOWN ***
6c75362e collected $0.32 from pot
*** SUMMARY ***
Total pot $0.33 | Rake $0.01 | Jackpot $0 | Bingo $0 | Fortune $0 | Tax $0
Board [8c 6c 6d]
Seat 1: bba39737 (button) folded before Flop (didn't bet)
Seat 2: dc29a28e (small blind) folded before Flop
Seat 3: 3c3b8bf8 (big blind) folded before Flop
Seat 4: 2d19d9d1 folded on the Flop
Seat 5: 6c75362e won ($0.32)
Seat 6: Hero folded before Flop (didn't bet)


Poker Hand #RC2078523833: Hold'em No Limit ($0.02/$0.05) - 2023/12/22 21:43:43
Table 'RushAndCash796672' 6-max Seat #1 is the button
Seat 1: 8aaa95a5 ($5.33 in chips)
Seat 2: f3d3c9ba ($10.34 in chips)
Seat 3: Hero ($7.04 in chips)
Seat 4: 6d679d40 ($6.45 in chips)
Seat 5: 1d81a4c5 ($4.74 in chips)
Seat 6: b6052383 ($5.93 in chips)
f3d3c9ba: posts small blind $0.02
Hero: posts big blind $0.05
*** HOLE CARDS ***
Dealt to 8aaa95a5 
Dealt to f3d3c9ba 
Dealt to Hero [Kd 4s]
Dealt to 6d679d40 
Dealt to 1d81a4c5 
Dealt to b6052383 
6d679d40: folds
1d81a4c5: folds
b6052383: folds
8aaa95a5: raises $0.08 to $0.13
f3d3c9ba: folds
Hero: folds
Uncalled bet ($0.08) returned to 8aaa95a5
*** SHOWDOWN ***
8aaa95a5 collected $0.12 from pot
*** SUMMARY ***
Total pot $0.12 | Rake $0 | Jackpot $0 | Bingo $0 | Fortune $0 | Tax $0
Seat 1: 8aaa95a5 (button) collected ($0.12)
Seat 2: f3d3c9ba (small blind) folded before Flop
Seat 3: Hero (big blind) folded before Flop
Seat 4: 6d679d40 folded before Flop (didn't bet)
Seat 5: 1d81a4c5 folded before Flop (didn't bet)
Seat 6: b6052383 folded before Flop (didn't bet)


Poker Hand #RC2078523743: Hold'em No Limit ($0.02/$0.05) - 2023/12/22 21:43:38
Table 'RushAndCash796629' 6-max Seat #1 is the button
Seat 1: 360d3b25 ($5 in chips)
Seat 2: 3bb1f7cc ($5.02 in chips)
Seat 3: 91937678 ($3.92 in chips)
Seat 4: Hero ($7.04 in chips)
Seat 5: 75daa184 ($8.83 in chips)
Seat 6: 311eeba4 ($17.49 in chips)
3bb1f7cc: posts small blind $0.02
91937678: posts big blind $0.05
*** HOLE CARDS ***
Dealt to 360d3b25 
Dealt to 3bb1f7cc 
Dealt to 91937678 
Dealt to Hero [9c Td]
Dealt to 75daa184 
Dealt to 311eeba4 
Hero: folds
75daa184: folds
311eeba4: folds
360d3b25: folds
3bb1f7cc: folds
Uncalled bet ($0.03) returned to 91937678
*** SHOWDOWN ***
91937678 collected $0.04 from pot
*** SUMMARY ***
Total pot $0.04 | Rake $0 | Jackpot $0 | Bingo $0 | Fortune $0 | Tax $0
Seat 1: 360d3b25 (button) folded before Flop (didn't bet)
Seat 2: 3bb1f7cc (small blind) folded before Flop
Seat 3: 91937678 (big blind) collected ($0.04)
Seat 4: Hero folded before Flop (didn't bet)
Seat 5: 75daa184 folded before Flop (didn't bet)
Seat 6: 311eeba4 folded before Flop (didn't bet)


Poker Hand #RC2078523395: Hold'em No Limit ($0.02/$0.05) - 2023/12/22 21:43:19
Table 'RushAndCash796460' 6-max Seat #1 is the button
Seat 1: Hero ($6.9 in chips)
Seat 2: ae47b4ce ($5.23 in chips)
Seat 3: 4c0d7324 ($9.92 in chips)
Seat 4: 48d31a27 ($5.16 in chips)
Seat 5: cbfe1acc ($3.98 in chips)
Seat 6: 875f34a0 ($24.78 in chips)
ae47b4ce: posts small blind $0.02
4c0d7324: posts big blind $0.05
*** HOLE CARDS ***
Dealt to Hero [Ah Kd]
Dealt to ae47b4ce 
Dealt to 4c0d7324 
Dealt to 48d31a27 
Dealt to cbfe1acc 
Dealt to 875f34a0 
48d31a27: folds
cbfe1acc: folds
875f34a0: folds
Hero: raises $0.08 to $0.13
ae47b4ce: folds
4c0d7324: calls $0.08
*** FLOP *** [7h 2d 8c]
4c0d7324: checks
Hero: bets $0.14
4c0d7324: folds
Uncalled bet ($0.14) returned to Hero
*** SHOWDOWN ***
Hero collected $0.27 from pot
*** SUMMARY ***
Total pot $0.28 | Rake $0.01 | Jackpot $0 | Bingo $0 | Fortune $0 | Tax $0
Board [7h 2d 8c]
Seat 1: Hero (button) won ($0.27)
Seat 2: ae47b4ce (small blind) folded before Flop
Seat 3: 4c0d7324 (big blind) folded on the Flop
Seat 4: 48d31a27 folded before Flop (didn't bet)
Seat 5: cbfe1acc folded before Flop (didn't bet)
Seat 6: 875f34a0 folded before Flop (didn't bet)


Poker Hand #RC2078522479: Hold'em No Limit ($0.02/$0.05) - 2023/12/22 21:42:27
Table 'RushAndCash796022' 6-max Seat #1 is the button
Seat 1: 6fefb285 ($5 in chips)
Seat 2: 6fcfcac0 ($5.57 in chips)
Seat 3: 875f34a0 ($24.67 in chips)
Seat 4: 6c94c615 ($5.2 in chips)
Seat 5: 53e5e018 ($3.32 in chips)
Seat 6: Hero ($7 in chips)
6fcfcac0: posts small blind $0.02
875f34a0: posts big blind $0.05
*** HOLE CARDS ***
Dealt to 6fefb285 
Dealt to 6fcfcac0 
Dealt to 875f34a0 
Dealt to 6c94c615 
Dealt to 53e5e018 
Dealt to Hero [7s 7h]
6c94c615: folds
53e5e018: folds
Hero: raises $0.05 to $0.1
6fefb285: folds
6fcfcac0: folds
875f34a0: calls $0.05
*** FLOP *** [6h 4d Jc]
875f34a0: checks
Hero: checks
*** TURN *** [6h 4d Jc] [9c]
875f34a0: checks
Hero: checks
*** RIVER *** [6h 4d Jc 9c] [Ah]
875f34a0: checks
Hero: checks
875f34a0: shows [Jd Ts] (Pair of Jacks)
Hero: shows [7s 7h] (Pair of Sevens)
*** SHOWDOWN ***
875f34a0 collected $0.21 from pot
*** SUMMARY ***
Total pot $0.22 | Rake $0.01 | Jackpot $0 | Bingo $0 | Fortune $0 | Tax $0
Board [6h 4d Jc 9c Ah]
Seat 1: 6fefb285 (button) folded before Flop (didn't bet)
Seat 2: 6fcfcac0 (small blind) folded before Flop
Seat 3: 875f34a0 (big blind) showed [Jd Ts] and won ($0.21) with Pair of Jacks
Seat 4: 6c94c615 folded before Flop (didn't bet)
Seat 5: 53e5e018 folded before Flop (didn't bet)
Seat 6: Hero showed [7s 7h] and lost with Pair of Sevens


Poker Hand #RC2078522073: Hold'em No Limit ($0.02/$0.05) - 2023/12/22 21:42:04
Table 'RushAndCash795833' 6-max Seat #1 is the button
Seat 1: 6c94c615 ($5.33 in chips)
Seat 2: Hero ($6.83 in chips)
Seat 3: fbeaaad2 ($15.88 in chips)
Seat 4: 75daa184 ($9.32 in chips)
Seat 5: de1c7123 ($8.86 in chips)
Seat 6: f0040865 ($6.02 in chips)
Hero: posts small blind $0.02
fbeaaad2: posts big blind $0.05
*** HOLE CARDS ***
Dealt to 6c94c615 
Dealt to Hero [Ks Ac]
Dealt to fbeaaad2 
Dealt to 75daa184 
Dealt to de1c7123 
Dealt to f0040865 
75daa184: folds
de1c7123: folds
f0040865: folds
6c94c615: raises $0.08 to $0.13
Hero: raises $0.36 to $0.49
fbeaaad2: folds
6c94c615: folds
Uncalled bet ($0.36) returned to Hero
*** SHOWDOWN ***
Hero collected $0.3 from pot
*** SUMMARY ***
Total pot $0.31 | Rake $0.01 | Jackpot $0 | Bingo $0 | Fortune $0 | Tax $0
Seat 1: 6c94c615 (button) folded before Flop
Seat 2: Hero (small blind) collected ($0.3)
Seat 3: fbeaaad2 (big blind) folded before Flop
Seat 4: 75daa184 folded before Flop (didn't bet)
Seat 5: de1c7123 folded before Flop (didn't bet)
Seat 6: f0040865 folded before Flop (didn't bet)


Poker Hand #RC2078521906: Hold'em No Limit ($0.02/$0.05) - 2023/12/22 21:41:55
Table 'RushAndCash795755' 6-max Seat #1 is the button
Seat 1: aeeb0181 ($7.02 in chips)
Seat 2: f71b25e9 ($7.73 in chips)
Seat 3: Hero ($6.88 in chips)
Seat 4: c9edf932 ($5.27 in chips)
Seat 5: 9b2d2337 ($23.19 in chips)
Seat 6: 45aa7628 ($6.46 in chips)
f71b25e9: posts small blind $0.02
Hero: posts big blind $0.05
*** HOLE CARDS ***
Dealt to aeeb0181 
Dealt to f71b25e9 
Dealt to Hero [3c 8d]
Dealt to c9edf932 
Dealt to 9b2d2337 
Dealt to 45aa7628 
c9edf932: folds
9b2d2337: raises $0.06 to $0.11
45aa7628: folds
aeeb0181: folds
f71b25e9: folds
Hero: folds
Uncalled bet ($0.06) returned to 9b2d2337
*** SHOWDOWN ***
9b2d2337 collected $0.12 from pot
*** SUMMARY ***
Total pot $0.12 | Rake $0 | Jackpot $0 | Bingo $0 | Fortune $0 | Tax $0
Seat 1: aeeb0181 (button) folded before Flop (didn't bet)
Seat 2: f71b25e9 (small blind) folded before Flop
Seat 3: Hero (big blind) folded before Flop
Seat 4: c9edf932 folded before Flop (didn't bet)
Seat 5: 9b2d2337 collected ($0.12)
Seat 6: 45aa7628 folded before Flop (didn't bet)


Poker Hand #RC2078521826: Hold'em No Limit ($0.02/$0.05) - 2023/12/22 21:41:51
Table 'RushAndCash795718' 6-max Seat #1 is the button
Seat 1: f71b25e9 ($7.73 in chips)
Seat 2: 9d5d55a2 ($5.75 in chips)
Seat 3: 1d0d69cf ($5 in chips)
Seat 4: Hero ($6.88 in chips)
Seat 5: d882ee6f ($1.1 in chips)
Seat 6: 8ad5eb6 ($3.63 in chips)
9d5d55a2: posts small blind $0.02
1d0d69cf: posts big blind $0.05
*** HOLE CARDS ***
Dealt to f71b25e9 
Dealt to 9d5d55a2 
Dealt to 1d0d69cf 
Dealt to Hero [6c 4c]
Dealt to d882ee6f 
Dealt to 8ad5eb6 
Hero: folds
d882ee6f: folds
8ad5eb6: raises $0.05 to $0.1
f71b25e9: folds
9d5d55a2: folds
1d0d69cf: raises $0.45 to $0.55
8ad5eb6: calls $0.45
*** FLOP *** [8s 6d Ac]
1d0d69cf: checks
8ad5eb6: checks
*** TURN *** [8s 6d Ac] [3c]
1d0d69cf: bets $0.79
8ad5eb6: folds
Uncalled bet ($0.79) returned to 1d0d69cf
*** SHOWDOWN ***
1d0d69cf collected $1.07 from pot
*** SUMMARY ***
Total pot $1.12 | Rake $0.05 | Jackpot $0 | Bingo $0 | Fortune $0 | Tax $0
Board [8s 6d Ac 3c]
Seat 1: f71b25e9 (button) folded before Flop (didn't bet)
Seat 2: 9d5d55a2 (small blind) folded before Flop
Seat 3: 1d0d69cf (big blind) won ($1.07)
Seat 4: Hero folded before Flop (didn't bet)
Seat 5: d882ee6f folded before Flop (didn't bet)
Seat 6: 8ad5eb6 folded on the Turn


Poker Hand #RC2078520967: Hold'em No Limit ($0.02/$0.05) - 2023/12/22 21:41:04
Table 'RushAndCash795306' 6-max Seat #1 is the button
Seat 1: Hero ($5 in chips)
Seat 2: 354a07bb ($9.91 in chips)
Seat 3: 65358b0f ($4.49 in chips)
Seat 4: 8ad5eb6 ($5.56 in chips)
Seat 5: 9b2d2337 ($23.43 in chips)
Seat 6: 6ff1e240 ($9.02 in chips)
354a07bb: posts small blind $0.02
65358b0f: posts big blind $0.05
*** HOLE CARDS ***
Dealt to Hero [Qd Qc]
Dealt to 354a07bb 
Dealt to 65358b0f 
Dealt to 8ad5eb6 
Dealt to 9b2d2337 
Dealt to 6ff1e240 
8ad5eb6: raises $0.05 to $0.1
9b2d2337: calls $0.1
6ff1e240: folds
Hero: raises $0.42 to $0.52
354a07bb: folds
65358b0f: folds
8ad5eb6: calls $0.42
9b2d2337: folds
*** FLOP *** [6c 8h 4s]
8ad5eb6: checks
Hero: bets $0.4
8ad5eb6: raises $1.01 to $1.41
Hero: raises $3.07 to $4.48 and is all-in
8ad5eb6: folds
Uncalled bet ($3.07) returned to Hero
*** SHOWDOWN ***
Hero collected $3.81 from pot
*** SUMMARY ***
Total pot $4.03 | Rake $0.15 | Jackpot $0.07 | Bingo $0 | Fortune $0 | Tax $0
Board [6c 8h 4s]
Seat 1: Hero (button) won ($3.81)
Seat 2: 354a07bb (small blind) folded before Flop
Seat 3: 65358b0f (big blind) folded before Flop
Seat 4: 8ad5eb6 folded on the Flop
Seat 5: 9b2d2337 folded before Flop
Seat 6: 6ff1e240 folded before Flop (didn't bet)


Poker Hand #RC2078520891: Hold'em No Limit ($0.02/$0.05) - 2023/12/22 21:40:59
Table 'RushAndCash795268' 6-max Seat #1 is the button
Seat 1: 610bd7fc ($8.7 in chips)
Seat 2: 9e7c6577 ($4.46 in chips)
Seat 3: d01821aa ($4.73 in chips)
Seat 4: 5261fe21 ($6.27 in chips)
Seat 5: 9b2d2337 ($23.43 in chips)
Seat 6: Hero ($5 in chips)
9e7c6577: posts small blind $0.02
d01821aa: posts big blind $0.05
*** HOLE CARDS ***
Dealt to 610bd7fc 
Dealt to 9e7c6577 
Dealt to d01821aa 
Dealt to 5261fe21 
Dealt to 9b2d2337 
Dealt to Hero [As 9h]
5261fe21: folds
9b2d2337: folds
Hero: folds
610bd7fc: raises $0.05 to $0.1
9e7c6577: raises $0.21 to $0.31
d01821aa: folds
610bd7fc: folds
Uncalled bet ($0.21) returned to 9e7c6577
*** SHOWDOWN ***
9e7c6577 collected $0.24 from pot
*** SUMMARY ***
Total pot $0.25 | Rake $0.01 | Jackpot $0 | Bingo $0 | Fortune $0 | Tax $0
Seat 1: 610bd7fc (button) folded before Flop
Seat 2: 9e7c6577 (small blind) collected ($0.24)
Seat 3: d01821aa (big blind) folded before Flop
Seat 4: 5261fe21 folded before Flop (didn't bet)
Seat 5: 9b2d2337 folded before Flop (didn't bet)
Seat 6: Hero folded before Flop (didn't bet)


Poker Hand #RC2078520820: Hold'em No Limit ($0.02/$0.05) - 2023/12/22 21:40:56
Table 'RushAndCash795236' 6-max Seat #1 is the button
Seat 1: f0b0a5f9 ($15.61 in chips)
Seat 2: 6a898db1 ($3.93 in chips)
Seat 3: 67b2bd28 ($4.91 in chips)
Seat 4: 1e3d103d ($10.04 in chips)
Seat 5: Hero ($5 in chips)
Seat 6: d9ec3117 ($5 in chips)
6a898db1: posts small blind $0.02
67b2bd28: posts big blind $0.05
*** HOLE CARDS ***
Dealt to f0b0a5f9 
Dealt to 6a898db1 
Dealt to 67b2bd28 
Dealt to 1e3d103d 
Dealt to Hero [4s Ac]
Dealt to d9ec3117 
1e3d103d: folds
Hero: folds
d9ec3117: folds
f0b0a5f9: raises $0.08 to $0.13
6a898db1: folds
67b2bd28: calls $0.08
*** FLOP *** [2s 4d Qc]
67b2bd28: checks
f0b0a5f9: bets $0.14
67b2bd28: calls $0.14
*** TURN *** [2s 4d Qc] [7s]
67b2bd28: checks
f0b0a5f9: bets $0.56
67b2bd28: folds
Uncalled bet ($0.56) returned to f0b0a5f9
*** SHOWDOWN ***
f0b0a5f9 collected $0.54 from pot
*** SUMMARY ***
Total pot $0.56 | Rake $0.02 | Jackpot $0 | Bingo $0 | Fortune $0 | Tax $0
Board [2s 4d Qc 7s]
Seat 1: f0b0a5f9 (button) won ($0.54)
Seat 2: 6a898db1 (small blind) folded before Flop
Seat 3: 67b2bd28 (big blind) folded on the Turn
Seat 4: 1e3d103d folded before Flop (didn't bet)
Seat 5: Hero folded before Flop (didn't bet)
Seat 6: d9ec3117 folded before Flop (didn't bet)


Poker Hand #RC2078520667: Hold'em No Limit ($0.02/$0.05) - 2023/12/22 21:40:47
Table 'RushAndCash795162' 6-max Seat #1 is the button
Seat 1: 9a957500 ($1.72 in chips)
Seat 2: Hero ($5 in chips)
Seat 3: 924de653 ($1.47 in chips)
Seat 4: f71b25e9 ($7.73 in chips)
Seat 5: 954d1f7b ($12.74 in chips)
Seat 6: 8da33d79 ($10.3 in chips)
Hero: posts small blind $0.02
924de653: posts big blind $0.05
*** HOLE CARDS ***
Dealt to 9a957500 
Dealt to Hero [Qc 9c]
Dealt to 924de653 
Dealt to f71b25e9 
Dealt to 954d1f7b 
Dealt to 8da33d79 
f71b25e9: folds
954d1f7b: folds
8da33d79: folds
9a957500: raises $0.1 to $0.15
Hero: folds
924de653: folds
Uncalled bet ($0.1) returned to 9a957500
*** SHOWDOWN ***
9a957500 collected $0.12 from pot
*** SUMMARY ***
Total pot $0.12 | Rake $0 | Jackpot $0 | Bingo $0 | Fortune $0 | Tax $0
Seat 1: 9a957500 (button) collected ($0.12)
Seat 2: Hero (small blind) folded before Flop
Seat 3: 924de653 (big blind) folded before Flop
Seat 4: f71b25e9 folded before Flop (didn't bet)
Seat 5: 954d1f7b folded before Flop (didn't bet)
Seat 6: 8da33d79 folded before Flop (didn't bet)


Poker Hand #RC2078520093: Hold'em No Limit ($0.02/$0.05) - 2023/12/22 21:40:14
Table 'RushAndCash794889' 6-max Seat #1 is the button
Seat 1: 893f08ec ($5.75 in chips)
Seat 2: fdc2d3ba ($13.5 in chips)
Seat 3: Hero ($5 in chips)
Seat 4: 469c47cc ($8.54 in chips)
Seat 5: a51bf3f3 ($2.57 in chips)
Seat 6: 7e84e7dc ($14.35 in chips)
fdc2d3ba: posts small blind $0.02
Hero: posts big blind $0.05
*** HOLE CARDS ***
Dealt to 893f08ec 
Dealt to fdc2d3ba 
Dealt to Hero [Qh 8h]
Dealt to 469c47cc 
Dealt to a51bf3f3 
Dealt to 7e84e7dc 
469c47cc: folds
a51bf3f3: raises $0.05 to $0.1
7e84e7dc: folds
893f08ec: folds
fdc2d3ba: calls $0.08
Hero: calls $0.05
*** FLOP *** [Jd 7c 4h]
fdc2d3ba: checks
Hero: checks
a51bf3f3: checks
*** TURN *** [Jd 7c 4h] [3d]
fdc2d3ba: bets $0.23
Hero: folds
a51bf3f3: folds
Uncalled bet ($0.23) returned to fdc2d3ba
*** SHOWDOWN ***
fdc2d3ba collected $0.29 from pot
*** SUMMARY ***
Total pot $0.3 | Rake $0.01 | Jackpot $0 | Bingo $0 | Fortune $0 | Tax $0
Board [Jd 7c 4h 3d]
Seat 1: 893f08ec (button) folded before Flop (didn't bet)
Seat 2: fdc2d3ba (small blind) won ($0.29)
Seat 3: Hero (big blind) folded on the Turn
Seat 4: 469c47cc folded before Flop (didn't bet)
Seat 5: a51bf3f3 folded on the Turn
Seat 6: 7e84e7dc folded before Flop (didn't bet)


Poker Hand #RC2078519620: Hold'em No Limit ($0.02/$0.05) - 2023/12/22 21:39:48
Table 'RushAndCash794654' 6-max Seat #1 is the button
Seat 1: f3d3c9ba ($10.12 in chips)
Seat 2: 94e2487d ($4.95 in chips)
Seat 3: cac59813 ($5.07 in chips)
Seat 4: 6ff1e240 ($9.09 in chips)
Seat 5: 5cd52bac ($6.97 in chips)
Seat 6: Hero ($5.1 in chips)
94e2487d: posts small blind $0.02
cac59813: posts big blind $0.05
*** HOLE CARDS ***
Dealt to f3d3c9ba 
Dealt to 94e2487d 
Dealt to cac59813 
Dealt to 6ff1e240 
Dealt to 5cd52bac 
Dealt to Hero [Kh 8h]
6ff1e240: folds
5cd52bac: folds
Hero: raises $0.05 to $0.1
f3d3c9ba: folds
94e2487d: folds
cac59813: raises $0.28 to $0.38
Hero: folds
Uncalled bet ($0.28) returned to cac59813
*** SHOWDOWN ***
cac59813 collected $0.21 from pot
*** SUMMARY ***
Total pot $0.22 | Rake $0.01 | Jackpot $0 | Bingo $0 | Fortune $0 | Tax $0
Seat 1: f3d3c9ba (button) folded before Flop (didn't bet)
Seat 2: 94e2487d (small blind) folded before Flop
Seat 3: cac59813 (big blind) collected ($0.21)
Seat 4: 6ff1e240 folded before Flop (didn't bet)
Seat 5: 5cd52bac folded before Flop (didn't bet)
Seat 6: Hero folded before Flop


Poker Hand #RC2078519494: Hold'em No Limit ($0.02/$0.05) - 2023/12/22 21:39:41
Table 'RushAndCash794593' 6-max Seat #1 is the button
Seat 1: 51c82b66 ($5.59 in chips)
Seat 2: f0b0a5f9 ($15.73 in chips)
Seat 3: 84572dc4 ($2.54 in chips)
Seat 4: Hero ($5.1 in chips)
Seat 5: f6b5f68e ($8.67 in chips)
Seat 6: b5f4d20f ($5 in chips)
f0b0a5f9: posts small blind $0.02
84572dc4: posts big blind $0.05
*** HOLE CARDS ***
Dealt to 51c82b66 
Dealt to f0b0a5f9 
Dealt to 84572dc4 
Dealt to Hero [9h 6h]
Dealt to f6b5f68e 
Dealt to b5f4d20f 
Hero: folds
f6b5f68e: folds
b5f4d20f: folds
51c82b66: folds
f0b0a5f9: calls $0.03
84572dc4: checks
*** FLOP *** [5c 8h Kc]
f0b0a5f9: checks
84572dc4: checks
*** TURN *** [5c 8h Kc] [6d]
f0b0a5f9: checks
84572dc4: checks
*** RIVER *** [5c 8h Kc 6d] [Ks]
f0b0a5f9: checks
84572dc4: bets $0.05
f0b0a5f9: folds
Uncalled bet ($0.05) returned to 84572dc4
*** SHOWDOWN ***
84572dc4 collected $0.1 from pot
*** SUMMARY ***
Total pot $0.1 | Rake $0 | Jackpot $0 | Bingo $0 | Fortune $0 | Tax $0
Board [5c 8h Kc 6d Ks]
Seat 1: 51c82b66 (button) folded before Flop (didn't bet)
Seat 2: f0b0a5f9 (small blind) folded on the River
Seat 3: 84572dc4 (big blind) won ($0.1)
Seat 4: Hero folded before Flop (didn't bet)
Seat 5: f6b5f68e folded before Flop (didn't bet)
Seat 6: b5f4d20f folded before Flop (didn't bet)


Poker Hand #RC2078518772: Hold'em No Limit ($0.02/$0.05) - 2023/12/22 21:39:04
Table 'RushAndCash794243' 6-max Seat #1 is the button
Seat 1: Hero ($5.23 in chips)
Seat 2: c53293cf ($5 in chips)
Seat 3: f0b0a5f9 ($15.59 in chips)
Seat 4: f3d3c9ba ($10.19 in chips)
Seat 5: c71b7029 ($9.38 in chips)
Seat 6: f30308e3 ($5 in chips)
c53293cf: posts small blind $0.02
f0b0a5f9: posts big blind $0.05
*** HOLE CARDS ***
Dealt to Hero [Qh 7h]
Dealt to c53293cf 
Dealt to f0b0a5f9 
Dealt to f3d3c9ba 
Dealt to c71b7029 
Dealt to f30308e3 
f3d3c9ba: folds
c71b7029: folds
f30308e3: folds
Hero: raises $0.08 to $0.13
c53293cf: folds
f0b0a5f9: raises $0.28 to $0.41
Hero: folds
Uncalled bet ($0.28) returned to f0b0a5f9
*** SHOWDOWN ***
f0b0a5f9 collected $0.27 from pot
*** SUMMARY ***
Total pot $0.28 | Rake $0.01 | Jackpot $0 | Bingo $0 | Fortune $0 | Tax $0
Seat 1: Hero (button) folded before Flop
Seat 2: c53293cf (small blind) folded before Flop
Seat 3: f0b0a5f9 (big blind) collected ($0.27)
Seat 4: f3d3c9ba folded before Flop (didn't bet)
Seat 5: c71b7029 folded before Flop (didn't bet)
Seat 6: f30308e3 folded before Flop (didn't bet)


Poker Hand #RC2078518551: Hold'em No Limit ($0.02/$0.05) - 2023/12/22 21:38:52
Table 'RushAndCash794141' 6-max Seat #1 is the button
Seat 1: b2bf2645 ($5.09 in chips)
Seat 2: cfacbec5 ($5 in chips)
Seat 3: d32741ba ($8.31 in chips)
Seat 4: 7d137087 ($7.61 in chips)
Seat 5: Hero ($5.23 in chips)
Seat 6: 354a07bb ($5 in chips)
cfacbec5: posts small blind $0.02
d32741ba: posts big blind $0.05
*** HOLE CARDS ***
Dealt to b2bf2645 
Dealt to cfacbec5 
Dealt to d32741ba 
Dealt to 7d137087 
Dealt to Hero [9c Ad]
Dealt to 354a07bb 
7d137087: folds
Hero: folds
354a07bb: folds
b2bf2645: folds
cfacbec5: calls $0.03
d32741ba: checks
*** FLOP *** [7h 5d 2d]
cfacbec5: checks
d32741ba: checks
*** TURN *** [7h 5d 2d] [Tc]
cfacbec5: checks
d32741ba: checks
*** RIVER *** [7h 5d 2d Tc] [6d]
cfacbec5: bets $0.05
d32741ba: folds
Uncalled bet ($0.05) returned to cfacbec5
*** SHOWDOWN ***
cfacbec5 collected $0.1 from pot
*** SUMMARY ***
Total pot $0.1 | Rake $0 | Jackpot $0 | Bingo $0 | Fortune $0 | Tax $0
Board [7h 5d 2d Tc 6d]
Seat 1: b2bf2645 (button) folded before Flop (didn't bet)
Seat 2: cfacbec5 (small blind) won ($0.1)
Seat 3: d32741ba (big blind) folded on the River
Seat 4: 7d137087 folded before Flop (didn't bet)
Seat 5: Hero folded before Flop (didn't bet)
Seat 6: 354a07bb folded before Flop (didn't bet)


Poker Hand #RC2078518484: Hold'em No Limit ($0.02/$0.05) - 2023/12/22 21:38:48
Table 'RushAndCash794112' 6-max Seat #1 is the button
Seat 1: Hero ($5.23 in chips)
Seat 2: d32741ba ($8.33 in chips)
Seat 3: c3adc948 ($10.39 in chips)
Seat 4: 30a2950b ($5 in chips)
Seat 5: b2bf2645 ($5.09 in chips)
Seat 6: 9942b4df ($5.5 in chips)
d32741ba: posts small blind $0.02
c3adc948: posts big blind $0.05
*** HOLE CARDS ***
Dealt to Hero [2d 6d]
Dealt to d32741ba 
Dealt to c3adc948 
Dealt to 30a2950b 
Dealt to b2bf2645 
Dealt to 9942b4df 
30a2950b: folds
b2bf2645: folds
9942b4df: folds
Hero: folds
d32741ba: folds
Uncalled bet ($0.03) returned to c3adc948
*** SHOWDOWN ***
c3adc948 collected $0.04 from pot
*** SUMMARY ***
Total pot $0.04 | Rake $0 | Jackpot $0 | Bingo $0 | Fortune $0 | Tax $0
Seat 1: Hero (button) folded before Flop (didn't bet)
Seat 2: d32741ba (small blind) folded before Flop
Seat 3: c3adc948 (big blind) collected ($0.04)
Seat 4: 30a2950b folded before Flop (didn't bet)
Seat 5: b2bf2645 folded before Flop (didn't bet)
Seat 6: 9942b4df folded before Flop (didn't bet)


Poker Hand #RC2078518325: Hold'em No Limit ($0.02/$0.05) - 2023/12/22 21:38:39
Table 'RushAndCash794035' 6-max Seat #1 is the button
Seat 1: 521feab9 ($5 in chips)
Seat 2: Hero ($5.25 in chips)
Seat 3: e1380a89 ($4.69 in chips)
Seat 4: 51c82b66 ($5.28 in chips)
Seat 5: edb6154b ($5.48 in chips)
Seat 6: 8aaa95a5 ($3.29 in chips)
Hero: posts small blind $0.02
e1380a89: posts big blind $0.05
*** HOLE CARDS ***
Dealt to 521feab9 
Dealt to Hero [5d 8s]
Dealt to e1380a89 
Dealt to 51c82b66 
Dealt to edb6154b 
Dealt to 8aaa95a5 
51c82b66: folds
edb6154b: raises $0.08 to $0.13
8aaa95a5: folds
521feab9: calls $0.13
Hero: folds
e1380a89: folds
*** FLOP *** [4c 7c Ac]
edb6154b: checks
521feab9: bets $0.17
edb6154b: folds
Uncalled bet ($0.17) returned to 521feab9
*** SHOWDOWN ***
521feab9 collected $0.32 from pot
*** SUMMARY ***
Total pot $0.33 | Rake $0.01 | Jackpot $0 | Bingo $0 | Fortune $0 | Tax $0
Board [4c 7c Ac]
Seat 1: 521feab9 (button) won ($0.32)
Seat 2: Hero (small blind) folded before Flop
Seat 3: e1380a89 (big blind) folded before Flop
Seat 4: 51c82b66 folded before Flop (didn't bet)
Seat 5: edb6154b folded on the Flop
Seat 6: 8aaa95a5 folded before Flop (didn't bet)


Poker Hand #RC2078517833: Hold'em No Limit ($0.02/$0.05) - 2023/12/22 21:38:12
Table 'RushAndCash793805' 6-max Seat #1 is the button
Seat 1: b976716a ($18.77 in chips)
Seat 2: b0446474 ($13.8 in chips)
Seat 3: Hero ($5.3 in chips)
Seat 4: ce1aa7a ($5.06 in chips)
Seat 5: c15106a4 ($4.98 in chips)
Seat 6: 8d15f06b ($11.45 in chips)
Cash Drop to Pot : total $0.5 
b0446474: posts small blind $0.02
Hero: posts big blind $0.05
*** HOLE CARDS ***
Dealt to b976716a 
Dealt to b0446474 
Dealt to Hero [2s 4h]
Dealt to ce1aa7a 
Dealt to c15106a4 
Dealt to 8d15f06b 
ce1aa7a: raises $0.08 to $0.13
c15106a4: raises $0.55 to $0.68
8d15f06b: folds
b976716a: folds
b0446474: folds
Hero: folds
ce1aa7a: calls $0.55
*** FLOP *** [Qs 3c 8c]
ce1aa7a: checks
c15106a4: bets $0.64
ce1aa7a: calls $0.64
*** TURN *** [Qs 3c 8c] [4d]
ce1aa7a: checks
c15106a4: checks
*** RIVER *** [Qs 3c 8c 4d] [7h]
ce1aa7a: bets $1.61
c15106a4: folds
Uncalled bet ($1.61) returned to ce1aa7a
*** SHOWDOWN ***
ce1aa7a collected $2.99 from pot
*** SUMMARY ***
Total pot $3.21 | Rake $0.15 | Jackpot $0.07 | Bingo $0 | Fortune $0 | Tax $0
Board [Qs 3c 8c 4d 7h]
Seat 1: b976716a (button) folded before Flop (didn't bet)
Seat 2: b0446474 (small blind) folded before Flop
Seat 3: Hero (big blind) folded before Flop
Seat 4: ce1aa7a won ($2.99)
Seat 5: c15106a4 folded on the River
Seat 6: 8d15f06b folded before Flop (didn't bet)


Poker Hand #RC2078517746: Hold'em No Limit ($0.02/$0.05) - 2023/12/22 21:38:07
Table 'RushAndCash793761' 6-max Seat #1 is the button
Seat 1: 41270a9a ($5.05 in chips)
Seat 2: b88dbe00 ($5.96 in chips)
Seat 3: 102e4185 ($7.27 in chips)
Seat 4: d9ec3117 ($5.3 in chips)
Seat 5: Hero ($5.3 in chips)
Seat 6: 1394bd6b ($6.93 in chips)
b88dbe00: posts small blind $0.02
102e4185: posts big blind $0.05
*** HOLE CARDS ***
Dealt to 41270a9a 
Dealt to b88dbe00 
Dealt to 102e4185 
Dealt to d9ec3117 
Dealt to Hero [Kd 5s]
Dealt to 1394bd6b 
d9ec3117: folds
Hero: folds
1394bd6b: folds
41270a9a: folds
b88dbe00: raises $0.07 to $0.12
102e4185: folds
Uncalled bet ($0.07) returned to b88dbe00
*** SHOWDOWN ***
b88dbe00 collected $0.1 from pot
*** SUMMARY ***
Total pot $0.1 | Rake $0 | Jackpot $0 | Bingo $0 | Fortune $0 | Tax $0
Seat 1: 41270a9a (button) folded before Flop (didn't bet)
Seat 2: b88dbe00 (small blind) collected ($0.1)
Seat 3: 102e4185 (big blind) folded before Flop
Seat 4: d9ec3117 folded before Flop (didn't bet)
Seat 5: Hero folded before Flop (didn't bet)
Seat 6: 1394bd6b folded before Flop (didn't bet)


Poker Hand #RC2078517592: Hold'em No Limit ($0.02/$0.05) - 2023/12/22 21:37:59
Table 'RushAndCash793688' 6-max Seat #1 is the button
Seat 1: bc7afeb2 ($5.04 in chips)
Seat 2: 257cb6ea ($5.55 in chips)
Seat 3: bf955ffb ($5 in chips)
Seat 4: b976716a ($18.77 in chips)
Seat 5: acefe34e ($6.24 in chips)
Seat 6: Hero ($5.3 in chips)
257cb6ea: posts small blind $0.02
bf955ffb: posts big blind $0.05
*** HOLE CARDS ***
Dealt to bc7afeb2 
Dealt to 257cb6ea 
Dealt to bf955ffb 
Dealt to b976716a 
Dealt to acefe34e 
Dealt to Hero [Kc Td]
b976716a: folds
acefe34e: folds
Hero: folds
bc7afeb2: folds
257cb6ea: raises $0.1 to $0.15
bf955ffb: folds
Uncalled bet ($0.1) returned to 257cb6ea
*** SHOWDOWN ***
257cb6ea collected $0.1 from pot
*** SUMMARY ***
Total pot $0.1 | Rake $0 | Jackpot $0 | Bingo $0 | Fortune $0 | Tax $0
Seat 1: bc7afeb2 (button) folded before Flop (didn't bet)
Seat 2: 257cb6ea (small blind) collected ($0.1)
Seat 3: bf955ffb (big blind) folded before Flop
Seat 4: b976716a folded before Flop (didn't bet)
Seat 5: acefe34e folded before Flop (didn't bet)
Seat 6: Hero folded before Flop (didn't bet)


Poker Hand #RC2078517520: Hold'em No Limit ($0.02/$0.05) - 2023/12/22 21:37:55
Table 'RushAndCash793654' 6-max Seat #1 is the button
Seat 1: 27e3981e ($1.91 in chips)
Seat 2: 7e84e7dc ($14.05 in chips)
Seat 3: 220b0aae ($13.93 in chips)
Seat 4: 587c07c3 ($6.31 in chips)
Seat 5: c8c17adc ($5 in chips)
Seat 6: Hero ($5.3 in chips)
7e84e7dc: posts small blind $0.02
220b0aae: posts big blind $0.05
*** HOLE CARDS ***
Dealt to 27e3981e 
Dealt to 7e84e7dc 
Dealt to 220b0aae 
Dealt to 587c07c3 
Dealt to c8c17adc 
Dealt to Hero [Th 8c]
587c07c3: folds
c8c17adc: folds
Hero: folds
27e3981e: calls $0.05
7e84e7dc: raises $0.2 to $0.25
220b0aae: folds
27e3981e: calls $0.2
*** FLOP *** [7d 5s 9s]
7e84e7dc: bets $0.32
27e3981e: calls $0.32
*** TURN *** [7d 5s 9s] [6c]
7e84e7dc: checks
27e3981e: bets $0.4
7e84e7dc: folds
Uncalled bet ($0.4) returned to 27e3981e
*** SHOWDOWN ***
27e3981e collected $1.13 from pot
*** SUMMARY ***
Total pot $1.19 | Rake $0.06 | Jackpot $0 | Bingo $0 | Fortune $0 | Tax $0
Board [7d 5s 9s 6c]
Seat 1: 27e3981e (button) won ($1.13)
Seat 2: 7e84e7dc (small blind) folded on the Turn
Seat 3: 220b0aae (big blind) folded before Flop
Seat 4: 587c07c3 folded before Flop (didn't bet)
Seat 5: c8c17adc folded before Flop (didn't bet)
Seat 6: Hero folded before Flop (didn't bet)


Poker Hand #RC2078517455: Hold'em No Limit ($0.02/$0.05) - 2023/12/22 21:37:52
Table 'RushAndCash793623' 6-max Seat #1 is the button
Seat 1: 6d679d40 ($6.08 in chips)
Seat 2: 57896c91 ($5.07 in chips)
Seat 3: 330b404c ($5.37 in chips)
Seat 4: Hero ($5.3 in chips)
Seat 5: 86f62bb0 ($9.6 in chips)
Seat 6: 3056048f ($5 in chips)
57896c91: posts small blind $0.02
330b404c: posts big blind $0.05
*** HOLE CARDS ***
Dealt to 6d679d40 
Dealt to 57896c91 
Dealt to 330b404c 
Dealt to Hero [7s 4c]
Dealt to 86f62bb0 
Dealt to 3056048f 
Hero: folds
86f62bb0: folds
3056048f: raises $0.08 to $0.13
6d679d40: folds
57896c91: folds
330b404c: folds
Uncalled bet ($0.08) returned to 3056048f
*** SHOWDOWN ***
3056048f collected $0.12 from pot
*** SUMMARY ***
Total pot $0.12 | Rake $0 | Jackpot $0 | Bingo $0 | Fortune $0 | Tax $0
Seat 1: 6d679d40 (button) folded before Flop (didn't bet)
Seat 2: 57896c91 (small blind) folded before Flop
Seat 3: 330b404c (big blind) folded before Flop
Seat 4: Hero folded before Flop (didn't bet)
Seat 5: 86f62bb0 folded before Flop (didn't bet)
Seat 6: 3056048f collected ($0.12)


Poker Hand #RC2078517399: Hold'em No Limit ($0.02/$0.05) - 2023/12/22 21:37:49
Table 'RushAndCash793594' 6-max Seat #1 is the button
Seat 1: Hero ($5.3 in chips)
Seat 2: 72f7386e ($17.26 in chips)
Seat 3: e24a2fed ($10.49 in chips)
Seat 4: ea9bed4a ($5 in chips)
Seat 5: ae32912c ($5.16 in chips)
Seat 6: 9fd86997 ($21.74 in chips)
72f7386e: posts small blind $0.02
e24a2fed: posts big blind $0.05
*** HOLE CARDS ***
Dealt to Hero [2c 9h]
Dealt to 72f7386e 
Dealt to e24a2fed 
Dealt to ea9bed4a 
Dealt to ae32912c 
Dealt to 9fd86997 
ea9bed4a: folds
ae32912c: folds
9fd86997: folds
Hero: folds
72f7386e: folds
Uncalled bet ($0.03) returned to e24a2fed
*** SHOWDOWN ***
e24a2fed collected $0.04 from pot
*** SUMMARY ***
Total pot $0.04 | Rake $0 | Jackpot $0 | Bingo $0 | Fortune $0 | Tax $0
Seat 1: Hero (button) folded before Flop (didn't bet)
Seat 2: 72f7386e (small blind) folded before Flop
Seat 3: e24a2fed (big blind) collected ($0.04)
Seat 4: ea9bed4a folded before Flop (didn't bet)
Seat 5: ae32912c folded before Flop (didn't bet)
Seat 6: 9fd86997 folded before Flop (didn't bet)


Poker Hand #RC2078517251: Hold'em No Limit ($0.02/$0.05) - 2023/12/22 21:37:41
Table 'RushAndCash793519' 6-max Seat #1 is the button
Seat 1: 23c96099 ($7.22 in chips)
Seat 2: 6d3323f ($12.37 in chips)
Seat 3: Hero ($5.28 in chips)
Seat 4: f087dc8d ($4.92 in chips)
Seat 5: 1e6e058c ($5 in chips)
Seat 6: 254bcf9e ($9.71 in chips)
6d3323f: posts small blind $0.02
Hero: posts big blind $0.05
*** HOLE CARDS ***
Dealt to 23c96099 
Dealt to 6d3323f 
Dealt to Hero [Ah Ts]
Dealt to f087dc8d 
Dealt to 1e6e058c 
Dealt to 254bcf9e 
f087dc8d: folds
1e6e058c: folds
254bcf9e: folds
23c96099: folds
6d3323f: folds
Uncalled bet ($0.03) returned to Hero
*** SHOWDOWN ***
Hero collected $0.04 from pot
*** SUMMARY ***
Total pot $0.04 | Rake $0 | Jackpot $0 | Bingo $0 | Fortune $0 | Tax $0
Seat 1: 23c96099 (button) folded before Flop (didn't bet)
Seat 2: 6d3323f (small blind) folded before Flop
Seat 3: Hero (big blind) collected ($0.04)
Seat 4: f087dc8d folded before Flop (didn't bet)
Seat 5: 1e6e058c folded before Flop (didn't bet)
Seat 6: 254bcf9e folded before Flop (didn't bet)


Poker Hand #RC2078517092: Hold'em No Limit ($0.02/$0.05) - 2023/12/22 21:37:31
Table 'RushAndCash793439' 6-max Seat #1 is the button
Seat 1: c2f3e299 ($7.08 in chips)
Seat 2: Hero ($5.3 in chips)
Seat 3: ce1aa7a ($5.08 in chips)
Seat 4: 2e44f78e ($12.66 in chips)
Seat 5: 84572dc4 ($2.47 in chips)
Seat 6: 6551e7ca ($5.02 in chips)
Hero: posts small blind $0.02
ce1aa7a: posts big blind $0.05
*** HOLE CARDS ***
Dealt to c2f3e299 
Dealt to Hero [Ks 3d]
Dealt to ce1aa7a 
Dealt to 2e44f78e 
Dealt to 84572dc4 
Dealt to 6551e7ca 
2e44f78e: folds
84572dc4: raises $0.08 to $0.13
6551e7ca: folds
c2f3e299: folds
Hero: folds
ce1aa7a: folds
Uncalled bet ($0.08) returned to 84572dc4
*** SHOWDOWN ***
84572dc4 collected $0.12 from pot
*** SUMMARY ***
Total pot $0.12 | Rake $0 | Jackpot $0 | Bingo $0 | Fortune $0 | Tax $0
Seat 1: c2f3e299 (button) folded before Flop (didn't bet)
Seat 2: Hero (small blind) folded before Flop
Seat 3: ce1aa7a (big blind) folded before Flop
Seat 4: 2e44f78e folded before Flop (didn't bet)
Seat 5: 84572dc4 collected ($0.12)
Seat 6: 6551e7ca folded before Flop (didn't bet)


Poker Hand #RC2078517008: Hold'em No Limit ($0.02/$0.05) - 2023/12/22 21:37:27
Table 'RushAndCash793397' 6-max Seat #1 is the button
Seat 1: 9e7c6577 ($4.11 in chips)
Seat 2: 11612373 ($12.09 in chips)
Seat 3: dbaa8f4e ($4.98 in chips)
Seat 4: Hero ($5.3 in chips)
Seat 5: e69446ee ($9.98 in chips)
Seat 6: e068fd71 ($2.28 in chips)
11612373: posts small blind $0.02
dbaa8f4e: posts big blind $0.05
*** HOLE CARDS ***
Dealt to 9e7c6577 
Dealt to 11612373 
Dealt to dbaa8f4e 
Dealt to Hero [Qh 3s]
Dealt to e69446ee 
Dealt to e068fd71 
Hero: folds
e69446ee: folds
e068fd71: folds
9e7c6577: raises $0.08 to $0.13
11612373: folds
dbaa8f4e: folds
Uncalled bet ($0.08) returned to 9e7c6577
*** SHOWDOWN ***
9e7c6577 collected $0.12 from pot
*** SUMMARY ***
Total pot $0.12 | Rake $0 | Jackpot $0 | Bingo $0 | Fortune $0 | Tax $0
Seat 1: 9e7c6577 (button) collected ($0.12)
Seat 2: 11612373 (small blind) folded before Flop
Seat 3: dbaa8f4e (big blind) folded before Flop
Seat 4: Hero folded before Flop (didn't bet)
Seat 5: e69446ee folded before Flop (didn't bet)
Seat 6: e068fd71 folded before Flop (didn't bet)


Poker Hand #RC2078516910: Hold'em No Limit ($0.02/$0.05) - 2023/12/22 21:37:22
Table 'RushAndCash793352' 6-max Seat #1 is the button
Seat 1: 50e4a888 ($5 in chips)
Seat 2: 9386dd90 ($5.76 in chips)
Seat 3: 72f7386e ($17.26 in chips)
Seat 4: 3091c4e7 ($5 in chips)
Seat 5: bb096a6e ($6.09 in chips)
Seat 6: Hero ($5.3 in chips)
9386dd90: posts small blind $0.02
72f7386e: posts big blind $0.05
*** HOLE CARDS ***
Dealt to 50e4a888 
Dealt to 9386dd90 
Dealt to 72f7386e 
Dealt to 3091c4e7 
Dealt to bb096a6e 
Dealt to Hero [Th 3s]
3091c4e7: folds
bb096a6e: folds
Hero: folds
50e4a888: folds
9386dd90: folds
Uncalled bet ($0.03) returned to 72f7386e
*** SHOWDOWN ***
72f7386e collected $0.04 from pot
*** SUMMARY ***
Total pot $0.04 | Rake $0 | Jackpot $0 | Bingo $0 | Fortune $0 | Tax $0
Seat 1: 50e4a888 (button) folded before Flop (didn't bet)
Seat 2: 9386dd90 (small blind) folded before Flop
Seat 3: 72f7386e (big blind) collected ($0.04)
Seat 4: 3091c4e7 folded before Flop (didn't bet)
Seat 5: bb096a6e folded before Flop (didn't bet)
Seat 6: Hero folded before Flop (didn't bet)


Poker Hand #RC2078516677: Hold'em No Limit ($0.02/$0.05) - 2023/12/22 21:37:08
Table 'RushAndCash793246' 6-max Seat #1 is the button
Seat 1: 5df9a842 ($5.12 in chips)
Seat 2: 90a9fad4 ($52.78 in chips)
Seat 3: f8f3fa91 ($5.15 in chips)
Seat 4: Hero ($5.23 in chips)
Seat 5: b31920b7 ($5.1 in chips)
Seat 6: 13f0d1ae ($7.6 in chips)
90a9fad4: posts small blind $0.02
f8f3fa91: posts big blind $0.05
*** HOLE CARDS ***
Dealt to 5df9a842 
Dealt to 90a9fad4 
Dealt to f8f3fa91 
Dealt to Hero [5c Ac]
Dealt to b31920b7 
Dealt to 13f0d1ae 
Hero: raises $0.05 to $0.1
b31920b7: folds
13f0d1ae: folds
5df9a842: folds
90a9fad4: folds
f8f3fa91: folds
Uncalled bet ($0.05) returned to Hero
*** SHOWDOWN ***
Hero collected $0.12 from pot
*** SUMMARY ***
Total pot $0.12 | Rake $0 | Jackpot $0 | Bingo $0 | Fortune $0 | Tax $0
Seat 1: 5df9a842 (button) folded before Flop (didn't bet)
Seat 2: 90a9fad4 (small blind) folded before Flop
Seat 3: f8f3fa91 (big blind) folded before Flop
Seat 4: Hero collected ($0.12)
Seat 5: b31920b7 folded before Flop (didn't bet)
Seat 6: 13f0d1ae folded before Flop (didn't bet)


Poker Hand #RC2078516530: Hold'em No Limit ($0.02/$0.05) - 2023/12/22 21:37:00
Table 'RushAndCash793176' 6-max Seat #1 is the button
Seat 1: f88f8e87 ($7.16 in chips)
Seat 2: 5cb14769 ($10.28 in chips)
Seat 3: Hero ($5.21 in chips)
Seat 4: 993ccadb ($14.44 in chips)
Seat 5: 3c41b7f8 ($7.42 in chips)
Seat 6: 8f240b5e ($5.11 in chips)
5cb14769: posts small blind $0.02
Hero: posts big blind $0.05
*** HOLE CARDS ***
Dealt to f88f8e87 
Dealt to 5cb14769 
Dealt to Hero [3c Qc]
Dealt to 993ccadb 
Dealt to 3c41b7f8 
Dealt to 8f240b5e 
993ccadb: folds
3c41b7f8: folds
8f240b5e: folds
f88f8e87: folds
5cb14769: folds
Uncalled bet ($0.03) returned to Hero
*** SHOWDOWN ***
Hero collected $0.04 from pot
*** SUMMARY ***
Total pot $0.04 | Rake $0 | Jackpot $0 | Bingo $0 | Fortune $0 | Tax $0
Seat 1: f88f8e87 (button) folded before Flop (didn't bet)
Seat 2: 5cb14769 (small blind) folded before Flop
Seat 3: Hero (big blind) collected ($0.04)
Seat 4: 993ccadb folded before Flop (didn't bet)
Seat 5: 3c41b7f8 folded before Flop (didn't bet)
Seat 6: 8f240b5e folded before Flop (didn't bet)


Poker Hand #RC2078516467: Hold'em No Limit ($0.02/$0.05) - 2023/12/22 21:36:56
Table 'RushAndCash793150' 6-max Seat #1 is the button
Seat 1: Hero ($5.21 in chips)
Seat 2: 4fbede3e ($2.33 in chips)
Seat 3: 6e04f103 ($5 in chips)
Seat 4: 998574b7 ($5.14 in chips)
Seat 5: 1f7caee2 ($3.6 in chips)
Seat 6: 4c81be2e ($9.75 in chips)
4fbede3e: posts small blind $0.02
6e04f103: posts big blind $0.05
*** HOLE CARDS ***
Dealt to Hero [4c Js]
Dealt to 4fbede3e 
Dealt to 6e04f103 
Dealt to 998574b7 
Dealt to 1f7caee2 
Dealt to 4c81be2e 
998574b7: folds
1f7caee2: raises $0.07 to $0.12
4c81be2e: folds
Hero: folds
4fbede3e: calls $0.1
6e04f103: folds
*** FLOP *** [Ah 7h 9c]
4fbede3e: checks
1f7caee2: bets $0.15
4fbede3e: folds
Uncalled bet ($0.15) returned to 1f7caee2
*** SHOWDOWN ***
1f7caee2 collected $0.28 from pot
*** SUMMARY ***
Total pot $0.29 | Rake $0.01 | Jackpot $0 | Bingo $0 | Fortune $0 | Tax $0
Board [Ah 7h 9c]
Seat 1: Hero (button) folded before Flop (didn't bet)
Seat 2: 4fbede3e (small blind) folded on the Flop
Seat 3: 6e04f103 (big blind) folded before Flop
Seat 4: 998574b7 folded before Flop (didn't bet)
Seat 5: 1f7caee2 won ($0.28)
Seat 6: 4c81be2e folded before Flop (didn't bet)


Poker Hand #RC2078515805: Hold'em No Limit ($0.02/$0.05) - 2023/12/22 21:36:19
Table 'RushAndCash792868' 6-max Seat #1 is the button
Seat 1: 2c867a7e ($12.37 in chips)
Seat 2: Hero ($5.07 in chips)
Seat 3: cdcc30cf ($5.12 in chips)
Seat 4: 4c81be2e ($9.85 in chips)
Seat 5: 5d732d5e ($5.28 in chips)
Seat 6: 1fac6fbb ($4.69 in chips)
Hero: posts small blind $0.02
cdcc30cf: posts big blind $0.05
*** HOLE CARDS ***
Dealt to 2c867a7e 
Dealt to Hero [6s 6h]
Dealt to cdcc30cf 
Dealt to 4c81be2e 
Dealt to 5d732d5e 
Dealt to 1fac6fbb 
4c81be2e: raises $0.05 to $0.1
5d732d5e: folds
1fac6fbb: folds
2c867a7e: folds
Hero: calls $0.08
cdcc30cf: folds
*** FLOP *** [9c 6d Ad]
Hero: checks
4c81be2e: checks
*** TURN *** [9c 6d Ad] [4s]
Hero: checks
4c81be2e: checks
*** RIVER *** [9c 6d Ad 4s] [4d]
Hero: bets $0.13
4c81be2e: folds
Uncalled bet ($0.13) returned to Hero
*** SHOWDOWN ***
Hero collected $0.24 from pot
*** SUMMARY ***
Total pot $0.25 | Rake $0.01 | Jackpot $0 | Bingo $0 | Fortune $0 | Tax $0
Board [9c 6d Ad 4s 4d]
Seat 1: 2c867a7e (button) folded before Flop (didn't bet)
Seat 2: Hero (small blind) won ($0.24)
Seat 3: cdcc30cf (big blind) folded before Flop
Seat 4: 4c81be2e folded on the River
Seat 5: 5d732d5e folded before Flop (didn't bet)
Seat 6: 1fac6fbb folded before Flop (didn't bet)


Poker Hand #RC2078515741: Hold'em No Limit ($0.02/$0.05) - 2023/12/22 21:36:15
Table 'RushAndCash792840' 6-max Seat #1 is the button
Seat 1: 6f212319 ($5.1 in chips)
Seat 2: a420712c ($5 in chips)
Seat 3: ea71423 ($6.24 in chips)
Seat 4: 153b1345 ($5.09 in chips)
Seat 5: Hero ($5.07 in chips)
Seat 6: 2c867a7e ($12.37 in chips)
a420712c: posts small blind $0.02
ea71423: posts big blind $0.05
*** HOLE CARDS ***
Dealt to 6f212319 
Dealt to a420712c 
Dealt to ea71423 
Dealt to 153b1345 
Dealt to Hero [2d Qc]
Dealt to 2c867a7e 
153b1345: folds
Hero: folds
2c867a7e: folds
6f212319: folds
a420712c: folds
Uncalled bet ($0.03) returned to ea71423
*** SHOWDOWN ***
ea71423 collected $0.04 from pot
*** SUMMARY ***
Total pot $0.04 | Rake $0 | Jackpot $0 | Bingo $0 | Fortune $0 | Tax $0
Seat 1: 6f212319 (button) folded before Flop (didn't bet)
Seat 2: a420712c (small blind) folded before Flop
Seat 3: ea71423 (big blind) collected ($0.04)
Seat 4: 153b1345 folded before Flop (didn't bet)
Seat 5: Hero folded before Flop (didn't bet)
Seat 6: 2c867a7e folded before Flop (didn't bet)


Poker Hand #RC2078515663: Hold'em No Limit ($0.02/$0.05) - 2023/12/22 21:36:11
Table 'RushAndCash792803' 6-max Seat #1 is the button
Seat 1: b8d8e3a7 ($8.18 in chips)
Seat 2: e65ad772 ($15.57 in chips)
Seat 3: 1dead1e2 ($3.48 in chips)
Seat 4: Hero ($5.07 in chips)
Seat 5: 1719c1d9 ($6.27 in chips)
Seat 6: bf955ffb ($5.07 in chips)
e65ad772: posts small blind $0.02
1dead1e2: posts big blind $0.05
*** HOLE CARDS ***
Dealt to b8d8e3a7 
Dealt to e65ad772 
Dealt to 1dead1e2 
Dealt to Hero [Js 5c]
Dealt to 1719c1d9 
Dealt to bf955ffb 
Hero: folds
1719c1d9: folds
bf955ffb: folds
b8d8e3a7: folds
e65ad772: raises $0.1 to $0.15
1dead1e2: folds
Uncalled bet ($0.1) returned to e65ad772
*** SHOWDOWN ***
e65ad772 collected $0.1 from pot
*** SUMMARY ***
Total pot $0.1 | Rake $0 | Jackpot $0 | Bingo $0 | Fortune $0 | Tax $0
Seat 1: b8d8e3a7 (button) folded before Flop (didn't bet)
Seat 2: e65ad772 (small blind) collected ($0.1)
Seat 3: 1dead1e2 (big blind) folded before Flop
Seat 4: Hero folded before Flop (didn't bet)
Seat 5: 1719c1d9 folded before Flop (didn't bet)
Seat 6: bf955ffb folded before Flop (didn't bet)


Poker Hand #RC2078515494: Hold'em No Limit ($0.02/$0.05) - 2023/12/22 21:36:02
Table 'RushAndCash792719' 6-max Seat #1 is the button
Seat 1: 77f8786f ($5 in chips)
Seat 2: 34ce5e3 ($5.07 in chips)
Seat 3: 42e18915 ($6.97 in chips)
Seat 4: 8e0f056d ($8.5 in chips)
Seat 5: 23c96099 ($6.4 in chips)
Seat 6: Hero ($5 in chips)
34ce5e3: posts small blind $0.02
42e18915: posts big blind $0.05
*** HOLE CARDS ***
Dealt to 77f8786f 
Dealt to 34ce5e3 
Dealt to 42e18915 
Dealt to 8e0f056d 
Dealt to 23c96099 
Dealt to Hero [Ks 7s]
8e0f056d: folds
23c96099: folds
Hero: raises $0.05 to $0.1
77f8786f: folds
34ce5e3: folds
42e18915: folds
Uncalled bet ($0.05) returned to Hero
*** SHOWDOWN ***
Hero collected $0.12 from pot
*** SUMMARY ***
Total pot $0.12 | Rake $0 | Jackpot $0 | Bingo $0 | Fortune $0 | Tax $0
Seat 1: 77f8786f (button) folded before Flop (didn't bet)
Seat 2: 34ce5e3 (small blind) folded before Flop
Seat 3: 42e18915 (big blind) folded before Flop
Seat 4: 8e0f056d folded before Flop (didn't bet)
Seat 5: 23c96099 folded before Flop (didn't bet)
Seat 6: Hero collected ($0.12)


Poker Hand #RC2078515265: Hold'em No Limit ($0.02/$0.05) - 2023/12/22 21:35:49
Table 'RushAndCash792620' 6-max Seat #1 is the button
Seat 1: 391fe85a ($5.12 in chips)
Seat 2: Hero ($5 in chips)
Seat 3: eeb37e34 ($9.75 in chips)
Seat 4: 311eeba4 ($17.83 in chips)
Seat 5: 8642862c ($5.39 in chips)
Seat 6: e194bfc6 ($9.69 in chips)
Hero: posts small blind $0.02
eeb37e34: posts big blind $0.05
*** HOLE CARDS ***
Dealt to 391fe85a 
Dealt to Hero [4d As]
Dealt to eeb37e34 
Dealt to 311eeba4 
Dealt to 8642862c 
Dealt to e194bfc6 
311eeba4: raises $0.1 to $0.15
8642862c: calls $0.15
e194bfc6: folds
391fe85a: folds
Hero: folds
eeb37e34: folds
*** FLOP *** [Tc 7c Ts]
311eeba4: checks
8642862c: checks
*** TURN *** [Tc 7c Ts] [6s]
311eeba4: checks
8642862c: bets $0.19
311eeba4: folds
Uncalled bet ($0.19) returned to 8642862c
*** SHOWDOWN ***
8642862c collected $0.36 from pot
*** SUMMARY ***
Total pot $0.37 | Rake $0.01 | Jackpot $0 | Bingo $0 | Fortune $0 | Tax $0
Board [Tc 7c Ts 6s]
Seat 1: 391fe85a (button) folded before Flop (didn't bet)
Seat 2: Hero (small blind) folded before Flop
Seat 3: eeb37e34 (big blind) folded before Flop
Seat 4: 311eeba4 folded on the Turn
Seat 5: 8642862c won ($0.36)
Seat 6: e194bfc6 folded before Flop (didn't bet)


Poker Hand #RC2078514821: Hold'em No Limit ($0.02/$0.05) - 2023/12/22 21:35:25
Table 'RushAndCash792409' 6-max Seat #1 is the button
Seat 1: 95bbee71 ($5 in chips)
Seat 2: b6052383 ($6.13 in chips)
Seat 3: Hero ($5 in chips)
Seat 4: 17da2929 ($5.07 in chips)
Seat 5: 956b2f28 ($4.85 in chips)
Seat 6: 7466ff6a ($19.85 in chips)
b6052383: posts small blind $0.02
Hero: posts big blind $0.05
*** HOLE CARDS ***
Dealt to 95bbee71 
Dealt to b6052383 
Dealt to Hero [Qs 2s]
Dealt to 17da2929 
Dealt to 956b2f28 
Dealt to 7466ff6a 
17da2929: folds
956b2f28: folds
7466ff6a: folds
95bbee71: raises $0.1 to $0.15
b6052383: folds
Hero: calls $0.1
*** FLOP *** [8c Ks 6c]
Hero: checks
95bbee71: bets $0.11
Hero: folds
Uncalled bet ($0.11) returned to 95bbee71
*** SHOWDOWN ***
95bbee71 collected $0.31 from pot
*** SUMMARY ***
Total pot $0.32 | Rake $0.01 | Jackpot $0 | Bingo $0 | Fortune $0 | Tax $0
Board [8c Ks 6c]
Seat 1: 95bbee71 (button) won ($0.31)
Seat 2: b6052383 (small blind) folded before Flop
Seat 3: Hero (big blind) folded on the Flop
Seat 4: 17da2929 folded before Flop (didn't bet)
Seat 5: 956b2f28 folded before Flop (didn't bet)
Seat 6: 7466ff6a folded before Flop (didn't bet)


Poker Hand #RC2078513907: Hold'em No Limit ($0.02/$0.05) - 2023/12/22 21:34:32
Table 'RushAndCash791988' 6-max Seat #1 is the button
Seat 1: Hero ($5 in chips)
Seat 2: 5d732d5e ($5.21 in chips)
Seat 3: 7d137087 ($8.2 in chips)
Seat 4: 7ab29bd ($6.09 in chips)
Seat 5: ebeb62f7 ($5.64 in chips)
Seat 6: c8389234 ($10.34 in chips)
5d732d5e: posts small blind $0.02
7d137087: posts big blind $0.05
*** HOLE CARDS ***
Dealt to Hero [Qh Ks]
Dealt to 5d732d5e 
Dealt to 7d137087 
Dealt to 7ab29bd 
Dealt to ebeb62f7 
Dealt to c8389234 
7ab29bd: raises $0.05 to $0.1
ebeb62f7: folds
c8389234: folds
Hero: calls $0.1
5d732d5e: folds
7d137087: calls $0.05
*** FLOP *** [5s Th Kc]
7d137087: checks
7ab29bd: checks
Hero: bets $0.15
7d137087: folds
7ab29bd: calls $0.15
*** TURN *** [5s Th Kc] [3s]
7ab29bd: checks
Hero: checks
*** RIVER *** [5s Th Kc 3s] [7d]
7ab29bd: checks
Hero: bets $0.21
7ab29bd: calls $0.21
Hero: shows [Qh Ks] (Pair of Kings)
7ab29bd: shows [Ah Kh] (Pair of Kings)
*** SHOWDOWN ***
7ab29bd collected $0.98 from pot
*** SUMMARY ***
Total pot $1.04 | Rake $0.06 | Jackpot $0 | Bingo $0 | Fortune $0 | Tax $0
Board [5s Th Kc 3s 7d]
Seat 1: Hero (button) showed [Qh Ks] and lost with Pair of Kings
Seat 2: 5d732d5e (small blind) folded before Flop
Seat 3: 7d137087 (big blind) folded on the Flop
Seat 4: 7ab29bd showed [Ah Kh] and won ($0.98) with Pair of Kings
Seat 5: ebeb62f7 folded before Flop (didn't bet)
Seat 6: c8389234 folded before Flop (didn't bet)


Poker Hand #RC2078513789: Hold'em No Limit ($0.02/$0.05) - 2023/12/22 21:34:26
Table 'RushAndCash791932' 6-max Seat #1 is the button
Seat 1: aeb6c819 ($10.28 in chips)
Seat 2: c5b816d3 ($5.56 in chips)
Seat 3: 921e997e ($8 in chips)
Seat 4: Hero ($5 in chips)
Seat 5: 73c8f8b5 ($5.95 in chips)
Seat 6: 4810f2d7 ($5.6 in chips)
c5b816d3: posts small blind $0.02
921e997e: posts big blind $0.05
*** HOLE CARDS ***
Dealt to aeb6c819 
Dealt to c5b816d3 
Dealt to 921e997e 
Dealt to Hero [Kd 7s]
Dealt to 73c8f8b5 
Dealt to 4810f2d7 
Hero: folds
73c8f8b5: folds
4810f2d7: folds
aeb6c819: raises $0.05 to $0.1
c5b816d3: folds
921e997e: raises $0.35 to $0.45
aeb6c819: folds
Uncalled bet ($0.35) returned to 921e997e
*** SHOWDOWN ***
921e997e collected $0.21 from pot
*** SUMMARY ***
Total pot $0.22 | Rake $0.01 | Jackpot $0 | Bingo $0 | Fortune $0 | Tax $0
Seat 1: aeb6c819 (button) folded before Flop
Seat 2: c5b816d3 (small blind) folded before Flop
Seat 3: 921e997e (big blind) collected ($0.21)
Seat 4: Hero folded before Flop (didn't bet)
Seat 5: 73c8f8b5 folded before Flop (didn't bet)
Seat 6: 4810f2d7 folded before Flop (didn't bet)


Poker Hand #RC2078513661: Hold'em No Limit ($0.02/$0.05) - 2023/12/22 21:34:18
Table 'RushAndCash791868' 6-max Seat #1 is the button
Seat 1: ffdc621e ($3 in chips)
Seat 2: 1a6eef5 ($3.95 in chips)
Seat 3: e9deb15a ($5 in chips)
Seat 4: d2739eda ($4.43 in chips)
Seat 5: 3a26c05c ($7.15 in chips)
Seat 6: Hero ($5 in chips)
1a6eef5: posts small blind $0.02
e9deb15a: posts big blind $0.05
*** HOLE CARDS ***
Dealt to ffdc621e 
Dealt to 1a6eef5 
Dealt to e9deb15a 
Dealt to d2739eda 
Dealt to 3a26c05c 
Dealt to Hero [Qd 3s]
d2739eda: folds
3a26c05c: folds
Hero: folds
ffdc621e: folds
1a6eef5: folds
Uncalled bet ($0.03) returned to e9deb15a
*** SHOWDOWN ***
e9deb15a collected $0.04 from pot
*** SUMMARY ***
Total pot $0.04 | Rake $0 | Jackpot $0 | Bingo $0 | Fortune $0 | Tax $0
Seat 1: ffdc621e (button) folded before Flop (didn't bet)
Seat 2: 1a6eef5 (small blind) folded before Flop
Seat 3: e9deb15a (big blind) collected ($0.04)
Seat 4: d2739eda folded before Flop (didn't bet)
Seat 5: 3a26c05c folded before Flop (didn't bet)
Seat 6: Hero folded before Flop (didn't bet)


Poker Hand #RC2078512988: Hold'em No Limit ($0.02/$0.05) - 2023/12/22 21:33:39
Table 'RushAndCash791542' 6-max Seat #1 is the button
Seat 1: ee1f67f7 ($6.26 in chips)
Seat 2: 7732abf7 ($23.4 in chips)
Seat 3: a4441de9 ($5.71 in chips)
Seat 4: Hero ($5 in chips)
Seat 5: f6f7aa18 ($5.86 in chips)
Seat 6: 50cbc258 ($9.23 in chips)
7732abf7: posts small blind $0.02
a4441de9: posts big blind $0.05
*** HOLE CARDS ***
Dealt to ee1f67f7 
Dealt to 7732abf7 
Dealt to a4441de9 
Dealt to Hero [Ah Qd]
Dealt to f6f7aa18 
Dealt to 50cbc258 
Hero: raises $0.05 to $0.1
f6f7aa18: calls $0.1
50cbc258: folds
ee1f67f7: folds
7732abf7: folds
a4441de9: folds
*** FLOP *** [3d Jc 4d]
Hero: bets $0.1
f6f7aa18: raises $0.36 to $0.46
Hero: folds
Uncalled bet ($0.36) returned to f6f7aa18
*** SHOWDOWN ***
f6f7aa18 collected $0.45 from pot
*** SUMMARY ***
Total pot $0.47 | Rake $0.02 | Jackpot $0 | Bingo $0 | Fortune $0 | Tax $0
Board [3d Jc 4d]
Seat 1: ee1f67f7 (button) folded before Flop (didn't bet)
Seat 2: 7732abf7 (small blind) folded before Flop
Seat 3: a4441de9 (big blind) folded before Flop
Seat 4: Hero folded on the Flop
Seat 5: f6f7aa18 won ($0.45)
Seat 6: 50cbc258 folded before Flop (didn't bet)


Poker Hand #RC2078512877: Hold'em No Limit ($0.02/$0.05) - 2023/12/22 21:33:34
Table 'RushAndCash791489' 6-max Seat #1 is the button
Seat 1: 84dda8d8 ($6.27 in chips)
Seat 2: Hero ($5 in chips)
Seat 3: 23c96099 ($7.42 in chips)
Seat 4: cbfe1acc ($3.93 in chips)
Seat 5: a9abc4b1 ($8.23 in chips)
Seat 6: 1d0d69cf ($5.47 in chips)
Hero: posts small blind $0.02
23c96099: posts big blind $0.05
*** HOLE CARDS ***
Dealt to 84dda8d8 
Dealt to Hero [2s 7h]
Dealt to 23c96099 
Dealt to cbfe1acc 
Dealt to a9abc4b1 
Dealt to 1d0d69cf 
cbfe1acc: folds
a9abc4b1: raises $0.05 to $0.1
1d0d69cf: folds
84dda8d8: calls $0.1
Hero: folds
23c96099: folds
*** FLOP *** [8h 5s Ac]
a9abc4b1: bets $0.08
84dda8d8: raises $0.15 to $0.23
a9abc4b1: folds
Uncalled bet ($0.15) returned to 84dda8d8
*** SHOWDOWN ***
84dda8d8 collected $0.41 from pot
*** SUMMARY ***
Total pot $0.43 | Rake $0.02 | Jackpot $0 | Bingo $0 | Fortune $0 | Tax $0
Board [8h 5s Ac]
Seat 1: 84dda8d8 (button) won ($0.41)
Seat 2: Hero (small blind) folded before Flop
Seat 3: 23c96099 (big blind) folded before Flop
Seat 4: cbfe1acc folded before Flop (didn't bet)
Seat 5: a9abc4b1 folded on the Flop
Seat 6: 1d0d69cf folded before Flop (didn't bet)


Poker Hand #RC2078512491: Hold'em No Limit ($0.02/$0.05) - 2023/12/22 21:33:12
Table 'RushAndCash791314' 6-max Seat #1 is the button
Seat 1: Hero ($5 in chips)
Seat 2: c7bcf41c ($5 in chips)
Seat 3: 8626eae9 ($5 in chips)
Seat 4: 68c6c5e7 ($27.62 in chips)
Seat 5: 956b2f28 ($4.86 in chips)
Seat 6: 312992d0 ($4.91 in chips)
c7bcf41c: posts small blind $0.02
8626eae9: posts big blind $0.05
*** HOLE CARDS ***
Dealt to Hero [5h Ah]
Dealt to c7bcf41c 
Dealt to 8626eae9 
Dealt to 68c6c5e7 
Dealt to 956b2f28 
Dealt to 312992d0 
68c6c5e7: folds
956b2f28: folds
312992d0: folds
Hero: raises $0.08 to $0.13
c7bcf41c: folds
8626eae9: raises $0.28 to $0.41
Hero: folds
Uncalled bet ($0.28) returned to 8626eae9
*** SHOWDOWN ***
8626eae9 collected $0.27 from pot
*** SUMMARY ***
Total pot $0.28 | Rake $0.01 | Jackpot $0 | Bingo $0 | Fortune $0 | Tax $0
Seat 1: Hero (button) folded before Flop
Seat 2: c7bcf41c (small blind) folded before Flop
Seat 3: 8626eae9 (big blind) collected ($0.27)
Seat 4: 68c6c5e7 folded before Flop (didn't bet)
Seat 5: 956b2f28 folded before Flop (didn't bet)
Seat 6: 312992d0 folded before Flop (didn't bet)


Poker Hand #RC2078512398: Hold'em No Limit ($0.02/$0.05) - 2023/12/22 21:33:06
Table 'RushAndCash791271' 6-max Seat #1 is the button
Seat 1: 2c2cc68d ($11.08 in chips)
Seat 2: 20a35d2e ($10.11 in chips)
Seat 3: Hero ($5 in chips)
Seat 4: 97e7da6 ($6.19 in chips)
Seat 5: 91fe4b49 ($4.76 in chips)
Seat 6: 8a8eafe4 ($4.95 in chips)
20a35d2e: posts small blind $0.02
Hero: posts big blind $0.05
*** HOLE CARDS ***
Dealt to 2c2cc68d 
Dealt to 20a35d2e 
Dealt to Hero [2d Td]
Dealt to 97e7da6 
Dealt to 91fe4b49 
Dealt to 8a8eafe4 
97e7da6: folds
91fe4b49: raises $0.08 to $0.13
8a8eafe4: folds
2c2cc68d: folds
20a35d2e: folds
Hero: folds
Uncalled bet ($0.08) returned to 91fe4b49
*** SHOWDOWN ***
91fe4b49 collected $0.12 from pot
*** SUMMARY ***
Total pot $0.12 | Rake $0 | Jackpot $0 | Bingo $0 | Fortune $0 | Tax $0
Seat 1: 2c2cc68d (button) folded before Flop (didn't bet)
Seat 2: 20a35d2e (small blind) folded before Flop
Seat 3: Hero (big blind) folded before Flop
Seat 4: 97e7da6 folded before Flop (didn't bet)
Seat 5: 91fe4b49 collected ($0.12)
Seat 6: 8a8eafe4 folded before Flop (didn't bet)


Poker Hand #RC2078512316: Hold'em No Limit ($0.02/$0.05) - 2023/12/22 21:33:01
Table 'RushAndCash791230' 6-max Seat #1 is the button
Seat 1: 1c28bbd5 ($4.83 in chips)
Seat 2: ff6f425f ($6.36 in chips)
Seat 3: 2d4acc60 ($8.36 in chips)
Seat 4: 2b9f6a0 ($5.49 in chips)
Seat 5: Hero ($5 in chips)
Seat 6: 52956fa5 ($5.03 in chips)
ff6f425f: posts small blind $0.02
2d4acc60: posts big blind $0.05
*** HOLE CARDS ***
Dealt to 1c28bbd5 
Dealt to ff6f425f 
Dealt to 2d4acc60 
Dealt to 2b9f6a0 
Dealt to Hero [Qd 8d]
Dealt to 52956fa5 
2b9f6a0: folds
Hero: folds
52956fa5: raises $0.05 to $0.1
1c28bbd5: folds
ff6f425f: folds
2d4acc60: calls $0.05
*** FLOP *** [Js 7h 4c]
2d4acc60: checks
52956fa5: bets $0.08
2d4acc60: calls $0.08
*** TURN *** [Js 7h 4c] [2h]
2d4acc60: checks
52956fa5: checks
*** RIVER *** [Js 7h 4c 2h] [4s]
2d4acc60: checks
52956fa5: bets $0.26
2d4acc60: folds
Uncalled bet ($0.26) returned to 52956fa5
*** SHOWDOWN ***
52956fa5 collected $0.37 from pot
*** SUMMARY ***
Total pot $0.38 | Rake $0.01 | Jackpot $0 | Bingo $0 | Fortune $0 | Tax $0
Board [Js 7h 4c 2h 4s]
Seat 1: 1c28bbd5 (button) folded before Flop (didn't bet)
Seat 2: ff6f425f (small blind) folded before Flop
Seat 3: 2d4acc60 (big blind) folded on the River
Seat 4: 2b9f6a0 folded before Flop (didn't bet)
Seat 5: Hero folded before Flop (didn't bet)
Seat 6: 52956fa5 won ($0.37)


Poker Hand #RC2078512243: Hold'em No Limit ($0.02/$0.05) - 2023/12/22 21:32:57
Table 'RushAndCash791196' 6-max Seat #1 is the button
Seat 1: 254bcf9e ($5.12 in chips)
Seat 2: 5861f243 ($5.12 in chips)
Seat 3: 80af7fe3 ($4.43 in chips)
Seat 4: Hero ($5 in chips)
Seat 5: d6d8d23b ($11.5 in chips)
Seat 6: 86f62bb0 ($9.08 in chips)
5861f243: posts small blind $0.02
80af7fe3: posts big blind $0.05
*** HOLE CARDS ***
Dealt to 254bcf9e 
Dealt to 5861f243 
Dealt to 80af7fe3 
Dealt to Hero [Kc Ts]
Dealt to d6d8d23b 
Dealt to 86f62bb0 
Hero: folds
d6d8d23b: raises $0.07 to $0.12
86f62bb0: raises $0.24 to $0.36
254bcf9e: folds
5861f243: folds
80af7fe3: folds
d6d8d23b: calls $0.24
*** FLOP *** [6h Js 4h]
d6d8d23b: checks
86f62bb0: bets $0.6
d6d8d23b: folds
Uncalled bet ($0.6) returned to 86f62bb0
*** SHOWDOWN ***
86f62bb0 collected $0.75 from pot
*** SUMMARY ***
Total pot $0.79 | Rake $0.04 | Jackpot $0 | Bingo $0 | Fortune $0 | Tax $0
Board [6h Js 4h]
Seat 1: 254bcf9e (button) folded before Flop (didn't bet)
Seat 2: 5861f243 (small blind) folded before Flop
Seat 3: 80af7fe3 (big blind) folded before Flop
Seat 4: Hero folded before Flop (didn't bet)
Seat 5: d6d8d23b folded on the Flop
Seat 6: 86f62bb0 won ($0.75)


Poker Hand #RC2078512146: Hold'em No Limit ($0.02/$0.05) - 2023/12/22 21:32:51
Table 'RushAndCash791151' 6-max Seat #1 is the button
Seat 1: c5b816d3 ($5.13 in chips)
Seat 2: aba41704 ($1.71 in chips)
Seat 3: dcd1ce07 ($19.83 in chips)
Seat 4: e6f6623d ($4.54 in chips)
Seat 5: Hero ($5 in chips)
Seat 6: 3a55a6df ($11.07 in chips)
aba41704: posts small blind $0.02
dcd1ce07: posts big blind $0.05
*** HOLE CARDS ***
Dealt to c5b816d3 
Dealt to aba41704 
Dealt to dcd1ce07 
Dealt to e6f6623d 
Dealt to Hero [Th 6s]
Dealt to 3a55a6df 
e6f6623d: folds
Hero: folds
3a55a6df: folds
c5b816d3: folds
aba41704: folds
Uncalled bet ($0.03) returned to dcd1ce07
*** SHOWDOWN ***
dcd1ce07 collected $0.04 from pot
*** SUMMARY ***
Total pot $0.04 | Rake $0 | Jackpot $0 | Bingo $0 | Fortune $0 | Tax $0
Seat 1: c5b816d3 (button) folded before Flop (didn't bet)
Seat 2: aba41704 (small blind) folded before Flop
Seat 3: dcd1ce07 (big blind) collected ($0.04)
Seat 4: e6f6623d folded before Flop (didn't bet)
Seat 5: Hero folded before Flop (didn't bet)
Seat 6: 3a55a6df folded before Flop (didn't bet)


Poker Hand #RC2078511965: Hold'em No Limit ($0.02/$0.05) - 2023/12/22 21:32:41
Table 'RushAndCash791067' 6-max Seat #1 is the button
Seat 1: Hero ($5 in chips)
Seat 2: 38eafb19 ($5 in chips)
Seat 3: cb9a7609 ($5.07 in chips)
Seat 4: 308f9422 ($3.65 in chips)
Seat 5: 84d4f92c ($7.11 in chips)
Seat 6: f0e3b048 ($5.56 in chips)
38eafb19: posts small blind $0.02
cb9a7609: posts big blind $0.05
*** HOLE CARDS ***
Dealt to Hero [4s 5s]
Dealt to 38eafb19 
Dealt to cb9a7609 
Dealt to 308f9422 
Dealt to 84d4f92c 
Dealt to f0e3b048 
308f9422: calls $0.05
84d4f92c: folds
f0e3b048: folds
Hero: folds
38eafb19: folds
cb9a7609: checks
*** FLOP *** [Kh 6s 8c]
cb9a7609: checks
308f9422: checks
*** TURN *** [Kh 6s 8c] [Ad]
cb9a7609: checks
308f9422: bets $0.06
cb9a7609: folds
Uncalled bet ($0.06) returned to 308f9422
*** SHOWDOWN ***
308f9422 collected $0.12 from pot
*** SUMMARY ***
Total pot $0.12 | Rake $0 | Jackpot $0 | Bingo $0 | Fortune $0 | Tax $0
Board [Kh 6s 8c Ad]
Seat 1: Hero (button) folded before Flop (didn't bet)
Seat 2: 38eafb19 (small blind) folded before Flop
Seat 3: cb9a7609 (big blind) folded on the Turn
Seat 4: 308f9422 won ($0.12)
Seat 5: 84d4f92c folded before Flop (didn't bet)
Seat 6: f0e3b048 folded before Flop (didn't bet)


Poker Hand #RC2078511384: Hold'em No Limit ($0.02/$0.05) - 2023/12/22 21:32:09
Table 'RushAndCash790788' 6-max Seat #1 is the button
Seat 1: 1719c1d9 ($6.39 in chips)
Seat 2: Hero ($5 in chips)
Seat 3: af1e12c2 ($5.04 in chips)
Seat 4: f58a969e ($5 in chips)
Seat 5: 998574b7 ($5.06 in chips)
Seat 6: c444ec1 ($6.72 in chips)
Hero: posts small blind $0.02
af1e12c2: posts big blind $0.05
*** HOLE CARDS ***
Dealt to 1719c1d9 
Dealt to Hero [3c 3s]
Dealt to af1e12c2 
Dealt to f58a969e 
Dealt to 998574b7 
Dealt to c444ec1 
f58a969e: folds
998574b7: folds
c444ec1: folds
1719c1d9: raises $0.08 to $0.13
Hero: calls $0.11
af1e12c2: folds
*** FLOP *** [2h 2s Qc]
Hero: checks
1719c1d9: bets $0.16
Hero: folds
Uncalled bet ($0.16) returned to 1719c1d9
*** SHOWDOWN ***
1719c1d9 collected $0.3 from pot
*** SUMMARY ***
Total pot $0.31 | Rake $0.01 | Jackpot $0 | Bingo $0 | Fortune $0 | Tax $0
Board [2h 2s Qc]
Seat 1: 1719c1d9 (button) won ($0.3)
Seat 2: Hero (small blind) folded on the Flop
Seat 3: af1e12c2 (big blind) folded before Flop
Seat 4: f58a969e folded before Flop (didn't bet)
Seat 5: 998574b7 folded before Flop (didn't bet)
Seat 6: c444ec1 folded before Flop (didn't bet)


Poker Hand #RC2078511245: Hold'em No Limit ($0.02/$0.05) - 2023/12/22 21:32:00
Table 'RushAndCash790722' 6-max Seat #1 is the button
Seat 1: 469c47cc ($9.73 in chips)
Seat 2: 3a26c05c ($7.42 in chips)
Seat 3: Hero ($5.05 in chips)
Seat 4: 4fedcb8f ($6.14 in chips)
Seat 5: ad0bb92a ($4.66 in chips)
Seat 6: 6ca5f777 ($5 in chips)
3a26c05c: posts small blind $0.02
Hero: posts big blind $0.05
*** HOLE CARDS ***
Dealt to 469c47cc 
Dealt to 3a26c05c 
Dealt to Hero [6d 7s]
Dealt to 4fedcb8f 
Dealt to ad0bb92a 
Dealt to 6ca5f777 
4fedcb8f: raises $0.1 to $0.15
ad0bb92a: folds
6ca5f777: folds
469c47cc: folds
3a26c05c: folds
Hero: folds
Uncalled bet ($0.1) returned to 4fedcb8f
*** SHOWDOWN ***
4fedcb8f collected $0.12 from pot
*** SUMMARY ***
Total pot $0.12 | Rake $0 | Jackpot $0 | Bingo $0 | Fortune $0 | Tax $0
Seat 1: 469c47cc (button) folded before Flop (didn't bet)
Seat 2: 3a26c05c (small blind) folded before Flop
Seat 3: Hero (big blind) folded before Flop
Seat 4: 4fedcb8f collected ($0.12)
Seat 5: ad0bb92a folded before Flop (didn't bet)
Seat 6: 6ca5f777 folded before Flop (didn't bet)


Poker Hand #RC2078511173: Hold'em No Limit ($0.02/$0.05) - 2023/12/22 21:31:56
Table 'RushAndCash790688' 6-max Seat #1 is the button
Seat 1: 40c4a4f ($9.52 in chips)
Seat 2: 9b2d2337 ($22.36 in chips)
Seat 3: a2a6891 ($5 in chips)
Seat 4: Hero ($5.05 in chips)
Seat 5: 5b05e7c ($2.34 in chips)
Seat 6: 6029883b ($5.42 in chips)
9b2d2337: posts small blind $0.02
a2a6891: posts big blind $0.05
*** HOLE CARDS ***
Dealt to 40c4a4f 
Dealt to 9b2d2337 
Dealt to a2a6891 
Dealt to Hero [Jd 6h]
Dealt to 5b05e7c 
Dealt to 6029883b 
Hero: folds
5b05e7c: folds
6029883b: raises $0.07 to $0.12
40c4a4f: calls $0.12
9b2d2337: folds
a2a6891: folds
*** FLOP *** [3h Qh 2d]
6029883b: checks
40c4a4f: bets $0.18
6029883b: raises $0.34 to $0.52
40c4a4f: calls $0.34
*** TURN *** [3h Qh 2d] [Th]
6029883b: checks
40c4a4f: bets $0.75
6029883b: folds
Uncalled bet ($0.75) returned to 40c4a4f
*** SHOWDOWN ***
40c4a4f collected $1.29 from pot
*** SUMMARY ***
Total pot $1.35 | Rake $0.06 | Jackpot $0 | Bingo $0 | Fortune $0 | Tax $0
Board [3h Qh 2d Th]
Seat 1: 40c4a4f (button) won ($1.29)
Seat 2: 9b2d2337 (small blind) folded before Flop
Seat 3: a2a6891 (big blind) folded before Flop
Seat 4: Hero folded before Flop (didn't bet)
Seat 5: 5b05e7c folded before Flop (didn't bet)
Seat 6: 6029883b folded on the Turn


Poker Hand #RC2078511117: Hold'em No Limit ($0.02/$0.05) - 2023/12/22 21:31:53
Table 'RushAndCash790661' 6-max Seat #1 is the button
Seat 1: 40c4a4f ($9.52 in chips)
Seat 2: aa2421a5 ($3.78 in chips)
Seat 3: 829aa739 ($6.5 in chips)
Seat 4: 23c96099 ($7.51 in chips)
Seat 5: ac89ef05 ($4.89 in chips)
Seat 6: Hero ($5.05 in chips)
aa2421a5: posts small blind $0.02
829aa739: posts big blind $0.05
*** HOLE CARDS ***
Dealt to 40c4a4f 
Dealt to aa2421a5 
Dealt to 829aa739 
Dealt to 23c96099 
Dealt to ac89ef05 
Dealt to Hero [4s 5h]
23c96099: folds
ac89ef05: folds
Hero: folds
40c4a4f: folds
aa2421a5: folds
Uncalled bet ($0.03) returned to 829aa739
*** SHOWDOWN ***
829aa739 collected $0.04 from pot
*** SUMMARY ***
Total pot $0.04 | Rake $0 | Jackpot $0 | Bingo $0 | Fortune $0 | Tax $0
Seat 1: 40c4a4f (button) folded before Flop (didn't bet)
Seat 2: aa2421a5 (small blind) folded before Flop
Seat 3: 829aa739 (big blind) collected ($0.04)
Seat 4: 23c96099 folded before Flop (didn't bet)
Seat 5: ac89ef05 folded before Flop (didn't bet)
Seat 6: Hero folded before Flop (didn't bet)


Poker Hand #RC2078511041: Hold'em No Limit ($0.02/$0.05) - 2023/12/22 21:31:48
Table 'RushAndCash790624' 6-max Seat #1 is the button
Seat 1: c2881b52 ($13.11 in chips)
Seat 2: cb16bb03 ($5.07 in chips)
Seat 3: 459d0f5c ($5 in chips)
Seat 4: Hero ($5.05 in chips)
Seat 5: 777bac87 ($5.13 in chips)
Seat 6: 2df55086 ($8.25 in chips)
cb16bb03: posts small blind $0.02
459d0f5c: posts big blind $0.05
*** HOLE CARDS ***
Dealt to c2881b52 
Dealt to cb16bb03 
Dealt to 459d0f5c 
Dealt to Hero [3h Ad]
Dealt to 777bac87 
Dealt to 2df55086 
Hero: folds
777bac87: folds
2df55086: folds
c2881b52: folds
cb16bb03: raises $0.08 to $0.13
459d0f5c: folds
Uncalled bet ($0.08) returned to cb16bb03
*** SHOWDOWN ***
cb16bb03 collected $0.1 from pot
*** SUMMARY ***
Total pot $0.1 | Rake $0 | Jackpot $0 | Bingo $0 | Fortune $0 | Tax $0
Seat 1: c2881b52 (button) folded before Flop (didn't bet)
Seat 2: cb16bb03 (small blind) collected ($0.1)
Seat 3: 459d0f5c (big blind) folded before Flop
Seat 4: Hero folded before Flop (didn't bet)
Seat 5: 777bac87 folded before Flop (didn't bet)
Seat 6: 2df55086 folded before Flop (didn't bet)


Poker Hand #RC2078510952: Hold'em No Limit ($0.02/$0.05) - 2023/12/22 21:31:44
Table 'RushAndCash790581' 6-max Seat #1 is the button
Seat 1: b7c101a2 ($12 in chips)
Seat 2: Hero ($5.07 in chips)
Seat 3: c9dcc850 ($7.2 in chips)
Seat 4: 27517d94 ($6.71 in chips)
Seat 5: c320c189 ($8.48 in chips)
Seat 6: 5a6bcca5 ($10.76 in chips)
Hero: posts small blind $0.02
c9dcc850: posts big blind $0.05
*** HOLE CARDS ***
Dealt to b7c101a2 
Dealt to Hero [9h 8d]
Dealt to c9dcc850 
Dealt to 27517d94 
Dealt to c320c189 
Dealt to 5a6bcca5 
27517d94: raises $0.08 to $0.13
c320c189: folds
5a6bcca5: folds
b7c101a2: calls $0.13
Hero: folds
c9dcc850: calls $0.08
*** FLOP *** [8h Jd 9s]
c9dcc850: bets $0.33
27517d94: folds
b7c101a2: folds
Uncalled bet ($0.33) returned to c9dcc850
*** SHOWDOWN ***
c9dcc850 collected $0.39 from pot
*** SUMMARY ***
Total pot $0.41 | Rake $0.02 | Jackpot $0 | Bingo $0 | Fortune $0 | Tax $0
Board [8h Jd 9s]
Seat 1: b7c101a2 (button) folded on the Flop
Seat 2: Hero (small blind) folded before Flop
Seat 3: c9dcc850 (big blind) won ($0.39)
Seat 4: 27517d94 folded on the Flop
Seat 5: c320c189 folded before Flop (didn't bet)
Seat 6: 5a6bcca5 folded before Flop (didn't bet)


Poker Hand #RC2078510767: Hold'em No Limit ($0.02/$0.05) - 2023/12/22 21:31:34
Table 'RushAndCash790492' 6-max Seat #1 is the button
Seat 1: 1ab06c8f ($6.61 in chips)
Seat 2: 5d55167a ($8.74 in chips)
Seat 3: Hero ($5.05 in chips)
Seat 4: 8e52c782 ($13.41 in chips)
Seat 5: fffa524d ($5.77 in chips)
Seat 6: 5da5ce8d ($19.86 in chips)
5d55167a: posts small blind $0.02
Hero: posts big blind $0.05
*** HOLE CARDS ***
Dealt to 1ab06c8f 
Dealt to 5d55167a 
Dealt to Hero [5c 4c]
Dealt to 8e52c782 
Dealt to fffa524d 
Dealt to 5da5ce8d 
8e52c782: folds
fffa524d: folds
5da5ce8d: folds
1ab06c8f: folds
5d55167a: folds
Uncalled bet ($0.03) returned to Hero
*** SHOWDOWN ***
Hero collected $0.04 from pot
*** SUMMARY ***
Total pot $0.04 | Rake $0 | Jackpot $0 | Bingo $0 | Fortune $0 | Tax $0
Seat 1: 1ab06c8f (button) folded before Flop (didn't bet)
Seat 2: 5d55167a (small blind) folded before Flop
Seat 3: Hero (big blind) collected ($0.04)
Seat 4: 8e52c782 folded before Flop (didn't bet)
Seat 5: fffa524d folded before Flop (didn't bet)
Seat 6: 5da5ce8d folded before Flop (didn't bet)


Poker Hand #RC2078510694: Hold'em No Limit ($0.02/$0.05) - 2023/12/22 21:31:29
Table 'RushAndCash790456' 6-max Seat #1 is the button
Seat 1: Hero ($5.05 in chips)
Seat 2: 2994a563 ($1.58 in chips)
Seat 3: aeeb0181 ($4.39 in chips)
Seat 4: f4b75c57 ($6.18 in chips)
Seat 5: cbfe1acc ($4.73 in chips)
Seat 6: 605ca6ae ($11.43 in chips)
2994a563: posts small blind $0.02
aeeb0181: posts big blind $0.05
*** HOLE CARDS ***
Dealt to Hero [2d Kc]
Dealt to 2994a563 
Dealt to aeeb0181 
Dealt to f4b75c57 
Dealt to cbfe1acc 
Dealt to 605ca6ae 
f4b75c57: folds
cbfe1acc: raises $0.08 to $0.13
605ca6ae: raises $0.25 to $0.38
Hero: folds
2994a563: folds
aeeb0181: raises $0.31 to $0.69
cbfe1acc: folds
605ca6ae: folds
Uncalled bet ($0.31) returned to aeeb0181
*** SHOWDOWN ***
aeeb0181 collected $0.87 from pot
*** SUMMARY ***
Total pot $0.91 | Rake $0.04 | Jackpot $0 | Bingo $0 | Fortune $0 | Tax $0
Seat 1: Hero (button) folded before Flop (didn't bet)
Seat 2: 2994a563 (small blind) folded before Flop
Seat 3: aeeb0181 (big blind) collected ($0.87)
Seat 4: f4b75c57 folded before Flop (didn't bet)
Seat 5: cbfe1acc folded before Flop
Seat 6: 605ca6ae folded before Flop


Poker Hand #RC2078510532: Hold'em No Limit ($0.02/$0.05) - 2023/12/22 21:31:20
Table 'RushAndCash790377' 6-max Seat #1 is the button
Seat 1: 4af1c8bb ($5.65 in chips)
Seat 2: de1c7123 ($5.18 in chips)
Seat 3: 9220db62 ($5.19 in chips)
Seat 4: 25941725 ($3.67 in chips)
Seat 5: Hero ($5.05 in chips)
Seat 6: 59846dec ($4.21 in chips)
de1c7123: posts small blind $0.02
9220db62: posts big blind $0.05
*** HOLE CARDS ***
Dealt to 4af1c8bb 
Dealt to de1c7123 
Dealt to 9220db62 
Dealt to 25941725 
Dealt to Hero [Ks 9s]
Dealt to 59846dec 
25941725: raises $0.07 to $0.12
Hero: folds
59846dec: raises $0.31 to $0.43
4af1c8bb: folds
de1c7123: folds
9220db62: calls $0.38
25941725: calls $0.31
*** FLOP *** [8d 7s 2s]
9220db62: checks
25941725: checks
59846dec: bets $0.99
9220db62: folds
25941725: folds
Uncalled bet ($0.99) returned to 59846dec
*** SHOWDOWN ***
59846dec collected $1.25 from pot
*** SUMMARY ***
Total pot $1.31 | Rake $0.06 | Jackpot $0 | Bingo $0 | Fortune $0 | Tax $0
Board [8d 7s 2s]
Seat 1: 4af1c8bb (button) folded before Flop (didn't bet)
Seat 2: de1c7123 (small blind) folded before Flop
Seat 3: 9220db62 (big blind) folded on the Flop
Seat 4: 25941725 folded on the Flop
Seat 5: Hero folded before Flop (didn't bet)
Seat 6: 59846dec won ($1.25)


Poker Hand #RC2078510472: Hold'em No Limit ($0.02/$0.05) - 2023/12/22 21:31:16
Table 'RushAndCash790350' 6-max Seat #1 is the button
Seat 1: fdbcec14 ($4.52 in chips)
Seat 2: 8c701e69 ($5.26 in chips)
Seat 3: e9deb15a ($5 in chips)
Seat 4: 8eb71456 ($14.62 in chips)
Seat 5: c44d0590 ($6.9 in chips)
Seat 6: Hero ($5.05 in chips)
8c701e69: posts small blind $0.02
e9deb15a: posts big blind $0.05
*** HOLE CARDS ***
Dealt to fdbcec14 
Dealt to 8c701e69 
Dealt to e9deb15a 
Dealt to 8eb71456 
Dealt to c44d0590 
Dealt to Hero [Jh 6d]
8eb71456: folds
c44d0590: folds
Hero: folds
fdbcec14: raises $0.05 to $0.1
8c701e69: raises $0.24 to $0.34
e9deb15a: folds
fdbcec14: raises $0.6 to $0.94
8c701e69: folds
Uncalled bet ($0.6) returned to fdbcec14
*** SHOWDOWN ***
fdbcec14 collected $0.7 from pot
*** SUMMARY ***
Total pot $0.73 | Rake $0.03 | Jackpot $0 | Bingo $0 | Fortune $0 | Tax $0
Seat 1: fdbcec14 (button) collected ($0.7)
Seat 2: 8c701e69 (small blind) folded before Flop
Seat 3: e9deb15a (big blind) folded before Flop
Seat 4: 8eb71456 folded before Flop (didn't bet)
Seat 5: c44d0590 folded before Flop (didn't bet)
Seat 6: Hero folded before Flop (didn't bet)


Poker Hand #RC2078510415: Hold'em No Limit ($0.02/$0.05) - 2023/12/22 21:31:13
Table 'RushAndCash790324' 6-max Seat #1 is the button
Seat 1: 803de95b ($6.51 in chips)
Seat 2: 2c867a7e ($12.52 in chips)
Seat 3: e1380a89 ($4.56 in chips)
Seat 4: e24a2fed ($9.82 in chips)
Seat 5: Hero ($5.05 in chips)
Seat 6: 875f34a0 ($28.08 in chips)
2c867a7e: posts small blind $0.02
e1380a89: posts big blind $0.05
*** HOLE CARDS ***
Dealt to 803de95b 
Dealt to 2c867a7e 
Dealt to e1380a89 
Dealt to e24a2fed 
Dealt to Hero [4h 7c]
Dealt to 875f34a0 
e24a2fed: folds
Hero: folds
875f34a0: folds
803de95b: folds
2c867a7e: folds
Uncalled bet ($0.03) returned to e1380a89
*** SHOWDOWN ***
e1380a89 collected $0.04 from pot
*** SUMMARY ***
Total pot $0.04 | Rake $0 | Jackpot $0 | Bingo $0 | Fortune $0 | Tax $0
Seat 1: 803de95b (button) folded before Flop (didn't bet)
Seat 2: 2c867a7e (small blind) folded before Flop
Seat 3: e1380a89 (big blind) collected ($0.04)
Seat 4: e24a2fed folded before Flop (didn't bet)
Seat 5: Hero folded before Flop (didn't bet)
Seat 6: 875f34a0 folded before Flop (didn't bet)


Poker Hand #RC2078510230: Hold'em No Limit ($0.02/$0.05) - 2023/12/22 21:31:02
Table 'RushAndCash790241' 6-max Seat #1 is the button
Seat 1: 9fd86997 ($20.19 in chips)
Seat 2: Hero ($5 in chips)
Seat 3: 8e0f056d ($8.44 in chips)
Seat 4: bd5964be ($5.05 in chips)
Seat 5: bf955ffb ($5.05 in chips)
Seat 6: 8b79b6b5 ($6.63 in chips)
Hero: posts small blind $0.02
8e0f056d: posts big blind $0.05
*** HOLE CARDS ***
Dealt to 9fd86997 
Dealt to Hero [Jh Kd]
Dealt to 8e0f056d 
Dealt to bd5964be 
Dealt to bf955ffb 
Dealt to 8b79b6b5 
bd5964be: folds
bf955ffb: folds
8b79b6b5: folds
9fd86997: folds
Hero: raises $0.1 to $0.15
8e0f056d: folds
Uncalled bet ($0.1) returned to Hero
*** SHOWDOWN ***
Hero collected $0.1 from pot
*** SUMMARY ***
Total pot $0.1 | Rake $0 | Jackpot $0 | Bingo $0 | Fortune $0 | Tax $0
Seat 1: 9fd86997 (button) folded before Flop (didn't bet)
Seat 2: Hero (small blind) collected ($0.1)
Seat 3: 8e0f056d (big blind) folded before Flop
Seat 4: bd5964be folded before Flop (didn't bet)
Seat 5: bf955ffb folded before Flop (didn't bet)
Seat 6: 8b79b6b5 folded before Flop (didn't bet)


Poker Hand #RC2078510150: Hold'em No Limit ($0.02/$0.05) - 2023/12/22 21:30:57
Table 'RushAndCash790200' 6-max Seat #1 is the button
Seat 1: 599a3d29 ($2.27 in chips)
Seat 2: e669c5d ($5.25 in chips)
Seat 3: c883264a ($5 in chips)
Seat 4: Hero ($5 in chips)
Seat 5: 6029883b ($5.56 in chips)
Seat 6: 45bb3f0f ($5.07 in chips)
e669c5d: posts small blind $0.02
c883264a: posts big blind $0.05
*** HOLE CARDS ***
Dealt to 599a3d29 
Dealt to e669c5d 
Dealt to c883264a 
Dealt to Hero [Js 6h]
Dealt to 6029883b 
Dealt to 45bb3f0f 
Hero: folds
6029883b: folds
45bb3f0f: folds
599a3d29: raises $0.05 to $0.1
e669c5d: folds
c883264a: folds
Uncalled bet ($0.05) returned to 599a3d29
*** SHOWDOWN ***
599a3d29 collected $0.12 from pot
*** SUMMARY ***
Total pot $0.12 | Rake $0 | Jackpot $0 | Bingo $0 | Fortune $0 | Tax $0
Seat 1: 599a3d29 (button) collected ($0.12)
Seat 2: e669c5d (small blind) folded before Flop
Seat 3: c883264a (big blind) folded before Flop
Seat 4: Hero folded before Flop (didn't bet)
Seat 5: 6029883b folded before Flop (didn't bet)
Seat 6: 45bb3f0f folded before Flop (didn't bet)


Poker Hand #RC2078510044: Hold'em No Limit ($0.02/$0.05) - 2023/12/22 21:30:51
Table 'RushAndCash790146' 6-max Seat #1 is the button
Seat 1: 469c47cc ($9.46 in chips)
Seat 2: 4f89a74a ($5.68 in chips)
Seat 3: Hero ($5.05 in chips)
Seat 4: 63c93090 ($6.86 in chips)
Seat 5: 8ced9a44 ($5.77 in chips)
Seat 6: d2e52b8d ($20.74 in chips)
4f89a74a: posts small blind $0.02
Hero: posts big blind $0.05
*** HOLE CARDS ***
Dealt to 469c47cc 
Dealt to 4f89a74a 
Dealt to Hero [2s 6d]
Dealt to 63c93090 
Dealt to 8ced9a44 
Dealt to d2e52b8d 
63c93090: folds
8ced9a44: folds
d2e52b8d: folds
469c47cc: folds
4f89a74a: raises $0.1 to $0.15
Hero: folds
Uncalled bet ($0.1) returned to 4f89a74a
*** SHOWDOWN ***
4f89a74a collected $0.1 from pot
*** SUMMARY ***
Total pot $0.1 | Rake $0 | Jackpot $0 | Bingo $0 | Fortune $0 | Tax $0
Seat 1: 469c47cc (button) folded before Flop (didn't bet)
Seat 2: 4f89a74a (small blind) collected ($0.1)
Seat 3: Hero (big blind) folded before Flop
Seat 4: 63c93090 folded before Flop (didn't bet)
Seat 5: 8ced9a44 folded before Flop (didn't bet)
Seat 6: d2e52b8d folded before Flop (didn't bet)


Poker Hand #RC2078509981: Hold'em No Limit ($0.02/$0.05) - 2023/12/22 21:30:48
Table 'RushAndCash790112' 6-max Seat #1 is the button
Seat 1: Hero ($5.05 in chips)
Seat 2: 80af7fe3 ($5.18 in chips)
Seat 3: 7c10f852 ($23.74 in chips)
Seat 4: 11ec2bb2 ($6.56 in chips)
Seat 5: 3c028e9 ($5.23 in chips)
Seat 6: 3580bebf ($12.92 in chips)
80af7fe3: posts small blind $0.02
7c10f852: posts big blind $0.05
*** HOLE CARDS ***
Dealt to Hero [3c Qh]
Dealt to 80af7fe3 
Dealt to 7c10f852 
Dealt to 11ec2bb2 
Dealt to 3c028e9 
Dealt to 3580bebf 
11ec2bb2: folds
3c028e9: folds
3580bebf: folds
Hero: folds
80af7fe3: folds
Uncalled bet ($0.03) returned to 7c10f852
*** SHOWDOWN ***
7c10f852 collected $0.04 from pot
*** SUMMARY ***
Total pot $0.04 | Rake $0 | Jackpot $0 | Bingo $0 | Fortune $0 | Tax $0
Seat 1: Hero (button) folded before Flop (didn't bet)
Seat 2: 80af7fe3 (small blind) folded before Flop
Seat 3: 7c10f852 (big blind) collected ($0.04)
Seat 4: 11ec2bb2 folded before Flop (didn't bet)
Seat 5: 3c028e9 folded before Flop (didn't bet)
Seat 6: 3580bebf folded before Flop (didn't bet)


Poker Hand #RC2078509895: Hold'em No Limit ($0.02/$0.05) - 2023/12/22 21:30:43
Table 'RushAndCash790065' 6-max Seat #1 is the button
Seat 1: d7f451d5 ($8.95 in chips)
Seat 2: da0c89bc ($6.5 in chips)
Seat 3: c2881b52 ($12.7 in chips)
Seat 4: e19dee32 ($5 in chips)
Seat 5: Hero ($5.05 in chips)
Seat 6: d7118976 ($5 in chips)
da0c89bc: posts small blind $0.02
c2881b52: posts big blind $0.05
*** HOLE CARDS ***
Dealt to d7f451d5 
Dealt to da0c89bc 
Dealt to c2881b52 
Dealt to e19dee32 
Dealt to Hero [4s Qc]
Dealt to d7118976 
e19dee32: folds
Hero: folds
d7118976: folds
d7f451d5: folds
da0c89bc: raises $0.1 to $0.15
c2881b52: folds
Uncalled bet ($0.1) returned to da0c89bc
*** SHOWDOWN ***
da0c89bc collected $0.1 from pot
*** SUMMARY ***
Total pot $0.1 | Rake $0 | Jackpot $0 | Bingo $0 | Fortune $0 | Tax $0
Seat 1: d7f451d5 (button) folded before Flop (didn't bet)
Seat 2: da0c89bc (small blind) collected ($0.1)
Seat 3: c2881b52 (big blind) folded before Flop
Seat 4: e19dee32 folded before Flop (didn't bet)
Seat 5: Hero folded before Flop (didn't bet)
Seat 6: d7118976 folded before Flop (didn't bet)


Poker Hand #RC2078509795: Hold'em No Limit ($0.02/$0.05) - 2023/12/22 21:30:37
Table 'RushAndCash790015' 6-max Seat #1 is the button
Seat 1: abe64b92 ($6.65 in chips)
Seat 2: 8a8eafe4 ($5.9 in chips)
Seat 3: adc999b ($16.23 in chips)
Seat 4: c44d0590 ($6.88 in chips)
Seat 5: 84d4f92c ($7 in chips)
Seat 6: Hero ($5.05 in chips)
8a8eafe4: posts small blind $0.02
adc999b: posts big blind $0.05
*** HOLE CARDS ***
Dealt to abe64b92 
Dealt to 8a8eafe4 
Dealt to adc999b 
Dealt to c44d0590 
Dealt to 84d4f92c 
Dealt to Hero [5s 6d]
c44d0590: folds
84d4f92c: folds
Hero: folds
abe64b92: folds
8a8eafe4: raises $0.05 to $0.1
adc999b: folds
Uncalled bet ($0.05) returned to 8a8eafe4
*** SHOWDOWN ***
8a8eafe4 collected $0.1 from pot
*** SUMMARY ***
Total pot $0.1 | Rake $0 | Jackpot $0 | Bingo $0 | Fortune $0 | Tax $0
Seat 1: abe64b92 (button) folded before Flop (didn't bet)
Seat 2: 8a8eafe4 (small blind) collected ($0.1)
Seat 3: adc999b (big blind) folded before Flop
Seat 4: c44d0590 folded before Flop (didn't bet)
Seat 5: 84d4f92c folded before Flop (didn't bet)
Seat 6: Hero folded before Flop (didn't bet)


Poker Hand #RC2078509670: Hold'em No Limit ($0.02/$0.05) - 2023/12/22 21:30:30
Table 'RushAndCash789953' 6-max Seat #1 is the button
Seat 1: Hero ($5.05 in chips)
Seat 2: 53442c3b ($10.46 in chips)
Seat 3: ab5dffec ($7.28 in chips)
Seat 4: e1380a89 ($4.58 in chips)
Seat 5: 8e0f056d ($8.37 in chips)
Seat 6: 93990934 ($7.06 in chips)
53442c3b: posts small blind $0.02
ab5dffec: posts big blind $0.05
*** HOLE CARDS ***
Dealt to Hero [8c 6c]
Dealt to 53442c3b 
Dealt to ab5dffec 
Dealt to e1380a89 
Dealt to 8e0f056d 
Dealt to 93990934 
e1380a89: folds
8e0f056d: folds
93990934: raises $0.1 to $0.15
Hero: folds
53442c3b: folds
ab5dffec: calls $0.1
*** FLOP *** [6h 5h 9d]
ab5dffec: checks
93990934: bets $0.16
ab5dffec: raises $0.41 to $0.57
93990934: calls $0.41
*** TURN *** [6h 5h 9d] [Ks]
ab5dffec: bets $1.1
93990934: calls $1.1
*** RIVER *** [6h 5h 9d Ks] [Th]
ab5dffec: bets $2.02
93990934: folds
Uncalled bet ($2.02) returned to ab5dffec
*** SHOWDOWN ***
ab5dffec collected $3.38 from pot
*** SUMMARY ***
Total pot $3.66 | Rake $0.21 | Jackpot $0.07 | Bingo $0 | Fortune $0 | Tax $0
Board [6h 5h 9d Ks Th]
Seat 1: Hero (button) folded before Flop (didn't bet)
Seat 2: 53442c3b (small blind) folded before Flop
Seat 3: ab5dffec (big blind) won ($3.38)
Seat 4: e1380a89 folded before Flop (didn't bet)
Seat 5: 8e0f056d folded before Flop (didn't bet)
Seat 6: 93990934 folded on the River


Poker Hand #RC2078509350: Hold'em No Limit ($0.02/$0.05) - 2023/12/22 21:30:13
Table 'RushAndCash789797' 6-max Seat #1 is the button
Seat 1: 59c7f4b1 ($5.5 in chips)
Seat 2: Hero ($5 in chips)
Seat 3: 30a2950b ($5.96 in chips)
Seat 4: fa93749b ($5 in chips)
Seat 5: db5367a6 ($9.95 in chips)
Seat 6: c2ec7797 ($5.28 in chips)
Hero: posts small blind $0.02
30a2950b: posts big blind $0.05
*** HOLE CARDS ***
Dealt to 59c7f4b1 
Dealt to Hero [4d 4c]
Dealt to 30a2950b 
Dealt to fa93749b 
Dealt to db5367a6 
Dealt to c2ec7797 
fa93749b: folds
db5367a6: folds
c2ec7797: folds
59c7f4b1: folds
Hero: raises $0.1 to $0.15
30a2950b: folds
Uncalled bet ($0.1) returned to Hero
*** SHOWDOWN ***
Hero collected $0.1 from pot
*** SUMMARY ***
Total pot $0.1 | Rake $0 | Jackpot $0 | Bingo $0 | Fortune $0 | Tax $0
Seat 1: 59c7f4b1 (button) folded before Flop (didn't bet)
Seat 2: Hero (small blind) collected ($0.1)
Seat 3: 30a2950b (big blind) folded before Flop
Seat 4: fa93749b folded before Flop (didn't bet)
Seat 5: db5367a6 folded before Flop (didn't bet)
Seat 6: c2ec7797 folded before Flop (didn't bet)


Poker Hand #RC2078507610: Hold'em No Limit ($0.02/$0.05) - 2023/12/22 21:28:30
Table 'RushAndCash788966' 6-max Seat #1 is the button
Seat 1: b18917a1 ($13.22 in chips)
Seat 2: 84497676 ($16.26 in chips)
Seat 3: Hero ($5 in chips)
Seat 4: e61ec3f2 ($5.24 in chips)
Seat 5: 68c6c5e7 ($26.4 in chips)
Seat 6: 55f8abbc ($8.43 in chips)
84497676: posts small blind $0.02
Hero: posts big blind $0.05
*** HOLE CARDS ***
Dealt to b18917a1 
Dealt to 84497676 
Dealt to Hero [Tc Th]
Dealt to e61ec3f2 
Dealt to 68c6c5e7 
Dealt to 55f8abbc 
e61ec3f2: folds
68c6c5e7: folds
55f8abbc: raises $0.08 to $0.13
b18917a1: folds
84497676: folds
Hero: raises $0.38 to $0.51
55f8abbc: calls $0.38
*** FLOP *** [Qc 2c 6c]
Hero: bets $0.35
55f8abbc: raises $0.91 to $1.26
Hero: raises $3.23 to $4.49 and is all-in
55f8abbc: calls $3.23
Hero: shows [Tc Th] (Pair of Tens)
55f8abbc: shows [Ad Qd] (Pair of Queens)
*** TURN *** [Qc 2c 6c] [4d]
55f8abbc: Chooses to EV Cashout 
*** RIVER *** [Qc 2c 6c 4d] [3h]
55f8abbc: Pays Cashout Risk ($2.53)
*** SHOWDOWN ***
55f8abbc collected $9.8 from pot
*** SUMMARY ***
Total pot $10.02 | Rake $0.15 | Jackpot $0.07 | Bingo $0 | Fortune $0 | Tax $0
Board [Qc 2c 6c 4d 3h]
Seat 1: b18917a1 (button) folded before Flop (didn't bet)
Seat 2: 84497676 (small blind) folded before Flop
Seat 3: Hero (big blind) showed [Tc Th] and lost with Pair of Tens
Seat 4: e61ec3f2 folded before Flop (didn't bet)
Seat 5: 68c6c5e7 folded before Flop (didn't bet)
Seat 6: 55f8abbc showed [Ad Qd] and won ($9.8) with Pair of Queens, Cashout Risk ($2.53)


Poker Hand #RC2078506804: Hold'em No Limit ($0.02/$0.05) - 2023/12/22 21:27:44
Table 'RushAndCash788605' 6-max Seat #1 is the button
Seat 1: 64f7e138 ($10.7 in chips)
Seat 2: 89ac50e8 ($10.6 in chips)
Seat 3: 94dc60fd ($5.67 in chips)
Seat 4: fbeaaad2 ($17.34 in chips)
Seat 5: Hero ($5.86 in chips)
Seat 6: 6186df3d ($6.03 in chips)
89ac50e8: posts small blind $0.02
94dc60fd: posts big blind $0.05
*** HOLE CARDS ***
Dealt to 64f7e138 
Dealt to 89ac50e8 
Dealt to 94dc60fd 
Dealt to fbeaaad2 
Dealt to Hero [Kc Ks]
Dealt to 6186df3d 
fbeaaad2: folds
Hero: raises $0.05 to $0.1
6186df3d: folds
64f7e138: folds
89ac50e8: folds
94dc60fd: calls $0.05
*** FLOP *** [8d 9s 5s]
94dc60fd: checks
Hero: bets $0.11
94dc60fd: calls $0.11
*** TURN *** [8d 9s 5s] [8s]
94dc60fd: checks
Hero: bets $0.22
94dc60fd: calls $0.22
*** RIVER *** [8d 9s 5s 8s] [As]
94dc60fd: bets $0.71
Hero: calls $0.71
94dc60fd: shows [8c 9h] (Eights Full over Nines)
Hero: shows [Kc Ks] (Ace High Flush)
*** SHOWDOWN ***
94dc60fd collected $2.12 from pot
*** SUMMARY ***
Total pot $2.3 | Rake $0.11 | Jackpot $0.07 | Bingo $0 | Fortune $0 | Tax $0
Board [8d 9s 5s 8s As]
Seat 1: 64f7e138 (button) folded before Flop (didn't bet)
Seat 2: 89ac50e8 (small blind) folded before Flop
Seat 3: 94dc60fd (big blind) showed [8c 9h] and won ($2.12) with Eights Full over Nines
Seat 4: fbeaaad2 folded before Flop (didn't bet)
Seat 5: Hero showed [Kc Ks] and lost with Ace High Flush
Seat 6: 6186df3d folded before Flop (didn't bet)


Poker Hand #RC2078506321: Hold'em No Limit ($0.02/$0.05) - 2023/12/22 21:27:16
Table 'RushAndCash788379' 6-max Seat #1 is the button
Seat 1: c4c1c89a ($5.4 in chips)
Seat 2: edac6d16 ($5.2 in chips)
Seat 3: 985b2ecb ($5.04 in chips)
Seat 4: 6ff1e240 ($9.07 in chips)
Seat 5: ff6f425f ($5.43 in chips)
Seat 6: Hero ($6.07 in chips)
edac6d16: posts small blind $0.02
985b2ecb: posts big blind $0.05
*** HOLE CARDS ***
Dealt to c4c1c89a 
Dealt to edac6d16 
Dealt to 985b2ecb 
Dealt to 6ff1e240 
Dealt to ff6f425f 
Dealt to Hero [4h 5h]
6ff1e240: folds
ff6f425f: folds
Hero: raises $0.05 to $0.1
c4c1c89a: folds
edac6d16: folds
985b2ecb: raises $0.11 to $0.21
Hero: calls $0.11
*** FLOP *** [9c Ks 7s]
985b2ecb: checks
Hero: checks
*** TURN *** [9c Ks 7s] [2h]
985b2ecb: bets $0.22
Hero: folds
Uncalled bet ($0.22) returned to 985b2ecb
*** SHOWDOWN ***
985b2ecb collected $0.42 from pot
*** SUMMARY ***
Total pot $0.44 | Rake $0.02 | Jackpot $0 | Bingo $0 | Fortune $0 | Tax $0
Board [9c Ks 7s 2h]
Seat 1: c4c1c89a (button) folded before Flop (didn't bet)
Seat 2: edac6d16 (small blind) folded before Flop
Seat 3: 985b2ecb (big blind) won ($0.42)
Seat 4: 6ff1e240 folded before Flop (didn't bet)
Seat 5: ff6f425f folded before Flop (didn't bet)
Seat 6: Hero folded on the Turn


Poker Hand #RC2078505440: Hold'em No Limit ($0.02/$0.05) - 2023/12/22 21:26:25
Table 'RushAndCash787969' 6-max Seat #1 is the button
Seat 1: 174ad468 ($5.92 in chips)
Seat 2: 985b2ecb ($6.25 in chips)
Seat 3: 72f7386e ($11.6 in chips)
Seat 4: Hero ($5 in chips)
Seat 5: 4af1c8bb ($4.27 in chips)
Seat 6: 39e048a4 ($8.51 in chips)
985b2ecb: posts small blind $0.02
72f7386e: posts big blind $0.05
*** HOLE CARDS ***
Dealt to 174ad468 
Dealt to 985b2ecb 
Dealt to 72f7386e 
Dealt to Hero [3s As]
Dealt to 4af1c8bb 
Dealt to 39e048a4 
Hero: raises $0.05 to $0.1
4af1c8bb: folds
39e048a4: folds
174ad468: folds
985b2ecb: raises $0.09 to $0.19
72f7386e: folds
Hero: calls $0.09
*** FLOP *** [Ac Th 7s]
985b2ecb: checks
Hero: checks
*** TURN *** [Ac Th 7s] [3d]
985b2ecb: bets $0.15
Hero: raises $0.25 to $0.4
985b2ecb: calls $0.25
*** RIVER *** [Ac Th 7s 3d] [Qh]
985b2ecb: checks
Hero: bets $0.62
985b2ecb: calls $0.62
Hero: shows [3s As] (Pair of Aces and Pair of Treys)
985b2ecb: shows [Ah 5h] (Pair of Aces)
*** SHOWDOWN ***
Hero collected $2.28 from pot
*** SUMMARY ***
Total pot $2.47 | Rake $0.12 | Jackpot $0.07 | Bingo $0 | Fortune $0 | Tax $0
Board [Ac Th 7s 3d Qh]
Seat 1: 174ad468 (button) folded before Flop (didn't bet)
Seat 2: 985b2ecb (small blind) showed [Ah 5h] and lost with Pair of Aces
Seat 3: 72f7386e (big blind) folded before Flop
Seat 4: Hero showed [3s As] and won ($2.28) with Pair of Aces and Pair of Treys
Seat 5: 4af1c8bb folded before Flop (didn't bet)
Seat 6: 39e048a4 folded before Flop (didn't bet)


Poker Hand #RC2078505374: Hold'em No Limit ($0.02/$0.05) - 2023/12/22 21:26:21
Table 'RushAndCash787937' 6-max Seat #1 is the button
Seat 1: Hero ($5 in chips)
Seat 2: 3a9b3c34 ($2.94 in chips)
Seat 3: c9c293e2 ($7.23 in chips)
Seat 4: a2ebb3c7 ($5.33 in chips)
Seat 5: 8ad5eb6 ($5.82 in chips)
Seat 6: 22426742 ($5.21 in chips)
3a9b3c34: posts small blind $0.02
c9c293e2: posts big blind $0.05
*** HOLE CARDS ***
Dealt to Hero [7c Ts]
Dealt to 3a9b3c34 
Dealt to c9c293e2 
Dealt to a2ebb3c7 
Dealt to 8ad5eb6 
Dealt to 22426742 
a2ebb3c7: folds
8ad5eb6: folds
22426742: folds
Hero: folds
3a9b3c34: folds
Uncalled bet ($0.03) returned to c9c293e2
*** SHOWDOWN ***
c9c293e2 collected $0.04 from pot
*** SUMMARY ***
Total pot $0.04 | Rake $0 | Jackpot $0 | Bingo $0 | Fortune $0 | Tax $0
Seat 1: Hero (button) folded before Flop (didn't bet)
Seat 2: 3a9b3c34 (small blind) folded before Flop
Seat 3: c9c293e2 (big blind) collected ($0.04)
Seat 4: a2ebb3c7 folded before Flop (didn't bet)
Seat 5: 8ad5eb6 folded before Flop (didn't bet)
Seat 6: 22426742 folded before Flop (didn't bet)


Poker Hand #RC2078505272: Hold'em No Limit ($0.02/$0.05) - 2023/12/22 21:26:16
Table 'RushAndCash787890' 6-max Seat #1 is the button
Seat 1: 9c5eb7eb ($13.61 in chips)
Seat 2: Hero ($5 in chips)
Seat 3: 8af98014 ($5 in chips)
Seat 4: d23c04d ($6.5 in chips)
Seat 5: 93570c4 ($4.43 in chips)
Seat 6: 9926d81a ($6.12 in chips)
Hero: posts small blind $0.02
8af98014: posts big blind $0.05
*** HOLE CARDS ***
Dealt to 9c5eb7eb 
Dealt to Hero [3h Ac]
Dealt to 8af98014 
Dealt to d23c04d 
Dealt to 93570c4 
Dealt to 9926d81a 
d23c04d: raises $0.08 to $0.13
93570c4: folds
9926d81a: folds
9c5eb7eb: folds
Hero: folds
8af98014: calls $0.08
*** FLOP *** [Qc 9h 2h]
8af98014: checks
d23c04d: bets $0.1
8af98014: folds
Uncalled bet ($0.1) returned to d23c04d
*** SHOWDOWN ***
d23c04d collected $0.27 from pot
*** SUMMARY ***
Total pot $0.28 | Rake $0.01 | Jackpot $0 | Bingo $0 | Fortune $0 | Tax $0
Board [Qc 9h 2h]
Seat 1: 9c5eb7eb (button) folded before Flop (didn't bet)
Seat 2: Hero (small blind) folded before Flop
Seat 3: 8af98014 (big blind) folded on the Flop
Seat 4: d23c04d won ($0.27)
Seat 5: 93570c4 folded before Flop (didn't bet)
Seat 6: 9926d81a folded before Flop (didn't bet)


Poker Hand #RC2078505160: Hold'em No Limit ($0.02/$0.05) - 2023/12/22 21:26:10
Table 'RushAndCash787837' 6-max Seat #1 is the button
Seat 1: 2f89a0 ($5.65 in chips)
Seat 2: a20c0bea ($5 in chips)
Seat 3: Hero ($5 in chips)
Seat 4: 59c7f4b1 ($6.07 in chips)
Seat 5: 38eafb19 ($5 in chips)
Seat 6: 33908c77 ($11.12 in chips)
a20c0bea: posts small blind $0.02
Hero: posts big blind $0.05
*** HOLE CARDS ***
Dealt to 2f89a0 
Dealt to a20c0bea 
Dealt to Hero [7s 5d]
Dealt to 59c7f4b1 
Dealt to 38eafb19 
Dealt to 33908c77 
59c7f4b1: raises $0.05 to $0.1
38eafb19: raises $0.15 to $0.25
33908c77: calls $0.25
2f89a0: folds
a20c0bea: folds
Hero: folds
59c7f4b1: folds
*** FLOP *** [2h 6s Tc]
38eafb19: checks
33908c77: bets $0.24
38eafb19: folds
Uncalled bet ($0.24) returned to 33908c77
*** SHOWDOWN ***
33908c77 collected $0.64 from pot
*** SUMMARY ***
Total pot $0.67 | Rake $0.03 | Jackpot $0 | Bingo $0 | Fortune $0 | Tax $0
Board [2h 6s Tc]
Seat 1: 2f89a0 (button) folded before Flop (didn't bet)
Seat 2: a20c0bea (small blind) folded before Flop
Seat 3: Hero (big blind) folded before Flop
Seat 4: 59c7f4b1 folded before Flop
Seat 5: 38eafb19 folded on the Flop
Seat 6: 33908c77 won ($0.64)


Poker Hand #RC2078505068: Hold'em No Limit ($0.02/$0.05) - 2023/12/22 21:26:04
Table 'RushAndCash787791' 6-max Seat #1 is the button
Seat 1: 8429395c ($5 in chips)
Seat 2: 3d292096 ($8.63 in chips)
Seat 3: d6c4e270 ($1.56 in chips)
Seat 4: 5261fe21 ($5.78 in chips)
Seat 5: Hero ($5 in chips)
Seat 6: 6ea11ecf ($3.93 in chips)
3d292096: posts small blind $0.02
d6c4e270: posts big blind $0.05
*** HOLE CARDS ***
Dealt to 8429395c 
Dealt to 3d292096 
Dealt to d6c4e270 
Dealt to 5261fe21 
Dealt to Hero [7s 6d]
Dealt to 6ea11ecf 
5261fe21: folds
Hero: folds
6ea11ecf: folds
8429395c: folds
3d292096: folds
Uncalled bet ($0.03) returned to d6c4e270
*** SHOWDOWN ***
d6c4e270 collected $0.04 from pot
*** SUMMARY ***
Total pot $0.04 | Rake $0 | Jackpot $0 | Bingo $0 | Fortune $0 | Tax $0
Seat 1: 8429395c (button) folded before Flop (didn't bet)
Seat 2: 3d292096 (small blind) folded before Flop
Seat 3: d6c4e270 (big blind) collected ($0.04)
Seat 4: 5261fe21 folded before Flop (didn't bet)
Seat 5: Hero folded before Flop (didn't bet)
Seat 6: 6ea11ecf folded before Flop (didn't bet)


Poker Hand #RC2078505003: Hold'em No Limit ($0.02/$0.05) - 2023/12/22 21:26:00
Table 'RushAndCash787757' 6-max Seat #1 is the button
Seat 1: c4382072 ($6.5 in chips)
Seat 2: 73c8f8b5 ($5.07 in chips)
Seat 3: 360d3b25 ($6.46 in chips)
Seat 4: 6abef4c5 ($5.71 in chips)
Seat 5: 7f067c94 ($43.41 in chips)
Seat 6: Hero ($5 in chips)
73c8f8b5: posts small blind $0.02
360d3b25: posts big blind $0.05
*** HOLE CARDS ***
Dealt to c4382072 
Dealt to 73c8f8b5 
Dealt to 360d3b25 
Dealt to 6abef4c5 
Dealt to 7f067c94 
Dealt to Hero [4c Kh]
6abef4c5: folds
7f067c94: folds
Hero: folds
c4382072: folds
73c8f8b5: folds
Uncalled bet ($0.03) returned to 360d3b25
*** SHOWDOWN ***
360d3b25 collected $0.04 from pot
*** SUMMARY ***
Total pot $0.04 | Rake $0 | Jackpot $0 | Bingo $0 | Fortune $0 | Tax $0
Seat 1: c4382072 (button) folded before Flop (didn't bet)
Seat 2: 73c8f8b5 (small blind) folded before Flop
Seat 3: 360d3b25 (big blind) collected ($0.04)
Seat 4: 6abef4c5 folded before Flop (didn't bet)
Seat 5: 7f067c94 folded before Flop (didn't bet)
Seat 6: Hero folded before Flop (didn't bet)


Poker Hand #RC2078504940: Hold'em No Limit ($0.02/$0.05) - 2023/12/22 21:25:57
Table 'RushAndCash787726' 6-max Seat #1 is the button
Seat 1: 19d300cc ($6.82 in chips)
Seat 2: 4810f2d7 ($5.51 in chips)
Seat 3: 3721b8cb ($5.53 in chips)
Seat 4: e24a2fed ($5 in chips)
Seat 5: Hero ($5 in chips)
Seat 6: bd4a4d17 ($19.76 in chips)
4810f2d7: posts small blind $0.02
3721b8cb: posts big blind $0.05
*** HOLE CARDS ***
Dealt to 19d300cc 
Dealt to 4810f2d7 
Dealt to 3721b8cb 
Dealt to e24a2fed 
Dealt to Hero [3c 6c]
Dealt to bd4a4d17 
e24a2fed: folds
Hero: folds
bd4a4d17: folds
19d300cc: raises $0.08 to $0.13
4810f2d7: folds
3721b8cb: raises $0.25 to $0.38
19d300cc: calls $0.25
*** FLOP *** [4d 4s Th]
3721b8cb: checks
19d300cc: checks
*** TURN *** [4d 4s Th] [Jh]
3721b8cb: checks
19d300cc: bets $0.4
3721b8cb: calls $0.4
*** RIVER *** [4d 4s Th Jh] [7d]
3721b8cb: checks
19d300cc: bets $1.3
3721b8cb: calls $1.3
19d300cc: shows [9h As] (Pair of Fours)
3721b8cb: shows [8s Ts] (Pair of Tens and Pair of Fours)
*** SHOWDOWN ***
3721b8cb collected $3.96 from pot
*** SUMMARY ***
Total pot $4.18 | Rake $0.15 | Jackpot $0.07 | Bingo $0 | Fortune $0 | Tax $0
Board [4d 4s Th Jh 7d]
Seat 1: 19d300cc (button) showed [9h As] and lost with Pair of Fours
Seat 2: 4810f2d7 (small blind) folded before Flop
Seat 3: 3721b8cb (big blind) showed [8s Ts] and won ($3.96) with Pair of Tens and Pair of Fours
Seat 4: e24a2fed folded before Flop (didn't bet)
Seat 5: Hero folded before Flop (didn't bet)
Seat 6: bd4a4d17 folded before Flop (didn't bet)


Poker Hand #RC2078504874: Hold'em No Limit ($0.02/$0.05) - 2023/12/22 21:25:53
Table 'RushAndCash787692' 6-max Seat #1 is the button
Seat 1: 50cbc258 ($3.93 in chips)
Seat 2: ad0bb92a ($4.62 in chips)
Seat 3: 1dd4f962 ($6.13 in chips)
Seat 4: Hero ($5 in chips)
Seat 5: f9adeea ($5 in chips)
Seat 6: 89988cd9 ($5.14 in chips)
ad0bb92a: posts small blind $0.02
1dd4f962: posts big blind $0.05
*** HOLE CARDS ***
Dealt to 50cbc258 
Dealt to ad0bb92a 
Dealt to 1dd4f962 
Dealt to Hero [2c Jd]
Dealt to f9adeea 
Dealt to 89988cd9 
Hero: folds
f9adeea: folds
89988cd9: raises $0.1 to $0.15
50cbc258: raises $0.3 to $0.45
ad0bb92a: folds
1dd4f962: folds
89988cd9: folds
Uncalled bet ($0.3) returned to 50cbc258
*** SHOWDOWN ***
50cbc258 collected $0.36 from pot
*** SUMMARY ***
Total pot $0.37 | Rake $0.01 | Jackpot $0 | Bingo $0 | Fortune $0 | Tax $0
Seat 1: 50cbc258 (button) collected ($0.36)
Seat 2: ad0bb92a (small blind) folded before Flop
Seat 3: 1dd4f962 (big blind) folded before Flop
Seat 4: Hero folded before Flop (didn't bet)
Seat 5: f9adeea folded before Flop (didn't bet)
Seat 6: 89988cd9 folded before Flop


Poker Hand #RC2078504801: Hold'em No Limit ($0.02/$0.05) - 2023/12/22 21:25:50
Table 'RushAndCash787656' 6-max Seat #1 is the button
Seat 1: Hero ($5 in chips)
Seat 2: 59ef18cb ($1.69 in chips)
Seat 3: 6029883b ($5.89 in chips)
Seat 4: 19915c5a ($4.77 in chips)
Seat 5: 829aa739 ($6.66 in chips)
Seat 6: bf955ffb ($5.16 in chips)
59ef18cb: posts small blind $0.02
6029883b: posts big blind $0.05
*** HOLE CARDS ***
Dealt to Hero [4s Th]
Dealt to 59ef18cb 
Dealt to 6029883b 
Dealt to 19915c5a 
Dealt to 829aa739 
Dealt to bf955ffb 
19915c5a: folds
829aa739: folds
bf955ffb: folds
Hero: folds
59ef18cb: raises $0.08 to $0.13
6029883b: folds
Uncalled bet ($0.08) returned to 59ef18cb
*** SHOWDOWN ***
59ef18cb collected $0.1 from pot
*** SUMMARY ***
Total pot $0.1 | Rake $0 | Jackpot $0 | Bingo $0 | Fortune $0 | Tax $0
Seat 1: Hero (button) folded before Flop (didn't bet)
Seat 2: 59ef18cb (small blind) collected ($0.1)
Seat 3: 6029883b (big blind) folded before Flop
Seat 4: 19915c5a folded before Flop (didn't bet)
Seat 5: 829aa739 folded before Flop (didn't bet)
Seat 6: bf955ffb folded before Flop (didn't bet)


Poker Hand #RC2078484577: Hold'em No Limit ($0.02/$0.05) - 2023/12/22 21:25:36
Table 'RushAndCash787559' 6-max Seat #1 is the button
Seat 1: 18f0f05c ($9.47 in chips)
Seat 2: Hero ($5 in chips)
Seat 3: 2d19d9d1 ($5.42 in chips)
Seat 4: 3d292096 ($8.68 in chips)
Seat 5: e6f6623d ($4.26 in chips)
Seat 6: 53b6f5a9 ($5.24 in chips)
Hero: posts small blind $0.02
2d19d9d1: posts big blind $0.05
*** HOLE CARDS ***
Dealt to 18f0f05c 
Dealt to Hero [Kd 5c]
Dealt to 2d19d9d1 
Dealt to 3d292096 
Dealt to e6f6623d 
Dealt to 53b6f5a9 
3d292096: folds
e6f6623d: folds
53b6f5a9: folds
18f0f05c: raises $0.06 to $0.11
Hero: folds
2d19d9d1: calls $0.06
*** FLOP *** [4h Ts 8s]
2d19d9d1: checks
18f0f05c: bets $0.08
2d19d9d1: folds
Uncalled bet ($0.08) returned to 18f0f05c
*** SHOWDOWN ***
18f0f05c collected $0.23 from pot
*** SUMMARY ***
Total pot $0.24 | Rake $0.01 | Jackpot $0 | Bingo $0 | Fortune $0 | Tax $0
Board [4h Ts 8s]
Seat 1: 18f0f05c (button) won ($0.23)
Seat 2: Hero (small blind) folded before Flop
Seat 3: 2d19d9d1 (big blind) folded on the Flop
Seat 4: 3d292096 folded before Flop (didn't bet)
Seat 5: e6f6623d folded before Flop (didn't bet)
Seat 6: 53b6f5a9 folded before Flop (didn't bet)


Poker Hand #RC2078484352: Hold'em No Limit ($0.02/$0.05) - 2023/12/22 21:25:24
Table 'RushAndCash787460' 6-max Seat #1 is the button
Seat 1: 2823eab6 ($2.97 in chips)
Seat 2: 1ab06c8f ($5.34 in chips)
Seat 3: Hero ($5 in chips)
Seat 4: 6bf9020c ($5.21 in chips)
Seat 5: e7562cd9 ($5.03 in chips)
Seat 6: 1f9b16cf ($5.57 in chips)
1ab06c8f: posts small blind $0.02
Hero: posts big blind $0.05
*** HOLE CARDS ***
Dealt to 2823eab6 
Dealt to 1ab06c8f 
Dealt to Hero [Qc 8h]
Dealt to 6bf9020c 
Dealt to e7562cd9 
Dealt to 1f9b16cf 
6bf9020c: folds
e7562cd9: folds
1f9b16cf: folds
2823eab6: raises $0.05 to $0.1
1ab06c8f: folds
Hero: folds
Uncalled bet ($0.05) returned to 2823eab6
*** SHOWDOWN ***
2823eab6 collected $0.12 from pot
*** SUMMARY ***
Total pot $0.12 | Rake $0 | Jackpot $0 | Bingo $0 | Fortune $0 | Tax $0
Seat 1: 2823eab6 (button) collected ($0.12)
Seat 2: 1ab06c8f (small blind) folded before Flop
Seat 3: Hero (big blind) folded before Flop
Seat 4: 6bf9020c folded before Flop (didn't bet)
Seat 5: e7562cd9 folded before Flop (didn't bet)
Seat 6: 1f9b16cf folded before Flop (didn't bet)


