Poker Hand #RC2078593403: Hold'em No Limit ($0.02/$0.05) - 2023/12/22 22:12:19
Table 'RushAndCash810572' 6-max Seat #1 is the button
Seat 1: 8626eae9 ($6.73 in chips)
Seat 2: 834fcc3f ($8.85 in chips)
Seat 3: Hero ($10.1 in chips)
Seat 4: 78624e82 ($5 in chips)
Seat 5: 859547f3 ($5 in chips)
Seat 6: c8c17adc ($6.54 in chips)
834fcc3f: posts small blind $0.02
Hero: posts big blind $0.05
*** HOLE CARDS ***
Dealt to 8626eae9 
Dealt to 834fcc3f 
Dealt to Hero [Qc 5c]
Dealt to 78624e82 
Dealt to 859547f3 
Dealt to c8c17adc 
78624e82: folds
859547f3: folds
c8c17adc: folds
8626eae9: raises $0.1 to $0.15
834fcc3f: folds
Hero: calls $0.1
*** FLOP *** [Tc Ks Jh]
Hero: checks
8626eae9: bets $0.16
Hero: folds
Uncalled bet ($0.16) returned to 8626eae9
*** SHOWDOWN ***
8626eae9 collected $0.31 from pot
*** SUMMARY ***
Total pot $0.32 | Rake $0.01 | Jackpot $0 | Bingo $0 | Fortune $0 | Tax $0
Board [Tc Ks Jh]
Seat 1: 8626eae9 (button) won ($0.31)
Seat 2: 834fcc3f (small blind) folded before Flop
Seat 3: Hero (big blind) folded on the Flop
Seat 4: 78624e82 folded before Flop (didn't bet)
Seat 5: 859547f3 folded before Flop (didn't bet)
Seat 6: c8c17adc folded before Flop (didn't bet)


Poker Hand #RC2078593331: Hold'em No Limit ($0.02/$0.05) - 2023/12/22 22:12:15
Table 'RushAndCash810535' 6-max Seat #1 is the button
Seat 1: 1dbba4dd ($5 in chips)
Seat 2: f123b78 ($5 in chips)
Seat 3: 15b7de4f ($5.07 in chips)
Seat 4: ede500fa ($6.77 in chips)
Seat 5: 92b02623 ($5.26 in chips)
Seat 6: Hero ($10.1 in chips)
f123b78: posts small blind $0.02
15b7de4f: posts big blind $0.05
*** HOLE CARDS ***
Dealt to 1dbba4dd 
Dealt to f123b78 
Dealt to 15b7de4f 
Dealt to ede500fa 
Dealt to 92b02623 
Dealt to Hero [8d 4s]
ede500fa: folds
92b02623: folds
Hero: folds
1dbba4dd: folds
f123b78: raises $0.09 to $0.14
15b7de4f: raises $0.32 to $0.46
f123b78: folds
Uncalled bet ($0.32) returned to 15b7de4f
*** SHOWDOWN ***
15b7de4f collected $0.27 from pot
*** SUMMARY ***
Total pot $0.28 | Rake $0.01 | Jackpot $0 | Bingo $0 | Fortune $0 | Tax $0
Seat 1: 1dbba4dd (button) folded before Flop (didn't bet)
Seat 2: f123b78 (small blind) folded before Flop
Seat 3: 15b7de4f (big blind) collected ($0.27)
Seat 4: ede500fa folded before Flop (didn't bet)
Seat 5: 92b02623 folded before Flop (didn't bet)
Seat 6: Hero folded before Flop (didn't bet)


Poker Hand #RC2078593263: Hold'em No Limit ($0.02/$0.05) - 2023/12/22 22:12:11
Table 'RushAndCash810505' 6-max Seat #1 is the button
Seat 1: Hero ($10.1 in chips)
Seat 2: 6a47753 ($5.02 in chips)
Seat 3: e40d200c ($4.48 in chips)
Seat 4: 73e5f99c ($5.42 in chips)
Seat 5: 9a9a6ce2 ($5.36 in chips)
Seat 6: 41270a9a ($5.91 in chips)
6a47753: posts small blind $0.02
e40d200c: posts big blind $0.05
*** HOLE CARDS ***
Dealt to Hero [5h 8h]
Dealt to 6a47753 
Dealt to e40d200c 
Dealt to 73e5f99c 
Dealt to 9a9a6ce2 
Dealt to 41270a9a 
73e5f99c: folds
9a9a6ce2: folds
41270a9a: folds
Hero: folds
6a47753: folds
Uncalled bet ($0.03) returned to e40d200c
*** SHOWDOWN ***
e40d200c collected $0.04 from pot
*** SUMMARY ***
Total pot $0.04 | Rake $0 | Jackpot $0 | Bingo $0 | Fortune $0 | Tax $0
Seat 1: Hero (button) folded before Flop (didn't bet)
Seat 2: 6a47753 (small blind) folded before Flop
Seat 3: e40d200c (big blind) collected ($0.04)
Seat 4: 73e5f99c folded before Flop (didn't bet)
Seat 5: 9a9a6ce2 folded before Flop (didn't bet)
Seat 6: 41270a9a folded before Flop (didn't bet)


Poker Hand #RC2078593196: Hold'em No Limit ($0.02/$0.05) - 2023/12/22 22:12:08
Table 'RushAndCash810472' 6-max Seat #1 is the button
Seat 1: d198170b ($6.79 in chips)
Seat 2: 19915c5a ($7.88 in chips)
Seat 3: eadbd152 ($5.57 in chips)
Seat 4: 9e0b201b ($2.6 in chips)
Seat 5: 20f0489f ($2.3 in chips)
Seat 6: Hero ($10.1 in chips)
19915c5a: posts small blind $0.02
eadbd152: posts big blind $0.05
*** HOLE CARDS ***
Dealt to d198170b 
Dealt to 19915c5a 
Dealt to eadbd152 
Dealt to 9e0b201b 
Dealt to 20f0489f 
Dealt to Hero [6d 3h]
9e0b201b: folds
20f0489f: folds
Hero: folds
d198170b: raises $0.08 to $0.13
19915c5a: folds
eadbd152: calls $0.08
*** FLOP *** [Jh 8s 5d]
eadbd152: checks
d198170b: bets $0.1
eadbd152: calls $0.1
*** TURN *** [Jh 8s 5d] [Tc]
eadbd152: checks
d198170b: checks
*** RIVER *** [Jh 8s 5d Tc] [Kd]
eadbd152: bets $0.4
d198170b: calls $0.4
eadbd152: shows [Qh Td] (Pair of Tens)
d198170b: shows [9s 9h] (Pair of Nines)
*** SHOWDOWN ***
eadbd152 collected $1.22 from pot
*** SUMMARY ***
Total pot $1.28 | Rake $0.06 | Jackpot $0 | Bingo $0 | Fortune $0 | Tax $0
Board [Jh 8s 5d Tc Kd]
Seat 1: d198170b (button) showed [9s 9h] and lost with Pair of Nines
Seat 2: 19915c5a (small blind) folded before Flop
Seat 3: eadbd152 (big blind) showed [Qh Td] and won ($1.22) with Pair of Tens
Seat 4: 9e0b201b folded before Flop (didn't bet)
Seat 5: 20f0489f folded before Flop (didn't bet)
Seat 6: Hero folded before Flop (didn't bet)


Poker Hand #RC2078593083: Hold'em No Limit ($0.02/$0.05) - 2023/12/22 22:12:02
Table 'RushAndCash810421' 6-max Seat #1 is the button
Seat 1: fcc84b31 ($5.91 in chips)
Seat 2: 9deb98b0 ($6.01 in chips)
Seat 3: 3487746e ($5.34 in chips)
Seat 4: Hero ($10.1 in chips)
Seat 5: 6ea11ecf ($15.45 in chips)
Seat 6: 2b268abe ($1.88 in chips)
9deb98b0: posts small blind $0.02
3487746e: posts big blind $0.05
*** HOLE CARDS ***
Dealt to fcc84b31 
Dealt to 9deb98b0 
Dealt to 3487746e 
Dealt to Hero [8h 2s]
Dealt to 6ea11ecf 
Dealt to 2b268abe 
Hero: folds
6ea11ecf: raises $0.08 to $0.13
2b268abe: folds
fcc84b31: folds
9deb98b0: calls $0.11
3487746e: folds
*** FLOP *** [4h Ac Js]
9deb98b0: checks
6ea11ecf: bets $0.16
9deb98b0: folds
Uncalled bet ($0.16) returned to 6ea11ecf
*** SHOWDOWN ***
6ea11ecf collected $0.3 from pot
*** SUMMARY ***
Total pot $0.31 | Rake $0.01 | Jackpot $0 | Bingo $0 | Fortune $0 | Tax $0
Board [4h Ac Js]
Seat 1: fcc84b31 (button) folded before Flop (didn't bet)
Seat 2: 9deb98b0 (small blind) folded on the Flop
Seat 3: 3487746e (big blind) folded before Flop
Seat 4: Hero folded before Flop (didn't bet)
Seat 5: 6ea11ecf won ($0.3)
Seat 6: 2b268abe folded before Flop (didn't bet)


Poker Hand #RC2078593008: Hold'em No Limit ($0.02/$0.05) - 2023/12/22 22:11:57
Table 'RushAndCash810389' 6-max Seat #1 is the button
Seat 1: d7f451d5 ($10.3 in chips)
Seat 2: 6ea11ecf ($15.47 in chips)
Seat 3: 4e73adeb ($10.19 in chips)
Seat 4: Hero ($10.1 in chips)
Seat 5: fcc84b31 ($5.91 in chips)
Seat 6: 6fb5b8 ($5 in chips)
6ea11ecf: posts small blind $0.02
4e73adeb: posts big blind $0.05
*** HOLE CARDS ***
Dealt to d7f451d5 
Dealt to 6ea11ecf 
Dealt to 4e73adeb 
Dealt to Hero [Ks 2d]
Dealt to fcc84b31 
Dealt to 6fb5b8 
Hero: folds
fcc84b31: folds
6fb5b8: folds
d7f451d5: folds
6ea11ecf: folds
Uncalled bet ($0.03) returned to 4e73adeb
*** SHOWDOWN ***
4e73adeb collected $0.04 from pot
*** SUMMARY ***
Total pot $0.04 | Rake $0 | Jackpot $0 | Bingo $0 | Fortune $0 | Tax $0
Seat 1: d7f451d5 (button) folded before Flop (didn't bet)
Seat 2: 6ea11ecf (small blind) folded before Flop
Seat 3: 4e73adeb (big blind) collected ($0.04)
Seat 4: Hero folded before Flop (didn't bet)
Seat 5: fcc84b31 folded before Flop (didn't bet)
Seat 6: 6fb5b8 folded before Flop (didn't bet)


Poker Hand #RC2078592948: Hold'em No Limit ($0.02/$0.05) - 2023/12/22 22:11:54
Table 'RushAndCash810363' 6-max Seat #1 is the button
Seat 1: 84572dc4 ($1.74 in chips)
Seat 2: Hero ($10.12 in chips)
Seat 3: 24503504 ($7.35 in chips)
Seat 4: b55e2f56 ($4.11 in chips)
Seat 5: bd6855dc ($5 in chips)
Seat 6: a6b60e2c ($6.36 in chips)
Hero: posts small blind $0.02
24503504: posts big blind $0.05
*** HOLE CARDS ***
Dealt to 84572dc4 
Dealt to Hero [8c Jh]
Dealt to 24503504 
Dealt to b55e2f56 
Dealt to bd6855dc 
Dealt to a6b60e2c 
b55e2f56: folds
bd6855dc: folds
a6b60e2c: raises $0.05 to $0.1
84572dc4: calls $0.1
Hero: folds
24503504: folds
*** FLOP *** [3h Ah 9c]
a6b60e2c: bets $0.14
84572dc4: folds
Uncalled bet ($0.14) returned to a6b60e2c
*** SHOWDOWN ***
a6b60e2c collected $0.26 from pot
*** SUMMARY ***
Total pot $0.27 | Rake $0.01 | Jackpot $0 | Bingo $0 | Fortune $0 | Tax $0
Board [3h Ah 9c]
Seat 1: 84572dc4 (button) folded on the Flop
Seat 2: Hero (small blind) folded before Flop
Seat 3: 24503504 (big blind) folded before Flop
Seat 4: b55e2f56 folded before Flop (didn't bet)
Seat 5: bd6855dc folded before Flop (didn't bet)
Seat 6: a6b60e2c won ($0.26)


Poker Hand #RC2078592792: Hold'em No Limit ($0.02/$0.05) - 2023/12/22 22:11:45
Table 'RushAndCash810299' 6-max Seat #1 is the button
Seat 1: 55f39ac6 ($1.51 in chips)
Seat 2: e8e3d92 ($5.86 in chips)
Seat 3: Hero ($10.17 in chips)
Seat 4: 1d497d4f ($5.63 in chips)
Seat 5: fe1e0829 ($7.16 in chips)
Seat 6: ff6f425f ($13.95 in chips)
e8e3d92: posts small blind $0.02
Hero: posts big blind $0.05
*** HOLE CARDS ***
Dealt to 55f39ac6 
Dealt to e8e3d92 
Dealt to Hero [5h 3h]
Dealt to 1d497d4f 
Dealt to fe1e0829 
Dealt to ff6f425f 
1d497d4f: folds
fe1e0829: raises $0.05 to $0.1
ff6f425f: folds
55f39ac6: folds
e8e3d92: folds
Hero: folds
Uncalled bet ($0.05) returned to fe1e0829
*** SHOWDOWN ***
fe1e0829 collected $0.12 from pot
*** SUMMARY ***
Total pot $0.12 | Rake $0 | Jackpot $0 | Bingo $0 | Fortune $0 | Tax $0
Seat 1: 55f39ac6 (button) folded before Flop (didn't bet)
Seat 2: e8e3d92 (small blind) folded before Flop
Seat 3: Hero (big blind) folded before Flop
Seat 4: 1d497d4f folded before Flop (didn't bet)
Seat 5: fe1e0829 collected ($0.12)
Seat 6: ff6f425f folded before Flop (didn't bet)


Poker Hand #RC2078592588: Hold'em No Limit ($0.02/$0.05) - 2023/12/22 22:11:32
Table 'RushAndCash810211' 6-max Seat #1 is the button
Seat 1: Hero ($10.17 in chips)
Seat 2: fc7e8623 ($24.7 in chips)
Seat 3: 81dbd3b1 ($5 in chips)
Seat 4: 7a53b5b7 ($5.12 in chips)
Seat 5: b36e65db ($5.27 in chips)
Seat 6: f6b5f68e ($5.55 in chips)
fc7e8623: posts small blind $0.02
81dbd3b1: posts big blind $0.05
*** HOLE CARDS ***
Dealt to Hero [3d Ts]
Dealt to fc7e8623 
Dealt to 81dbd3b1 
Dealt to 7a53b5b7 
Dealt to b36e65db 
Dealt to f6b5f68e 
7a53b5b7: raises $0.06 to $0.11
b36e65db: folds
f6b5f68e: folds
Hero: folds
fc7e8623: folds
81dbd3b1: folds
Uncalled bet ($0.06) returned to 7a53b5b7
*** SHOWDOWN ***
7a53b5b7 collected $0.12 from pot
*** SUMMARY ***
Total pot $0.12 | Rake $0 | Jackpot $0 | Bingo $0 | Fortune $0 | Tax $0
Seat 1: Hero (button) folded before Flop (didn't bet)
Seat 2: fc7e8623 (small blind) folded before Flop
Seat 3: 81dbd3b1 (big blind) folded before Flop
Seat 4: 7a53b5b7 collected ($0.12)
Seat 5: b36e65db folded before Flop (didn't bet)
Seat 6: f6b5f68e folded before Flop (didn't bet)


Poker Hand #RC2078592508: Hold'em No Limit ($0.02/$0.05) - 2023/12/22 22:11:28
Table 'RushAndCash810174' 6-max Seat #1 is the button
Seat 1: 859547f3 ($5.05 in chips)
Seat 2: 5b0e22a7 ($4.56 in chips)
Seat 3: 4e73adeb ($10.19 in chips)
Seat 4: Hero ($10.17 in chips)
Seat 5: b55e2f56 ($4.11 in chips)
Seat 6: af5e2eda ($5.43 in chips)
5b0e22a7: posts small blind $0.02
4e73adeb: posts big blind $0.05
*** HOLE CARDS ***
Dealt to 859547f3 
Dealt to 5b0e22a7 
Dealt to 4e73adeb 
Dealt to Hero [5c 9s]
Dealt to b55e2f56 
Dealt to af5e2eda 
Hero: folds
b55e2f56: folds
af5e2eda: folds
859547f3: folds
5b0e22a7: folds
Uncalled bet ($0.03) returned to 4e73adeb
*** SHOWDOWN ***
4e73adeb collected $0.04 from pot
*** SUMMARY ***
Total pot $0.04 | Rake $0 | Jackpot $0 | Bingo $0 | Fortune $0 | Tax $0
Seat 1: 859547f3 (button) folded before Flop (didn't bet)
Seat 2: 5b0e22a7 (small blind) folded before Flop
Seat 3: 4e73adeb (big blind) collected ($0.04)
Seat 4: Hero folded before Flop (didn't bet)
Seat 5: b55e2f56 folded before Flop (didn't bet)
Seat 6: af5e2eda folded before Flop (didn't bet)


Poker Hand #RC2078592454: Hold'em No Limit ($0.02/$0.05) - 2023/12/22 22:11:25
Table 'RushAndCash810149' 6-max Seat #1 is the button
Seat 1: 1c79ceea ($5 in chips)
Seat 2: 3411c139 ($2.19 in chips)
Seat 3: 9942b4df ($9.41 in chips)
Seat 4: 8cc6d37b ($5 in chips)
Seat 5: Hero ($10.17 in chips)
Seat 6: 2066fdc8 ($5.31 in chips)
3411c139: posts small blind $0.02
9942b4df: posts big blind $0.05
*** HOLE CARDS ***
Dealt to 1c79ceea 
Dealt to 3411c139 
Dealt to 9942b4df 
Dealt to 8cc6d37b 
Dealt to Hero [3s 4d]
Dealt to 2066fdc8 
8cc6d37b: folds
Hero: folds
2066fdc8: folds
1c79ceea: folds
3411c139: folds
Uncalled bet ($0.03) returned to 9942b4df
*** SHOWDOWN ***
9942b4df collected $0.04 from pot
*** SUMMARY ***
Total pot $0.04 | Rake $0 | Jackpot $0 | Bingo $0 | Fortune $0 | Tax $0
Seat 1: 1c79ceea (button) folded before Flop (didn't bet)
Seat 2: 3411c139 (small blind) folded before Flop
Seat 3: 9942b4df (big blind) collected ($0.04)
Seat 4: 8cc6d37b folded before Flop (didn't bet)
Seat 5: Hero folded before Flop (didn't bet)
Seat 6: 2066fdc8 folded before Flop (didn't bet)


Poker Hand #RC2078592394: Hold'em No Limit ($0.02/$0.05) - 2023/12/22 22:11:21
Table 'RushAndCash810123' 6-max Seat #1 is the button
Seat 1: 23c96099 ($8.28 in chips)
Seat 2: 8a1c58b7 ($14.96 in chips)
Seat 3: 1ffd1a84 ($5.44 in chips)
Seat 4: 9942b4df ($9.41 in chips)
Seat 5: ac4c4fe3 ($6.42 in chips)
Seat 6: Hero ($10.17 in chips)
8a1c58b7: posts small blind $0.02
1ffd1a84: posts big blind $0.05
*** HOLE CARDS ***
Dealt to 23c96099 
Dealt to 8a1c58b7 
Dealt to 1ffd1a84 
Dealt to 9942b4df 
Dealt to ac4c4fe3 
Dealt to Hero [Jc 9s]
9942b4df: folds
ac4c4fe3: folds
Hero: folds
23c96099: folds
8a1c58b7: folds
Uncalled bet ($0.03) returned to 1ffd1a84
*** SHOWDOWN ***
1ffd1a84 collected $0.04 from pot
*** SUMMARY ***
Total pot $0.04 | Rake $0 | Jackpot $0 | Bingo $0 | Fortune $0 | Tax $0
Seat 1: 23c96099 (button) folded before Flop (didn't bet)
Seat 2: 8a1c58b7 (small blind) folded before Flop
Seat 3: 1ffd1a84 (big blind) collected ($0.04)
Seat 4: 9942b4df folded before Flop (didn't bet)
Seat 5: ac4c4fe3 folded before Flop (didn't bet)
Seat 6: Hero folded before Flop (didn't bet)


Poker Hand #RC2078591533: Hold'em No Limit ($0.02/$0.05) - 2023/12/22 22:10:30
Table 'RushAndCash809723' 6-max Seat #1 is the button
Seat 1: Hero ($10.03 in chips)
Seat 2: 8f80311 ($8.4 in chips)
Seat 3: dc33dad3 ($2.38 in chips)
Seat 4: aa2421a5 ($3.61 in chips)
Seat 5: 608e0c0e ($5 in chips)
Seat 6: 8ca2bfbe ($5.46 in chips)
8f80311: posts small blind $0.02
dc33dad3: posts big blind $0.05
*** HOLE CARDS ***
Dealt to Hero [Ah Qc]
Dealt to 8f80311 
Dealt to dc33dad3 
Dealt to aa2421a5 
Dealt to 608e0c0e 
Dealt to 8ca2bfbe 
aa2421a5: folds
608e0c0e: folds
8ca2bfbe: folds
Hero: raises $0.08 to $0.13
8f80311: folds
dc33dad3: calls $0.08
*** FLOP *** [2c 2s Th]
dc33dad3: checks
Hero: checks
*** TURN *** [2c 2s Th] [Js]
dc33dad3: checks
Hero: checks
*** RIVER *** [2c 2s Th Js] [As]
dc33dad3: checks
Hero: bets $0.14
dc33dad3: folds
Uncalled bet ($0.14) returned to Hero
*** SHOWDOWN ***
Hero collected $0.27 from pot
*** SUMMARY ***
Total pot $0.28 | Rake $0.01 | Jackpot $0 | Bingo $0 | Fortune $0 | Tax $0
Board [2c 2s Th Js As]
Seat 1: Hero (button) won ($0.27)
Seat 2: 8f80311 (small blind) folded before Flop
Seat 3: dc33dad3 (big blind) folded on the River
Seat 4: aa2421a5 folded before Flop (didn't bet)
Seat 5: 608e0c0e folded before Flop (didn't bet)
Seat 6: 8ca2bfbe folded before Flop (didn't bet)


Poker Hand #RC2078591457: Hold'em No Limit ($0.02/$0.05) - 2023/12/22 22:10:26
Table 'RushAndCash809689' 6-max Seat #1 is the button
Seat 1: 9b5806d5 ($3.76 in chips)
Seat 2: a6b60e2c ($5.96 in chips)
Seat 3: 3716c1bf ($5.22 in chips)
Seat 4: Hero ($10.03 in chips)
Seat 5: c53293cf ($7.05 in chips)
Seat 6: 614c6639 ($5.46 in chips)
a6b60e2c: posts small blind $0.02
3716c1bf: posts big blind $0.05
*** HOLE CARDS ***
Dealt to 9b5806d5 
Dealt to a6b60e2c 
Dealt to 3716c1bf 
Dealt to Hero [6s 9d]
Dealt to c53293cf 
Dealt to 614c6639 
Hero: folds
c53293cf: folds
614c6639: folds
9b5806d5: raises $0.07 to $0.12
a6b60e2c: folds
3716c1bf: folds
Uncalled bet ($0.07) returned to 9b5806d5
*** SHOWDOWN ***
9b5806d5 collected $0.12 from pot
*** SUMMARY ***
Total pot $0.12 | Rake $0 | Jackpot $0 | Bingo $0 | Fortune $0 | Tax $0
Seat 1: 9b5806d5 (button) collected ($0.12)
Seat 2: a6b60e2c (small blind) folded before Flop
Seat 3: 3716c1bf (big blind) folded before Flop
Seat 4: Hero folded before Flop (didn't bet)
Seat 5: c53293cf folded before Flop (didn't bet)
Seat 6: 614c6639 folded before Flop (didn't bet)


Poker Hand #RC2078591274: Hold'em No Limit ($0.02/$0.05) - 2023/12/22 22:10:16
Table 'RushAndCash809607' 6-max Seat #1 is the button
Seat 1: a4441de9 ($6.73 in chips)
Seat 2: Hero ($10.05 in chips)
Seat 3: 10def899 ($6.49 in chips)
Seat 4: 95c1d271 ($5.13 in chips)
Seat 5: c76e55cb ($5.07 in chips)
Seat 6: 317ccf77 ($4.37 in chips)
Hero: posts small blind $0.02
10def899: posts big blind $0.05
*** HOLE CARDS ***
Dealt to a4441de9 
Dealt to Hero [Kh 3h]
Dealt to 10def899 
Dealt to 95c1d271 
Dealt to c76e55cb 
Dealt to 317ccf77 
95c1d271: folds
c76e55cb: folds
317ccf77: folds
a4441de9: raises $0.08 to $0.13
Hero: folds
10def899: folds
Uncalled bet ($0.08) returned to a4441de9
*** SHOWDOWN ***
a4441de9 collected $0.12 from pot
*** SUMMARY ***
Total pot $0.12 | Rake $0 | Jackpot $0 | Bingo $0 | Fortune $0 | Tax $0
Seat 1: a4441de9 (button) collected ($0.12)
Seat 2: Hero (small blind) folded before Flop
Seat 3: 10def899 (big blind) folded before Flop
Seat 4: 95c1d271 folded before Flop (didn't bet)
Seat 5: c76e55cb folded before Flop (didn't bet)
Seat 6: 317ccf77 folded before Flop (didn't bet)


Poker Hand #RC2078591099: Hold'em No Limit ($0.02/$0.05) - 2023/12/22 22:10:06
Table 'RushAndCash809523' 6-max Seat #1 is the button
Seat 1: d6dcfaa3 ($5.24 in chips)
Seat 2: 7a7585e4 ($4.61 in chips)
Seat 3: Hero ($10.03 in chips)
Seat 4: 2afe98d4 ($5.56 in chips)
Seat 5: d1ef5267 ($5.55 in chips)
Seat 6: 2eea48d3 ($5 in chips)
7a7585e4: posts small blind $0.02
Hero: posts big blind $0.05
*** HOLE CARDS ***
Dealt to d6dcfaa3 
Dealt to 7a7585e4 
Dealt to Hero [Ac Kc]
Dealt to 2afe98d4 
Dealt to d1ef5267 
Dealt to 2eea48d3 
2afe98d4: folds
d1ef5267: folds
2eea48d3: folds
d6dcfaa3: folds
7a7585e4: folds
Uncalled bet ($0.03) returned to Hero
*** SHOWDOWN ***
Hero collected $0.04 from pot
*** SUMMARY ***
Total pot $0.04 | Rake $0 | Jackpot $0 | Bingo $0 | Fortune $0 | Tax $0
Seat 1: d6dcfaa3 (button) folded before Flop (didn't bet)
Seat 2: 7a7585e4 (small blind) folded before Flop
Seat 3: Hero (big blind) collected ($0.04)
Seat 4: 2afe98d4 folded before Flop (didn't bet)
Seat 5: d1ef5267 folded before Flop (didn't bet)
Seat 6: 2eea48d3 folded before Flop (didn't bet)


Poker Hand #RC2078590964: Hold'em No Limit ($0.02/$0.05) - 2023/12/22 22:09:58
Table 'RushAndCash809466' 6-max Seat #1 is the button
Seat 1: Hero ($10.03 in chips)
Seat 2: 20b21409 ($5.75 in chips)
Seat 3: d132ea52 ($2.93 in chips)
Seat 4: 55f39ac6 ($1.78 in chips)
Seat 5: ad189083 ($1.7 in chips)
Seat 6: 9ffc9c0 ($3.42 in chips)
20b21409: posts small blind $0.02
d132ea52: posts big blind $0.05
*** HOLE CARDS ***
Dealt to Hero [Jc 7c]
Dealt to 20b21409 
Dealt to d132ea52 
Dealt to 55f39ac6 
Dealt to ad189083 
Dealt to 9ffc9c0 
55f39ac6: raises $0.1 to $0.15
ad189083: folds
9ffc9c0: folds
Hero: folds
20b21409: folds
d132ea52: folds
Uncalled bet ($0.1) returned to 55f39ac6
*** SHOWDOWN ***
55f39ac6 collected $0.12 from pot
*** SUMMARY ***
Total pot $0.12 | Rake $0 | Jackpot $0 | Bingo $0 | Fortune $0 | Tax $0
Seat 1: Hero (button) folded before Flop (didn't bet)
Seat 2: 20b21409 (small blind) folded before Flop
Seat 3: d132ea52 (big blind) folded before Flop
Seat 4: 55f39ac6 collected ($0.12)
Seat 5: ad189083 folded before Flop (didn't bet)
Seat 6: 9ffc9c0 folded before Flop (didn't bet)


Poker Hand #RC2078590710: Hold'em No Limit ($0.02/$0.05) - 2023/12/22 22:09:42
Table 'RushAndCash809350' 6-max Seat #1 is the button
Seat 1: f62e3ab5 ($6.22 in chips)
Seat 2: Hero ($10.05 in chips)
Seat 3: 5208eb88 ($5.57 in chips)
Seat 4: 9134f24d ($5.1 in chips)
Seat 5: 376e9d31 ($5.25 in chips)
Seat 6: 7c10f852 ($35 in chips)
Hero: posts small blind $0.02
5208eb88: posts big blind $0.05
*** HOLE CARDS ***
Dealt to f62e3ab5 
Dealt to Hero [8s Js]
Dealt to 5208eb88 
Dealt to 9134f24d 
Dealt to 376e9d31 
Dealt to 7c10f852 
9134f24d: folds
376e9d31: raises $0.07 to $0.12
7c10f852: folds
f62e3ab5: folds
Hero: folds
5208eb88: calls $0.07
*** FLOP *** [9s 6d 9h]
5208eb88: checks
376e9d31: bets $0.09
5208eb88: raises $0.21 to $0.3
376e9d31: folds
Uncalled bet ($0.21) returned to 5208eb88
*** SHOWDOWN ***
5208eb88 collected $0.42 from pot
*** SUMMARY ***
Total pot $0.44 | Rake $0.02 | Jackpot $0 | Bingo $0 | Fortune $0 | Tax $0
Board [9s 6d 9h]
Seat 1: f62e3ab5 (button) folded before Flop (didn't bet)
Seat 2: Hero (small blind) folded before Flop
Seat 3: 5208eb88 (big blind) won ($0.42)
Seat 4: 9134f24d folded before Flop (didn't bet)
Seat 5: 376e9d31 folded on the Flop
Seat 6: 7c10f852 folded before Flop (didn't bet)


Poker Hand #RC2078590195: Hold'em No Limit ($0.02/$0.05) - 2023/12/22 22:09:13
Table 'RushAndCash809115' 6-max Seat #1 is the button
Seat 1: 5208eb88 ($5.08 in chips)
Seat 2: 6a898db1 ($9.74 in chips)
Seat 3: Hero ($10.3 in chips)
Seat 4: 50a0bc08 ($8.23 in chips)
Seat 5: 754a57b2 ($5 in chips)
Seat 6: 9e9d954c ($5.9 in chips)
6a898db1: posts small blind $0.02
Hero: posts big blind $0.05
*** HOLE CARDS ***
Dealt to 5208eb88 
Dealt to 6a898db1 
Dealt to Hero [4h 3h]
Dealt to 50a0bc08 
Dealt to 754a57b2 
Dealt to 9e9d954c 
50a0bc08: calls $0.05
754a57b2: folds
9e9d954c: folds
5208eb88: raises $0.2 to $0.25
6a898db1: folds
Hero: calls $0.2
50a0bc08: calls $0.2
*** FLOP *** [9d 9c 5h]
Hero: checks
50a0bc08: checks
5208eb88: checks
*** TURN *** [9d 9c 5h] [Jh]
Hero: checks
50a0bc08: checks
5208eb88: bets $0.39
Hero: folds
50a0bc08: folds
Uncalled bet ($0.39) returned to 5208eb88
*** SHOWDOWN ***
5208eb88 collected $0.74 from pot
*** SUMMARY ***
Total pot $0.77 | Rake $0.03 | Jackpot $0 | Bingo $0 | Fortune $0 | Tax $0
Board [9d 9c 5h Jh]
Seat 1: 5208eb88 (button) won ($0.74)
Seat 2: 6a898db1 (small blind) folded before Flop
Seat 3: Hero (big blind) folded on the Turn
Seat 4: 50a0bc08 folded on the Turn
Seat 5: 754a57b2 folded before Flop (didn't bet)
Seat 6: 9e9d954c folded before Flop (didn't bet)


Poker Hand #RC2078590125: Hold'em No Limit ($0.02/$0.05) - 2023/12/22 22:09:09
Table 'RushAndCash809084' 6-max Seat #1 is the button
Seat 1: 57896c91 ($8.97 in chips)
Seat 2: 78624e82 ($5.65 in chips)
Seat 3: 58c8aa5f ($5 in chips)
Seat 4: Hero ($10.3 in chips)
Seat 5: 46892673 ($6.2 in chips)
Seat 6: df439f39 ($5.12 in chips)
78624e82: posts small blind $0.02
58c8aa5f: posts big blind $0.05
*** HOLE CARDS ***
Dealt to 57896c91 
Dealt to 78624e82 
Dealt to 58c8aa5f 
Dealt to Hero [Tc 4h]
Dealt to 46892673 
Dealt to df439f39 
Hero: folds
46892673: folds
df439f39: raises $0.06 to $0.11
57896c91: folds
78624e82: calls $0.09
58c8aa5f: folds
*** FLOP *** [4s Kc 7h]
78624e82: bets $0.09
df439f39: calls $0.09
*** TURN *** [4s Kc 7h] [8d]
78624e82: checks
df439f39: bets $0.4
78624e82: folds
Uncalled bet ($0.4) returned to df439f39
*** SHOWDOWN ***
df439f39 collected $0.43 from pot
*** SUMMARY ***
Total pot $0.45 | Rake $0.02 | Jackpot $0 | Bingo $0 | Fortune $0 | Tax $0
Board [4s Kc 7h 8d]
Seat 1: 57896c91 (button) folded before Flop (didn't bet)
Seat 2: 78624e82 (small blind) folded on the Turn
Seat 3: 58c8aa5f (big blind) folded before Flop
Seat 4: Hero folded before Flop (didn't bet)
Seat 5: 46892673 folded before Flop (didn't bet)
Seat 6: df439f39 won ($0.43)


Poker Hand #RC2078590071: Hold'em No Limit ($0.02/$0.05) - 2023/12/22 22:09:06
Table 'RushAndCash809059' 6-max Seat #1 is the button
Seat 1: 98347374 ($16.39 in chips)
Seat 2: 7728b936 ($6.96 in chips)
Seat 3: 846054b0 ($9.45 in chips)
Seat 4: Hero ($10.3 in chips)
Seat 5: f283b60 ($5.07 in chips)
Seat 6: 348e259a ($3.31 in chips)
7728b936: posts small blind $0.02
846054b0: posts big blind $0.05
*** HOLE CARDS ***
Dealt to 98347374 
Dealt to 7728b936 
Dealt to 846054b0 
Dealt to Hero [3h 2c]
Dealt to f283b60 
Dealt to 348e259a 
Hero: folds
f283b60: folds
348e259a: folds
98347374: folds
7728b936: raises $0.08 to $0.13
846054b0: folds
Uncalled bet ($0.08) returned to 7728b936
*** SHOWDOWN ***
7728b936 collected $0.1 from pot
*** SUMMARY ***
Total pot $0.1 | Rake $0 | Jackpot $0 | Bingo $0 | Fortune $0 | Tax $0
Seat 1: 98347374 (button) folded before Flop (didn't bet)
Seat 2: 7728b936 (small blind) collected ($0.1)
Seat 3: 846054b0 (big blind) folded before Flop
Seat 4: Hero folded before Flop (didn't bet)
Seat 5: f283b60 folded before Flop (didn't bet)
Seat 6: 348e259a folded before Flop (didn't bet)


Poker Hand #RC2078589991: Hold'em No Limit ($0.02/$0.05) - 2023/12/22 22:09:02
Table 'RushAndCash809025' 6-max Seat #1 is the button
Seat 1: f93190a6 ($8.91 in chips)
Seat 2: 348e259a ($3.33 in chips)
Seat 3: 9601129f ($9.03 in chips)
Seat 4: 9ffc9c0 ($3.49 in chips)
Seat 5: Hero ($10.3 in chips)
Seat 6: 71fd2b18 ($5.42 in chips)
348e259a: posts small blind $0.02
9601129f: posts big blind $0.05
*** HOLE CARDS ***
Dealt to f93190a6 
Dealt to 348e259a 
Dealt to 9601129f 
Dealt to 9ffc9c0 
Dealt to Hero [3h 8s]
Dealt to 71fd2b18 
9ffc9c0: folds
Hero: folds
71fd2b18: raises $0.05 to $0.1
f93190a6: folds
348e259a: folds
9601129f: folds
Uncalled bet ($0.05) returned to 71fd2b18
*** SHOWDOWN ***
71fd2b18 collected $0.12 from pot
*** SUMMARY ***
Total pot $0.12 | Rake $0 | Jackpot $0 | Bingo $0 | Fortune $0 | Tax $0
Seat 1: f93190a6 (button) folded before Flop (didn't bet)
Seat 2: 348e259a (small blind) folded before Flop
Seat 3: 9601129f (big blind) folded before Flop
Seat 4: 9ffc9c0 folded before Flop (didn't bet)
Seat 5: Hero folded before Flop (didn't bet)
Seat 6: 71fd2b18 collected ($0.12)


Poker Hand #RC2078589925: Hold'em No Limit ($0.02/$0.05) - 2023/12/22 22:08:58
Table 'RushAndCash808996' 6-max Seat #1 is the button
Seat 1: 1968b4b2 ($4.87 in chips)
Seat 2: f6b5f68e ($5.79 in chips)
Seat 3: 2e44f78e ($8.09 in chips)
Seat 4: 641f40f7 ($8.65 in chips)
Seat 5: 9ffc9c0 ($3.49 in chips)
Seat 6: Hero ($10.3 in chips)
f6b5f68e: posts small blind $0.02
2e44f78e: posts big blind $0.05
*** HOLE CARDS ***
Dealt to 1968b4b2 
Dealt to f6b5f68e 
Dealt to 2e44f78e 
Dealt to 641f40f7 
Dealt to 9ffc9c0 
Dealt to Hero [2s 6c]
641f40f7: folds
9ffc9c0: folds
Hero: folds
1968b4b2: folds
f6b5f68e: folds
Uncalled bet ($0.03) returned to 2e44f78e
*** SHOWDOWN ***
2e44f78e collected $0.04 from pot
*** SUMMARY ***
Total pot $0.04 | Rake $0 | Jackpot $0 | Bingo $0 | Fortune $0 | Tax $0
Seat 1: 1968b4b2 (button) folded before Flop (didn't bet)
Seat 2: f6b5f68e (small blind) folded before Flop
Seat 3: 2e44f78e (big blind) collected ($0.04)
Seat 4: 641f40f7 folded before Flop (didn't bet)
Seat 5: 9ffc9c0 folded before Flop (didn't bet)
Seat 6: Hero folded before Flop (didn't bet)


Poker Hand #RC2078589790: Hold'em No Limit ($0.02/$0.05) - 2023/12/22 22:08:50
Table 'RushAndCash808935' 6-max Seat #1 is the button
Seat 1: 78624e82 ($5.7 in chips)
Seat 2: 70054137 ($5.33 in chips)
Seat 3: fa93749b ($7.54 in chips)
Seat 4: Hero ($10.23 in chips)
Seat 5: 74a53cac ($19.18 in chips)
Seat 6: 68fa2a12 ($5.25 in chips)
70054137: posts small blind $0.02
fa93749b: posts big blind $0.05
*** HOLE CARDS ***
Dealt to 78624e82 
Dealt to 70054137 
Dealt to fa93749b 
Dealt to Hero [4h 4s]
Dealt to 74a53cac 
Dealt to 68fa2a12 
Hero: raises $0.05 to $0.1
74a53cac: folds
68fa2a12: folds
78624e82: folds
70054137: folds
fa93749b: folds
Uncalled bet ($0.05) returned to Hero
*** SHOWDOWN ***
Hero collected $0.12 from pot
*** SUMMARY ***
Total pot $0.12 | Rake $0 | Jackpot $0 | Bingo $0 | Fortune $0 | Tax $0
Seat 1: 78624e82 (button) folded before Flop (didn't bet)
Seat 2: 70054137 (small blind) folded before Flop
Seat 3: fa93749b (big blind) folded before Flop
Seat 4: Hero collected ($0.12)
Seat 5: 74a53cac folded before Flop (didn't bet)
Seat 6: 68fa2a12 folded before Flop (didn't bet)


Poker Hand #RC2078589583: Hold'em No Limit ($0.02/$0.05) - 2023/12/22 22:08:39
Table 'RushAndCash808838' 6-max Seat #1 is the button
Seat 1: 317ccf77 ($4.55 in chips)
Seat 2: Hero ($10.25 in chips)
Seat 3: acefe34e ($7.11 in chips)
Seat 4: afc1ca79 ($3.45 in chips)
Seat 5: 8aaa95a5 ($3.75 in chips)
Seat 6: a473649d ($12.97 in chips)
Hero: posts small blind $0.02
acefe34e: posts big blind $0.05
*** HOLE CARDS ***
Dealt to 317ccf77 
Dealt to Hero [Jh 2c]
Dealt to acefe34e 
Dealt to afc1ca79 
Dealt to 8aaa95a5 
Dealt to a473649d 
afc1ca79: folds
8aaa95a5: raises $0.08 to $0.13
a473649d: folds
317ccf77: folds
Hero: folds
acefe34e: folds
Uncalled bet ($0.08) returned to 8aaa95a5
*** SHOWDOWN ***
8aaa95a5 collected $0.12 from pot
*** SUMMARY ***
Total pot $0.12 | Rake $0 | Jackpot $0 | Bingo $0 | Fortune $0 | Tax $0
Seat 1: 317ccf77 (button) folded before Flop (didn't bet)
Seat 2: Hero (small blind) folded before Flop
Seat 3: acefe34e (big blind) folded before Flop
Seat 4: afc1ca79 folded before Flop (didn't bet)
Seat 5: 8aaa95a5 collected ($0.12)
Seat 6: a473649d folded before Flop (didn't bet)


Poker Hand #RC2078589292: Hold'em No Limit ($0.02/$0.05) - 2023/12/22 22:08:22
Table 'RushAndCash808700' 6-max Seat #1 is the button
Seat 1: 70237164 ($4.86 in chips)
Seat 2: b49a0d77 ($9.44 in chips)
Seat 3: Hero ($10.3 in chips)
Seat 4: 1259a422 ($8.3 in chips)
Seat 5: f2927765 ($6.49 in chips)
Seat 6: 8d188907 ($5 in chips)
b49a0d77: posts small blind $0.02
Hero: posts big blind $0.05
*** HOLE CARDS ***
Dealt to 70237164 
Dealt to b49a0d77 
Dealt to Hero [Kh 2s]
Dealt to 1259a422 
Dealt to f2927765 
Dealt to 8d188907 
1259a422: folds
f2927765: folds
8d188907: folds
70237164: raises $0.13 to $0.18
b49a0d77: calls $0.16
Hero: folds
*** FLOP *** [5s Kc Qd]
b49a0d77: checks
70237164: bets $0.14
b49a0d77: folds
Uncalled bet ($0.14) returned to 70237164
*** SHOWDOWN ***
70237164 collected $0.39 from pot
*** SUMMARY ***
Total pot $0.41 | Rake $0.02 | Jackpot $0 | Bingo $0 | Fortune $0 | Tax $0
Board [5s Kc Qd]
Seat 1: 70237164 (button) won ($0.39)
Seat 2: b49a0d77 (small blind) folded on the Flop
Seat 3: Hero (big blind) folded before Flop
Seat 4: 1259a422 folded before Flop (didn't bet)
Seat 5: f2927765 folded before Flop (didn't bet)
Seat 6: 8d188907 folded before Flop (didn't bet)


Poker Hand #RC2078589203: Hold'em No Limit ($0.02/$0.05) - 2023/12/22 22:08:17
Table 'RushAndCash808661' 6-max Seat #1 is the button
Seat 1: 4cd2ab9f ($9.4 in chips)
Seat 2: 7e84e7dc ($15.28 in chips)
Seat 3: 43d779d1 ($5 in chips)
Seat 4: c3c9a58d ($20.26 in chips)
Seat 5: Hero ($10.3 in chips)
Seat 6: 404f9df4 ($5.86 in chips)
7e84e7dc: posts small blind $0.02
43d779d1: posts big blind $0.05
*** HOLE CARDS ***
Dealt to 4cd2ab9f 
Dealt to 7e84e7dc 
Dealt to 43d779d1 
Dealt to c3c9a58d 
Dealt to Hero [6d Js]
Dealt to 404f9df4 
c3c9a58d: calls $0.05
Hero: folds
404f9df4: folds
4cd2ab9f: calls $0.05
7e84e7dc: folds
43d779d1: checks
*** FLOP *** [2s 5d 2c]
43d779d1: checks
c3c9a58d: bets $0.17
4cd2ab9f: folds
43d779d1: calls $0.17
*** TURN *** [2s 5d 2c] [8c]
43d779d1: checks
c3c9a58d: bets $0.26
43d779d1: calls $0.26
*** RIVER *** [2s 5d 2c 8c] [8h]
43d779d1: checks
c3c9a58d: bets $5.7
43d779d1: calls $4.52 and is all-in
Uncalled bet ($1.18) returned to c3c9a58d
c3c9a58d: shows [8s 8d] (Four Eights)
43d779d1: shows [2d Qs] (Twos Full over Eights)
*** SHOWDOWN ***
c3c9a58d collected $9.85 from pot
*** SUMMARY ***
Total pot $10.07 | Rake $0.15 | Jackpot $0.07 | Bingo $0 | Fortune $0 | Tax $0
Board [2s 5d 2c 8c 8h]
Seat 1: 4cd2ab9f (button) folded on the Flop
Seat 2: 7e84e7dc (small blind) folded before Flop
Seat 3: 43d779d1 (big blind) showed [2d Qs] and lost with Twos Full over Eights
Seat 4: c3c9a58d showed [8s 8d] and won ($9.85) with Four Eights
Seat 5: Hero folded before Flop (didn't bet)
Seat 6: 404f9df4 folded before Flop (didn't bet)


Poker Hand #RC2078589143: Hold'em No Limit ($0.02/$0.05) - 2023/12/22 22:08:13
Table 'RushAndCash808634' 6-max Seat #1 is the button
Seat 1: Hero ($10.3 in chips)
Seat 2: 30f8d14e ($4.53 in chips)
Seat 3: bd6855dc ($5.43 in chips)
Seat 4: 48b86f00 ($5.73 in chips)
Seat 5: 17da2929 ($5.31 in chips)
Seat 6: b3e85c60 ($13.52 in chips)
30f8d14e: posts small blind $0.02
bd6855dc: posts big blind $0.05
*** HOLE CARDS ***
Dealt to Hero [4c Kd]
Dealt to 30f8d14e 
Dealt to bd6855dc 
Dealt to 48b86f00 
Dealt to 17da2929 
Dealt to b3e85c60 
48b86f00: folds
17da2929: folds
b3e85c60: raises $0.08 to $0.13
Hero: folds
30f8d14e: calls $0.11
bd6855dc: folds
*** FLOP *** [6d 9h 3s]
30f8d14e: checks
b3e85c60: checks
*** TURN *** [6d 9h 3s] [Kh]
30f8d14e: bets $0.11
b3e85c60: raises $0.27 to $0.38
30f8d14e: calls $0.27
*** RIVER *** [6d 9h 3s Kh] [4s]
30f8d14e: bets $0.54
b3e85c60: calls $0.54
30f8d14e: shows [7c 8c] (King-High)
b3e85c60: shows [Kc As] (Pair of Kings)
*** SHOWDOWN ***
b3e85c60 collected $1.98 from pot
*** SUMMARY ***
Total pot $2.15 | Rake $0.1 | Jackpot $0.07 | Bingo $0 | Fortune $0 | Tax $0
Board [6d 9h 3s Kh 4s]
Seat 1: Hero (button) folded before Flop (didn't bet)
Seat 2: 30f8d14e (small blind) showed [7c 8c] and lost with King-High
Seat 3: bd6855dc (big blind) folded before Flop
Seat 4: 48b86f00 folded before Flop (didn't bet)
Seat 5: 17da2929 folded before Flop (didn't bet)
Seat 6: b3e85c60 showed [Kc As] and won ($1.98) with Pair of Kings


Poker Hand #RC2078589049: Hold'em No Limit ($0.02/$0.05) - 2023/12/22 22:08:08
Table 'RushAndCash808592' 6-max Seat #1 is the button
Seat 1: f5ffb37c ($5.22 in chips)
Seat 2: 5861f243 ($5.84 in chips)
Seat 3: 4cce9bd4 ($5.34 in chips)
Seat 4: 517da49 ($10.51 in chips)
Seat 5: b01c40bf ($18.39 in chips)
Seat 6: Hero ($10.3 in chips)
5861f243: posts small blind $0.02
4cce9bd4: posts big blind $0.05
*** HOLE CARDS ***
Dealt to f5ffb37c 
Dealt to 5861f243 
Dealt to 4cce9bd4 
Dealt to 517da49 
Dealt to b01c40bf 
Dealt to Hero [6h 8h]
517da49: folds
b01c40bf: folds
Hero: folds
f5ffb37c: raises $0.05 to $0.1
5861f243: folds
4cce9bd4: calls $0.05
*** FLOP *** [6s 4d Ah]
4cce9bd4: checks
f5ffb37c: bets $0.08
4cce9bd4: folds
Uncalled bet ($0.08) returned to f5ffb37c
*** SHOWDOWN ***
f5ffb37c collected $0.21 from pot
*** SUMMARY ***
Total pot $0.22 | Rake $0.01 | Jackpot $0 | Bingo $0 | Fortune $0 | Tax $0
Board [6s 4d Ah]
Seat 1: f5ffb37c (button) won ($0.21)
Seat 2: 5861f243 (small blind) folded before Flop
Seat 3: 4cce9bd4 (big blind) folded on the Flop
Seat 4: 517da49 folded before Flop (didn't bet)
Seat 5: b01c40bf folded before Flop (didn't bet)
Seat 6: Hero folded before Flop (didn't bet)


Poker Hand #RC2078588985: Hold'em No Limit ($0.02/$0.05) - 2023/12/22 22:08:04
Table 'RushAndCash808564' 6-max Seat #1 is the button
Seat 1: e7ed98a7 ($5.24 in chips)
Seat 2: 153d5b53 ($4.68 in chips)
Seat 3: 6d679d40 ($5.97 in chips)
Seat 4: Hero ($10.3 in chips)
Seat 5: a1f716b ($5.83 in chips)
Seat 6: dfd36278 ($5.4 in chips)
153d5b53: posts small blind $0.02
6d679d40: posts big blind $0.05
*** HOLE CARDS ***
Dealt to e7ed98a7 
Dealt to 153d5b53 
Dealt to 6d679d40 
Dealt to Hero [6c Js]
Dealt to a1f716b 
Dealt to dfd36278 
Hero: folds
a1f716b: folds
dfd36278: folds
e7ed98a7: folds
153d5b53: raises $0.08 to $0.13
6d679d40: raises $0.22 to $0.35
153d5b53: raises $0.53 to $0.88
6d679d40: calls $0.53
*** FLOP *** [2c 5c 3c]
153d5b53: bets $1.32
6d679d40: raises $3.77 to $5.09 and is all-in
153d5b53: calls $2.48 and is all-in
Uncalled bet ($1.29) returned to 6d679d40
6d679d40: shows [3d 3h] (Three Treys)
153d5b53: shows [Qs Qc] (Pair of Queens)
6d679d40: Chooses to EV Cashout 
*** TURN *** [2c 5c 3c] [5d]
*** RIVER *** [2c 5c 3c 5d] [7d]
6d679d40: Pays Cashout Risk ($3.28)
*** SHOWDOWN ***
6d679d40 collected $9.14 from pot
*** SUMMARY ***
Total pot $9.36 | Rake $0.15 | Jackpot $0.07 | Bingo $0 | Fortune $0 | Tax $0
Board [2c 5c 3c 5d 7d]
Seat 1: e7ed98a7 (button) folded before Flop (didn't bet)
Seat 2: 153d5b53 (small blind) showed [Qs Qc] and lost with Pair of Queens and Pair of Fives
Seat 3: 6d679d40 (big blind) showed [3d 3h] and won ($9.14) with Treys Full over Fives, Cashout Risk ($3.28)
Seat 4: Hero folded before Flop (didn't bet)
Seat 5: a1f716b folded before Flop (didn't bet)
Seat 6: dfd36278 folded before Flop (didn't bet)


Poker Hand #RC2078588844: Hold'em No Limit ($0.02/$0.05) - 2023/12/22 22:07:55
Table 'RushAndCash808497' 6-max Seat #1 is the button
Seat 1: ab5dffec ($6.26 in chips)
Seat 2: 9b0ec3a ($19.72 in chips)
Seat 3: Hero ($10.35 in chips)
Seat 4: 1e3d103d ($7.89 in chips)
Seat 5: da1fa015 ($6.92 in chips)
Seat 6: f57c6794 ($7.28 in chips)
9b0ec3a: posts small blind $0.02
Hero: posts big blind $0.05
*** HOLE CARDS ***
Dealt to ab5dffec 
Dealt to 9b0ec3a 
Dealt to Hero [Qs 2d]
Dealt to 1e3d103d 
Dealt to da1fa015 
Dealt to f57c6794 
1e3d103d: folds
da1fa015: raises $0.08 to $0.13
f57c6794: calls $0.13
ab5dffec: folds
9b0ec3a: folds
Hero: folds
*** FLOP *** [3h 7h 4h]
da1fa015: bets $0.11
f57c6794: folds
Uncalled bet ($0.11) returned to da1fa015
*** SHOWDOWN ***
da1fa015 collected $0.32 from pot
*** SUMMARY ***
Total pot $0.33 | Rake $0.01 | Jackpot $0 | Bingo $0 | Fortune $0 | Tax $0
Board [3h 7h 4h]
Seat 1: ab5dffec (button) folded before Flop (didn't bet)
Seat 2: 9b0ec3a (small blind) folded before Flop
Seat 3: Hero (big blind) folded before Flop
Seat 4: 1e3d103d folded before Flop (didn't bet)
Seat 5: da1fa015 won ($0.32)
Seat 6: f57c6794 folded on the Flop


Poker Hand #RC2078588715: Hold'em No Limit ($0.02/$0.05) - 2023/12/22 22:07:48
Table 'RushAndCash808433' 6-max Seat #1 is the button
Seat 1: 2075befd ($11.43 in chips)
Seat 2: Hero ($10.37 in chips)
Seat 3: 71c72b00 ($5.21 in chips)
Seat 4: c8c17adc ($6.71 in chips)
Seat 5: c0936c93 ($6.28 in chips)
Seat 6: 5a7ccd94 ($4.73 in chips)
Hero: posts small blind $0.02
71c72b00: posts big blind $0.05
*** HOLE CARDS ***
Dealt to 2075befd 
Dealt to Hero [5h Jd]
Dealt to 71c72b00 
Dealt to c8c17adc 
Dealt to c0936c93 
Dealt to 5a7ccd94 
c8c17adc: raises $0.1 to $0.15
c0936c93: folds
5a7ccd94: folds
2075befd: folds
Hero: folds
71c72b00: folds
Uncalled bet ($0.1) returned to c8c17adc
*** SHOWDOWN ***
c8c17adc collected $0.12 from pot
*** SUMMARY ***
Total pot $0.12 | Rake $0 | Jackpot $0 | Bingo $0 | Fortune $0 | Tax $0
Seat 1: 2075befd (button) folded before Flop (didn't bet)
Seat 2: Hero (small blind) folded before Flop
Seat 3: 71c72b00 (big blind) folded before Flop
Seat 4: c8c17adc collected ($0.12)
Seat 5: c0936c93 folded before Flop (didn't bet)
Seat 6: 5a7ccd94 folded before Flop (didn't bet)


Poker Hand #RC2078588658: Hold'em No Limit ($0.02/$0.05) - 2023/12/22 22:07:44
Table 'RushAndCash808409' 6-max Seat #1 is the button
Seat 1: 976fcde7 ($6.36 in chips)
Seat 2: 11612373 ($16.82 in chips)
Seat 3: 4a7d05b1 ($6.45 in chips)
Seat 4: 6c4d56b8 ($5.23 in chips)
Seat 5: cbfe1acc ($5.01 in chips)
Seat 6: Hero ($10.37 in chips)
11612373: posts small blind $0.02
4a7d05b1: posts big blind $0.05
*** HOLE CARDS ***
Dealt to 976fcde7 
Dealt to 11612373 
Dealt to 4a7d05b1 
Dealt to 6c4d56b8 
Dealt to cbfe1acc 
Dealt to Hero [4h Qh]
6c4d56b8: folds
cbfe1acc: folds
Hero: folds
976fcde7: folds
11612373: folds
Uncalled bet ($0.03) returned to 4a7d05b1
*** SHOWDOWN ***
4a7d05b1 collected $0.04 from pot
*** SUMMARY ***
Total pot $0.04 | Rake $0 | Jackpot $0 | Bingo $0 | Fortune $0 | Tax $0
Seat 1: 976fcde7 (button) folded before Flop (didn't bet)
Seat 2: 11612373 (small blind) folded before Flop
Seat 3: 4a7d05b1 (big blind) collected ($0.04)
Seat 4: 6c4d56b8 folded before Flop (didn't bet)
Seat 5: cbfe1acc folded before Flop (didn't bet)
Seat 6: Hero folded before Flop (didn't bet)


Poker Hand #RC2078588572: Hold'em No Limit ($0.02/$0.05) - 2023/12/22 22:07:39
Table 'RushAndCash808371' 6-max Seat #1 is the button
Seat 1: Hero ($10.37 in chips)
Seat 2: 7385f3 ($4.77 in chips)
Seat 3: acefe34e ($7.26 in chips)
Seat 4: d132ea52 ($2.8 in chips)
Seat 5: 49173806 ($10.94 in chips)
Seat 6: 9e0b201b ($2.91 in chips)
7385f3: posts small blind $0.02
acefe34e: posts big blind $0.05
*** HOLE CARDS ***
Dealt to Hero [9d 2s]
Dealt to 7385f3 
Dealt to acefe34e 
Dealt to d132ea52 
Dealt to 49173806 
Dealt to 9e0b201b 
d132ea52: folds
49173806: folds
9e0b201b: raises $0.08 to $0.13
Hero: folds
7385f3: calls $0.11
acefe34e: calls $0.08
*** FLOP *** [4d 7h 5h]
7385f3: checks
acefe34e: checks
9e0b201b: bets $0.2
7385f3: calls $0.2
acefe34e: folds
*** TURN *** [4d 7h 5h] [3h]
7385f3: checks
9e0b201b: bets $0.27
7385f3: raises $0.96 to $1.23
9e0b201b: raises $1.35 to $2.58 and is all-in
7385f3: calls $1.35
9e0b201b: shows [Th Qh] (Queen High Flush)
7385f3: shows [6d 6h] (Sevens-High Straight)
*** RIVER *** [4d 7h 5h 3h] [8d]
*** SHOWDOWN ***
9e0b201b collected $5.73 from pot
*** SUMMARY ***
Total pot $5.95 | Rake $0.15 | Jackpot $0.07 | Bingo $0 | Fortune $0 | Tax $0
Board [4d 7h 5h 3h 8d]
Seat 1: Hero (button) folded before Flop (didn't bet)
Seat 2: 7385f3 (small blind) showed [6d 6h] and lost with Eights-High Straight
Seat 3: acefe34e (big blind) folded on the Flop
Seat 4: d132ea52 folded before Flop (didn't bet)
Seat 5: 49173806 folded before Flop (didn't bet)
Seat 6: 9e0b201b showed [Th Qh] and won ($5.73) with Queen High Flush


Poker Hand #RC2078588519: Hold'em No Limit ($0.02/$0.05) - 2023/12/22 22:07:36
Table 'RushAndCash808349' 6-max Seat #1 is the button
Seat 1: Hero ($10.37 in chips)
Seat 2: 8af98014 ($6.15 in chips)
Seat 3: 8a6d1b ($11.16 in chips)
Seat 4: 8eb71456 ($12.9 in chips)
Seat 5: 5144e66c ($5.32 in chips)
Seat 6: 3a20c3a ($9.03 in chips)
8af98014: posts small blind $0.02
8a6d1b: posts big blind $0.05
*** HOLE CARDS ***
Dealt to Hero [3s 9h]
Dealt to 8af98014 
Dealt to 8a6d1b 
Dealt to 8eb71456 
Dealt to 5144e66c 
Dealt to 3a20c3a 
8eb71456: folds
5144e66c: folds
3a20c3a: folds
Hero: folds
8af98014: folds
Uncalled bet ($0.03) returned to 8a6d1b
*** SHOWDOWN ***
8a6d1b collected $0.04 from pot
*** SUMMARY ***
Total pot $0.04 | Rake $0 | Jackpot $0 | Bingo $0 | Fortune $0 | Tax $0
Seat 1: Hero (button) folded before Flop (didn't bet)
Seat 2: 8af98014 (small blind) folded before Flop
Seat 3: 8a6d1b (big blind) collected ($0.04)
Seat 4: 8eb71456 folded before Flop (didn't bet)
Seat 5: 5144e66c folded before Flop (didn't bet)
Seat 6: 3a20c3a folded before Flop (didn't bet)


Poker Hand #RC2078588438: Hold'em No Limit ($0.02/$0.05) - 2023/12/22 22:07:31
Table 'RushAndCash808310' 6-max Seat #1 is the button
Seat 1: beea6e5f ($8.28 in chips)
Seat 2: 20ec78d4 ($5.22 in chips)
Seat 3: Hero ($10.42 in chips)
Seat 4: e6f6623d ($4.98 in chips)
Seat 5: a4441de9 ($5.92 in chips)
Seat 6: e4111047 ($4.45 in chips)
20ec78d4: posts small blind $0.02
Hero: posts big blind $0.05
*** HOLE CARDS ***
Dealt to beea6e5f 
Dealt to 20ec78d4 
Dealt to Hero [Kd 3c]
Dealt to e6f6623d 
Dealt to a4441de9 
Dealt to e4111047 
e6f6623d: folds
a4441de9: raises $0.05 to $0.1
e4111047: folds
beea6e5f: folds
20ec78d4: folds
Hero: folds
Uncalled bet ($0.05) returned to a4441de9
*** SHOWDOWN ***
a4441de9 collected $0.12 from pot
*** SUMMARY ***
Total pot $0.12 | Rake $0 | Jackpot $0 | Bingo $0 | Fortune $0 | Tax $0
Seat 1: beea6e5f (button) folded before Flop (didn't bet)
Seat 2: 20ec78d4 (small blind) folded before Flop
Seat 3: Hero (big blind) folded before Flop
Seat 4: e6f6623d folded before Flop (didn't bet)
Seat 5: a4441de9 collected ($0.12)
Seat 6: e4111047 folded before Flop (didn't bet)


Poker Hand #RC2078588371: Hold'em No Limit ($0.02/$0.05) - 2023/12/22 22:07:27
Table 'RushAndCash808278' 6-max Seat #1 is the button
Seat 1: 74883d85 ($4.86 in chips)
Seat 2: 3b322324 ($5.35 in chips)
Seat 3: 947be4c8 ($4.7 in chips)
Seat 4: b31f68a1 ($5.82 in chips)
Seat 5: Hero ($10.42 in chips)
Seat 6: cbfe1acc ($5.03 in chips)
3b322324: posts small blind $0.02
947be4c8: posts big blind $0.05
*** HOLE CARDS ***
Dealt to 74883d85 
Dealt to 3b322324 
Dealt to 947be4c8 
Dealt to b31f68a1 
Dealt to Hero [5s 9c]
Dealt to cbfe1acc 
b31f68a1: folds
Hero: folds
cbfe1acc: folds
74883d85: raises $0.05 to $0.1
3b322324: folds
947be4c8: calls $0.05
*** FLOP *** [4d Ac Tc]
947be4c8: checks
74883d85: checks
*** TURN *** [4d Ac Tc] [6h]
947be4c8: bets $0.13
74883d85: calls $0.13
*** RIVER *** [4d Ac Tc 6h] [6s]
947be4c8: bets $0.24
74883d85: folds
Uncalled bet ($0.24) returned to 947be4c8
*** SHOWDOWN ***
947be4c8 collected $0.46 from pot
*** SUMMARY ***
Total pot $0.48 | Rake $0.02 | Jackpot $0 | Bingo $0 | Fortune $0 | Tax $0
Board [4d Ac Tc 6h 6s]
Seat 1: 74883d85 (button) folded on the River
Seat 2: 3b322324 (small blind) folded before Flop
Seat 3: 947be4c8 (big blind) won ($0.46)
Seat 4: b31f68a1 folded before Flop (didn't bet)
Seat 5: Hero folded before Flop (didn't bet)
Seat 6: cbfe1acc folded before Flop (didn't bet)


Poker Hand #RC2078588306: Hold'em No Limit ($0.02/$0.05) - 2023/12/22 22:07:24
Table 'RushAndCash808249' 6-max Seat #1 is the button
Seat 1: 1c5ffeb9 ($5.24 in chips)
Seat 2: 5902639 ($7.56 in chips)
Seat 3: def6b062 ($6.15 in chips)
Seat 4: Hero ($10.42 in chips)
Seat 5: 98347374 ($16.56 in chips)
Seat 6: 521feab9 ($5 in chips)
5902639: posts small blind $0.02
def6b062: posts big blind $0.05
*** HOLE CARDS ***
Dealt to 1c5ffeb9 
Dealt to 5902639 
Dealt to def6b062 
Dealt to Hero [Jh 5d]
Dealt to 98347374 
Dealt to 521feab9 
Hero: folds
98347374: folds
521feab9: folds
1c5ffeb9: raises $0.1 to $0.15
5902639: folds
def6b062: raises $0.32 to $0.47
1c5ffeb9: calls $0.32
*** FLOP *** [5c 2d 2h]
def6b062: bets $0.4
1c5ffeb9: calls $0.4
*** TURN *** [5c 2d 2h] [6d]
def6b062: checks
1c5ffeb9: bets $0.59
def6b062: folds
Uncalled bet ($0.59) returned to 1c5ffeb9
*** SHOWDOWN ***
1c5ffeb9 collected $1.61 from pot
*** SUMMARY ***
Total pot $1.76 | Rake $0.08 | Jackpot $0.07 | Bingo $0 | Fortune $0 | Tax $0
Board [5c 2d 2h 6d]
Seat 1: 1c5ffeb9 (button) won ($1.61)
Seat 2: 5902639 (small blind) folded before Flop
Seat 3: def6b062 (big blind) folded on the Turn
Seat 4: Hero folded before Flop (didn't bet)
Seat 5: 98347374 folded before Flop (didn't bet)
Seat 6: 521feab9 folded before Flop (didn't bet)


Poker Hand #RC2078588222: Hold'em No Limit ($0.02/$0.05) - 2023/12/22 22:07:19
Table 'RushAndCash808211' 6-max Seat #1 is the button
Seat 1: 2bb677ff ($8.98 in chips)
Seat 2: 697fb04a ($40.96 in chips)
Seat 3: 4879e77e ($6.75 in chips)
Seat 4: e527ebf4 ($7.13 in chips)
Seat 5: Hero ($10.42 in chips)
Seat 6: 81bfbf74 ($5.15 in chips)
697fb04a: posts small blind $0.02
4879e77e: posts big blind $0.05
*** HOLE CARDS ***
Dealt to 2bb677ff 
Dealt to 697fb04a 
Dealt to 4879e77e 
Dealt to e527ebf4 
Dealt to Hero [3d 2c]
Dealt to 81bfbf74 
e527ebf4: folds
Hero: folds
81bfbf74: folds
2bb677ff: folds
697fb04a: folds
Uncalled bet ($0.03) returned to 4879e77e
*** SHOWDOWN ***
4879e77e collected $0.04 from pot
*** SUMMARY ***
Total pot $0.04 | Rake $0 | Jackpot $0 | Bingo $0 | Fortune $0 | Tax $0
Seat 1: 2bb677ff (button) folded before Flop (didn't bet)
Seat 2: 697fb04a (small blind) folded before Flop
Seat 3: 4879e77e (big blind) collected ($0.04)
Seat 4: e527ebf4 folded before Flop (didn't bet)
Seat 5: Hero folded before Flop (didn't bet)
Seat 6: 81bfbf74 folded before Flop (didn't bet)


Poker Hand #RC2078588144: Hold'em No Limit ($0.02/$0.05) - 2023/12/22 22:07:14
Table 'RushAndCash808173' 6-max Seat #1 is the button
Seat 1: 354c4fad ($5.99 in chips)
Seat 2: Hero ($10.44 in chips)
Seat 3: d50b3b7c ($5.52 in chips)
Seat 4: 58864a6e ($17.24 in chips)
Seat 5: 452fead6 ($5 in chips)
Seat 6: af5e2eda ($5.17 in chips)
Hero: posts small blind $0.02
d50b3b7c: posts big blind $0.05
*** HOLE CARDS ***
Dealt to 354c4fad 
Dealt to Hero [Jh 3d]
Dealt to d50b3b7c 
Dealt to 58864a6e 
Dealt to 452fead6 
Dealt to af5e2eda 
58864a6e: folds
452fead6: folds
af5e2eda: folds
354c4fad: folds
Hero: folds
Uncalled bet ($0.03) returned to d50b3b7c
*** SHOWDOWN ***
d50b3b7c collected $0.04 from pot
*** SUMMARY ***
Total pot $0.04 | Rake $0 | Jackpot $0 | Bingo $0 | Fortune $0 | Tax $0
Seat 1: 354c4fad (button) folded before Flop (didn't bet)
Seat 2: Hero (small blind) folded before Flop
Seat 3: d50b3b7c (big blind) collected ($0.04)
Seat 4: 58864a6e folded before Flop (didn't bet)
Seat 5: 452fead6 folded before Flop (didn't bet)
Seat 6: af5e2eda folded before Flop (didn't bet)


Poker Hand #RC2078588077: Hold'em No Limit ($0.02/$0.05) - 2023/12/22 22:07:11
Table 'RushAndCash808143' 6-max Seat #1 is the button
Seat 1: c4ffe01a ($11.26 in chips)
Seat 2: 641f40f7 ($5 in chips)
Seat 3: 20ec78d4 ($5.27 in chips)
Seat 4: 4f2e237f ($5.07 in chips)
Seat 5: 70054137 ($5.19 in chips)
Seat 6: Hero ($10.44 in chips)
641f40f7: posts small blind $0.02
20ec78d4: posts big blind $0.05
*** HOLE CARDS ***
Dealt to c4ffe01a 
Dealt to 641f40f7 
Dealt to 20ec78d4 
Dealt to 4f2e237f 
Dealt to 70054137 
Dealt to Hero [3h Jc]
4f2e237f: folds
70054137: folds
Hero: folds
c4ffe01a: raises $0.08 to $0.13
641f40f7: folds
20ec78d4: folds
Uncalled bet ($0.08) returned to c4ffe01a
*** SHOWDOWN ***
c4ffe01a collected $0.12 from pot
*** SUMMARY ***
Total pot $0.12 | Rake $0 | Jackpot $0 | Bingo $0 | Fortune $0 | Tax $0
Seat 1: c4ffe01a (button) collected ($0.12)
Seat 2: 641f40f7 (small blind) folded before Flop
Seat 3: 20ec78d4 (big blind) folded before Flop
Seat 4: 4f2e237f folded before Flop (didn't bet)
Seat 5: 70054137 folded before Flop (didn't bet)
Seat 6: Hero folded before Flop (didn't bet)


Poker Hand #RC2078588013: Hold'em No Limit ($0.02/$0.05) - 2023/12/22 22:07:07
Table 'RushAndCash808115' 6-max Seat #1 is the button
Seat 1: fcc84b31 ($4.58 in chips)
Seat 2: 354c4fad ($6.01 in chips)
Seat 3: cf8a8e96 ($12.28 in chips)
Seat 4: 1b4a662e ($6.05 in chips)
Seat 5: 29045822 ($5.07 in chips)
Seat 6: Hero ($10.44 in chips)
354c4fad: posts small blind $0.02
cf8a8e96: posts big blind $0.05
*** HOLE CARDS ***
Dealt to fcc84b31 
Dealt to 354c4fad 
Dealt to cf8a8e96 
Dealt to 1b4a662e 
Dealt to 29045822 
Dealt to Hero [2d 3d]
1b4a662e: raises $0.06 to $0.11
29045822: folds
Hero: folds
fcc84b31: folds
354c4fad: folds
cf8a8e96: folds
Uncalled bet ($0.06) returned to 1b4a662e
*** SHOWDOWN ***
1b4a662e collected $0.12 from pot
*** SUMMARY ***
Total pot $0.12 | Rake $0 | Jackpot $0 | Bingo $0 | Fortune $0 | Tax $0
Seat 1: fcc84b31 (button) folded before Flop (didn't bet)
Seat 2: 354c4fad (small blind) folded before Flop
Seat 3: cf8a8e96 (big blind) folded before Flop
Seat 4: 1b4a662e collected ($0.12)
Seat 5: 29045822 folded before Flop (didn't bet)
Seat 6: Hero folded before Flop (didn't bet)


Poker Hand #RC2078587936: Hold'em No Limit ($0.02/$0.05) - 2023/12/22 22:07:02
Table 'RushAndCash808082' 6-max Seat #1 is the button
Seat 1: Hero ($10.44 in chips)
Seat 2: 317ccf77 ($4.22 in chips)
Seat 3: 354c4fad ($6.06 in chips)
Seat 4: 2e699c3b ($5.49 in chips)
Seat 5: ea71423 ($6.03 in chips)
Seat 6: a420712c ($9.79 in chips)
317ccf77: posts small blind $0.02
354c4fad: posts big blind $0.05
*** HOLE CARDS ***
Dealt to Hero [3s Td]
Dealt to 317ccf77 
Dealt to 354c4fad 
Dealt to 2e699c3b 
Dealt to ea71423 
Dealt to a420712c 
2e699c3b: folds
ea71423: folds
a420712c: raises $0.08 to $0.13
Hero: folds
317ccf77: raises $0.24 to $0.37
354c4fad: folds
a420712c: calls $0.24
*** FLOP *** [9h 7d 6h]
317ccf77: bets $0.4
a420712c: folds
Uncalled bet ($0.4) returned to 317ccf77
*** SHOWDOWN ***
317ccf77 collected $0.75 from pot
*** SUMMARY ***
Total pot $0.79 | Rake $0.04 | Jackpot $0 | Bingo $0 | Fortune $0 | Tax $0
Board [9h 7d 6h]
Seat 1: Hero (button) folded before Flop (didn't bet)
Seat 2: 317ccf77 (small blind) won ($0.75)
Seat 3: 354c4fad (big blind) folded before Flop
Seat 4: 2e699c3b folded before Flop (didn't bet)
Seat 5: ea71423 folded before Flop (didn't bet)
Seat 6: a420712c folded on the Flop


Poker Hand #RC2078587323: Hold'em No Limit ($0.02/$0.05) - 2023/12/22 22:06:28
Table 'RushAndCash807803' 6-max Seat #1 is the button
Seat 1: 7c2eba4e ($14.97 in chips)
Seat 2: ea71423 ($5.89 in chips)
Seat 3: Hero ($10.59 in chips)
Seat 4: 57896c91 ($9.74 in chips)
Seat 5: cbfe1acc ($5.13 in chips)
Seat 6: 2f4c4e21 ($5.07 in chips)
ea71423: posts small blind $0.02
Hero: posts big blind $0.05
*** HOLE CARDS ***
Dealt to 7c2eba4e 
Dealt to ea71423 
Dealt to Hero [3h Ks]
Dealt to 57896c91 
Dealt to cbfe1acc 
Dealt to 2f4c4e21 
57896c91: folds
cbfe1acc: folds
2f4c4e21: folds
7c2eba4e: folds
ea71423: raises $0.1 to $0.15
Hero: calls $0.1
*** FLOP *** [4c 7s Qc]
ea71423: checks
Hero: checks
*** TURN *** [4c 7s Qc] [8d]
ea71423: bets $0.1
Hero: folds
Uncalled bet ($0.1) returned to ea71423
*** SHOWDOWN ***
ea71423 collected $0.29 from pot
*** SUMMARY ***
Total pot $0.3 | Rake $0.01 | Jackpot $0 | Bingo $0 | Fortune $0 | Tax $0
Board [4c 7s Qc 8d]
Seat 1: 7c2eba4e (button) folded before Flop (didn't bet)
Seat 2: ea71423 (small blind) won ($0.29)
Seat 3: Hero (big blind) folded on the Turn
Seat 4: 57896c91 folded before Flop (didn't bet)
Seat 5: cbfe1acc folded before Flop (didn't bet)
Seat 6: 2f4c4e21 folded before Flop (didn't bet)


Poker Hand #RC2078587238: Hold'em No Limit ($0.02/$0.05) - 2023/12/22 22:06:23
Table 'RushAndCash807762' 6-max Seat #1 is the button
Seat 1: 29045822 ($5 in chips)
Seat 2: ede500fa ($5 in chips)
Seat 3: 22b6f6c6 ($5.45 in chips)
Seat 4: 9a9a6ce2 ($5 in chips)
Seat 5: Hero ($10.59 in chips)
Seat 6: a8629ffc ($1.75 in chips)
ede500fa: posts small blind $0.02
22b6f6c6: posts big blind $0.05
*** HOLE CARDS ***
Dealt to 29045822 
Dealt to ede500fa 
Dealt to 22b6f6c6 
Dealt to 9a9a6ce2 
Dealt to Hero [Js 9c]
Dealt to a8629ffc 
9a9a6ce2: folds
Hero: folds
a8629ffc: raises $0.08 to $0.13
29045822: folds
ede500fa: folds
22b6f6c6: raises $0.22 to $0.35
a8629ffc: calls $0.22
*** FLOP *** [2h 2c 3d]
22b6f6c6: bets $0.54
a8629ffc: raises $0.86 to $1.4 and is all-in
22b6f6c6: calls $0.86
a8629ffc: shows [Tc Ac] (Pair of Twos)
22b6f6c6: shows [Kd Kc] (Pair of Kings and Pair of Twos)
*** TURN *** [2h 2c 3d] [2s]
*** RIVER *** [2h 2c 3d 2s] [6s]
*** SHOWDOWN ***
22b6f6c6 collected $3.3 from pot
*** SUMMARY ***
Total pot $3.52 | Rake $0.15 | Jackpot $0.07 | Bingo $0 | Fortune $0 | Tax $0
Board [2h 2c 3d 2s 6s]
Seat 1: 29045822 (button) folded before Flop (didn't bet)
Seat 2: ede500fa (small blind) folded before Flop
Seat 3: 22b6f6c6 (big blind) showed [Kd Kc] and won ($3.3) with Twos Full over Kings
Seat 4: 9a9a6ce2 folded before Flop (didn't bet)
Seat 5: Hero folded before Flop (didn't bet)
Seat 6: a8629ffc showed [Tc Ac] and lost with Three Twos


Poker Hand #RC2078587161: Hold'em No Limit ($0.02/$0.05) - 2023/12/22 22:06:19
Table 'RushAndCash807728' 6-max Seat #1 is the button
Seat 1: 9a9a6ce2 ($5 in chips)
Seat 2: 1d0d69cf ($5.07 in chips)
Seat 3: 1d497d4f ($5.09 in chips)
Seat 4: 9220db62 ($6.08 in chips)
Seat 5: cd02a153 ($6.39 in chips)
Seat 6: Hero ($10.59 in chips)
1d0d69cf: posts small blind $0.02
1d497d4f: posts big blind $0.05
*** HOLE CARDS ***
Dealt to 9a9a6ce2 
Dealt to 1d0d69cf 
Dealt to 1d497d4f 
Dealt to 9220db62 
Dealt to cd02a153 
Dealt to Hero [4h Qd]
9220db62: folds
cd02a153: folds
Hero: folds
9a9a6ce2: folds
1d0d69cf: folds
Uncalled bet ($0.03) returned to 1d497d4f
*** SHOWDOWN ***
1d497d4f collected $0.04 from pot
*** SUMMARY ***
Total pot $0.04 | Rake $0 | Jackpot $0 | Bingo $0 | Fortune $0 | Tax $0
Seat 1: 9a9a6ce2 (button) folded before Flop (didn't bet)
Seat 2: 1d0d69cf (small blind) folded before Flop
Seat 3: 1d497d4f (big blind) collected ($0.04)
Seat 4: 9220db62 folded before Flop (didn't bet)
Seat 5: cd02a153 folded before Flop (didn't bet)
Seat 6: Hero folded before Flop (didn't bet)


Poker Hand #RC2078586946: Hold'em No Limit ($0.02/$0.05) - 2023/12/22 22:06:06
Table 'RushAndCash807625' 6-max Seat #1 is the button
Seat 1: aae3e1cd ($5.85 in chips)
Seat 2: Hero ($10.61 in chips)
Seat 3: e49e39a2 ($12.22 in chips)
Seat 4: e8e3d92 ($5.23 in chips)
Seat 5: 22b6f6c6 ($5.45 in chips)
Seat 6: 21a497ff ($5.05 in chips)
Hero: posts small blind $0.02
e49e39a2: posts big blind $0.05
*** HOLE CARDS ***
Dealt to aae3e1cd 
Dealt to Hero [Qh 6h]
Dealt to e49e39a2 
Dealt to e8e3d92 
Dealt to 22b6f6c6 
Dealt to 21a497ff 
e8e3d92: raises $0.08 to $0.13
22b6f6c6: folds
21a497ff: folds
aae3e1cd: folds
Hero: folds
e49e39a2: folds
Uncalled bet ($0.08) returned to e8e3d92
*** SHOWDOWN ***
e8e3d92 collected $0.12 from pot
*** SUMMARY ***
Total pot $0.12 | Rake $0 | Jackpot $0 | Bingo $0 | Fortune $0 | Tax $0
Seat 1: aae3e1cd (button) folded before Flop (didn't bet)
Seat 2: Hero (small blind) folded before Flop
Seat 3: e49e39a2 (big blind) folded before Flop
Seat 4: e8e3d92 collected ($0.12)
Seat 5: 22b6f6c6 folded before Flop (didn't bet)
Seat 6: 21a497ff folded before Flop (didn't bet)


Poker Hand #RC2078586854: Hold'em No Limit ($0.02/$0.05) - 2023/12/22 22:06:01
Table 'RushAndCash807581' 6-max Seat #1 is the button
Seat 1: 1d0d69cf ($5.09 in chips)
Seat 2: 190cd877 ($5.61 in chips)
Seat 3: 4df77985 ($6.07 in chips)
Seat 4: eb4aaed4 ($5.48 in chips)
Seat 5: 1e3d103d ($8.09 in chips)
Seat 6: Hero ($10.61 in chips)
190cd877: posts small blind $0.02
4df77985: posts big blind $0.05
*** HOLE CARDS ***
Dealt to 1d0d69cf 
Dealt to 190cd877 
Dealt to 4df77985 
Dealt to eb4aaed4 
Dealt to 1e3d103d 
Dealt to Hero [Qd 3s]
eb4aaed4: folds
1e3d103d: folds
Hero: folds
1d0d69cf: folds
190cd877: raises $0.1 to $0.15
4df77985: folds
Uncalled bet ($0.1) returned to 190cd877
*** SHOWDOWN ***
190cd877 collected $0.1 from pot
*** SUMMARY ***
Total pot $0.1 | Rake $0 | Jackpot $0 | Bingo $0 | Fortune $0 | Tax $0
Seat 1: 1d0d69cf (button) folded before Flop (didn't bet)
Seat 2: 190cd877 (small blind) collected ($0.1)
Seat 3: 4df77985 (big blind) folded before Flop
Seat 4: eb4aaed4 folded before Flop (didn't bet)
Seat 5: 1e3d103d folded before Flop (didn't bet)
Seat 6: Hero folded before Flop (didn't bet)


Poker Hand #RC2078586550: Hold'em No Limit ($0.02/$0.05) - 2023/12/22 22:05:44
Table 'RushAndCash807435' 6-max Seat #1 is the button
Seat 1: b8432f9c ($4.76 in chips)
Seat 2: 98347374 ($16.68 in chips)
Seat 3: Hero ($10.66 in chips)
Seat 4: c2881b52 ($9.21 in chips)
Seat 5: c7d7813b ($5.07 in chips)
Seat 6: e4111047 ($5.27 in chips)
98347374: posts small blind $0.02
Hero: posts big blind $0.05
*** HOLE CARDS ***
Dealt to b8432f9c 
Dealt to 98347374 
Dealt to Hero [Ah 4c]
Dealt to c2881b52 
Dealt to c7d7813b 
Dealt to e4111047 
c2881b52: folds
c7d7813b: raises $0.05 to $0.1
e4111047: folds
b8432f9c: folds
98347374: folds
Hero: folds
Uncalled bet ($0.05) returned to c7d7813b
*** SHOWDOWN ***
c7d7813b collected $0.12 from pot
*** SUMMARY ***
Total pot $0.12 | Rake $0 | Jackpot $0 | Bingo $0 | Fortune $0 | Tax $0
Seat 1: b8432f9c (button) folded before Flop (didn't bet)
Seat 2: 98347374 (small blind) folded before Flop
Seat 3: Hero (big blind) folded before Flop
Seat 4: c2881b52 folded before Flop (didn't bet)
Seat 5: c7d7813b collected ($0.12)
Seat 6: e4111047 folded before Flop (didn't bet)


Poker Hand #RC2078586173: Hold'em No Limit ($0.02/$0.05) - 2023/12/22 22:05:21
Table 'RushAndCash807266' 6-max Seat #1 is the button
Seat 1: Hero ($10.79 in chips)
Seat 2: 6c75362e ($11.86 in chips)
Seat 3: a3f6014b ($9.5 in chips)
Seat 4: b4aaf9de ($12.09 in chips)
Seat 5: 45bb3f0f ($5.03 in chips)
Seat 6: 2643d6fa ($5.2 in chips)
6c75362e: posts small blind $0.02
a3f6014b: posts big blind $0.05
*** HOLE CARDS ***
Dealt to Hero [Td Ks]
Dealt to 6c75362e 
Dealt to a3f6014b 
Dealt to b4aaf9de 
Dealt to 45bb3f0f 
Dealt to 2643d6fa 
b4aaf9de: folds
45bb3f0f: folds
2643d6fa: folds
Hero: raises $0.08 to $0.13
6c75362e: folds
a3f6014b: raises $0.28 to $0.41
Hero: folds
Uncalled bet ($0.28) returned to a3f6014b
*** SHOWDOWN ***
a3f6014b collected $0.27 from pot
*** SUMMARY ***
Total pot $0.28 | Rake $0.01 | Jackpot $0 | Bingo $0 | Fortune $0 | Tax $0
Seat 1: Hero (button) folded before Flop
Seat 2: 6c75362e (small blind) folded before Flop
Seat 3: a3f6014b (big blind) collected ($0.27)
Seat 4: b4aaf9de folded before Flop (didn't bet)
Seat 5: 45bb3f0f folded before Flop (didn't bet)
Seat 6: 2643d6fa folded before Flop (didn't bet)


Poker Hand #RC2078585719: Hold'em No Limit ($0.02/$0.05) - 2023/12/22 22:04:53
Table 'RushAndCash807056' 6-max Seat #1 is the button
Seat 1: 3933d58 ($5.26 in chips)
Seat 2: Hero ($10.74 in chips)
Seat 3: 4eec4948 ($2 in chips)
Seat 4: 4069ada7 ($5.38 in chips)
Seat 5: 129846c0 ($7.03 in chips)
Seat 6: c883264a ($9.38 in chips)
Hero: posts small blind $0.02
4eec4948: posts big blind $0.05
*** HOLE CARDS ***
Dealt to 3933d58 
Dealt to Hero [Ah 3d]
Dealt to 4eec4948 
Dealt to 4069ada7 
Dealt to 129846c0 
Dealt to c883264a 
4069ada7: folds
129846c0: folds
c883264a: folds
3933d58: folds
Hero: raises $0.1 to $0.15
4eec4948: folds
Uncalled bet ($0.1) returned to Hero
*** SHOWDOWN ***
Hero collected $0.1 from pot
*** SUMMARY ***
Total pot $0.1 | Rake $0 | Jackpot $0 | Bingo $0 | Fortune $0 | Tax $0
Seat 1: 3933d58 (button) folded before Flop (didn't bet)
Seat 2: Hero (small blind) collected ($0.1)
Seat 3: 4eec4948 (big blind) folded before Flop
Seat 4: 4069ada7 folded before Flop (didn't bet)
Seat 5: 129846c0 folded before Flop (didn't bet)
Seat 6: c883264a folded before Flop (didn't bet)


Poker Hand #RC2078585638: Hold'em No Limit ($0.02/$0.05) - 2023/12/22 22:04:48
Table 'RushAndCash807020' 6-max Seat #1 is the button
Seat 1: a20c0bea ($6.67 in chips)
Seat 2: 153b1345 ($6.9 in chips)
Seat 3: 2bd4532c ($3.93 in chips)
Seat 4: b5577ea2 ($4.64 in chips)
Seat 5: Hero ($10.74 in chips)
Seat 6: 20ec78d4 ($5.42 in chips)
153b1345: posts small blind $0.02
2bd4532c: posts big blind $0.05
*** HOLE CARDS ***
Dealt to a20c0bea 
Dealt to 153b1345 
Dealt to 2bd4532c 
Dealt to b5577ea2 
Dealt to Hero [5h 2d]
Dealt to 20ec78d4 
b5577ea2: folds
Hero: folds
20ec78d4: folds
a20c0bea: raises $0.08 to $0.13
153b1345: folds
2bd4532c: folds
Uncalled bet ($0.08) returned to a20c0bea
*** SHOWDOWN ***
a20c0bea collected $0.12 from pot
*** SUMMARY ***
Total pot $0.12 | Rake $0 | Jackpot $0 | Bingo $0 | Fortune $0 | Tax $0
Seat 1: a20c0bea (button) collected ($0.12)
Seat 2: 153b1345 (small blind) folded before Flop
Seat 3: 2bd4532c (big blind) folded before Flop
Seat 4: b5577ea2 folded before Flop (didn't bet)
Seat 5: Hero folded before Flop (didn't bet)
Seat 6: 20ec78d4 folded before Flop (didn't bet)


Poker Hand #RC2078585406: Hold'em No Limit ($0.02/$0.05) - 2023/12/22 22:04:35
Table 'RushAndCash806909' 6-max Seat #1 is the button
Seat 1: 73f9c9d7 ($5 in chips)
Seat 2: a64d864a ($5.21 in chips)
Seat 3: d14ab6dc ($5 in chips)
Seat 4: Hero ($10.67 in chips)
Seat 5: 1f3b352 ($4.95 in chips)
Seat 6: d0f6c873 ($5 in chips)
a64d864a: posts small blind $0.02
d14ab6dc: posts big blind $0.05
*** HOLE CARDS ***
Dealt to 73f9c9d7 
Dealt to a64d864a 
Dealt to d14ab6dc 
Dealt to Hero [Kc Qc]
Dealt to 1f3b352 
Dealt to d0f6c873 
Hero: raises $0.05 to $0.1
1f3b352: folds
d0f6c873: folds
73f9c9d7: folds
a64d864a: folds
d14ab6dc: folds
Uncalled bet ($0.05) returned to Hero
*** SHOWDOWN ***
Hero collected $0.12 from pot
*** SUMMARY ***
Total pot $0.12 | Rake $0 | Jackpot $0 | Bingo $0 | Fortune $0 | Tax $0
Seat 1: 73f9c9d7 (button) folded before Flop (didn't bet)
Seat 2: a64d864a (small blind) folded before Flop
Seat 3: d14ab6dc (big blind) folded before Flop
Seat 4: Hero collected ($0.12)
Seat 5: 1f3b352 folded before Flop (didn't bet)
Seat 6: d0f6c873 folded before Flop (didn't bet)


Poker Hand #RC2078585341: Hold'em No Limit ($0.02/$0.05) - 2023/12/22 22:04:31
Table 'RushAndCash806879' 6-max Seat #1 is the button
Seat 1: Hero ($10.67 in chips)
Seat 2: a420712c ($10.61 in chips)
Seat 3: 404f9df4 ($6.05 in chips)
Seat 4: 6ded132b ($16.53 in chips)
Seat 5: 2665e6a9 ($5.05 in chips)
Seat 6: 28846e83 ($5.71 in chips)
a420712c: posts small blind $0.02
404f9df4: posts big blind $0.05
*** HOLE CARDS ***
Dealt to Hero [9h 6c]
Dealt to a420712c 
Dealt to 404f9df4 
Dealt to 6ded132b 
Dealt to 2665e6a9 
Dealt to 28846e83 
6ded132b: folds
2665e6a9: folds
28846e83: raises $0.08 to $0.13
Hero: folds
a420712c: folds
404f9df4: folds
Uncalled bet ($0.08) returned to 28846e83
*** SHOWDOWN ***
28846e83 collected $0.12 from pot
*** SUMMARY ***
Total pot $0.12 | Rake $0 | Jackpot $0 | Bingo $0 | Fortune $0 | Tax $0
Seat 1: Hero (button) folded before Flop (didn't bet)
Seat 2: a420712c (small blind) folded before Flop
Seat 3: 404f9df4 (big blind) folded before Flop
Seat 4: 6ded132b folded before Flop (didn't bet)
Seat 5: 2665e6a9 folded before Flop (didn't bet)
Seat 6: 28846e83 collected ($0.12)


Poker Hand #RC2078585277: Hold'em No Limit ($0.02/$0.05) - 2023/12/22 22:04:28
Table 'RushAndCash806850' 6-max Seat #1 is the button
Seat 1: 88e57a08 ($15.59 in chips)
Seat 2: 8626eae9 ($5 in chips)
Seat 3: b75c858f ($5 in chips)
Seat 4: Hero ($10.67 in chips)
Seat 5: d01e69bc ($3.93 in chips)
Seat 6: 47ffe1d8 ($4.92 in chips)
8626eae9: posts small blind $0.02
b75c858f: posts big blind $0.05
*** HOLE CARDS ***
Dealt to 88e57a08 
Dealt to 8626eae9 
Dealt to b75c858f 
Dealt to Hero [Kd Ts]
Dealt to d01e69bc 
Dealt to 47ffe1d8 
Hero: folds
d01e69bc: folds
47ffe1d8: folds
88e57a08: folds
8626eae9: raises $0.08 to $0.13
b75c858f: calls $0.08
*** FLOP *** [Ac 3d 4h]
8626eae9: bets $0.13
b75c858f: folds
Uncalled bet ($0.13) returned to 8626eae9
*** SHOWDOWN ***
8626eae9 collected $0.25 from pot
*** SUMMARY ***
Total pot $0.26 | Rake $0.01 | Jackpot $0 | Bingo $0 | Fortune $0 | Tax $0
Board [Ac 3d 4h]
Seat 1: 88e57a08 (button) folded before Flop (didn't bet)
Seat 2: 8626eae9 (small blind) won ($0.25)
Seat 3: b75c858f (big blind) folded on the Flop
Seat 4: Hero folded before Flop (didn't bet)
Seat 5: d01e69bc folded before Flop (didn't bet)
Seat 6: 47ffe1d8 folded before Flop (didn't bet)


Poker Hand #RC2078585085: Hold'em No Limit ($0.02/$0.05) - 2023/12/22 22:04:17
Table 'RushAndCash806762' 6-max Seat #1 is the button
Seat 1: 58782f5b ($5.54 in chips)
Seat 2: Hero ($10.62 in chips)
Seat 3: 3b322324 ($5.8 in chips)
Seat 4: 78333bbd ($5.17 in chips)
Seat 5: 30a2950b ($5.3 in chips)
Seat 6: b8a497b1 ($4.64 in chips)
Hero: posts small blind $0.02
3b322324: posts big blind $0.05
*** HOLE CARDS ***
Dealt to 58782f5b 
Dealt to Hero [Jc 3c]
Dealt to 3b322324 
Dealt to 78333bbd 
Dealt to 30a2950b 
Dealt to b8a497b1 
78333bbd: folds
30a2950b: folds
b8a497b1: folds
58782f5b: folds
Hero: raises $0.1 to $0.15
3b322324: folds
Uncalled bet ($0.1) returned to Hero
*** SHOWDOWN ***
Hero collected $0.1 from pot
*** SUMMARY ***
Total pot $0.1 | Rake $0 | Jackpot $0 | Bingo $0 | Fortune $0 | Tax $0
Seat 1: 58782f5b (button) folded before Flop (didn't bet)
Seat 2: Hero (small blind) collected ($0.1)
Seat 3: 3b322324 (big blind) folded before Flop
Seat 4: 78333bbd folded before Flop (didn't bet)
Seat 5: 30a2950b folded before Flop (didn't bet)
Seat 6: b8a497b1 folded before Flop (didn't bet)


Poker Hand #RC2078584762: Hold'em No Limit ($0.02/$0.05) - 2023/12/22 22:03:58
Table 'RushAndCash806616' 6-max Seat #1 is the button
Seat 1: 153d5b53 ($6.13 in chips)
Seat 2: Hero ($10.57 in chips)
Seat 3: d6c4e270 ($3.36 in chips)
Seat 4: b0755516 ($5 in chips)
Seat 5: 6c75362e ($11.86 in chips)
Seat 6: 8d188907 ($5.26 in chips)
Hero: posts small blind $0.02
d6c4e270: posts big blind $0.05
*** HOLE CARDS ***
Dealt to 153d5b53 
Dealt to Hero [As Kd]
Dealt to d6c4e270 
Dealt to b0755516 
Dealt to 6c75362e 
Dealt to 8d188907 
b0755516: folds
6c75362e: folds
8d188907: folds
153d5b53: folds
Hero: raises $0.1 to $0.15
d6c4e270: folds
Uncalled bet ($0.1) returned to Hero
*** SHOWDOWN ***
Hero collected $0.1 from pot
*** SUMMARY ***
Total pot $0.1 | Rake $0 | Jackpot $0 | Bingo $0 | Fortune $0 | Tax $0
Seat 1: 153d5b53 (button) folded before Flop (didn't bet)
Seat 2: Hero (small blind) collected ($0.1)
Seat 3: d6c4e270 (big blind) folded before Flop
Seat 4: b0755516 folded before Flop (didn't bet)
Seat 5: 6c75362e folded before Flop (didn't bet)
Seat 6: 8d188907 folded before Flop (didn't bet)


Poker Hand #RC2078584701: Hold'em No Limit ($0.02/$0.05) - 2023/12/22 22:03:55
Table 'RushAndCash806588' 6-max Seat #1 is the button
Seat 1: Hero ($10.57 in chips)
Seat 2: 8d94440d ($5 in chips)
Seat 3: 5761cd5e ($5.35 in chips)
Seat 4: bd6855dc ($6.19 in chips)
Seat 5: 4c0d7324 ($6.48 in chips)
Seat 6: 8f80311 ($7.98 in chips)
8d94440d: posts small blind $0.02
5761cd5e: posts big blind $0.05
*** HOLE CARDS ***
Dealt to Hero [As 7c]
Dealt to 8d94440d 
Dealt to 5761cd5e 
Dealt to bd6855dc 
Dealt to 4c0d7324 
Dealt to 8f80311 
bd6855dc: folds
4c0d7324: folds
8f80311: folds
Hero: folds
8d94440d: raises $0.07 to $0.12
5761cd5e: folds
Uncalled bet ($0.07) returned to 8d94440d
*** SHOWDOWN ***
8d94440d collected $0.1 from pot
*** SUMMARY ***
Total pot $0.1 | Rake $0 | Jackpot $0 | Bingo $0 | Fortune $0 | Tax $0
Seat 1: Hero (button) folded before Flop (didn't bet)
Seat 2: 8d94440d (small blind) collected ($0.1)
Seat 3: 5761cd5e (big blind) folded before Flop
Seat 4: bd6855dc folded before Flop (didn't bet)
Seat 5: 4c0d7324 folded before Flop (didn't bet)
Seat 6: 8f80311 folded before Flop (didn't bet)


Poker Hand #RC2078584645: Hold'em No Limit ($0.02/$0.05) - 2023/12/22 22:03:51
Table 'RushAndCash806563' 6-max Seat #1 is the button
Seat 1: 4f2e237f ($5 in chips)
Seat 2: bd6855dc ($6.21 in chips)
Seat 3: 46892673 ($5.93 in chips)
Seat 4: 8d94440d ($5 in chips)
Seat 5: Hero ($10.57 in chips)
Seat 6: f06064a0 ($5.88 in chips)
bd6855dc: posts small blind $0.02
46892673: posts big blind $0.05
*** HOLE CARDS ***
Dealt to 4f2e237f 
Dealt to bd6855dc 
Dealt to 46892673 
Dealt to 8d94440d 
Dealt to Hero [7h 3s]
Dealt to f06064a0 
8d94440d: folds
Hero: folds
f06064a0: folds
4f2e237f: folds
bd6855dc: folds
Uncalled bet ($0.03) returned to 46892673
*** SHOWDOWN ***
46892673 collected $0.04 from pot
*** SUMMARY ***
Total pot $0.04 | Rake $0 | Jackpot $0 | Bingo $0 | Fortune $0 | Tax $0
Seat 1: 4f2e237f (button) folded before Flop (didn't bet)
Seat 2: bd6855dc (small blind) folded before Flop
Seat 3: 46892673 (big blind) collected ($0.04)
Seat 4: 8d94440d folded before Flop (didn't bet)
Seat 5: Hero folded before Flop (didn't bet)
Seat 6: f06064a0 folded before Flop (didn't bet)


Poker Hand #RC2078584585: Hold'em No Limit ($0.02/$0.05) - 2023/12/22 22:03:48
Table 'RushAndCash806536' 6-max Seat #1 is the button
Seat 1: 2f7f1fcd ($5.23 in chips)
Seat 2: f340b2b ($5.84 in chips)
Seat 3: c3adc948 ($16.98 in chips)
Seat 4: c8ce633e ($7.15 in chips)
Seat 5: 8d94440d ($5 in chips)
Seat 6: Hero ($10.57 in chips)
f340b2b: posts small blind $0.02
c3adc948: posts big blind $0.05
*** HOLE CARDS ***
Dealt to 2f7f1fcd 
Dealt to f340b2b 
Dealt to c3adc948 
Dealt to c8ce633e 
Dealt to 8d94440d 
Dealt to Hero [7s Ad]
c8ce633e: folds
8d94440d: folds
Hero: folds
2f7f1fcd: raises $0.07 to $0.12
f340b2b: folds
c3adc948: folds
Uncalled bet ($0.07) returned to 2f7f1fcd
*** SHOWDOWN ***
2f7f1fcd collected $0.12 from pot
*** SUMMARY ***
Total pot $0.12 | Rake $0 | Jackpot $0 | Bingo $0 | Fortune $0 | Tax $0
Seat 1: 2f7f1fcd (button) collected ($0.12)
Seat 2: f340b2b (small blind) folded before Flop
Seat 3: c3adc948 (big blind) folded before Flop
Seat 4: c8ce633e folded before Flop (didn't bet)
Seat 5: 8d94440d folded before Flop (didn't bet)
Seat 6: Hero folded before Flop (didn't bet)


Poker Hand #RC2078584046: Hold'em No Limit ($0.02/$0.05) - 2023/12/22 22:03:14
Table 'RushAndCash806288' 6-max Seat #1 is the button
Seat 1: c8ce633e ($7.25 in chips)
Seat 2: 130f7150 ($8.5 in chips)
Seat 3: Hero ($10.46 in chips)
Seat 4: ab8d3eb5 ($6.19 in chips)
Seat 5: d63b428e ($7.98 in chips)
Seat 6: c8aa0ffb ($3.92 in chips)
130f7150: posts small blind $0.02
Hero: posts big blind $0.05
*** HOLE CARDS ***
Dealt to c8ce633e 
Dealt to 130f7150 
Dealt to Hero [Ks Jh]
Dealt to ab8d3eb5 
Dealt to d63b428e 
Dealt to c8aa0ffb 
ab8d3eb5: folds
d63b428e: folds
c8aa0ffb: folds
c8ce633e: raises $0.05 to $0.1
130f7150: folds
Hero: calls $0.05
*** FLOP *** [8s 7s 9c]
Hero: checks
c8ce633e: checks
*** TURN *** [8s 7s 9c] [Tc]
Hero: bets $0.11
c8ce633e: folds
Uncalled bet ($0.11) returned to Hero
*** SHOWDOWN ***
Hero collected $0.21 from pot
*** SUMMARY ***
Total pot $0.22 | Rake $0.01 | Jackpot $0 | Bingo $0 | Fortune $0 | Tax $0
Board [8s 7s 9c Tc]
Seat 1: c8ce633e (button) folded on the Turn
Seat 2: 130f7150 (small blind) folded before Flop
Seat 3: Hero (big blind) won ($0.21)
Seat 4: ab8d3eb5 folded before Flop (didn't bet)
Seat 5: d63b428e folded before Flop (didn't bet)
Seat 6: c8aa0ffb folded before Flop (didn't bet)


Poker Hand #RC2078582989: Hold'em No Limit ($0.02/$0.05) - 2023/12/22 22:02:15
Table 'RushAndCash805782' 6-max Seat #1 is the button
Seat 1: bcaa3feb ($5.82 in chips)
Seat 2: 2075befd ($11.48 in chips)
Seat 3: Hero ($11.29 in chips)
Seat 4: 3d292096 ($8.71 in chips)
Seat 5: 3288926 ($15.21 in chips)
Seat 6: 90511c4f ($5.02 in chips)
2075befd: posts small blind $0.02
Hero: posts big blind $0.05
*** HOLE CARDS ***
Dealt to bcaa3feb 
Dealt to 2075befd 
Dealt to Hero [Qs As]
Dealt to 3d292096 
Dealt to 3288926 
Dealt to 90511c4f 
3d292096: folds
3288926: folds
90511c4f: folds
bcaa3feb: folds
2075befd: raises $0.1 to $0.15
Hero: raises $0.35 to $0.5
2075befd: calls $0.35
*** FLOP *** [Ts 2h Jd]
2075befd: checks
Hero: bets $0.33
2075befd: raises $1 to $1.33
Hero: folds
Uncalled bet ($1) returned to 2075befd
*** SHOWDOWN ***
2075befd collected $1.51 from pot
*** SUMMARY ***
Total pot $1.66 | Rake $0.08 | Jackpot $0.07 | Bingo $0 | Fortune $0 | Tax $0
Board [Ts 2h Jd]
Seat 1: bcaa3feb (button) folded before Flop (didn't bet)
Seat 2: 2075befd (small blind) won ($1.51)
Seat 3: Hero (big blind) folded on the Flop
Seat 4: 3d292096 folded before Flop (didn't bet)
Seat 5: 3288926 folded before Flop (didn't bet)
Seat 6: 90511c4f folded before Flop (didn't bet)


Poker Hand #RC2078582934: Hold'em No Limit ($0.02/$0.05) - 2023/12/22 22:02:11
Table 'RushAndCash805757' 6-max Seat #1 is the button
Seat 1: 83815da3 ($5.03 in chips)
Seat 2: 4cd2ab9f ($5 in chips)
Seat 3: c7ed8123 ($2 in chips)
Seat 4: ee19881a ($5 in chips)
Seat 5: Hero ($11.29 in chips)
Seat 6: c8389234 ($15.23 in chips)
4cd2ab9f: posts small blind $0.02
c7ed8123: posts big blind $0.05
*** HOLE CARDS ***
Dealt to 83815da3 
Dealt to 4cd2ab9f 
Dealt to c7ed8123 
Dealt to ee19881a 
Dealt to Hero [7s 4d]
Dealt to c8389234 
ee19881a: folds
Hero: folds
c8389234: folds
83815da3: folds
4cd2ab9f: folds
Uncalled bet ($0.03) returned to c7ed8123
*** SHOWDOWN ***
c7ed8123 collected $0.04 from pot
*** SUMMARY ***
Total pot $0.04 | Rake $0 | Jackpot $0 | Bingo $0 | Fortune $0 | Tax $0
Seat 1: 83815da3 (button) folded before Flop (didn't bet)
Seat 2: 4cd2ab9f (small blind) folded before Flop
Seat 3: c7ed8123 (big blind) collected ($0.04)
Seat 4: ee19881a folded before Flop (didn't bet)
Seat 5: Hero folded before Flop (didn't bet)
Seat 6: c8389234 folded before Flop (didn't bet)


Poker Hand #RC2078582880: Hold'em No Limit ($0.02/$0.05) - 2023/12/22 22:02:08
Table 'RushAndCash805734' 6-max Seat #1 is the button
Seat 1: f1ad1775 ($4.88 in chips)
Seat 2: 49f9d1df ($7.29 in chips)
Seat 3: 3c14ea5f ($5.31 in chips)
Seat 4: 4cd2ab9f ($5 in chips)
Seat 5: 86f62bb0 ($10.28 in chips)
Seat 6: Hero ($11.29 in chips)
49f9d1df: posts small blind $0.02
3c14ea5f: posts big blind $0.05
*** HOLE CARDS ***
Dealt to f1ad1775 
Dealt to 49f9d1df 
Dealt to 3c14ea5f 
Dealt to 4cd2ab9f 
Dealt to 86f62bb0 
Dealt to Hero [9c Td]
4cd2ab9f: folds
86f62bb0: folds
Hero: folds
f1ad1775: folds
49f9d1df: raises $0.1 to $0.15
3c14ea5f: calls $0.1
*** FLOP *** [Kc 3s 7d]
49f9d1df: bets $0.1
3c14ea5f: calls $0.1
*** TURN *** [Kc 3s 7d] [As]
49f9d1df: checks
3c14ea5f: checks
*** RIVER *** [Kc 3s 7d As] [5c]
49f9d1df: checks
3c14ea5f: checks
49f9d1df: shows [Kh Jh] (Pair of Kings)
3c14ea5f: shows [4c 4d] (Pair of Fours)
*** SHOWDOWN ***
49f9d1df collected $0.48 from pot
*** SUMMARY ***
Total pot $0.5 | Rake $0.02 | Jackpot $0 | Bingo $0 | Fortune $0 | Tax $0
Board [Kc 3s 7d As 5c]
Seat 1: f1ad1775 (button) folded before Flop (didn't bet)
Seat 2: 49f9d1df (small blind) showed [Kh Jh] and won ($0.48) with Pair of Kings
Seat 3: 3c14ea5f (big blind) showed [4c 4d] and lost with Pair of Fours
Seat 4: 4cd2ab9f folded before Flop (didn't bet)
Seat 5: 86f62bb0 folded before Flop (didn't bet)
Seat 6: Hero folded before Flop (didn't bet)


Poker Hand #RC2078582539: Hold'em No Limit ($0.02/$0.05) - 2023/12/22 22:01:48
Table 'RushAndCash805570' 6-max Seat #1 is the button
Seat 1: b8432f9c ($4.74 in chips)
Seat 2: faf15048 ($2.55 in chips)
Seat 3: c70a390e ($5 in chips)
Seat 4: Hero ($11.39 in chips)
Seat 5: d6c4e270 ($1.68 in chips)
Seat 6: 8aaa95a5 ($4.33 in chips)
faf15048: posts small blind $0.02
c70a390e: posts big blind $0.05
*** HOLE CARDS ***
Dealt to b8432f9c 
Dealt to faf15048 
Dealt to c70a390e 
Dealt to Hero [6d 6s]
Dealt to d6c4e270 
Dealt to 8aaa95a5 
Hero: raises $0.05 to $0.1
d6c4e270: calls $0.1
8aaa95a5: folds
b8432f9c: calls $0.1
faf15048: raises $0.45 to $0.55
c70a390e: folds
Hero: folds
d6c4e270: raises $0.45 to $1
b8432f9c: folds
faf15048: raises $1.55 to $2.55 and is all-in
d6c4e270: calls $0.68 and is all-in
Uncalled bet ($0.87) returned to faf15048
faf15048: shows [Js Jc]
d6c4e270: shows [Kd Kc]
*** FIRST FLOP *** [4s Ks 5s]
*** FIRST TURN *** [4s Ks 5s] [Kh]
*** FIRST RIVER *** [4s Ks 5s Kh] [Td]
*** SECOND FLOP *** [Qh 4h Th]
*** SECOND TURN *** [Qh 4h Th] [Ts]
*** SECOND RIVER *** [Qh 4h Th Ts] [9s]
*** FIRST SHOWDOWN ***
d6c4e270 collected $1.7 from pot
*** SECOND SHOWDOWN ***
d6c4e270 collected $1.7 from pot
*** SUMMARY ***
Total pot $3.61 | Rake $0.14 | Jackpot $0.07 | Bingo $0 | Fortune $0 | Tax $0
Hand was run two times
FIRST Board [4s Ks 5s Kh Td]
SECOND Board [Qh 4h Th Ts 9s]
Seat 1: b8432f9c (button) folded before Flop
Seat 2: faf15048 (small blind) showed [Js Jc] and lost with Pair of Kings and Pair of Jacks, and lost with Pair of Jacks and Pair of Tens
Seat 3: c70a390e (big blind) folded before Flop
Seat 4: Hero folded before Flop
Seat 5: d6c4e270 showed [Kd Kc] and won ($1.7) with Four Kings, and won ($1.7) with Pair of Kings and Pair of Tens
Seat 6: 8aaa95a5 folded before Flop (didn't bet)


Poker Hand #RC2078582339: Hold'em No Limit ($0.02/$0.05) - 2023/12/22 22:01:36
Table 'RushAndCash805483' 6-max Seat #1 is the button
Seat 1: ba0591c5 ($5.04 in chips)
Seat 2: Hero ($11.41 in chips)
Seat 3: 9601129f ($8.76 in chips)
Seat 4: f2927765 ($6.07 in chips)
Seat 5: 111c92ae ($7.88 in chips)
Seat 6: 89f19970 ($5.24 in chips)
Hero: posts small blind $0.02
9601129f: posts big blind $0.05
*** HOLE CARDS ***
Dealt to ba0591c5 
Dealt to Hero [Qd Th]
Dealt to 9601129f 
Dealt to f2927765 
Dealt to 111c92ae 
Dealt to 89f19970 
f2927765: folds
111c92ae: folds
89f19970: folds
ba0591c5: raises $0.08 to $0.13
Hero: folds
9601129f: folds
Uncalled bet ($0.08) returned to ba0591c5
*** SHOWDOWN ***
ba0591c5 collected $0.12 from pot
*** SUMMARY ***
Total pot $0.12 | Rake $0 | Jackpot $0 | Bingo $0 | Fortune $0 | Tax $0
Seat 1: ba0591c5 (button) collected ($0.12)
Seat 2: Hero (small blind) folded before Flop
Seat 3: 9601129f (big blind) folded before Flop
Seat 4: f2927765 folded before Flop (didn't bet)
Seat 5: 111c92ae folded before Flop (didn't bet)
Seat 6: 89f19970 folded before Flop (didn't bet)


Poker Hand #RC2078582161: Hold'em No Limit ($0.02/$0.05) - 2023/12/22 22:01:26
Table 'RushAndCash805404' 6-max Seat #1 is the button
Seat 1: 8c340ae9 ($5 in chips)
Seat 2: cd02a153 ($6.34 in chips)
Seat 3: Hero ($11.46 in chips)
Seat 4: 28218a38 ($4.5 in chips)
Seat 5: d2e52b8d ($33.81 in chips)
Seat 6: 2afe98d4 ($5.62 in chips)
cd02a153: posts small blind $0.02
Hero: posts big blind $0.05
*** HOLE CARDS ***
Dealt to 8c340ae9 
Dealt to cd02a153 
Dealt to Hero [4h 5s]
Dealt to 28218a38 
Dealt to d2e52b8d 
Dealt to 2afe98d4 
28218a38: folds
d2e52b8d: folds
2afe98d4: folds
8c340ae9: raises $0.1 to $0.15
cd02a153: folds
Hero: folds
Uncalled bet ($0.1) returned to 8c340ae9
*** SHOWDOWN ***
8c340ae9 collected $0.12 from pot
*** SUMMARY ***
Total pot $0.12 | Rake $0 | Jackpot $0 | Bingo $0 | Fortune $0 | Tax $0
Seat 1: 8c340ae9 (button) collected ($0.12)
Seat 2: cd02a153 (small blind) folded before Flop
Seat 3: Hero (big blind) folded before Flop
Seat 4: 28218a38 folded before Flop (didn't bet)
Seat 5: d2e52b8d folded before Flop (didn't bet)
Seat 6: 2afe98d4 folded before Flop (didn't bet)


Poker Hand #RC2078582087: Hold'em No Limit ($0.02/$0.05) - 2023/12/22 22:01:22
Table 'RushAndCash805368' 6-max Seat #1 is the button
Seat 1: 80af7fe3 ($7.77 in chips)
Seat 2: 36acf706 ($8.21 in chips)
Seat 3: f06064a0 ($5.41 in chips)
Seat 4: cf8a8e96 ($11.2 in chips)
Seat 5: 3dc18159 ($7.81 in chips)
Seat 6: Hero ($11.46 in chips)
36acf706: posts small blind $0.02
f06064a0: posts big blind $0.05
*** HOLE CARDS ***
Dealt to 80af7fe3 
Dealt to 36acf706 
Dealt to f06064a0 
Dealt to cf8a8e96 
Dealt to 3dc18159 
Dealt to Hero [5d Jc]
cf8a8e96: folds
3dc18159: folds
Hero: folds
80af7fe3: folds
36acf706: raises $0.08 to $0.13
f06064a0: calls $0.08
*** FLOP *** [Jh As 5h]
36acf706: bets $0.09
f06064a0: calls $0.09
*** TURN *** [Jh As 5h] [8s]
36acf706: checks
f06064a0: bets $0.22
36acf706: calls $0.22
*** RIVER *** [Jh As 5h 8s] [Tc]
36acf706: checks
f06064a0: bets $0.66
36acf706: folds
Uncalled bet ($0.66) returned to f06064a0
*** SHOWDOWN ***
f06064a0 collected $0.84 from pot
*** SUMMARY ***
Total pot $0.88 | Rake $0.04 | Jackpot $0 | Bingo $0 | Fortune $0 | Tax $0
Board [Jh As 5h 8s Tc]
Seat 1: 80af7fe3 (button) folded before Flop (didn't bet)
Seat 2: 36acf706 (small blind) folded on the River
Seat 3: f06064a0 (big blind) won ($0.84)
Seat 4: cf8a8e96 folded before Flop (didn't bet)
Seat 5: 3dc18159 folded before Flop (didn't bet)
Seat 6: Hero folded before Flop (didn't bet)


Poker Hand #RC2078582023: Hold'em No Limit ($0.02/$0.05) - 2023/12/22 22:01:18
Table 'RushAndCash805337' 6-max Seat #1 is the button
Seat 1: 2b33eb01 ($5.17 in chips)
Seat 2: 725fcf25 ($14.39 in chips)
Seat 3: ea94f4a8 ($3.95 in chips)
Seat 4: Hero ($11.46 in chips)
Seat 5: 697fb04a ($41.28 in chips)
Seat 6: 67297113 ($5.83 in chips)
725fcf25: posts small blind $0.02
ea94f4a8: posts big blind $0.05
*** HOLE CARDS ***
Dealt to 2b33eb01 
Dealt to 725fcf25 
Dealt to ea94f4a8 
Dealt to Hero [3h 9d]
Dealt to 697fb04a 
Dealt to 67297113 
Hero: folds
697fb04a: raises $0.05 to $0.1
67297113: folds
2b33eb01: folds
725fcf25: folds
ea94f4a8: calls $0.05
*** FLOP *** [Qs 5c 7h]
ea94f4a8: checks
697fb04a: bets $0.11
ea94f4a8: calls $0.11
*** TURN *** [Qs 5c 7h] [2h]
ea94f4a8: checks
697fb04a: checks
*** RIVER *** [Qs 5c 7h 2h] [2d]
ea94f4a8: bets $3.74 and is all-in
697fb04a: folds
Uncalled bet ($3.74) returned to ea94f4a8
*** SHOWDOWN ***
ea94f4a8 collected $0.42 from pot
*** SUMMARY ***
Total pot $0.44 | Rake $0.02 | Jackpot $0 | Bingo $0 | Fortune $0 | Tax $0
Board [Qs 5c 7h 2h 2d]
Seat 1: 2b33eb01 (button) folded before Flop (didn't bet)
Seat 2: 725fcf25 (small blind) folded before Flop
Seat 3: ea94f4a8 (big blind) won ($0.42)
Seat 4: Hero folded before Flop (didn't bet)
Seat 5: 697fb04a folded on the River
Seat 6: 67297113 folded before Flop (didn't bet)


Poker Hand #RC2078581337: Hold'em No Limit ($0.02/$0.05) - 2023/12/22 22:00:38
Table 'RushAndCash805018' 6-max Seat #1 is the button
Seat 1: Hero ($10.73 in chips)
Seat 2: 7093f460 ($4.99 in chips)
Seat 3: 7385f3 ($4.78 in chips)
Seat 4: 697fb04a ($42.09 in chips)
Seat 5: d0173848 ($1.69 in chips)
Seat 6: f6b5f68e ($6.53 in chips)
7093f460: posts small blind $0.02
7385f3: posts big blind $0.05
*** HOLE CARDS ***
Dealt to Hero [Kh Ah]
Dealt to 7093f460 
Dealt to 7385f3 
Dealt to 697fb04a 
Dealt to d0173848 
Dealt to f6b5f68e 
697fb04a: raises $0.05 to $0.1
d0173848: folds
f6b5f68e: folds
Hero: raises $0.37 to $0.47
7093f460: folds
7385f3: folds
697fb04a: calls $0.37
*** FLOP *** [8c 3s 5s]
697fb04a: checks
Hero: bets $0.34
697fb04a: calls $0.34
*** TURN *** [8c 3s 5s] [7d]
697fb04a: checks
Hero: checks
*** RIVER *** [8c 3s 5s 7d] [As]
697fb04a: checks
Hero: bets $0.56
697fb04a: folds
Uncalled bet ($0.56) returned to Hero
*** SHOWDOWN ***
Hero collected $1.54 from pot
*** SUMMARY ***
Total pot $1.69 | Rake $0.08 | Jackpot $0.07 | Bingo $0 | Fortune $0 | Tax $0
Board [8c 3s 5s 7d As]
Seat 1: Hero (button) won ($1.54)
Seat 2: 7093f460 (small blind) folded before Flop
Seat 3: 7385f3 (big blind) folded before Flop
Seat 4: 697fb04a folded on the River
Seat 5: d0173848 folded before Flop (didn't bet)
Seat 6: f6b5f68e folded before Flop (didn't bet)


Poker Hand #RC2078581272: Hold'em No Limit ($0.02/$0.05) - 2023/12/22 22:00:35
Table 'RushAndCash804984' 6-max Seat #1 is the button
Seat 1: Hero ($10.73 in chips)
Seat 2: 78624e82 ($5.41 in chips)
Seat 3: 5f9f6e5e ($5.31 in chips)
Seat 4: d6d8d23b ($6.04 in chips)
Seat 5: 859547f3 ($5.26 in chips)
Seat 6: 37a644bb ($5 in chips)
78624e82: posts small blind $0.02
5f9f6e5e: posts big blind $0.05
*** HOLE CARDS ***
Dealt to Hero [7d 2s]
Dealt to 78624e82 
Dealt to 5f9f6e5e 
Dealt to d6d8d23b 
Dealt to 859547f3 
Dealt to 37a644bb 
d6d8d23b: folds
859547f3: folds
37a644bb: raises $0.05 to $0.1
Hero: folds
78624e82: folds
5f9f6e5e: folds
Uncalled bet ($0.05) returned to 37a644bb
*** SHOWDOWN ***
37a644bb collected $0.12 from pot
*** SUMMARY ***
Total pot $0.12 | Rake $0 | Jackpot $0 | Bingo $0 | Fortune $0 | Tax $0
Seat 1: Hero (button) folded before Flop (didn't bet)
Seat 2: 78624e82 (small blind) folded before Flop
Seat 3: 5f9f6e5e (big blind) folded before Flop
Seat 4: d6d8d23b folded before Flop (didn't bet)
Seat 5: 859547f3 folded before Flop (didn't bet)
Seat 6: 37a644bb collected ($0.12)


Poker Hand #RC2078581147: Hold'em No Limit ($0.02/$0.05) - 2023/12/22 22:00:27
Table 'RushAndCash804927' 6-max Seat #1 is the button
Seat 1: 5c59e6a6 ($5.4 in chips)
Seat 2: 200bc0f9 ($6.93 in chips)
Seat 3: Hero ($10.71 in chips)
Seat 4: 57eb4842 ($5.07 in chips)
Seat 5: 190cd877 ($5.16 in chips)
Seat 6: 7093f460 ($4.99 in chips)
200bc0f9: posts small blind $0.02
Hero: posts big blind $0.05
*** HOLE CARDS ***
Dealt to 5c59e6a6 
Dealt to 200bc0f9 
Dealt to Hero [8d Th]
Dealt to 57eb4842 
Dealt to 190cd877 
Dealt to 7093f460 
57eb4842: folds
190cd877: folds
7093f460: folds
5c59e6a6: folds
200bc0f9: folds
Uncalled bet ($0.03) returned to Hero
*** SHOWDOWN ***
Hero collected $0.04 from pot
*** SUMMARY ***
Total pot $0.04 | Rake $0 | Jackpot $0 | Bingo $0 | Fortune $0 | Tax $0
Seat 1: 5c59e6a6 (button) folded before Flop (didn't bet)
Seat 2: 200bc0f9 (small blind) folded before Flop
Seat 3: Hero (big blind) collected ($0.04)
Seat 4: 57eb4842 folded before Flop (didn't bet)
Seat 5: 190cd877 folded before Flop (didn't bet)
Seat 6: 7093f460 folded before Flop (didn't bet)


Poker Hand #RC2078580971: Hold'em No Limit ($0.02/$0.05) - 2023/12/22 22:00:17
Table 'RushAndCash804846' 6-max Seat #1 is the button
Seat 1: 1e6e058c ($8.11 in chips)
Seat 2: Hero ($10.73 in chips)
Seat 3: b8adc645 ($5.07 in chips)
Seat 4: c84db7d6 ($5.17 in chips)
Seat 5: c9414c7d ($10.09 in chips)
Seat 6: c7726580 ($5 in chips)
Hero: posts small blind $0.02
b8adc645: posts big blind $0.05
*** HOLE CARDS ***
Dealt to 1e6e058c 
Dealt to Hero [4c Th]
Dealt to b8adc645 
Dealt to c84db7d6 
Dealt to c9414c7d 
Dealt to c7726580 
c84db7d6: raises $0.07 to $0.12
c9414c7d: calls $0.12
c7726580: folds
1e6e058c: folds
Hero: folds
b8adc645: folds
*** FLOP *** [7c Ac Td]
c84db7d6: checks
c9414c7d: bets $0.11
c84db7d6: folds
Uncalled bet ($0.11) returned to c9414c7d
*** SHOWDOWN ***
c9414c7d collected $0.3 from pot
*** SUMMARY ***
Total pot $0.31 | Rake $0.01 | Jackpot $0 | Bingo $0 | Fortune $0 | Tax $0
Board [7c Ac Td]
Seat 1: 1e6e058c (button) folded before Flop (didn't bet)
Seat 2: Hero (small blind) folded before Flop
Seat 3: b8adc645 (big blind) folded before Flop
Seat 4: c84db7d6 folded on the Flop
Seat 5: c9414c7d won ($0.3)
Seat 6: c7726580 folded before Flop (didn't bet)


Poker Hand #RC2078580802: Hold'em No Limit ($0.02/$0.05) - 2023/12/22 22:00:08
Table 'RushAndCash804772' 6-max Seat #1 is the button
Seat 1: f0e3b048 ($6.57 in chips)
Seat 2: d6dcfaa3 ($5.82 in chips)
Seat 3: 703f412f ($5.58 in chips)
Seat 4: Hero ($10.66 in chips)
Seat 5: 2bd4532c ($3.48 in chips)
Seat 6: 24503504 ($7.22 in chips)
d6dcfaa3: posts small blind $0.02
703f412f: posts big blind $0.05
*** HOLE CARDS ***
Dealt to f0e3b048 
Dealt to d6dcfaa3 
Dealt to 703f412f 
Dealt to Hero [4d 4s]
Dealt to 2bd4532c 
Dealt to 24503504 
Hero: raises $0.05 to $0.1
2bd4532c: folds
24503504: folds
f0e3b048: folds
d6dcfaa3: folds
703f412f: folds
Uncalled bet ($0.05) returned to Hero
*** SHOWDOWN ***
Hero collected $0.12 from pot
*** SUMMARY ***
Total pot $0.12 | Rake $0 | Jackpot $0 | Bingo $0 | Fortune $0 | Tax $0
Seat 1: f0e3b048 (button) folded before Flop (didn't bet)
Seat 2: d6dcfaa3 (small blind) folded before Flop
Seat 3: 703f412f (big blind) folded before Flop
Seat 4: Hero collected ($0.12)
Seat 5: 2bd4532c folded before Flop (didn't bet)
Seat 6: 24503504 folded before Flop (didn't bet)


Poker Hand #RC2078580749: Hold'em No Limit ($0.02/$0.05) - 2023/12/22 22:00:04
Table 'RushAndCash804750' 6-max Seat #1 is the button
Seat 1: 26a46ed7 ($5.57 in chips)
Seat 2: 242358f0 ($6.19 in chips)
Seat 3: 9e9d954c ($5.76 in chips)
Seat 4: Hero ($10.66 in chips)
Seat 5: 25a36e51 ($0.69 in chips)
Seat 6: 71519e57 ($5.63 in chips)
242358f0: posts small blind $0.02
9e9d954c: posts big blind $0.05
*** HOLE CARDS ***
Dealt to 26a46ed7 
Dealt to 242358f0 
Dealt to 9e9d954c 
Dealt to Hero [Ah 9d]
Dealt to 25a36e51 
Dealt to 71519e57 
Hero: folds
25a36e51: folds
71519e57: folds
26a46ed7: raises $0.1 to $0.15
242358f0: folds
9e9d954c: raises $0.38 to $0.53
26a46ed7: folds
Uncalled bet ($0.38) returned to 9e9d954c
*** SHOWDOWN ***
9e9d954c collected $0.31 from pot
*** SUMMARY ***
Total pot $0.32 | Rake $0.01 | Jackpot $0 | Bingo $0 | Fortune $0 | Tax $0
Seat 1: 26a46ed7 (button) folded before Flop
Seat 2: 242358f0 (small blind) folded before Flop
Seat 3: 9e9d954c (big blind) collected ($0.31)
Seat 4: Hero folded before Flop (didn't bet)
Seat 5: 25a36e51 folded before Flop (didn't bet)
Seat 6: 71519e57 folded before Flop (didn't bet)


Poker Hand #RC2078580024: Hold'em No Limit ($0.02/$0.05) - 2023/12/22 21:59:22
Table 'RushAndCash804415' 6-max Seat #1 is the button
Seat 1: 18aade85 ($8.68 in chips)
Seat 2: 26a46ed7 ($6.37 in chips)
Seat 3: fc7e8623 ($24.58 in chips)
Seat 4: Hero ($10.76 in chips)
Seat 5: 9e9d954c ($4.96 in chips)
Seat 6: ff34c3d1 ($11.75 in chips)
26a46ed7: posts small blind $0.02
fc7e8623: posts big blind $0.05
*** HOLE CARDS ***
Dealt to 18aade85 
Dealt to 26a46ed7 
Dealt to fc7e8623 
Dealt to Hero [4h 4c]
Dealt to 9e9d954c 
Dealt to ff34c3d1 
Hero: raises $0.05 to $0.1
9e9d954c: calls $0.1
ff34c3d1: folds
18aade85: folds
26a46ed7: raises $0.35 to $0.45
fc7e8623: folds
Hero: folds
9e9d954c: calls $0.35
*** FLOP *** [6s 4s 8d]
26a46ed7: bets $0.35
9e9d954c: calls $0.35
*** TURN *** [6s 4s 8d] [5s]
26a46ed7: checks
9e9d954c: bets $1.16
26a46ed7: folds
Uncalled bet ($1.16) returned to 9e9d954c
*** SHOWDOWN ***
9e9d954c collected $1.6 from pot
*** SUMMARY ***
Total pot $1.75 | Rake $0.08 | Jackpot $0.07 | Bingo $0 | Fortune $0 | Tax $0
Board [6s 4s 8d 5s]
Seat 1: 18aade85 (button) folded before Flop (didn't bet)
Seat 2: 26a46ed7 (small blind) folded on the Turn
Seat 3: fc7e8623 (big blind) folded before Flop
Seat 4: Hero folded before Flop
Seat 5: 9e9d954c won ($1.6)
Seat 6: ff34c3d1 folded before Flop (didn't bet)


Poker Hand #RC2078579940: Hold'em No Limit ($0.02/$0.05) - 2023/12/22 21:59:17
Table 'RushAndCash804374' 6-max Seat #1 is the button
Seat 1: 3b322324 ($5.31 in chips)
Seat 2: c8c17adc ($8.74 in chips)
Seat 3: f2833e42 ($10.3 in chips)
Seat 4: Hero ($10.76 in chips)
Seat 5: d79b0c6a ($5.34 in chips)
Seat 6: 9b5806d5 ($5.1 in chips)
c8c17adc: posts small blind $0.02
f2833e42: posts big blind $0.05
*** HOLE CARDS ***
Dealt to 3b322324 
Dealt to c8c17adc 
Dealt to f2833e42 
Dealt to Hero [Js 2h]
Dealt to d79b0c6a 
Dealt to 9b5806d5 
Hero: folds
d79b0c6a: folds
9b5806d5: folds
3b322324: folds
c8c17adc: folds
Uncalled bet ($0.03) returned to f2833e42
*** SHOWDOWN ***
f2833e42 collected $0.04 from pot
*** SUMMARY ***
Total pot $0.04 | Rake $0 | Jackpot $0 | Bingo $0 | Fortune $0 | Tax $0
Seat 1: 3b322324 (button) folded before Flop (didn't bet)
Seat 2: c8c17adc (small blind) folded before Flop
Seat 3: f2833e42 (big blind) collected ($0.04)
Seat 4: Hero folded before Flop (didn't bet)
Seat 5: d79b0c6a folded before Flop (didn't bet)
Seat 6: 9b5806d5 folded before Flop (didn't bet)


Poker Hand #RC2078579835: Hold'em No Limit ($0.02/$0.05) - 2023/12/22 21:59:12
Table 'RushAndCash804322' 6-max Seat #1 is the button
Seat 1: b55e2f56 ($4.24 in chips)
Seat 2: 1fc1f571 ($18.17 in chips)
Seat 3: a6b60e2c ($5.75 in chips)
Seat 4: de6954c1 ($6.25 in chips)
Seat 5: 3d929f9f ($8.48 in chips)
Seat 6: Hero ($10.76 in chips)
1fc1f571: posts small blind $0.02
a6b60e2c: posts big blind $0.05
*** HOLE CARDS ***
Dealt to b55e2f56 
Dealt to 1fc1f571 
Dealt to a6b60e2c 
Dealt to de6954c1 
Dealt to 3d929f9f 
Dealt to Hero [5c Js]
de6954c1: folds
3d929f9f: folds
Hero: folds
b55e2f56: folds
1fc1f571: raises $0.1 to $0.15
a6b60e2c: folds
Uncalled bet ($0.1) returned to 1fc1f571
*** SHOWDOWN ***
1fc1f571 collected $0.1 from pot
*** SUMMARY ***
Total pot $0.1 | Rake $0 | Jackpot $0 | Bingo $0 | Fortune $0 | Tax $0
Seat 1: b55e2f56 (button) folded before Flop (didn't bet)
Seat 2: 1fc1f571 (small blind) collected ($0.1)
Seat 3: a6b60e2c (big blind) folded before Flop
Seat 4: de6954c1 folded before Flop (didn't bet)
Seat 5: 3d929f9f folded before Flop (didn't bet)
Seat 6: Hero folded before Flop (didn't bet)


Poker Hand #RC2078579589: Hold'em No Limit ($0.02/$0.05) - 2023/12/22 21:58:58
Table 'RushAndCash804214' 6-max Seat #1 is the button
Seat 1: fab544c8 ($8.48 in chips)
Seat 2: Hero ($10.78 in chips)
Seat 3: 330b404c ($13.92 in chips)
Seat 4: 8e36a030 ($7.07 in chips)
Seat 5: eb32f25a ($6.18 in chips)
Seat 6: 21adc60b ($5.29 in chips)
Hero: posts small blind $0.02
330b404c: posts big blind $0.05
*** HOLE CARDS ***
Dealt to fab544c8 
Dealt to Hero [5d 3s]
Dealt to 330b404c 
Dealt to 8e36a030 
Dealt to eb32f25a 
Dealt to 21adc60b 
8e36a030: folds
eb32f25a: raises $0.08 to $0.13
21adc60b: folds
fab544c8: calls $0.13
Hero: folds
330b404c: calls $0.08
*** FLOP *** [6d 4c Jh]
330b404c: checks
eb32f25a: bets $0.14
fab544c8: folds
330b404c: raises $0.44 to $0.58
eb32f25a: calls $0.44
*** TURN *** [6d 4c Jh] [8d]
330b404c: bets $1.89
eb32f25a: folds
Uncalled bet ($1.89) returned to 330b404c
*** SHOWDOWN ***
330b404c collected $1.43 from pot
*** SUMMARY ***
Total pot $1.57 | Rake $0.07 | Jackpot $0.07 | Bingo $0 | Fortune $0 | Tax $0
Board [6d 4c Jh 8d]
Seat 1: fab544c8 (button) folded on the Flop
Seat 2: Hero (small blind) folded before Flop
Seat 3: 330b404c (big blind) won ($1.43)
Seat 4: 8e36a030 folded before Flop (didn't bet)
Seat 5: eb32f25a folded on the Turn
Seat 6: 21adc60b folded before Flop (didn't bet)


Poker Hand #RC2078579512: Hold'em No Limit ($0.02/$0.05) - 2023/12/22 21:58:54
Table 'RushAndCash804179' 6-max Seat #1 is the button
Seat 1: d0ae9fc ($2.86 in chips)
Seat 2: 1c28bbd5 ($4.71 in chips)
Seat 3: e0f80030 ($5 in chips)
Seat 4: Hero ($10.78 in chips)
Seat 5: a09c3cfc ($3.3 in chips)
Seat 6: 5761cd5e ($5 in chips)
1c28bbd5: posts small blind $0.02
e0f80030: posts big blind $0.05
*** HOLE CARDS ***
Dealt to d0ae9fc 
Dealt to 1c28bbd5 
Dealt to e0f80030 
Dealt to Hero [Qd 7s]
Dealt to a09c3cfc 
Dealt to 5761cd5e 
Hero: folds
a09c3cfc: folds
5761cd5e: raises $0.1 to $0.15
d0ae9fc: folds
1c28bbd5: folds
e0f80030: calls $0.1
*** FLOP *** [7h Tc Jh]
e0f80030: checks
5761cd5e: checks
*** TURN *** [7h Tc Jh] [4s]
e0f80030: checks
5761cd5e: checks
*** RIVER *** [7h Tc Jh 4s] [6h]
e0f80030: checks
5761cd5e: checks
e0f80030: shows [8s As] (Ace-High)
5761cd5e: shows [9d 9h] (Pair of Nines)
*** SHOWDOWN ***
5761cd5e collected $0.31 from pot
*** SUMMARY ***
Total pot $0.32 | Rake $0.01 | Jackpot $0 | Bingo $0 | Fortune $0 | Tax $0
Board [7h Tc Jh 4s 6h]
Seat 1: d0ae9fc (button) folded before Flop (didn't bet)
Seat 2: 1c28bbd5 (small blind) folded before Flop
Seat 3: e0f80030 (big blind) showed [8s As] and lost with Ace-High
Seat 4: Hero folded before Flop (didn't bet)
Seat 5: a09c3cfc folded before Flop (didn't bet)
Seat 6: 5761cd5e showed [9d 9h] and won ($0.31) with Pair of Nines


Poker Hand #RC2078579332: Hold'em No Limit ($0.02/$0.05) - 2023/12/22 21:58:44
Table 'RushAndCash804094' 6-max Seat #1 is the button
Seat 1: b9aa0c94 ($33.65 in chips)
Seat 2: 30a2950b ($5.32 in chips)
Seat 3: ec5f3643 ($4.24 in chips)
Seat 4: ac89ef05 ($5.03 in chips)
Seat 5: Hero ($10.71 in chips)
Seat 6: d6c4e270 ($1.96 in chips)
30a2950b: posts small blind $0.02
ec5f3643: posts big blind $0.05
*** HOLE CARDS ***
Dealt to b9aa0c94 
Dealt to 30a2950b 
Dealt to ec5f3643 
Dealt to ac89ef05 
Dealt to Hero [Kd Ah]
Dealt to d6c4e270 
ac89ef05: folds
Hero: raises $0.05 to $0.1
d6c4e270: folds
b9aa0c94: folds
30a2950b: folds
ec5f3643: folds
Uncalled bet ($0.05) returned to Hero
*** SHOWDOWN ***
Hero collected $0.12 from pot
*** SUMMARY ***
Total pot $0.12 | Rake $0 | Jackpot $0 | Bingo $0 | Fortune $0 | Tax $0
Seat 1: b9aa0c94 (button) folded before Flop (didn't bet)
Seat 2: 30a2950b (small blind) folded before Flop
Seat 3: ec5f3643 (big blind) folded before Flop
Seat 4: ac89ef05 folded before Flop (didn't bet)
Seat 5: Hero collected ($0.12)
Seat 6: d6c4e270 folded before Flop (didn't bet)


Poker Hand #RC2078578983: Hold'em No Limit ($0.02/$0.05) - 2023/12/22 21:58:24
Table 'RushAndCash803934' 6-max Seat #1 is the button
Seat 1: d0f6c873 ($4.56 in chips)
Seat 2: 7732abf7 ($15.13 in chips)
Seat 3: Hero ($10.76 in chips)
Seat 4: 18205b99 ($4.86 in chips)
Seat 5: 9db3bc7b ($10.17 in chips)
Seat 6: c6813ed5 ($7.92 in chips)
7732abf7: posts small blind $0.02
Hero: posts big blind $0.05
*** HOLE CARDS ***
Dealt to d0f6c873 
Dealt to 7732abf7 
Dealt to Hero [9c Th]
Dealt to 18205b99 
Dealt to 9db3bc7b 
Dealt to c6813ed5 
18205b99: folds
9db3bc7b: folds
c6813ed5: raises $0.06 to $0.11
d0f6c873: calls $0.11
7732abf7: folds
Hero: folds
*** FLOP *** [Qh 9h 7h]
c6813ed5: bets $0.08
d0f6c873: calls $0.08
*** TURN *** [Qh 9h 7h] [5h]
c6813ed5: checks
d0f6c873: bets $0.23
c6813ed5: raises $0.23 to $0.46
d0f6c873: folds
Uncalled bet ($0.23) returned to c6813ed5
*** SHOWDOWN ***
c6813ed5 collected $0.87 from pot
*** SUMMARY ***
Total pot $0.91 | Rake $0.04 | Jackpot $0 | Bingo $0 | Fortune $0 | Tax $0
Board [Qh 9h 7h 5h]
Seat 1: d0f6c873 (button) folded on the Turn
Seat 2: 7732abf7 (small blind) folded before Flop
Seat 3: Hero (big blind) folded before Flop
Seat 4: 18205b99 folded before Flop (didn't bet)
Seat 5: 9db3bc7b folded before Flop (didn't bet)
Seat 6: c6813ed5 won ($0.87)


Poker Hand #RC2078578869: Hold'em No Limit ($0.02/$0.05) - 2023/12/22 21:58:17
Table 'RushAndCash803888' 6-max Seat #1 is the button
Seat 1: 7d137087 ($7.75 in chips)
Seat 2: 6fefb285 ($6.71 in chips)
Seat 3: 376e9d31 ($4.69 in chips)
Seat 4: Hero ($10.76 in chips)
Seat 5: 7faa6e20 ($7.3 in chips)
Seat 6: d6dcfaa3 ($5.92 in chips)
6fefb285: posts small blind $0.02
376e9d31: posts big blind $0.05
*** HOLE CARDS ***
Dealt to 7d137087 
Dealt to 6fefb285 
Dealt to 376e9d31 
Dealt to Hero [3h 2s]
Dealt to 7faa6e20 
Dealt to d6dcfaa3 
Hero: folds
7faa6e20: folds
d6dcfaa3: folds
7d137087: raises $0.08 to $0.13
6fefb285: raises $0.31 to $0.44
376e9d31: folds
7d137087: calls $0.31
*** FLOP *** [9s 4d 9c]
6fefb285: bets $0.56
7d137087: folds
Uncalled bet ($0.56) returned to 6fefb285
*** SHOWDOWN ***
6fefb285 collected $0.89 from pot
*** SUMMARY ***
Total pot $0.93 | Rake $0.04 | Jackpot $0 | Bingo $0 | Fortune $0 | Tax $0
Board [9s 4d 9c]
Seat 1: 7d137087 (button) folded on the Flop
Seat 2: 6fefb285 (small blind) won ($0.89)
Seat 3: 376e9d31 (big blind) folded before Flop
Seat 4: Hero folded before Flop (didn't bet)
Seat 5: 7faa6e20 folded before Flop (didn't bet)
Seat 6: d6dcfaa3 folded before Flop (didn't bet)


Poker Hand #RC2078578657: Hold'em No Limit ($0.02/$0.05) - 2023/12/22 21:58:04
Table 'RushAndCash803792' 6-max Seat #1 is the button
Seat 1: 7016689e ($7.43 in chips)
Seat 2: d32741ba ($9.23 in chips)
Seat 3: 610bd7fc ($8.45 in chips)
Seat 4: Hero ($10.76 in chips)
Seat 5: b34a3506 ($5.19 in chips)
Seat 6: 6e0be8e1 ($6.16 in chips)
d32741ba: posts small blind $0.02
610bd7fc: posts big blind $0.05
*** HOLE CARDS ***
Dealt to 7016689e 
Dealt to d32741ba 
Dealt to 610bd7fc 
Dealt to Hero [Ts 5s]
Dealt to b34a3506 
Dealt to 6e0be8e1 
Hero: folds
b34a3506: folds
6e0be8e1: folds
7016689e: raises $0.08 to $0.13
d32741ba: folds
610bd7fc: folds
Uncalled bet ($0.08) returned to 7016689e
*** SHOWDOWN ***
7016689e collected $0.12 from pot
*** SUMMARY ***
Total pot $0.12 | Rake $0 | Jackpot $0 | Bingo $0 | Fortune $0 | Tax $0
Seat 1: 7016689e (button) collected ($0.12)
Seat 2: d32741ba (small blind) folded before Flop
Seat 3: 610bd7fc (big blind) folded before Flop
Seat 4: Hero folded before Flop (didn't bet)
Seat 5: b34a3506 folded before Flop (didn't bet)
Seat 6: 6e0be8e1 folded before Flop (didn't bet)


Poker Hand #RC2078578345: Hold'em No Limit ($0.02/$0.05) - 2023/12/22 21:57:47
Table 'RushAndCash803643' 6-max Seat #1 is the button
Seat 1: Hero ($10.89 in chips)
Seat 2: 129846c0 ($5 in chips)
Seat 3: a6b60e2c ($5.52 in chips)
Seat 4: 1a2ba0b4 ($6.34 in chips)
Seat 5: a1bfa6f0 ($4.8 in chips)
Seat 6: 6969351a ($7.76 in chips)
129846c0: posts small blind $0.02
a6b60e2c: posts big blind $0.05
*** HOLE CARDS ***
Dealt to Hero [6c Kc]
Dealt to 129846c0 
Dealt to a6b60e2c 
Dealt to 1a2ba0b4 
Dealt to a1bfa6f0 
Dealt to 6969351a 
1a2ba0b4: folds
a1bfa6f0: folds
6969351a: folds
Hero: raises $0.08 to $0.13
129846c0: raises $0.39 to $0.52
a6b60e2c: folds
Hero: folds
Uncalled bet ($0.39) returned to 129846c0
*** SHOWDOWN ***
129846c0 collected $0.3 from pot
*** SUMMARY ***
Total pot $0.31 | Rake $0.01 | Jackpot $0 | Bingo $0 | Fortune $0 | Tax $0
Seat 1: Hero (button) folded before Flop
Seat 2: 129846c0 (small blind) collected ($0.3)
Seat 3: a6b60e2c (big blind) folded before Flop
Seat 4: 1a2ba0b4 folded before Flop (didn't bet)
Seat 5: a1bfa6f0 folded before Flop (didn't bet)
Seat 6: 6969351a folded before Flop (didn't bet)


Poker Hand #RC2078578280: Hold'em No Limit ($0.02/$0.05) - 2023/12/22 21:57:43
Table 'RushAndCash803611' 6-max Seat #1 is the button
Seat 1: 69662cf8 ($5 in chips)
Seat 2: 2f160a64 ($8.03 in chips)
Seat 3: Hero ($10.94 in chips)
Seat 4: dc851cb6 ($9.71 in chips)
Seat 5: b55e2f56 ($3.47 in chips)
Seat 6: d6dcfaa3 ($5.46 in chips)
2f160a64: posts small blind $0.02
Hero: posts big blind $0.05
*** HOLE CARDS ***
Dealt to 69662cf8 
Dealt to 2f160a64 
Dealt to Hero [Qd 9s]
Dealt to dc851cb6 
Dealt to b55e2f56 
Dealt to d6dcfaa3 
dc851cb6: folds
b55e2f56: raises $0.1 to $0.15
d6dcfaa3: raises $0.28 to $0.43
69662cf8: folds
2f160a64: folds
Hero: folds
b55e2f56: calls $0.28
*** FLOP *** [Qh 7s 6d]
b55e2f56: checks
d6dcfaa3: bets $0.31
b55e2f56: folds
Uncalled bet ($0.31) returned to d6dcfaa3
*** SHOWDOWN ***
d6dcfaa3 collected $0.89 from pot
*** SUMMARY ***
Total pot $0.93 | Rake $0.04 | Jackpot $0 | Bingo $0 | Fortune $0 | Tax $0
Board [Qh 7s 6d]
Seat 1: 69662cf8 (button) folded before Flop (didn't bet)
Seat 2: 2f160a64 (small blind) folded before Flop
Seat 3: Hero (big blind) folded before Flop
Seat 4: dc851cb6 folded before Flop (didn't bet)
Seat 5: b55e2f56 folded on the Flop
Seat 6: d6dcfaa3 won ($0.89)


Poker Hand #RC2078578105: Hold'em No Limit ($0.02/$0.05) - 2023/12/22 21:57:33
Table 'RushAndCash803527' 6-max Seat #1 is the button
Seat 1: Hero ($10.87 in chips)
Seat 2: b9aa0c94 ($32.48 in chips)
Seat 3: 7b8defcb ($4.03 in chips)
Seat 4: aeeb0181 ($12.84 in chips)
Seat 5: e8e3d92 ($5.37 in chips)
Seat 6: fab544c8 ($8.5 in chips)
b9aa0c94: posts small blind $0.02
7b8defcb: posts big blind $0.05
*** HOLE CARDS ***
Dealt to Hero [Ah Td]
Dealt to b9aa0c94 
Dealt to 7b8defcb 
Dealt to aeeb0181 
Dealt to e8e3d92 
Dealt to fab544c8 
aeeb0181: folds
e8e3d92: folds
fab544c8: folds
Hero: raises $0.08 to $0.13
b9aa0c94: folds
7b8defcb: folds
Uncalled bet ($0.08) returned to Hero
*** SHOWDOWN ***
Hero collected $0.12 from pot
*** SUMMARY ***
Total pot $0.12 | Rake $0 | Jackpot $0 | Bingo $0 | Fortune $0 | Tax $0
Seat 1: Hero (button) collected ($0.12)
Seat 2: b9aa0c94 (small blind) folded before Flop
Seat 3: 7b8defcb (big blind) folded before Flop
Seat 4: aeeb0181 folded before Flop (didn't bet)
Seat 5: e8e3d92 folded before Flop (didn't bet)
Seat 6: fab544c8 folded before Flop (didn't bet)


Poker Hand #RC2078577996: Hold'em No Limit ($0.02/$0.05) - 2023/12/22 21:57:27
Table 'RushAndCash803475' 6-max Seat #1 is the button
Seat 1: 4d74ad6d ($5 in chips)
Seat 2: Hero ($10.89 in chips)
Seat 3: 153b1345 ($8.96 in chips)
Seat 4: c8adf5d ($7.03 in chips)
Seat 5: 6db75c19 ($12.48 in chips)
Seat 6: b0755516 ($5 in chips)
Hero: posts small blind $0.02
153b1345: posts big blind $0.05
*** HOLE CARDS ***
Dealt to 4d74ad6d 
Dealt to Hero [3c 6s]
Dealt to 153b1345 
Dealt to c8adf5d 
Dealt to 6db75c19 
Dealt to b0755516 
c8adf5d: folds
6db75c19: folds
b0755516: folds
4d74ad6d: folds
Hero: folds
Uncalled bet ($0.03) returned to 153b1345
*** SHOWDOWN ***
153b1345 collected $0.04 from pot
*** SUMMARY ***
Total pot $0.04 | Rake $0 | Jackpot $0 | Bingo $0 | Fortune $0 | Tax $0
Seat 1: 4d74ad6d (button) folded before Flop (didn't bet)
Seat 2: Hero (small blind) folded before Flop
Seat 3: 153b1345 (big blind) collected ($0.04)
Seat 4: c8adf5d folded before Flop (didn't bet)
Seat 5: 6db75c19 folded before Flop (didn't bet)
Seat 6: b0755516 folded before Flop (didn't bet)


Poker Hand #RC2078577293: Hold'em No Limit ($0.02/$0.05) - 2023/12/22 21:56:46
Table 'RushAndCash803152' 6-max Seat #1 is the button
Seat 1: 36acf706 ($6.87 in chips)
Seat 2: ed75fdbb ($5 in chips)
Seat 3: 5f11c3da ($14.83 in chips)
Seat 4: 500558b3 ($5.07 in chips)
Seat 5: 4a7d05b1 ($6.03 in chips)
Seat 6: Hero ($10.99 in chips)
ed75fdbb: posts small blind $0.02
5f11c3da: posts big blind $0.05
*** HOLE CARDS ***
Dealt to 36acf706 
Dealt to ed75fdbb 
Dealt to 5f11c3da 
Dealt to 500558b3 
Dealt to 4a7d05b1 
Dealt to Hero [Kh Tc]
500558b3: folds
4a7d05b1: folds
Hero: raises $0.05 to $0.1
36acf706: folds
ed75fdbb: folds
5f11c3da: calls $0.05
*** FLOP *** [6d 8h 4d]
5f11c3da: checks
Hero: checks
*** TURN *** [6d 8h 4d] [9h]
5f11c3da: bets $0.17
Hero: folds
Uncalled bet ($0.17) returned to 5f11c3da
*** SHOWDOWN ***
5f11c3da collected $0.21 from pot
*** SUMMARY ***
Total pot $0.22 | Rake $0.01 | Jackpot $0 | Bingo $0 | Fortune $0 | Tax $0
Board [6d 8h 4d 9h]
Seat 1: 36acf706 (button) folded before Flop (didn't bet)
Seat 2: ed75fdbb (small blind) folded before Flop
Seat 3: 5f11c3da (big blind) won ($0.21)
Seat 4: 500558b3 folded before Flop (didn't bet)
Seat 5: 4a7d05b1 folded before Flop (didn't bet)
Seat 6: Hero folded on the Turn


Poker Hand #RC2078576522: Hold'em No Limit ($0.02/$0.05) - 2023/12/22 21:56:00
Table 'RushAndCash802790' 6-max Seat #1 is the button
Seat 1: f4866d35 ($1.45 in chips)
Seat 2: 777bac87 ($5 in chips)
Seat 3: bf955ffb ($8.46 in chips)
Seat 4: 500558b3 ($5.2 in chips)
Seat 5: c8aa0ffb ($4.03 in chips)
Seat 6: Hero ($10.8 in chips)
777bac87: posts small blind $0.02
bf955ffb: posts big blind $0.05
*** HOLE CARDS ***
Dealt to f4866d35 
Dealt to 777bac87 
Dealt to bf955ffb 
Dealt to 500558b3 
Dealt to c8aa0ffb 
Dealt to Hero [2c 2d]
500558b3: raises $0.08 to $0.13
c8aa0ffb: folds
Hero: calls $0.13
f4866d35: folds
777bac87: folds
bf955ffb: folds
*** FLOP *** [3s Kh Qc]
500558b3: checks
Hero: checks
*** TURN *** [3s Kh Qc] [7d]
500558b3: checks
Hero: checks
*** RIVER *** [3s Kh Qc 7d] [7c]
500558b3: checks
Hero: checks
500558b3: shows [9h Ah] (Pair of Sevens)
Hero: shows [2c 2d] (Pair of Sevens and Pair of Twos)
*** SHOWDOWN ***
Hero collected $0.32 from pot
*** SUMMARY ***
Total pot $0.33 | Rake $0.01 | Jackpot $0 | Bingo $0 | Fortune $0 | Tax $0
Board [3s Kh Qc 7d 7c]
Seat 1: f4866d35 (button) folded before Flop (didn't bet)
Seat 2: 777bac87 (small blind) folded before Flop
Seat 3: bf955ffb (big blind) folded before Flop
Seat 4: 500558b3 showed [9h Ah] and lost with Pair of Sevens
Seat 5: c8aa0ffb folded before Flop (didn't bet)
Seat 6: Hero showed [2c 2d] and won ($0.32) with Pair of Sevens and Pair of Twos


Poker Hand #RC2078576172: Hold'em No Limit ($0.02/$0.05) - 2023/12/22 21:55:38
Table 'RushAndCash802635' 6-max Seat #1 is the button
Seat 1: f60e42f0 ($9.17 in chips)
Seat 2: e7ed98a7 ($5 in chips)
Seat 3: 78c7aa39 ($7.34 in chips)
Seat 4: e4d2f8b7 ($9.8 in chips)
Seat 5: 2f160a64 ($8 in chips)
Seat 6: Hero ($10.8 in chips)
e7ed98a7: posts small blind $0.02
78c7aa39: posts big blind $0.05
*** HOLE CARDS ***
Dealt to f60e42f0 
Dealt to e7ed98a7 
Dealt to 78c7aa39 
Dealt to e4d2f8b7 
Dealt to 2f160a64 
Dealt to Hero [3h 3s]
e4d2f8b7: folds
2f160a64: folds
Hero: folds
f60e42f0: folds
e7ed98a7: folds
Uncalled bet ($0.03) returned to 78c7aa39
*** SHOWDOWN ***
78c7aa39 collected $0.04 from pot
*** SUMMARY ***
Total pot $0.04 | Rake $0 | Jackpot $0 | Bingo $0 | Fortune $0 | Tax $0
Seat 1: f60e42f0 (button) folded before Flop (didn't bet)
Seat 2: e7ed98a7 (small blind) folded before Flop
Seat 3: 78c7aa39 (big blind) collected ($0.04)
Seat 4: e4d2f8b7 folded before Flop (didn't bet)
Seat 5: 2f160a64 folded before Flop (didn't bet)
Seat 6: Hero folded before Flop (didn't bet)


Poker Hand #RC2078575274: Hold'em No Limit ($0.02/$0.05) - 2023/12/22 21:54:47
Table 'RushAndCash802208' 6-max Seat #1 is the button
Seat 1: d9ec3117 ($5 in chips)
Seat 2: eab48ced ($5.91 in chips)
Seat 3: Hero ($11.03 in chips)
Seat 4: 587c07c3 ($5.07 in chips)
Seat 5: 102e4185 ($7.9 in chips)
Seat 6: 1be6b9fd ($16.99 in chips)
eab48ced: posts small blind $0.02
Hero: posts big blind $0.05
*** HOLE CARDS ***
Dealt to d9ec3117 
Dealt to eab48ced 
Dealt to Hero [Ts Tc]
Dealt to 587c07c3 
Dealt to 102e4185 
Dealt to 1be6b9fd 
587c07c3: folds
102e4185: raises $0.08 to $0.13
1be6b9fd: folds
d9ec3117: folds
eab48ced: folds
Hero: calls $0.08
*** FLOP *** [7c Js 2d]
Hero: checks
102e4185: bets $0.1
Hero: calls $0.1
*** TURN *** [7c Js 2d] [Kc]
Hero: checks
102e4185: checks
*** RIVER *** [7c Js 2d Kc] [8c]
Hero: checks
102e4185: bets $0.36
Hero: folds
Uncalled bet ($0.36) returned to 102e4185
*** SHOWDOWN ***
102e4185 collected $0.46 from pot
*** SUMMARY ***
Total pot $0.48 | Rake $0.02 | Jackpot $0 | Bingo $0 | Fortune $0 | Tax $0
Board [7c Js 2d Kc 8c]
Seat 1: d9ec3117 (button) folded before Flop (didn't bet)
Seat 2: eab48ced (small blind) folded before Flop
Seat 3: Hero (big blind) folded on the River
Seat 4: 587c07c3 folded before Flop (didn't bet)
Seat 5: 102e4185 won ($0.46)
Seat 6: 1be6b9fd folded before Flop (didn't bet)


Poker Hand #RC2078575139: Hold'em No Limit ($0.02/$0.05) - 2023/12/22 21:54:38
Table 'RushAndCash802143' 6-max Seat #1 is the button
Seat 1: Hero ($11.03 in chips)
Seat 2: 4df77985 ($4.38 in chips)
Seat 3: 32c92a7b ($5.15 in chips)
Seat 4: 8aaa95a5 ($4.47 in chips)
Seat 5: deb19c7 ($11.04 in chips)
Seat 6: 8014c02 ($13.48 in chips)
4df77985: posts small blind $0.02
32c92a7b: posts big blind $0.05
*** HOLE CARDS ***
Dealt to Hero [5s 7s]
Dealt to 4df77985 
Dealt to 32c92a7b 
Dealt to 8aaa95a5 
Dealt to deb19c7 
Dealt to 8014c02 
8aaa95a5: folds
deb19c7: folds
8014c02: folds
Hero: folds
4df77985: folds
Uncalled bet ($0.03) returned to 32c92a7b
*** SHOWDOWN ***
32c92a7b collected $0.04 from pot
*** SUMMARY ***
Total pot $0.04 | Rake $0 | Jackpot $0 | Bingo $0 | Fortune $0 | Tax $0
Seat 1: Hero (button) folded before Flop (didn't bet)
Seat 2: 4df77985 (small blind) folded before Flop
Seat 3: 32c92a7b (big blind) collected ($0.04)
Seat 4: 8aaa95a5 folded before Flop (didn't bet)
Seat 5: deb19c7 folded before Flop (didn't bet)
Seat 6: 8014c02 folded before Flop (didn't bet)


Poker Hand #RC2078575079: Hold'em No Limit ($0.02/$0.05) - 2023/12/22 21:54:35
Table 'RushAndCash802115' 6-max Seat #1 is the button
Seat 1: 129846c0 ($5 in chips)
Seat 2: f6b5f68e ($5.93 in chips)
Seat 3: a420712c ($8.61 in chips)
Seat 4: Hero ($11.03 in chips)
Seat 5: 8014c02 ($13.48 in chips)
Seat 6: 17be45ec ($5.77 in chips)
f6b5f68e: posts small blind $0.02
a420712c: posts big blind $0.05
*** HOLE CARDS ***
Dealt to 129846c0 
Dealt to f6b5f68e 
Dealt to a420712c 
Dealt to Hero [5h 8s]
Dealt to 8014c02 
Dealt to 17be45ec 
Hero: folds
8014c02: folds
17be45ec: raises $0.05 to $0.1
129846c0: folds
f6b5f68e: folds
a420712c: folds
Uncalled bet ($0.05) returned to 17be45ec
*** SHOWDOWN ***
17be45ec collected $0.12 from pot
*** SUMMARY ***
Total pot $0.12 | Rake $0 | Jackpot $0 | Bingo $0 | Fortune $0 | Tax $0
Seat 1: 129846c0 (button) folded before Flop (didn't bet)
Seat 2: f6b5f68e (small blind) folded before Flop
Seat 3: a420712c (big blind) folded before Flop
Seat 4: Hero folded before Flop (didn't bet)
Seat 5: 8014c02 folded before Flop (didn't bet)
Seat 6: 17be45ec collected ($0.12)


Poker Hand #RC2078544340: Hold'em No Limit ($0.02/$0.05) - 2023/12/22 21:53:53
Table 'RushAndCash801755' 6-max Seat #1 is the button
Seat 1: ab8d3eb5 ($5.43 in chips)
Seat 2: Hero ($10.44 in chips)
Seat 3: 90b5844 ($4.98 in chips)
Seat 4: 49a9584 ($5.08 in chips)
Seat 5: 9b5806d5 ($5.02 in chips)
Seat 6: 17e936 ($5 in chips)
Hero: posts small blind $0.02
90b5844: posts big blind $0.05
*** HOLE CARDS ***
Dealt to ab8d3eb5 
Dealt to Hero [Ad Jc]
Dealt to 90b5844 
Dealt to 49a9584 
Dealt to 9b5806d5 
Dealt to 17e936 
49a9584: folds
9b5806d5: raises $0.07 to $0.12
17e936: folds
ab8d3eb5: folds
Hero: calls $0.1
90b5844: folds
*** FLOP *** [9d Ts Jd]
Hero: checks
9b5806d5: bets $0.16
Hero: calls $0.16
*** TURN *** [9d Ts Jd] [2c]
Hero: checks
9b5806d5: bets $0.32
Hero: calls $0.32
*** RIVER *** [9d Ts Jd 2c] [5c]
Hero: checks
9b5806d5: checks
Hero: shows [Ad Jc] (Pair of Jacks)
9b5806d5: shows [Qs Js] (Pair of Jacks)
*** SHOWDOWN ***
Hero collected $1.19 from pot
*** SUMMARY ***
Total pot $1.25 | Rake $0.06 | Jackpot $0 | Bingo $0 | Fortune $0 | Tax $0
Board [9d Ts Jd 2c 5c]
Seat 1: ab8d3eb5 (button) folded before Flop (didn't bet)
Seat 2: Hero (small blind) showed [Ad Jc] and won ($1.19) with Pair of Jacks
Seat 3: 90b5844 (big blind) folded before Flop
Seat 4: 49a9584 folded before Flop (didn't bet)
Seat 5: 9b5806d5 showed [Qs Js] and lost with Pair of Jacks
Seat 6: 17e936 folded before Flop (didn't bet)


Poker Hand #RC2078544247: Hold'em No Limit ($0.02/$0.05) - 2023/12/22 21:53:48
Table 'RushAndCash801706' 6-max Seat #1 is the button
Seat 1: 42e18915 ($7.18 in chips)
Seat 2: c71b7029 ($9.88 in chips)
Seat 3: 9d5d55a2 ($5.05 in chips)
Seat 4: eab48ced ($5.5 in chips)
Seat 5: Hero ($10.44 in chips)
Seat 6: a7f7b0f3 ($5.09 in chips)
c71b7029: posts small blind $0.02
9d5d55a2: posts big blind $0.05
*** HOLE CARDS ***
Dealt to 42e18915 
Dealt to c71b7029 
Dealt to 9d5d55a2 
Dealt to eab48ced 
Dealt to Hero [4s 8s]
Dealt to a7f7b0f3 
eab48ced: folds
Hero: folds
a7f7b0f3: folds
42e18915: folds
c71b7029: folds
Uncalled bet ($0.03) returned to 9d5d55a2
*** SHOWDOWN ***
9d5d55a2 collected $0.04 from pot
*** SUMMARY ***
Total pot $0.04 | Rake $0 | Jackpot $0 | Bingo $0 | Fortune $0 | Tax $0
Seat 1: 42e18915 (button) folded before Flop (didn't bet)
Seat 2: c71b7029 (small blind) folded before Flop
Seat 3: 9d5d55a2 (big blind) collected ($0.04)
Seat 4: eab48ced folded before Flop (didn't bet)
Seat 5: Hero folded before Flop (didn't bet)
Seat 6: a7f7b0f3 folded before Flop (didn't bet)


Poker Hand #RC2078544121: Hold'em No Limit ($0.02/$0.05) - 2023/12/22 21:53:41
Table 'RushAndCash801644' 6-max Seat #1 is the button
Seat 1: 1b4a662e ($5.11 in chips)
Seat 2: 2bb677ff ($5.67 in chips)
Seat 3: b3f18178 ($3.44 in chips)
Seat 4: 4879e77e ($4.94 in chips)
Seat 5: 6c75362e ($10.51 in chips)
Seat 6: Hero ($10.44 in chips)
2bb677ff: posts small blind $0.02
b3f18178: posts big blind $0.05
*** HOLE CARDS ***
Dealt to 1b4a662e 
Dealt to 2bb677ff 
Dealt to b3f18178 
Dealt to 4879e77e 
Dealt to 6c75362e 
Dealt to Hero [7d Kd]
4879e77e: raises $0.06 to $0.11
6c75362e: folds
Hero: folds
1b4a662e: folds
2bb677ff: folds
b3f18178: calls $0.06
*** FLOP *** [4d Ac Kh]
b3f18178: checks
4879e77e: bets $0.07
b3f18178: calls $0.07
*** TURN *** [4d Ac Kh] [Ks]
b3f18178: checks
4879e77e: checks
*** RIVER *** [4d Ac Kh Ks] [8d]
b3f18178: checks
4879e77e: bets $0.36
b3f18178: calls $0.36
4879e77e: shows [8s 8c] (Eights Full over Kings)
b3f18178: shows [Ah 9h] (Pair of Aces and Pair of Kings)
*** SHOWDOWN ***
4879e77e collected $1.05 from pot
*** SUMMARY ***
Total pot $1.1 | Rake $0.05 | Jackpot $0 | Bingo $0 | Fortune $0 | Tax $0
Board [4d Ac Kh Ks 8d]
Seat 1: 1b4a662e (button) folded before Flop (didn't bet)
Seat 2: 2bb677ff (small blind) folded before Flop
Seat 3: b3f18178 (big blind) showed [Ah 9h] and lost with Pair of Aces and Pair of Kings
Seat 4: 4879e77e showed [8s 8c] and won ($1.05) with Eights Full over Kings
Seat 5: 6c75362e folded before Flop (didn't bet)
Seat 6: Hero folded before Flop (didn't bet)


Poker Hand #RC2078543524: Hold'em No Limit ($0.02/$0.05) - 2023/12/22 21:53:06
Table 'RushAndCash801367' 6-max Seat #1 is the button
Seat 1: 4ab8a557 ($6.17 in chips)
Seat 2: e3e578eb ($5 in chips)
Seat 3: Hero ($10.49 in chips)
Seat 4: 4c3513b2 ($4.86 in chips)
Seat 5: bfc64a4a ($4.91 in chips)
Seat 6: 10106905 ($2.33 in chips)
e3e578eb: posts small blind $0.02
Hero: posts big blind $0.05
*** HOLE CARDS ***
Dealt to 4ab8a557 
Dealt to e3e578eb 
Dealt to Hero [8s 2d]
Dealt to 4c3513b2 
Dealt to bfc64a4a 
Dealt to 10106905 
4c3513b2: folds
bfc64a4a: folds
10106905: raises $0.1 to $0.15
4ab8a557: folds
e3e578eb: raises $0.45 to $0.6
Hero: folds
10106905: raises $1.73 to $2.33 and is all-in
e3e578eb: folds
Uncalled bet ($1.73) returned to 10106905
*** SHOWDOWN ***
10106905 collected $1.19 from pot
*** SUMMARY ***
Total pot $1.25 | Rake $0.06 | Jackpot $0 | Bingo $0 | Fortune $0 | Tax $0
Seat 1: 4ab8a557 (button) folded before Flop (didn't bet)
Seat 2: e3e578eb (small blind) folded before Flop
Seat 3: Hero (big blind) folded before Flop
Seat 4: 4c3513b2 folded before Flop (didn't bet)
Seat 5: bfc64a4a folded before Flop (didn't bet)
Seat 6: 10106905 collected ($1.19)


Poker Hand #RC2078543269: Hold'em No Limit ($0.02/$0.05) - 2023/12/22 21:52:50
Table 'RushAndCash801249' 6-max Seat #1 is the button
Seat 1: e519a9e8 ($14.85 in chips)
Seat 2: Hero ($10.51 in chips)
Seat 3: a3f6014b ($9.57 in chips)
Seat 4: 1be6b9fd ($17.06 in chips)
Seat 5: 3288926 ($7.73 in chips)
Seat 6: a7226c6 ($5 in chips)
Hero: posts small blind $0.02
a3f6014b: posts big blind $0.05
*** HOLE CARDS ***
Dealt to e519a9e8 
Dealt to Hero [Ac 7h]
Dealt to a3f6014b 
Dealt to 1be6b9fd 
Dealt to 3288926 
Dealt to a7226c6 
1be6b9fd: folds
3288926: folds
a7226c6: folds
e519a9e8: raises $0.07 to $0.12
Hero: folds
a3f6014b: folds
Uncalled bet ($0.07) returned to e519a9e8
*** SHOWDOWN ***
e519a9e8 collected $0.12 from pot
*** SUMMARY ***
Total pot $0.12 | Rake $0 | Jackpot $0 | Bingo $0 | Fortune $0 | Tax $0
Seat 1: e519a9e8 (button) collected ($0.12)
Seat 2: Hero (small blind) folded before Flop
Seat 3: a3f6014b (big blind) folded before Flop
Seat 4: 1be6b9fd folded before Flop (didn't bet)
Seat 5: 3288926 folded before Flop (didn't bet)
Seat 6: a7226c6 folded before Flop (didn't bet)


Poker Hand #RC2078543120: Hold'em No Limit ($0.02/$0.05) - 2023/12/22 21:52:41
Table 'RushAndCash801183' 6-max Seat #1 is the button
Seat 1: Hero ($10.51 in chips)
Seat 2: e519a9e8 ($14.87 in chips)
Seat 3: 2c867a7e ($11.77 in chips)
Seat 4: 48b86f00 ($5.08 in chips)
Seat 5: 235741f1 ($8.48 in chips)
Seat 6: d25e9ff3 ($5.79 in chips)
e519a9e8: posts small blind $0.02
2c867a7e: posts big blind $0.05
*** HOLE CARDS ***
Dealt to Hero [3s 3c]
Dealt to e519a9e8 
Dealt to 2c867a7e 
Dealt to 48b86f00 
Dealt to 235741f1 
Dealt to d25e9ff3 
48b86f00: raises $0.07 to $0.12
235741f1: raises $0.27 to $0.39
d25e9ff3: folds
Hero: folds
e519a9e8: folds
2c867a7e: folds
48b86f00: folds
Uncalled bet ($0.27) returned to 235741f1
*** SHOWDOWN ***
235741f1 collected $0.3 from pot
*** SUMMARY ***
Total pot $0.31 | Rake $0.01 | Jackpot $0 | Bingo $0 | Fortune $0 | Tax $0
Seat 1: Hero (button) folded before Flop (didn't bet)
Seat 2: e519a9e8 (small blind) folded before Flop
Seat 3: 2c867a7e (big blind) folded before Flop
Seat 4: 48b86f00 folded before Flop
Seat 5: 235741f1 collected ($0.3)
Seat 6: d25e9ff3 folded before Flop (didn't bet)


Poker Hand #RC2078543059: Hold'em No Limit ($0.02/$0.05) - 2023/12/22 21:52:38
Table 'RushAndCash801158' 6-max Seat #1 is the button
Seat 1: 8a6d1b ($10.31 in chips)
Seat 2: 4c3513b2 ($4.88 in chips)
Seat 3: c71b7029 ($9.95 in chips)
Seat 4: 8626eae9 ($6.05 in chips)
Seat 5: Hero ($10.51 in chips)
Seat 6: 95a5beb4 ($5.21 in chips)
4c3513b2: posts small blind $0.02
c71b7029: posts big blind $0.05
*** HOLE CARDS ***
Dealt to 8a6d1b 
Dealt to 4c3513b2 
Dealt to c71b7029 
Dealt to 8626eae9 
Dealt to Hero [7c 9s]
Dealt to 95a5beb4 
8626eae9: folds
Hero: folds
95a5beb4: raises $0.08 to $0.13
8a6d1b: calls $0.13
4c3513b2: folds
c71b7029: folds
*** FLOP *** [Ac 6d 5s]
95a5beb4: checks
8a6d1b: checks
*** TURN *** [Ac 6d 5s] [2s]
95a5beb4: bets $0.27
8a6d1b: folds
Uncalled bet ($0.27) returned to 95a5beb4
*** SHOWDOWN ***
95a5beb4 collected $0.32 from pot
*** SUMMARY ***
Total pot $0.33 | Rake $0.01 | Jackpot $0 | Bingo $0 | Fortune $0 | Tax $0
Board [Ac 6d 5s 2s]
Seat 1: 8a6d1b (button) folded on the Turn
Seat 2: 4c3513b2 (small blind) folded before Flop
Seat 3: c71b7029 (big blind) folded before Flop
Seat 4: 8626eae9 folded before Flop (didn't bet)
Seat 5: Hero folded before Flop (didn't bet)
Seat 6: 95a5beb4 won ($0.32)


Poker Hand #RC2078542988: Hold'em No Limit ($0.02/$0.05) - 2023/12/22 21:52:34
Table 'RushAndCash801128' 6-max Seat #1 is the button
Seat 1: 2fb7c647 ($2.43 in chips)
Seat 2: 53246866 ($5 in chips)
Seat 3: Hero ($10.56 in chips)
Seat 4: efbf8ee8 ($6.62 in chips)
Seat 5: f4866d35 ($1 in chips)
Seat 6: 3d929f9f ($8.9 in chips)
53246866: posts small blind $0.02
Hero: posts big blind $0.05
*** HOLE CARDS ***
Dealt to 2fb7c647 
Dealt to 53246866 
Dealt to Hero [8s Qd]
Dealt to efbf8ee8 
Dealt to f4866d35 
Dealt to 3d929f9f 
efbf8ee8: folds
f4866d35: folds
3d929f9f: folds
2fb7c647: raises $0.1 to $0.15
53246866: folds
Hero: folds
Uncalled bet ($0.1) returned to 2fb7c647
*** SHOWDOWN ***
2fb7c647 collected $0.12 from pot
*** SUMMARY ***
Total pot $0.12 | Rake $0 | Jackpot $0 | Bingo $0 | Fortune $0 | Tax $0
Seat 1: 2fb7c647 (button) collected ($0.12)
Seat 2: 53246866 (small blind) folded before Flop
Seat 3: Hero (big blind) folded before Flop
Seat 4: efbf8ee8 folded before Flop (didn't bet)
Seat 5: f4866d35 folded before Flop (didn't bet)
Seat 6: 3d929f9f folded before Flop (didn't bet)


Poker Hand #RC2078542925: Hold'em No Limit ($0.02/$0.05) - 2023/12/22 21:52:30
Table 'RushAndCash801098' 6-max Seat #1 is the button
Seat 1: 8626eae9 ($6.05 in chips)
Seat 2: 242358f0 ($5 in chips)
Seat 3: c84db7d6 ($4.42 in chips)
Seat 4: 6c4d56b8 ($5.23 in chips)
Seat 5: Hero ($10.56 in chips)
Seat 6: 2c867a7e ($11.7 in chips)
242358f0: posts small blind $0.02
c84db7d6: posts big blind $0.05
*** HOLE CARDS ***
Dealt to 8626eae9 
Dealt to 242358f0 
Dealt to c84db7d6 
Dealt to 6c4d56b8 
Dealt to Hero [7h 5c]
Dealt to 2c867a7e 
6c4d56b8: folds
Hero: folds
2c867a7e: raises $0.06 to $0.11
8626eae9: folds
242358f0: folds
c84db7d6: folds
Uncalled bet ($0.06) returned to 2c867a7e
*** SHOWDOWN ***
2c867a7e collected $0.12 from pot
*** SUMMARY ***
Total pot $0.12 | Rake $0 | Jackpot $0 | Bingo $0 | Fortune $0 | Tax $0
Seat 1: 8626eae9 (button) folded before Flop (didn't bet)
Seat 2: 242358f0 (small blind) folded before Flop
Seat 3: c84db7d6 (big blind) folded before Flop
Seat 4: 6c4d56b8 folded before Flop (didn't bet)
Seat 5: Hero folded before Flop (didn't bet)
Seat 6: 2c867a7e collected ($0.12)


Poker Hand #RC2078542866: Hold'em No Limit ($0.02/$0.05) - 2023/12/22 21:52:27
Table 'RushAndCash801072' 6-max Seat #1 is the button
Seat 1: 4760057b ($5.03 in chips)
Seat 2: 348e259a ($1.95 in chips)
Seat 3: aaeab039 ($5 in chips)
Seat 4: Hero ($10.56 in chips)
Seat 5: c84db7d6 ($4.42 in chips)
Seat 6: 19d300cc ($9.3 in chips)
348e259a: posts small blind $0.02
aaeab039: posts big blind $0.05
*** HOLE CARDS ***
Dealt to 4760057b 
Dealt to 348e259a 
Dealt to aaeab039 
Dealt to Hero [8h Th]
Dealt to c84db7d6 
Dealt to 19d300cc 
Hero: folds
c84db7d6: folds
19d300cc: raises $0.08 to $0.13
4760057b: folds
348e259a: folds
aaeab039: folds
Uncalled bet ($0.08) returned to 19d300cc
*** SHOWDOWN ***
19d300cc collected $0.12 from pot
*** SUMMARY ***
Total pot $0.12 | Rake $0 | Jackpot $0 | Bingo $0 | Fortune $0 | Tax $0
Seat 1: 4760057b (button) folded before Flop (didn't bet)
Seat 2: 348e259a (small blind) folded before Flop
Seat 3: aaeab039 (big blind) folded before Flop
Seat 4: Hero folded before Flop (didn't bet)
Seat 5: c84db7d6 folded before Flop (didn't bet)
Seat 6: 19d300cc collected ($0.12)


Poker Hand #RC2078542799: Hold'em No Limit ($0.02/$0.05) - 2023/12/22 21:52:23
Table 'RushAndCash801041' 6-max Seat #1 is the button
Seat 1: Hero ($10.56 in chips)
Seat 2: d4d7018e ($6.22 in chips)
Seat 3: 972d9171 ($11.05 in chips)
Seat 4: 3a55a6df ($11.2 in chips)
Seat 5: 5cb14769 ($9.21 in chips)
Seat 6: fcb65fa9 ($2.75 in chips)
d4d7018e: posts small blind $0.02
972d9171: posts big blind $0.05
*** HOLE CARDS ***
Dealt to Hero [Tc 9s]
Dealt to d4d7018e 
Dealt to 972d9171 
Dealt to 3a55a6df 
Dealt to 5cb14769 
Dealt to fcb65fa9 
3a55a6df: folds
5cb14769: folds
fcb65fa9: folds
Hero: folds
d4d7018e: folds
Uncalled bet ($0.03) returned to 972d9171
*** SHOWDOWN ***
972d9171 collected $0.04 from pot
*** SUMMARY ***
Total pot $0.04 | Rake $0 | Jackpot $0 | Bingo $0 | Fortune $0 | Tax $0
Seat 1: Hero (button) folded before Flop (didn't bet)
Seat 2: d4d7018e (small blind) folded before Flop
Seat 3: 972d9171 (big blind) collected ($0.04)
Seat 4: 3a55a6df folded before Flop (didn't bet)
Seat 5: 5cb14769 folded before Flop (didn't bet)
Seat 6: fcb65fa9 folded before Flop (didn't bet)


Poker Hand #RC2078542686: Hold'em No Limit ($0.02/$0.05) - 2023/12/22 21:52:16
Table 'RushAndCash800991' 6-max Seat #1 is the button
Seat 1: a75d4daa ($5.42 in chips)
Seat 2: Hero ($10.58 in chips)
Seat 3: 97876c28 ($5.14 in chips)
Seat 4: 1826138f ($5 in chips)
Seat 5: 851fc2ef ($10.35 in chips)
Seat 6: c550b71c ($5.38 in chips)
Hero: posts small blind $0.02
97876c28: posts big blind $0.05
*** HOLE CARDS ***
Dealt to a75d4daa 
Dealt to Hero [9s Kh]
Dealt to 97876c28 
Dealt to 1826138f 
Dealt to 851fc2ef 
Dealt to c550b71c 
1826138f: folds
851fc2ef: folds
c550b71c: folds
a75d4daa: raises $0.08 to $0.13
Hero: folds
97876c28: calls $0.08
*** FLOP *** [Jd Ac Td]
97876c28: checks
a75d4daa: checks
*** TURN *** [Jd Ac Td] [Kd]
97876c28: checks
a75d4daa: checks
*** RIVER *** [Jd Ac Td Kd] [2h]
97876c28: checks
a75d4daa: checks
97876c28: shows [8h 8s] (Pair of Eights)
a75d4daa: shows [6d 7s] (Ace-High)
*** SHOWDOWN ***
97876c28 collected $0.27 from pot
*** SUMMARY ***
Total pot $0.28 | Rake $0.01 | Jackpot $0 | Bingo $0 | Fortune $0 | Tax $0
Board [Jd Ac Td Kd 2h]
Seat 1: a75d4daa (button) showed [6d 7s] and lost with Ace-High
Seat 2: Hero (small blind) folded before Flop
Seat 3: 97876c28 (big blind) showed [8h 8s] and won ($0.27) with Pair of Eights
Seat 4: 1826138f folded before Flop (didn't bet)
Seat 5: 851fc2ef folded before Flop (didn't bet)
Seat 6: c550b71c folded before Flop (didn't bet)


Poker Hand #RC2078542553: Hold'em No Limit ($0.02/$0.05) - 2023/12/22 21:52:09
Table 'RushAndCash800923' 6-max Seat #1 is the button
Seat 1: b77cfdca ($5.32 in chips)
Seat 2: Hero ($10.6 in chips)
Seat 3: 801c157f ($28.18 in chips)
Seat 4: 6d679d40 ($6.56 in chips)
Seat 5: 5f11c3da ($15.72 in chips)
Seat 6: 645d1c61 ($0.94 in chips)
Hero: posts small blind $0.02
801c157f: posts big blind $0.05
*** HOLE CARDS ***
Dealt to b77cfdca 
Dealt to Hero [5d 2h]
Dealt to 801c157f 
Dealt to 6d679d40 
Dealt to 5f11c3da 
Dealt to 645d1c61 
6d679d40: folds
5f11c3da: folds
645d1c61: folds
b77cfdca: folds
Hero: folds
Uncalled bet ($0.03) returned to 801c157f
*** SHOWDOWN ***
801c157f collected $0.04 from pot
*** SUMMARY ***
Total pot $0.04 | Rake $0 | Jackpot $0 | Bingo $0 | Fortune $0 | Tax $0
Seat 1: b77cfdca (button) folded before Flop (didn't bet)
Seat 2: Hero (small blind) folded before Flop
Seat 3: 801c157f (big blind) collected ($0.04)
Seat 4: 6d679d40 folded before Flop (didn't bet)
Seat 5: 5f11c3da folded before Flop (didn't bet)
Seat 6: 645d1c61 folded before Flop (didn't bet)


Poker Hand #RC2078542153: Hold'em No Limit ($0.02/$0.05) - 2023/12/22 21:51:47
Table 'RushAndCash800730' 6-max Seat #1 is the button
Seat 1: 5cb14769 ($9.3 in chips)
Seat 2: 4a7d05b1 ($4.11 in chips)
Seat 3: 6fc982d6 ($5 in chips)
Seat 4: 2f2fbc2 ($2.57 in chips)
Seat 5: b3e85c60 ($13.88 in chips)
Seat 6: Hero ($10.53 in chips)
4a7d05b1: posts small blind $0.02
6fc982d6: posts big blind $0.05
*** HOLE CARDS ***
Dealt to 5cb14769 
Dealt to 4a7d05b1 
Dealt to 6fc982d6 
Dealt to 2f2fbc2 
Dealt to b3e85c60 
Dealt to Hero [8d Kd]
2f2fbc2: folds
b3e85c60: folds
Hero: raises $0.05 to $0.1
5cb14769: folds
4a7d05b1: folds
6fc982d6: folds
Uncalled bet ($0.05) returned to Hero
*** SHOWDOWN ***
Hero collected $0.12 from pot
*** SUMMARY ***
Total pot $0.12 | Rake $0 | Jackpot $0 | Bingo $0 | Fortune $0 | Tax $0
Seat 1: 5cb14769 (button) folded before Flop (didn't bet)
Seat 2: 4a7d05b1 (small blind) folded before Flop
Seat 3: 6fc982d6 (big blind) folded before Flop
Seat 4: 2f2fbc2 folded before Flop (didn't bet)
Seat 5: b3e85c60 folded before Flop (didn't bet)
Seat 6: Hero collected ($0.12)


Poker Hand #RC2078541894: Hold'em No Limit ($0.02/$0.05) - 2023/12/22 21:51:33
Table 'RushAndCash800600' 6-max Seat #1 is the button
Seat 1: 129846c0 ($5 in chips)
Seat 2: e62ff290 ($5 in chips)
Seat 3: ca88dd67 ($5.14 in chips)
Seat 4: 2f2fbc2 ($2.72 in chips)
Seat 5: Hero ($10.32 in chips)
Seat 6: 18f0f05c ($6.51 in chips)
e62ff290: posts small blind $0.02
ca88dd67: posts big blind $0.05
*** HOLE CARDS ***
Dealt to 129846c0 
Dealt to e62ff290 
Dealt to ca88dd67 
Dealt to 2f2fbc2 
Dealt to Hero [Qd Qc]
Dealt to 18f0f05c 
2f2fbc2: raises $0.1 to $0.15
Hero: raises $0.37 to $0.52
18f0f05c: folds
129846c0: folds
e62ff290: folds
ca88dd67: folds
2f2fbc2: folds
Uncalled bet ($0.37) returned to Hero
*** SHOWDOWN ***
Hero collected $0.36 from pot
*** SUMMARY ***
Total pot $0.37 | Rake $0.01 | Jackpot $0 | Bingo $0 | Fortune $0 | Tax $0
Seat 1: 129846c0 (button) folded before Flop (didn't bet)
Seat 2: e62ff290 (small blind) folded before Flop
Seat 3: ca88dd67 (big blind) folded before Flop
Seat 4: 2f2fbc2 folded before Flop
Seat 5: Hero collected ($0.36)
Seat 6: 18f0f05c folded before Flop (didn't bet)


Poker Hand #RC2078541640: Hold'em No Limit ($0.02/$0.05) - 2023/12/22 21:51:18
Table 'RushAndCash800471' 6-max Seat #1 is the button
Seat 1: b4f829a4 ($5 in chips)
Seat 2: a6b60e2c ($2.87 in chips)
Seat 3: Hero ($10.37 in chips)
Seat 4: c550b71c ($5.4 in chips)
Seat 5: 1594e0b ($7.19 in chips)
Seat 6: 4cfc823 ($5.81 in chips)
a6b60e2c: posts small blind $0.02
Hero: posts big blind $0.05
*** HOLE CARDS ***
Dealt to b4f829a4 
Dealt to a6b60e2c 
Dealt to Hero [4s Ac]
Dealt to c550b71c 
Dealt to 1594e0b 
Dealt to 4cfc823 
c550b71c: folds
1594e0b: folds
4cfc823: raises $0.08 to $0.13
b4f829a4: folds
a6b60e2c: raises $0.24 to $0.37
Hero: folds
4cfc823: folds
Uncalled bet ($0.24) returned to a6b60e2c
*** SHOWDOWN ***
a6b60e2c collected $0.3 from pot
*** SUMMARY ***
Total pot $0.31 | Rake $0.01 | Jackpot $0 | Bingo $0 | Fortune $0 | Tax $0
Seat 1: b4f829a4 (button) folded before Flop (didn't bet)
Seat 2: a6b60e2c (small blind) collected ($0.3)
Seat 3: Hero (big blind) folded before Flop
Seat 4: c550b71c folded before Flop (didn't bet)
Seat 5: 1594e0b folded before Flop (didn't bet)
Seat 6: 4cfc823 folded before Flop


Poker Hand #RC2078541570: Hold'em No Limit ($0.02/$0.05) - 2023/12/22 21:51:13
Table 'RushAndCash800439' 6-max Seat #1 is the button
Seat 1: fa7bd554 ($6.09 in chips)
Seat 2: 19915c5a ($10.85 in chips)
Seat 3: 57896c91 ($6.16 in chips)
Seat 4: Hero ($10.37 in chips)
Seat 5: edb6154b ($7.46 in chips)
Seat 6: 84d4f92c ($7.78 in chips)
19915c5a: posts small blind $0.02
57896c91: posts big blind $0.05
*** HOLE CARDS ***
Dealt to fa7bd554 
Dealt to 19915c5a 
Dealt to 57896c91 
Dealt to Hero [7d Qd]
Dealt to edb6154b 
Dealt to 84d4f92c 
Hero: folds
edb6154b: folds
84d4f92c: folds
fa7bd554: raises $0.08 to $0.13
19915c5a: folds
57896c91: folds
Uncalled bet ($0.08) returned to fa7bd554
*** SHOWDOWN ***
fa7bd554 collected $0.12 from pot
*** SUMMARY ***
Total pot $0.12 | Rake $0 | Jackpot $0 | Bingo $0 | Fortune $0 | Tax $0
Seat 1: fa7bd554 (button) collected ($0.12)
Seat 2: 19915c5a (small blind) folded before Flop
Seat 3: 57896c91 (big blind) folded before Flop
Seat 4: Hero folded before Flop (didn't bet)
Seat 5: edb6154b folded before Flop (didn't bet)
Seat 6: 84d4f92c folded before Flop (didn't bet)


Poker Hand #RC2078541516: Hold'em No Limit ($0.02/$0.05) - 2023/12/22 21:51:10
Table 'RushAndCash800412' 6-max Seat #1 is the button
Seat 1: Hero ($10.37 in chips)
Seat 2: 3160ff3c ($15.22 in chips)
Seat 3: e789f462 ($1.75 in chips)
Seat 4: d393ec26 ($5.42 in chips)
Seat 5: 6db75c19 ($12.12 in chips)
Seat 6: ca0b098f ($5.16 in chips)
3160ff3c: posts small blind $0.02
e789f462: posts big blind $0.05
*** HOLE CARDS ***
Dealt to Hero [6c 3c]
Dealt to 3160ff3c 
Dealt to e789f462 
Dealt to d393ec26 
Dealt to 6db75c19 
Dealt to ca0b098f 
d393ec26: folds
6db75c19: raises $0.08 to $0.13
ca0b098f: folds
Hero: folds
3160ff3c: folds
e789f462: calls $0.08
*** FLOP *** [4s Qc As]
e789f462: checks
6db75c19: bets $0.07
e789f462: folds
Uncalled bet ($0.07) returned to 6db75c19
*** SHOWDOWN ***
6db75c19 collected $0.27 from pot
*** SUMMARY ***
Total pot $0.28 | Rake $0.01 | Jackpot $0 | Bingo $0 | Fortune $0 | Tax $0
Board [4s Qc As]
Seat 1: Hero (button) folded before Flop (didn't bet)
Seat 2: 3160ff3c (small blind) folded before Flop
Seat 3: e789f462 (big blind) folded on the Flop
Seat 4: d393ec26 folded before Flop (didn't bet)
Seat 5: 6db75c19 won ($0.27)
Seat 6: ca0b098f folded before Flop (didn't bet)


Poker Hand #RC2078541467: Hold'em No Limit ($0.02/$0.05) - 2023/12/22 21:51:07
Table 'RushAndCash800390' 6-max Seat #1 is the button
Seat 1: 354a07bb ($7.55 in chips)
Seat 2: 93990934 ($5 in chips)
Seat 3: e8e3d92 ($5 in chips)
Seat 4: 8d94440d ($5.14 in chips)
Seat 5: d32741ba ($11.94 in chips)
Seat 6: Hero ($10.37 in chips)
93990934: posts small blind $0.02
e8e3d92: posts big blind $0.05
*** HOLE CARDS ***
Dealt to 354a07bb 
Dealt to 93990934 
Dealt to e8e3d92 
Dealt to 8d94440d 
Dealt to d32741ba 
Dealt to Hero [2h Jc]
8d94440d: folds
d32741ba: raises $0.08 to $0.13
Hero: folds
354a07bb: folds
93990934: folds
e8e3d92: folds
Uncalled bet ($0.08) returned to d32741ba
*** SHOWDOWN ***
d32741ba collected $0.12 from pot
*** SUMMARY ***
Total pot $0.12 | Rake $0 | Jackpot $0 | Bingo $0 | Fortune $0 | Tax $0
Seat 1: 354a07bb (button) folded before Flop (didn't bet)
Seat 2: 93990934 (small blind) folded before Flop
Seat 3: e8e3d92 (big blind) folded before Flop
Seat 4: 8d94440d folded before Flop (didn't bet)
Seat 5: d32741ba collected ($0.12)
Seat 6: Hero folded before Flop (didn't bet)


Poker Hand #RC2078541411: Hold'em No Limit ($0.02/$0.05) - 2023/12/22 21:51:03
Table 'RushAndCash800363' 6-max Seat #1 is the button
Seat 1: e99cedcc ($5.84 in chips)
Seat 2: ae67cc8b ($6.74 in chips)
Seat 3: acefe34e ($5.07 in chips)
Seat 4: f938f1e ($5.24 in chips)
Seat 5: Hero ($10.37 in chips)
Seat 6: 14f02886 ($5 in chips)
ae67cc8b: posts small blind $0.02
acefe34e: posts big blind $0.05
*** HOLE CARDS ***
Dealt to e99cedcc 
Dealt to ae67cc8b 
Dealt to acefe34e 
Dealt to f938f1e 
Dealt to Hero [5h Ac]
Dealt to 14f02886 
f938f1e: folds
Hero: folds
14f02886: raises $0.1 to $0.15
e99cedcc: raises $0.31 to $0.46
ae67cc8b: folds
acefe34e: folds
14f02886: folds
Uncalled bet ($0.31) returned to e99cedcc
*** SHOWDOWN ***
e99cedcc collected $0.36 from pot
*** SUMMARY ***
Total pot $0.37 | Rake $0.01 | Jackpot $0 | Bingo $0 | Fortune $0 | Tax $0
Seat 1: e99cedcc (button) collected ($0.36)
Seat 2: ae67cc8b (small blind) folded before Flop
Seat 3: acefe34e (big blind) folded before Flop
Seat 4: f938f1e folded before Flop (didn't bet)
Seat 5: Hero folded before Flop (didn't bet)
Seat 6: 14f02886 folded before Flop


Poker Hand #RC2078541360: Hold'em No Limit ($0.02/$0.05) - 2023/12/22 21:51:00
Table 'RushAndCash800337' 6-max Seat #1 is the button
Seat 1: 6c4d56b8 ($5.22 in chips)
Seat 2: 95bbee71 ($9.94 in chips)
Seat 3: 26a46ed7 ($6.81 in chips)
Seat 4: 9c51ae09 ($5 in chips)
Seat 5: Hero ($10.37 in chips)
Seat 6: eeb37e34 ($11.6 in chips)
95bbee71: posts small blind $0.02
26a46ed7: posts big blind $0.05
*** HOLE CARDS ***
Dealt to 6c4d56b8 
Dealt to 95bbee71 
Dealt to 26a46ed7 
Dealt to 9c51ae09 
Dealt to Hero [5c 8s]
Dealt to eeb37e34 
9c51ae09: raises $0.05 to $0.1
Hero: folds
eeb37e34: folds
6c4d56b8: folds
95bbee71: folds
26a46ed7: folds
Uncalled bet ($0.05) returned to 9c51ae09
*** SHOWDOWN ***
9c51ae09 collected $0.12 from pot
*** SUMMARY ***
Total pot $0.12 | Rake $0 | Jackpot $0 | Bingo $0 | Fortune $0 | Tax $0
Seat 1: 6c4d56b8 (button) folded before Flop (didn't bet)
Seat 2: 95bbee71 (small blind) folded before Flop
Seat 3: 26a46ed7 (big blind) folded before Flop
Seat 4: 9c51ae09 collected ($0.12)
Seat 5: Hero folded before Flop (didn't bet)
Seat 6: eeb37e34 folded before Flop (didn't bet)


Poker Hand #RC2078541302: Hold'em No Limit ($0.02/$0.05) - 2023/12/22 21:50:56
Table 'RushAndCash800308' 6-max Seat #1 is the button
Seat 1: Hero ($10.37 in chips)
Seat 2: 45bb3f0f ($5.15 in chips)
Seat 3: d6dcfaa3 ($5 in chips)
Seat 4: ae03a04e ($5.08 in chips)
Seat 5: 4542d7e7 ($4.44 in chips)
Seat 6: 6d679d40 ($5.82 in chips)
45bb3f0f: posts small blind $0.02
d6dcfaa3: posts big blind $0.05
*** HOLE CARDS ***
Dealt to Hero [5c 9h]
Dealt to 45bb3f0f 
Dealt to d6dcfaa3 
Dealt to ae03a04e 
Dealt to 4542d7e7 
Dealt to 6d679d40 
ae03a04e: folds
4542d7e7: folds
6d679d40: folds
Hero: folds
45bb3f0f: raises $0.1 to $0.15
d6dcfaa3: folds
Uncalled bet ($0.1) returned to 45bb3f0f
*** SHOWDOWN ***
45bb3f0f collected $0.1 from pot
*** SUMMARY ***
Total pot $0.1 | Rake $0 | Jackpot $0 | Bingo $0 | Fortune $0 | Tax $0
Seat 1: Hero (button) folded before Flop (didn't bet)
Seat 2: 45bb3f0f (small blind) collected ($0.1)
Seat 3: d6dcfaa3 (big blind) folded before Flop
Seat 4: ae03a04e folded before Flop (didn't bet)
Seat 5: 4542d7e7 folded before Flop (didn't bet)
Seat 6: 6d679d40 folded before Flop (didn't bet)


Poker Hand #RC2078541098: Hold'em No Limit ($0.02/$0.05) - 2023/12/22 21:50:45
Table 'RushAndCash800209' 6-max Seat #1 is the button
Seat 1: 11811683 ($7.91 in chips)
Seat 2: 6354b4bd ($5 in chips)
Seat 3: Hero ($10.35 in chips)
Seat 4: 1594e0b ($7.26 in chips)
Seat 5: 2e44f78e ($11.59 in chips)
Seat 6: f9ff013a ($5.07 in chips)
6354b4bd: posts small blind $0.02
Hero: posts big blind $0.05
*** HOLE CARDS ***
Dealt to 11811683 
Dealt to 6354b4bd 
Dealt to Hero [8c 3h]
Dealt to 1594e0b 
Dealt to 2e44f78e 
Dealt to f9ff013a 
1594e0b: folds
2e44f78e: folds
f9ff013a: folds
11811683: folds
6354b4bd: folds
Uncalled bet ($0.03) returned to Hero
*** SHOWDOWN ***
Hero collected $0.04 from pot
*** SUMMARY ***
Total pot $0.04 | Rake $0 | Jackpot $0 | Bingo $0 | Fortune $0 | Tax $0
Seat 1: 11811683 (button) folded before Flop (didn't bet)
Seat 2: 6354b4bd (small blind) folded before Flop
Seat 3: Hero (big blind) collected ($0.04)
Seat 4: 1594e0b folded before Flop (didn't bet)
Seat 5: 2e44f78e folded before Flop (didn't bet)
Seat 6: f9ff013a folded before Flop (didn't bet)


Poker Hand #RC2078540894: Hold'em No Limit ($0.02/$0.05) - 2023/12/22 21:50:34
Table 'RushAndCash800118' 6-max Seat #1 is the button
Seat 1: 3933d58 ($5.05 in chips)
Seat 2: Hero ($10.37 in chips)
Seat 3: af92dfc8 ($7.34 in chips)
Seat 4: ae03a04e ($5.08 in chips)
Seat 5: f4b75c57 ($4.51 in chips)
Seat 6: 8a6d1b ($9.98 in chips)
Hero: posts small blind $0.02
af92dfc8: posts big blind $0.05
*** HOLE CARDS ***
Dealt to 3933d58 
Dealt to Hero [Kh 7h]
Dealt to af92dfc8 
Dealt to ae03a04e 
Dealt to f4b75c57 
Dealt to 8a6d1b 
ae03a04e: folds
f4b75c57: raises $0.1 to $0.15
8a6d1b: folds
3933d58: folds
Hero: folds
af92dfc8: folds
Uncalled bet ($0.1) returned to f4b75c57
*** SHOWDOWN ***
f4b75c57 collected $0.12 from pot
*** SUMMARY ***
Total pot $0.12 | Rake $0 | Jackpot $0 | Bingo $0 | Fortune $0 | Tax $0
Seat 1: 3933d58 (button) folded before Flop (didn't bet)
Seat 2: Hero (small blind) folded before Flop
Seat 3: af92dfc8 (big blind) folded before Flop
Seat 4: ae03a04e folded before Flop (didn't bet)
Seat 5: f4b75c57 collected ($0.12)
Seat 6: 8a6d1b folded before Flop (didn't bet)


Poker Hand #RC2078540830: Hold'em No Limit ($0.02/$0.05) - 2023/12/22 21:50:30
Table 'RushAndCash800089' 6-max Seat #1 is the button
Seat 1: d25e9ff3 ($5.58 in chips)
Seat 2: 1453842b ($5 in chips)
Seat 3: 622d6af4 ($20.16 in chips)
Seat 4: Hero ($10.37 in chips)
Seat 5: 725fcf25 ($5.43 in chips)
Seat 6: 8d94440d ($5.07 in chips)
1453842b: posts small blind $0.02
622d6af4: posts big blind $0.05
*** HOLE CARDS ***
Dealt to d25e9ff3 
Dealt to 1453842b 
Dealt to 622d6af4 
Dealt to Hero [As 7c]
Dealt to 725fcf25 
Dealt to 8d94440d 
Hero: folds
725fcf25: folds
8d94440d: folds
d25e9ff3: folds
1453842b: folds
Uncalled bet ($0.03) returned to 622d6af4
*** SHOWDOWN ***
622d6af4 collected $0.04 from pot
*** SUMMARY ***
Total pot $0.04 | Rake $0 | Jackpot $0 | Bingo $0 | Fortune $0 | Tax $0
Seat 1: d25e9ff3 (button) folded before Flop (didn't bet)
Seat 2: 1453842b (small blind) folded before Flop
Seat 3: 622d6af4 (big blind) collected ($0.04)
Seat 4: Hero folded before Flop (didn't bet)
Seat 5: 725fcf25 folded before Flop (didn't bet)
Seat 6: 8d94440d folded before Flop (didn't bet)


Poker Hand #RC2078540759: Hold'em No Limit ($0.02/$0.05) - 2023/12/22 21:50:26
Table 'RushAndCash800053' 6-max Seat #1 is the button
Seat 1: 851fc2ef ($10.39 in chips)
Seat 2: 29b0f5be ($6.7 in chips)
Seat 3: 373bc096 ($7.13 in chips)
Seat 4: Hero ($10.37 in chips)
Seat 5: 499dbd1a ($2.83 in chips)
Seat 6: c8c17adc ($8.07 in chips)
29b0f5be: posts small blind $0.02
373bc096: posts big blind $0.05
*** HOLE CARDS ***
Dealt to 851fc2ef 
Dealt to 29b0f5be 
Dealt to 373bc096 
Dealt to Hero [5d Js]
Dealt to 499dbd1a 
Dealt to c8c17adc 
Hero: folds
499dbd1a: folds
c8c17adc: raises $0.1 to $0.15
851fc2ef: folds
29b0f5be: folds
373bc096: folds
Uncalled bet ($0.1) returned to c8c17adc
*** SHOWDOWN ***
c8c17adc collected $0.12 from pot
*** SUMMARY ***
Total pot $0.12 | Rake $0 | Jackpot $0 | Bingo $0 | Fortune $0 | Tax $0
Seat 1: 851fc2ef (button) folded before Flop (didn't bet)
Seat 2: 29b0f5be (small blind) folded before Flop
Seat 3: 373bc096 (big blind) folded before Flop
Seat 4: Hero folded before Flop (didn't bet)
Seat 5: 499dbd1a folded before Flop (didn't bet)
Seat 6: c8c17adc collected ($0.12)


Poker Hand #RC2078540693: Hold'em No Limit ($0.02/$0.05) - 2023/12/22 21:50:22
Table 'RushAndCash800021' 6-max Seat #1 is the button
Seat 1: Hero ($10.37 in chips)
Seat 2: 81ecaac5 ($6.39 in chips)
Seat 3: 8d94440d ($5.12 in chips)
Seat 4: d0f6c873 ($6.68 in chips)
Seat 5: 9c51ae09 ($5 in chips)
Seat 6: d935a1ba ($5.63 in chips)
81ecaac5: posts small blind $0.02
8d94440d: posts big blind $0.05
*** HOLE CARDS ***
Dealt to Hero [Td 6d]
Dealt to 81ecaac5 
Dealt to 8d94440d 
Dealt to d0f6c873 
Dealt to 9c51ae09 
Dealt to d935a1ba 
d0f6c873: folds
9c51ae09: folds
d935a1ba: folds
Hero: folds
81ecaac5: calls $0.03
8d94440d: checks
*** FLOP *** [Kc 4h Kh]
81ecaac5: bets $0.05
8d94440d: folds
Uncalled bet ($0.05) returned to 81ecaac5
*** SHOWDOWN ***
81ecaac5 collected $0.1 from pot
*** SUMMARY ***
Total pot $0.1 | Rake $0 | Jackpot $0 | Bingo $0 | Fortune $0 | Tax $0
Board [Kc 4h Kh]
Seat 1: Hero (button) folded before Flop (didn't bet)
Seat 2: 81ecaac5 (small blind) won ($0.1)
Seat 3: 8d94440d (big blind) folded on the Flop
Seat 4: d0f6c873 folded before Flop (didn't bet)
Seat 5: 9c51ae09 folded before Flop (didn't bet)
Seat 6: d935a1ba folded before Flop (didn't bet)


Poker Hand #RC2078540605: Hold'em No Limit ($0.02/$0.05) - 2023/12/22 21:50:17
Table 'RushAndCash799975' 6-max Seat #1 is the button
Seat 1: 956b2f28 ($5.79 in chips)
Seat 2: f9ff013a ($5.02 in chips)
Seat 3: dc851cb6 ($12.08 in chips)
Seat 4: Hero ($10.37 in chips)
Seat 5: 10def899 ($5.7 in chips)
Seat 6: 8014c02 ($14.02 in chips)
f9ff013a: posts small blind $0.02
dc851cb6: posts big blind $0.05
*** HOLE CARDS ***
Dealt to 956b2f28 
Dealt to f9ff013a 
Dealt to dc851cb6 
Dealt to Hero [8s 5h]
Dealt to 10def899 
Dealt to 8014c02 
Hero: folds
10def899: raises $0.05 to $0.1
8014c02: folds
956b2f28: calls $0.1
f9ff013a: folds
dc851cb6: raises $0.38 to $0.48
10def899: folds
956b2f28: folds
Uncalled bet ($0.38) returned to dc851cb6
*** SHOWDOWN ***
dc851cb6 collected $0.31 from pot
*** SUMMARY ***
Total pot $0.32 | Rake $0.01 | Jackpot $0 | Bingo $0 | Fortune $0 | Tax $0
Seat 1: 956b2f28 (button) folded before Flop
Seat 2: f9ff013a (small blind) folded before Flop
Seat 3: dc851cb6 (big blind) collected ($0.31)
Seat 4: Hero folded before Flop (didn't bet)
Seat 5: 10def899 folded before Flop
Seat 6: 8014c02 folded before Flop (didn't bet)


Poker Hand #RC2078540486: Hold'em No Limit ($0.02/$0.05) - 2023/12/22 21:50:11
Table 'RushAndCash799915' 6-max Seat #1 is the button
Seat 1: b7c101a2 ($12.59 in chips)
Seat 2: Hero ($10.39 in chips)
Seat 3: 44681c1f ($11.24 in chips)
Seat 4: d0ea92a4 ($9.88 in chips)
Seat 5: bf28a393 ($5.07 in chips)
Seat 6: 3d929f9f ($9.32 in chips)
Hero: posts small blind $0.02
44681c1f: posts big blind $0.05
*** HOLE CARDS ***
Dealt to b7c101a2 
Dealt to Hero [9h 7c]
Dealt to 44681c1f 
Dealt to d0ea92a4 
Dealt to bf28a393 
Dealt to 3d929f9f 
d0ea92a4: folds
bf28a393: folds
3d929f9f: folds
b7c101a2: folds
Hero: folds
Uncalled bet ($0.03) returned to 44681c1f
*** SHOWDOWN ***
44681c1f collected $0.04 from pot
*** SUMMARY ***
Total pot $0.04 | Rake $0 | Jackpot $0 | Bingo $0 | Fortune $0 | Tax $0
Seat 1: b7c101a2 (button) folded before Flop (didn't bet)
Seat 2: Hero (small blind) folded before Flop
Seat 3: 44681c1f (big blind) collected ($0.04)
Seat 4: d0ea92a4 folded before Flop (didn't bet)
Seat 5: bf28a393 folded before Flop (didn't bet)
Seat 6: 3d929f9f folded before Flop (didn't bet)


Poker Hand #RC2078540420: Hold'em No Limit ($0.02/$0.05) - 2023/12/22 21:50:07
Table 'RushAndCash799881' 6-max Seat #1 is the button
Seat 1: 3a9b3c34 ($3.53 in chips)
Seat 2: f0040865 ($5.94 in chips)
Seat 3: 963f3a1f ($2.88 in chips)
Seat 4: a7076373 ($5.71 in chips)
Seat 5: Hero ($10.39 in chips)
Seat 6: 9e4b1c03 ($7.3 in chips)
f0040865: posts small blind $0.02
963f3a1f: posts big blind $0.05
*** HOLE CARDS ***
Dealt to 3a9b3c34 
Dealt to f0040865 
Dealt to 963f3a1f 
Dealt to a7076373 
Dealt to Hero [6c 2d]
Dealt to 9e4b1c03 
a7076373: folds
Hero: folds
9e4b1c03: folds
3a9b3c34: folds
f0040865: raises $0.1 to $0.15
963f3a1f: folds
Uncalled bet ($0.1) returned to f0040865
*** SHOWDOWN ***
f0040865 collected $0.1 from pot
*** SUMMARY ***
Total pot $0.1 | Rake $0 | Jackpot $0 | Bingo $0 | Fortune $0 | Tax $0
Seat 1: 3a9b3c34 (button) folded before Flop (didn't bet)
Seat 2: f0040865 (small blind) collected ($0.1)
Seat 3: 963f3a1f (big blind) folded before Flop
Seat 4: a7076373 folded before Flop (didn't bet)
Seat 5: Hero folded before Flop (didn't bet)
Seat 6: 9e4b1c03 folded before Flop (didn't bet)


Poker Hand #RC2078540363: Hold'em No Limit ($0.02/$0.05) - 2023/12/22 21:50:03
Table 'RushAndCash799851' 6-max Seat #1 is the button
Seat 1: 311eeba4 ($17.98 in chips)
Seat 2: f43dd94b ($5.3 in chips)
Seat 3: Hero ($10.44 in chips)
Seat 4: c8389234 ($12.01 in chips)
Seat 5: 7736e9f3 ($5 in chips)
Seat 6: fcd47b7a ($2.87 in chips)
f43dd94b: posts small blind $0.02
Hero: posts big blind $0.05
*** HOLE CARDS ***
Dealt to 311eeba4 
Dealt to f43dd94b 
Dealt to Hero [8s Qc]
Dealt to c8389234 
Dealt to 7736e9f3 
Dealt to fcd47b7a 
c8389234: raises $0.1 to $0.15
7736e9f3: folds
fcd47b7a: calls $0.15
311eeba4: folds
f43dd94b: folds
Hero: folds
*** FLOP *** [Qh Ks 2s]
c8389234: bets $0.19
fcd47b7a: calls $0.19
*** TURN *** [Qh Ks 2s] [7h]
c8389234: bets $0.5
fcd47b7a: calls $0.5
*** RIVER *** [Qh Ks 2s 7h] [8h]
c8389234: bets $1.16
fcd47b7a: folds
Uncalled bet ($1.16) returned to c8389234
c8389234: shows [As] (Ace-High)
*** SHOWDOWN ***
c8389234 collected $1.6 from pot
*** SUMMARY ***
Total pot $1.75 | Rake $0.08 | Jackpot $0.07 | Bingo $0 | Fortune $0 | Tax $0
Board [Qh Ks 2s 7h 8h]
Seat 1: 311eeba4 (button) folded before Flop (didn't bet)
Seat 2: f43dd94b (small blind) folded before Flop
Seat 3: Hero (big blind) folded before Flop
Seat 4: c8389234 showed [As] and won ($1.6)
Seat 5: 7736e9f3 folded before Flop (didn't bet)
Seat 6: fcd47b7a folded on the River


Poker Hand #RC2078540296: Hold'em No Limit ($0.02/$0.05) - 2023/12/22 21:50:00
Table 'RushAndCash799816' 6-max Seat #1 is the button
Seat 1: 84d4f92c ($7.63 in chips)
Seat 2: 7ea98c69 ($5 in chips)
Seat 3: 311eeba4 ($18.03 in chips)
Seat 4: 3056048f ($5.63 in chips)
Seat 5: ab5dffec ($6.48 in chips)
Seat 6: Hero ($10.44 in chips)
7ea98c69: posts small blind $0.02
311eeba4: posts big blind $0.05
*** HOLE CARDS ***
Dealt to 84d4f92c 
Dealt to 7ea98c69 
Dealt to 311eeba4 
Dealt to 3056048f 
Dealt to ab5dffec 
Dealt to Hero [Js 5c]
3056048f: folds
ab5dffec: folds
Hero: folds
84d4f92c: folds
7ea98c69: folds
Uncalled bet ($0.03) returned to 311eeba4
*** SHOWDOWN ***
311eeba4 collected $0.04 from pot
*** SUMMARY ***
Total pot $0.04 | Rake $0 | Jackpot $0 | Bingo $0 | Fortune $0 | Tax $0
Seat 1: 84d4f92c (button) folded before Flop (didn't bet)
Seat 2: 7ea98c69 (small blind) folded before Flop
Seat 3: 311eeba4 (big blind) collected ($0.04)
Seat 4: 3056048f folded before Flop (didn't bet)
Seat 5: ab5dffec folded before Flop (didn't bet)
Seat 6: Hero folded before Flop (didn't bet)


Poker Hand #RC2078539896: Hold'em No Limit ($0.02/$0.05) - 2023/12/22 21:49:36
Table 'RushAndCash799628' 6-max Seat #1 is the button
Seat 1: a1dfe2ad ($6.29 in chips)
Seat 2: Hero ($10.54 in chips)
Seat 3: 1e7880dc ($14.04 in chips)
Seat 4: fa93749b ($9.8 in chips)
Seat 5: e6f6623d ($4.31 in chips)
Seat 6: ae32912c ($5.04 in chips)
Hero: posts small blind $0.02
1e7880dc: posts big blind $0.05
*** HOLE CARDS ***
Dealt to a1dfe2ad 
Dealt to Hero [Tc 8c]
Dealt to 1e7880dc 
Dealt to fa93749b 
Dealt to e6f6623d 
Dealt to ae32912c 
fa93749b: folds
e6f6623d: folds
ae32912c: folds
a1dfe2ad: raises $0.05 to $0.1
Hero: calls $0.08
1e7880dc: raises $0.46 to $0.56
a1dfe2ad: calls $0.46
Hero: folds
*** FLOP *** [Qd 4c 7s]
1e7880dc: bets $0.41
a1dfe2ad: calls $0.41
*** TURN *** [Qd 4c 7s] [7d]
1e7880dc: bets $1.02
a1dfe2ad: folds
Uncalled bet ($1.02) returned to 1e7880dc
*** SHOWDOWN ***
1e7880dc collected $1.88 from pot
*** SUMMARY ***
Total pot $2.04 | Rake $0.09 | Jackpot $0.07 | Bingo $0 | Fortune $0 | Tax $0
Board [Qd 4c 7s 7d]
Seat 1: a1dfe2ad (button) folded on the Turn
Seat 2: Hero (small blind) folded before Flop
Seat 3: 1e7880dc (big blind) won ($1.88)
Seat 4: fa93749b folded before Flop (didn't bet)
Seat 5: e6f6623d folded before Flop (didn't bet)
Seat 6: ae32912c folded before Flop (didn't bet)


Poker Hand #RC2078539719: Hold'em No Limit ($0.02/$0.05) - 2023/12/22 21:49:26
Table 'RushAndCash799546' 6-max Seat #1 is the button
Seat 1: f06064a0 ($5.54 in chips)
Seat 2: 4e925dd0 ($5.57 in chips)
Seat 3: Hero ($10.59 in chips)
Seat 4: 8a1c58b7 ($13.2 in chips)
Seat 5: 373bc096 ($7.08 in chips)
Seat 6: a75d4daa ($5.14 in chips)
4e925dd0: posts small blind $0.02
Hero: posts big blind $0.05
*** HOLE CARDS ***
Dealt to f06064a0 
Dealt to 4e925dd0 
Dealt to Hero [Qs Tc]
Dealt to 8a1c58b7 
Dealt to 373bc096 
Dealt to a75d4daa 
8a1c58b7: folds
373bc096: raises $0.06 to $0.11
a75d4daa: folds
f06064a0: folds
4e925dd0: folds
Hero: folds
Uncalled bet ($0.06) returned to 373bc096
*** SHOWDOWN ***
373bc096 collected $0.12 from pot
*** SUMMARY ***
Total pot $0.12 | Rake $0 | Jackpot $0 | Bingo $0 | Fortune $0 | Tax $0
Seat 1: f06064a0 (button) folded before Flop (didn't bet)
Seat 2: 4e925dd0 (small blind) folded before Flop
Seat 3: Hero (big blind) folded before Flop
Seat 4: 8a1c58b7 folded before Flop (didn't bet)
Seat 5: 373bc096 collected ($0.12)
Seat 6: a75d4daa folded before Flop (didn't bet)


Poker Hand #RC2078539665: Hold'em No Limit ($0.02/$0.05) - 2023/12/22 21:49:23
Table 'RushAndCash799521' 6-max Seat #1 is the button
Seat 1: eb32f25a ($5 in chips)
Seat 2: c7726580 ($5 in chips)
Seat 3: 1fe12acf ($4.83 in chips)
Seat 4: Hero ($10.59 in chips)
Seat 5: 2f2fbc2 ($2.23 in chips)
Seat 6: 200bc0f9 ($6.62 in chips)
c7726580: posts small blind $0.02
1fe12acf: posts big blind $0.05
*** HOLE CARDS ***
Dealt to eb32f25a 
Dealt to c7726580 
Dealt to 1fe12acf 
Dealt to Hero [Js 2d]
Dealt to 2f2fbc2 
Dealt to 200bc0f9 
Hero: folds
2f2fbc2: folds
200bc0f9: folds
eb32f25a: folds
c7726580: folds
Uncalled bet ($0.03) returned to 1fe12acf
*** SHOWDOWN ***
1fe12acf collected $0.04 from pot
*** SUMMARY ***
Total pot $0.04 | Rake $0 | Jackpot $0 | Bingo $0 | Fortune $0 | Tax $0
Seat 1: eb32f25a (button) folded before Flop (didn't bet)
Seat 2: c7726580 (small blind) folded before Flop
Seat 3: 1fe12acf (big blind) collected ($0.04)
Seat 4: Hero folded before Flop (didn't bet)
Seat 5: 2f2fbc2 folded before Flop (didn't bet)
Seat 6: 200bc0f9 folded before Flop (didn't bet)


Poker Hand #RC2078539606: Hold'em No Limit ($0.02/$0.05) - 2023/12/22 21:49:19
Table 'RushAndCash799496' 6-max Seat #1 is the button
Seat 1: Hero ($10.59 in chips)
Seat 2: d7f451d5 ($9.35 in chips)
Seat 3: 102e4185 ($8.26 in chips)
Seat 4: 3bb1f7cc ($5 in chips)
Seat 5: 61343ab7 ($5.26 in chips)
Seat 6: 4e20b85a ($5 in chips)
d7f451d5: posts small blind $0.02
102e4185: posts big blind $0.05
*** HOLE CARDS ***
Dealt to Hero [3h 6s]
Dealt to d7f451d5 
Dealt to 102e4185 
Dealt to 3bb1f7cc 
Dealt to 61343ab7 
Dealt to 4e20b85a 
3bb1f7cc: folds
61343ab7: folds
4e20b85a: raises $0.06 to $0.11
Hero: folds
d7f451d5: folds
102e4185: folds
Uncalled bet ($0.06) returned to 4e20b85a
*** SHOWDOWN ***
4e20b85a collected $0.12 from pot
*** SUMMARY ***
Total pot $0.12 | Rake $0 | Jackpot $0 | Bingo $0 | Fortune $0 | Tax $0
Seat 1: Hero (button) folded before Flop (didn't bet)
Seat 2: d7f451d5 (small blind) folded before Flop
Seat 3: 102e4185 (big blind) folded before Flop
Seat 4: 3bb1f7cc folded before Flop (didn't bet)
Seat 5: 61343ab7 folded before Flop (didn't bet)
Seat 6: 4e20b85a collected ($0.12)


Poker Hand #RC2078539545: Hold'em No Limit ($0.02/$0.05) - 2023/12/22 21:49:15
Table 'RushAndCash799470' 6-max Seat #1 is the button
Seat 1: f2927765 ($6.94 in chips)
Seat 2: e527ebf4 ($5.6 in chips)
Seat 3: 6e8725eb ($5.36 in chips)
Seat 4: b4439dda ($6.38 in chips)
Seat 5: Hero ($10.59 in chips)
Seat 6: b9870dbd ($6.74 in chips)
e527ebf4: posts small blind $0.02
6e8725eb: posts big blind $0.05
*** HOLE CARDS ***
Dealt to f2927765 
Dealt to e527ebf4 
Dealt to 6e8725eb 
Dealt to b4439dda 
Dealt to Hero [8c 3s]
Dealt to b9870dbd 
b4439dda: raises $0.06 to $0.11
Hero: folds
b9870dbd: folds
f2927765: folds
e527ebf4: folds
6e8725eb: calls $0.06
*** FLOP *** [9s Jh Qh]
6e8725eb: bets $0.24
b4439dda: calls $0.24
*** TURN *** [9s Jh Qh] [Qd]
6e8725eb: checks
b4439dda: checks
*** RIVER *** [9s Jh Qh Qd] [2s]
6e8725eb: checks
b4439dda: bets $1
6e8725eb: calls $1
b4439dda: shows [Jd Js] (Jacks Full over Queens)
6e8725eb: shows [3h 3d] (Pair of Queens and Pair of Treys)
*** SHOWDOWN ***
b4439dda collected $2.52 from pot
*** SUMMARY ***
Total pot $2.72 | Rake $0.13 | Jackpot $0.07 | Bingo $0 | Fortune $0 | Tax $0
Board [9s Jh Qh Qd 2s]
Seat 1: f2927765 (button) folded before Flop (didn't bet)
Seat 2: e527ebf4 (small blind) folded before Flop
Seat 3: 6e8725eb (big blind) showed [3h 3d] and lost with Pair of Queens and Pair of Treys
Seat 4: b4439dda showed [Jd Js] and won ($2.52) with Jacks Full over Queens
Seat 5: Hero folded before Flop (didn't bet)
Seat 6: b9870dbd folded before Flop (didn't bet)


Poker Hand #RC2078539199: Hold'em No Limit ($0.02/$0.05) - 2023/12/22 21:48:56
Table 'RushAndCash799303' 6-max Seat #1 is the button
Seat 1: 308f9422 ($6 in chips)
Seat 2: cf8a8e96 ($8.68 in chips)
Seat 3: Hero ($10.69 in chips)
Seat 4: 18aade85 ($4.9 in chips)
Seat 5: 3f112fc ($5 in chips)
Seat 6: aeeb0181 ($11.88 in chips)
cf8a8e96: posts small blind $0.02
Hero: posts big blind $0.05
*** HOLE CARDS ***
Dealt to 308f9422 
Dealt to cf8a8e96 
Dealt to Hero [3d Jd]
Dealt to 18aade85 
Dealt to 3f112fc 
Dealt to aeeb0181 
18aade85: folds
3f112fc: folds
aeeb0181: folds
308f9422: raises $0.05 to $0.1
cf8a8e96: folds
Hero: calls $0.05
*** FLOP *** [2h Qs 2s]
Hero: checks
308f9422: bets $0.11
Hero: folds
Uncalled bet ($0.11) returned to 308f9422
*** SHOWDOWN ***
308f9422 collected $0.21 from pot
*** SUMMARY ***
Total pot $0.22 | Rake $0.01 | Jackpot $0 | Bingo $0 | Fortune $0 | Tax $0
Board [2h Qs 2s]
Seat 1: 308f9422 (button) won ($0.21)
Seat 2: cf8a8e96 (small blind) folded before Flop
Seat 3: Hero (big blind) folded on the Flop
Seat 4: 18aade85 folded before Flop (didn't bet)
Seat 5: 3f112fc folded before Flop (didn't bet)
Seat 6: aeeb0181 folded before Flop (didn't bet)


Poker Hand #RC2078539137: Hold'em No Limit ($0.02/$0.05) - 2023/12/22 21:48:52
Table 'RushAndCash799272' 6-max Seat #1 is the button
Seat 1: Hero ($10.69 in chips)
Seat 2: b0755516 ($5 in chips)
Seat 3: 7b8defcb ($5 in chips)
Seat 4: cf8a8e96 ($8.68 in chips)
Seat 5: 6d3488f1 ($7.94 in chips)
Seat 6: 8626eae9 ($7.56 in chips)
b0755516: posts small blind $0.02
7b8defcb: posts big blind $0.05
*** HOLE CARDS ***
Dealt to Hero [Ts Kc]
Dealt to b0755516 
Dealt to 7b8defcb 
Dealt to cf8a8e96 
Dealt to 6d3488f1 
Dealt to 8626eae9 
cf8a8e96: folds
6d3488f1: folds
8626eae9: folds
Hero: folds
b0755516: folds
Uncalled bet ($0.03) returned to 7b8defcb
*** SHOWDOWN ***
7b8defcb collected $0.04 from pot
*** SUMMARY ***
Total pot $0.04 | Rake $0 | Jackpot $0 | Bingo $0 | Fortune $0 | Tax $0
Seat 1: Hero (button) folded before Flop (didn't bet)
Seat 2: b0755516 (small blind) folded before Flop
Seat 3: 7b8defcb (big blind) collected ($0.04)
Seat 4: cf8a8e96 folded before Flop (didn't bet)
Seat 5: 6d3488f1 folded before Flop (didn't bet)
Seat 6: 8626eae9 folded before Flop (didn't bet)


Poker Hand #RC2078537966: Hold'em No Limit ($0.02/$0.05) - 2023/12/22 21:47:43
Table 'RushAndCash798694' 6-max Seat #1 is the button
Seat 1: c44d0590 ($7.62 in chips)
Seat 2: Hero ($11.02 in chips)
Seat 3: ca0b098f ($5.1 in chips)
Seat 4: 93d5c821 ($5.46 in chips)
Seat 5: 8626eae9 ($7.16 in chips)
Seat 6: 538e953f ($5.66 in chips)
Hero: posts small blind $0.02
ca0b098f: posts big blind $0.05
*** HOLE CARDS ***
Dealt to c44d0590 
Dealt to Hero [Ah 7h]
Dealt to ca0b098f 
Dealt to 93d5c821 
Dealt to 8626eae9 
Dealt to 538e953f 
93d5c821: folds
8626eae9: raises $0.05 to $0.1
538e953f: folds
c44d0590: folds
Hero: calls $0.08
ca0b098f: calls $0.05
*** FLOP *** [Ts 5c 9s]
Hero: checks
ca0b098f: checks
8626eae9: checks
*** TURN *** [Ts 5c 9s] [Ad]
Hero: checks
ca0b098f: checks
8626eae9: bets $0.23
Hero: calls $0.23
ca0b098f: folds
*** RIVER *** [Ts 5c 9s Ad] [Kd]
Hero: checks
8626eae9: bets $0.57
Hero: folds
Uncalled bet ($0.57) returned to 8626eae9
*** SHOWDOWN ***
8626eae9 collected $0.73 from pot
*** SUMMARY ***
Total pot $0.76 | Rake $0.03 | Jackpot $0 | Bingo $0 | Fortune $0 | Tax $0
Board [Ts 5c 9s Ad Kd]
Seat 1: c44d0590 (button) folded before Flop (didn't bet)
Seat 2: Hero (small blind) folded on the River
Seat 3: ca0b098f (big blind) folded on the Turn
Seat 4: 93d5c821 folded before Flop (didn't bet)
Seat 5: 8626eae9 won ($0.73)
Seat 6: 538e953f folded before Flop (didn't bet)


Poker Hand #RC2078537905: Hold'em No Limit ($0.02/$0.05) - 2023/12/22 21:47:39
Table 'RushAndCash798664' 6-max Seat #1 is the button
Seat 1: f0b0a5f9 ($19.85 in chips)
Seat 2: 4f704fa2 ($5.09 in chips)
Seat 3: de3b84bb ($28.58 in chips)
Seat 4: Hero ($11.02 in chips)
Seat 5: 93b1a4e4 ($11 in chips)
Seat 6: c6813ed5 ($8.95 in chips)
4f704fa2: posts small blind $0.02
de3b84bb: posts big blind $0.05
*** HOLE CARDS ***
Dealt to f0b0a5f9 
Dealt to 4f704fa2 
Dealt to de3b84bb 
Dealt to Hero [Ad 7s]
Dealt to 93b1a4e4 
Dealt to c6813ed5 
Hero: folds
93b1a4e4: folds
c6813ed5: folds
f0b0a5f9: folds
4f704fa2: folds
Uncalled bet ($0.03) returned to de3b84bb
*** SHOWDOWN ***
de3b84bb collected $0.04 from pot
*** SUMMARY ***
Total pot $0.04 | Rake $0 | Jackpot $0 | Bingo $0 | Fortune $0 | Tax $0
Seat 1: f0b0a5f9 (button) folded before Flop (didn't bet)
Seat 2: 4f704fa2 (small blind) folded before Flop
Seat 3: de3b84bb (big blind) collected ($0.04)
Seat 4: Hero folded before Flop (didn't bet)
Seat 5: 93b1a4e4 folded before Flop (didn't bet)
Seat 6: c6813ed5 folded before Flop (didn't bet)


Poker Hand #RC2078537846: Hold'em No Limit ($0.02/$0.05) - 2023/12/22 21:47:36
Table 'RushAndCash798635' 6-max Seat #1 is the button
Seat 1: 37e2503b ($7.11 in chips)
Seat 2: b0446474 ($13.05 in chips)
Seat 3: 8369fc6c ($6.79 in chips)
Seat 4: f766d59e ($4.86 in chips)
Seat 5: Hero ($11.02 in chips)
Seat 6: 18f0f05c ($7.62 in chips)
b0446474: posts small blind $0.02
8369fc6c: posts big blind $0.05
*** HOLE CARDS ***
Dealt to 37e2503b 
Dealt to b0446474 
Dealt to 8369fc6c 
Dealt to f766d59e 
Dealt to Hero [8s 5s]
Dealt to 18f0f05c 
f766d59e: folds
Hero: folds
18f0f05c: folds
37e2503b: raises $0.05 to $0.1
b0446474: folds
8369fc6c: folds
Uncalled bet ($0.05) returned to 37e2503b
*** SHOWDOWN ***
37e2503b collected $0.12 from pot
*** SUMMARY ***
Total pot $0.12 | Rake $0 | Jackpot $0 | Bingo $0 | Fortune $0 | Tax $0
Seat 1: 37e2503b (button) collected ($0.12)
Seat 2: b0446474 (small blind) folded before Flop
Seat 3: 8369fc6c (big blind) folded before Flop
Seat 4: f766d59e folded before Flop (didn't bet)
Seat 5: Hero folded before Flop (didn't bet)
Seat 6: 18f0f05c folded before Flop (didn't bet)


Poker Hand #RC2078537796: Hold'em No Limit ($0.02/$0.05) - 2023/12/22 21:47:32
Table 'RushAndCash798611' 6-max Seat #1 is the button
Seat 1: 90b5844 ($5.72 in chips)
Seat 2: b9870dbd ($5.78 in chips)
Seat 3: 83f47841 ($12 in chips)
Seat 4: f766d59e ($4.86 in chips)
Seat 5: Hero ($11.02 in chips)
Seat 6: 8e36a030 ($7.85 in chips)
b9870dbd: posts small blind $0.02
83f47841: posts big blind $0.05
*** HOLE CARDS ***
Dealt to 90b5844 
Dealt to b9870dbd 
Dealt to 83f47841 
Dealt to f766d59e 
Dealt to Hero [5c 8h]
Dealt to 8e36a030 
f766d59e: folds
Hero: folds
8e36a030: folds
90b5844: raises $0.05 to $0.1
b9870dbd: folds
83f47841: calls $0.05
*** FLOP *** [Jh 7s Kd]
83f47841: checks
90b5844: checks
*** TURN *** [Jh 7s Kd] [6c]
83f47841: bets $0.1
90b5844: calls $0.1
*** RIVER *** [Jh 7s Kd 6c] [5h]
83f47841: bets $0.14
90b5844: calls $0.14
83f47841: shows [Th 6h] (Pair of Sixes)
90b5844: shows [Qs Qc] (Pair of Queens)
*** SHOWDOWN ***
90b5844 collected $0.67 from pot
*** SUMMARY ***
Total pot $0.7 | Rake $0.03 | Jackpot $0 | Bingo $0 | Fortune $0 | Tax $0
Board [Jh 7s Kd 6c 5h]
Seat 1: 90b5844 (button) showed [Qs Qc] and won ($0.67) with Pair of Queens
Seat 2: b9870dbd (small blind) folded before Flop
Seat 3: 83f47841 (big blind) showed [Th 6h] and lost with Pair of Sixes
Seat 4: f766d59e folded before Flop (didn't bet)
Seat 5: Hero folded before Flop (didn't bet)
Seat 6: 8e36a030 folded before Flop (didn't bet)


Poker Hand #RC2078537731: Hold'em No Limit ($0.02/$0.05) - 2023/12/22 21:47:29
Table 'RushAndCash798581' 6-max Seat #1 is the button
Seat 1: Hero ($11.02 in chips)
Seat 2: 2e44f78e ($12.64 in chips)
Seat 3: 983d74a ($7.38 in chips)
Seat 4: 548ecbec ($7.86 in chips)
Seat 5: 2c88a657 ($6.17 in chips)
Seat 6: 886872c9 ($8.67 in chips)
2e44f78e: posts small blind $0.02
983d74a: posts big blind $0.05
*** HOLE CARDS ***
Dealt to Hero [9h 4c]
Dealt to 2e44f78e 
Dealt to 983d74a 
Dealt to 548ecbec 
Dealt to 2c88a657 
Dealt to 886872c9 
548ecbec: raises $0.08 to $0.13
2c88a657: folds
886872c9: folds
Hero: folds
2e44f78e: folds
983d74a: folds
Uncalled bet ($0.08) returned to 548ecbec
*** SHOWDOWN ***
548ecbec collected $0.12 from pot
*** SUMMARY ***
Total pot $0.12 | Rake $0 | Jackpot $0 | Bingo $0 | Fortune $0 | Tax $0
Seat 1: Hero (button) folded before Flop (didn't bet)
Seat 2: 2e44f78e (small blind) folded before Flop
Seat 3: 983d74a (big blind) folded before Flop
Seat 4: 548ecbec collected ($0.12)
Seat 5: 2c88a657 folded before Flop (didn't bet)
Seat 6: 886872c9 folded before Flop (didn't bet)


Poker Hand #RC2078537667: Hold'em No Limit ($0.02/$0.05) - 2023/12/22 21:47:25
Table 'RushAndCash798549' 6-max Seat #1 is the button
Seat 1: 7f009379 ($5 in chips)
Seat 2: 886872c9 ($8.69 in chips)
Seat 3: 1fc1f571 ($15.66 in chips)
Seat 4: 4b46876e ($7.04 in chips)
Seat 5: Hero ($11.02 in chips)
Seat 6: 9220db62 ($5.53 in chips)
886872c9: posts small blind $0.02
1fc1f571: posts big blind $0.05
*** HOLE CARDS ***
Dealt to 7f009379 
Dealt to 886872c9 
Dealt to 1fc1f571 
Dealt to 4b46876e 
Dealt to Hero [Jc 4s]
Dealt to 9220db62 
4b46876e: folds
Hero: folds
9220db62: raises $0.1 to $0.15
7f009379: folds
886872c9: folds
1fc1f571: folds
Uncalled bet ($0.1) returned to 9220db62
*** SHOWDOWN ***
9220db62 collected $0.12 from pot
*** SUMMARY ***
Total pot $0.12 | Rake $0 | Jackpot $0 | Bingo $0 | Fortune $0 | Tax $0
Seat 1: 7f009379 (button) folded before Flop (didn't bet)
Seat 2: 886872c9 (small blind) folded before Flop
Seat 3: 1fc1f571 (big blind) folded before Flop
Seat 4: 4b46876e folded before Flop (didn't bet)
Seat 5: Hero folded before Flop (didn't bet)
Seat 6: 9220db62 collected ($0.12)


Poker Hand #RC2078537569: Hold'em No Limit ($0.02/$0.05) - 2023/12/22 21:47:18
Table 'RushAndCash798500' 6-max Seat #1 is the button
Seat 1: f3afbdac ($4.46 in chips)
Seat 2: 2afe98d4 ($5.35 in chips)
Seat 3: f3d3c9ba ($10.33 in chips)
Seat 4: d935a1ba ($8.12 in chips)
Seat 5: Hero ($11.02 in chips)
Seat 6: 956b2f28 ($4.04 in chips)
2afe98d4: posts small blind $0.02
f3d3c9ba: posts big blind $0.05
*** HOLE CARDS ***
Dealt to f3afbdac 
Dealt to 2afe98d4 
Dealt to f3d3c9ba 
Dealt to d935a1ba 
Dealt to Hero [Ts Kh]
Dealt to 956b2f28 
d935a1ba: folds
Hero: folds
956b2f28: raises $0.1 to $0.15
f3afbdac: folds
2afe98d4: folds
f3d3c9ba: folds
Uncalled bet ($0.1) returned to 956b2f28
*** SHOWDOWN ***
956b2f28 collected $0.12 from pot
*** SUMMARY ***
Total pot $0.12 | Rake $0 | Jackpot $0 | Bingo $0 | Fortune $0 | Tax $0
Seat 1: f3afbdac (button) folded before Flop (didn't bet)
Seat 2: 2afe98d4 (small blind) folded before Flop
Seat 3: f3d3c9ba (big blind) folded before Flop
Seat 4: d935a1ba folded before Flop (didn't bet)
Seat 5: Hero folded before Flop (didn't bet)
Seat 6: 956b2f28 collected ($0.12)


Poker Hand #RC2078537385: Hold'em No Limit ($0.02/$0.05) - 2023/12/22 21:47:05
Table 'RushAndCash798406' 6-max Seat #1 is the button
Seat 1: ef1573b1 ($7.71 in chips)
Seat 2: 19d300cc ($5.64 in chips)
Seat 3: Hero ($11.07 in chips)
Seat 4: 8a94bd25 ($5.63 in chips)
Seat 5: 4c0d7324 ($7.57 in chips)
Seat 6: 11811683 ($6.49 in chips)
19d300cc: posts small blind $0.02
Hero: posts big blind $0.05
*** HOLE CARDS ***
Dealt to ef1573b1 
Dealt to 19d300cc 
Dealt to Hero [Jc 6s]
Dealt to 8a94bd25 
Dealt to 4c0d7324 
Dealt to 11811683 
8a94bd25: folds
4c0d7324: folds
11811683: raises $0.05 to $0.1
ef1573b1: folds
19d300cc: calls $0.08
Hero: folds
*** FLOP *** [9c Qh Kc]
19d300cc: checks
11811683: bets $0.13
19d300cc: calls $0.13
*** TURN *** [9c Qh Kc] [2h]
19d300cc: checks
11811683: checks
*** RIVER *** [9c Qh Kc 2h] [2s]
19d300cc: bets $0.55
11811683: calls $0.55
19d300cc: shows [6c 8c] (Pair of Twos)
11811683: shows [Ts Qs] (Pair of Queens and Pair of Twos)
*** SHOWDOWN ***
11811683 collected $1.47 from pot
*** SUMMARY ***
Total pot $1.61 | Rake $0.07 | Jackpot $0.07 | Bingo $0 | Fortune $0 | Tax $0
Board [9c Qh Kc 2h 2s]
Seat 1: ef1573b1 (button) folded before Flop (didn't bet)
Seat 2: 19d300cc (small blind) showed [6c 8c] and lost with Pair of Twos
Seat 3: Hero (big blind) folded before Flop
Seat 4: 8a94bd25 folded before Flop (didn't bet)
Seat 5: 4c0d7324 folded before Flop (didn't bet)
Seat 6: 11811683 showed [Ts Qs] and won ($1.47) with Pair of Queens and Pair of Twos


Poker Hand #RC2078537314: Hold'em No Limit ($0.02/$0.05) - 2023/12/22 21:47:00
Table 'RushAndCash798372' 6-max Seat #1 is the button
Seat 1: db83a6ff ($3.84 in chips)
Seat 2: Hero ($11.09 in chips)
Seat 3: b0446474 ($13.1 in chips)
Seat 4: 3d929f9f ($9.52 in chips)
Seat 5: edb6154b ($6.06 in chips)
Seat 6: b75c858f ($5 in chips)
Hero: posts small blind $0.02
b0446474: posts big blind $0.05
*** HOLE CARDS ***
Dealt to db83a6ff 
Dealt to Hero [9c 5d]
Dealt to b0446474 
Dealt to 3d929f9f 
Dealt to edb6154b 
Dealt to b75c858f 
3d929f9f: folds
edb6154b: raises $0.08 to $0.13
b75c858f: folds
db83a6ff: folds
Hero: folds
b0446474: folds
Uncalled bet ($0.08) returned to edb6154b
*** SHOWDOWN ***
edb6154b collected $0.12 from pot
*** SUMMARY ***
Total pot $0.12 | Rake $0 | Jackpot $0 | Bingo $0 | Fortune $0 | Tax $0
Seat 1: db83a6ff (button) folded before Flop (didn't bet)
Seat 2: Hero (small blind) folded before Flop
Seat 3: b0446474 (big blind) folded before Flop
Seat 4: 3d929f9f folded before Flop (didn't bet)
Seat 5: edb6154b collected ($0.12)
Seat 6: b75c858f folded before Flop (didn't bet)


Poker Hand #RC2078537221: Hold'em No Limit ($0.02/$0.05) - 2023/12/22 21:46:55
Table 'RushAndCash798331' 6-max Seat #1 is the button
Seat 1: 1b6c567d ($4.05 in chips)
Seat 2: c2881b52 ($8.42 in chips)
Seat 3: c320c189 ($9.01 in chips)
Seat 4: Hero ($11.09 in chips)
Seat 5: 834fcc3f ($8.06 in chips)
Seat 6: cddd79e8 ($5.17 in chips)
c2881b52: posts small blind $0.02
c320c189: posts big blind $0.05
*** HOLE CARDS ***
Dealt to 1b6c567d 
Dealt to c2881b52 
Dealt to c320c189 
Dealt to Hero [Ah 9d]
Dealt to 834fcc3f 
Dealt to cddd79e8 
Hero: folds
834fcc3f: folds
cddd79e8: folds
1b6c567d: raises $0.05 to $0.1
c2881b52: folds
c320c189: folds
Uncalled bet ($0.05) returned to 1b6c567d
*** SHOWDOWN ***
1b6c567d collected $0.12 from pot
*** SUMMARY ***
Total pot $0.12 | Rake $0 | Jackpot $0 | Bingo $0 | Fortune $0 | Tax $0
Seat 1: 1b6c567d (button) collected ($0.12)
Seat 2: c2881b52 (small blind) folded before Flop
Seat 3: c320c189 (big blind) folded before Flop
Seat 4: Hero folded before Flop (didn't bet)
Seat 5: 834fcc3f folded before Flop (didn't bet)
Seat 6: cddd79e8 folded before Flop (didn't bet)


Poker Hand #RC2078537166: Hold'em No Limit ($0.02/$0.05) - 2023/12/22 21:46:51
Table 'RushAndCash798303' 6-max Seat #1 is the button
Seat 1: b4aaf9de ($9.41 in chips)
Seat 2: d82e5b20 ($5.25 in chips)
Seat 3: 7aec2951 ($6.27 in chips)
Seat 4: Hero ($11.09 in chips)
Seat 5: 3910f1b8 ($4.93 in chips)
Seat 6: 354a07bb ($8.3 in chips)
d82e5b20: posts small blind $0.02
7aec2951: posts big blind $0.05
*** HOLE CARDS ***
Dealt to b4aaf9de 
Dealt to d82e5b20 
Dealt to 7aec2951 
Dealt to Hero [8d 3d]
Dealt to 3910f1b8 
Dealt to 354a07bb 
Hero: folds
3910f1b8: folds
354a07bb: folds
b4aaf9de: folds
d82e5b20: raises $0.08 to $0.13
7aec2951: calls $0.08
*** FLOP *** [Th Kd 7d]
d82e5b20: bets $0.09
7aec2951: calls $0.09
*** TURN *** [Th Kd 7d] [4c]
d82e5b20: checks
7aec2951: checks
*** RIVER *** [Th Kd 7d 4c] [9c]
d82e5b20: bets $0.33
7aec2951: calls $0.33
d82e5b20: shows [Ks As] (Pair of Kings)
7aec2951: shows [Ts Js] (Pair of Tens)
*** SHOWDOWN ***
d82e5b20 collected $1.05 from pot
*** SUMMARY ***
Total pot $1.1 | Rake $0.05 | Jackpot $0 | Bingo $0 | Fortune $0 | Tax $0
Board [Th Kd 7d 4c 9c]
Seat 1: b4aaf9de (button) folded before Flop (didn't bet)
Seat 2: d82e5b20 (small blind) showed [Ks As] and won ($1.05) with Pair of Kings
Seat 3: 7aec2951 (big blind) showed [Ts Js] and lost with Pair of Tens
Seat 4: Hero folded before Flop (didn't bet)
Seat 5: 3910f1b8 folded before Flop (didn't bet)
Seat 6: 354a07bb folded before Flop (didn't bet)


Poker Hand #RC2078536418: Hold'em No Limit ($0.02/$0.05) - 2023/12/22 21:46:08
Table 'RushAndCash797941' 6-max Seat #1 is the button
Seat 1: Hero ($10.49 in chips)
Seat 2: 354a07bb ($8.91 in chips)
Seat 3: 4ab8a557 ($7.18 in chips)
Seat 4: 76a1de63 ($5.33 in chips)
Seat 5: 73f6d035 ($7.55 in chips)
Seat 6: b61f5bde ($8.76 in chips)
354a07bb: posts small blind $0.02
4ab8a557: posts big blind $0.05
*** HOLE CARDS ***
Dealt to Hero [Ks Jh]
Dealt to 354a07bb 
Dealt to 4ab8a557 
Dealt to 76a1de63 
Dealt to 73f6d035 
Dealt to b61f5bde 
76a1de63: folds
73f6d035: folds
b61f5bde: folds
Hero: raises $0.08 to $0.13
354a07bb: calls $0.11
4ab8a557: folds
*** FLOP *** [3d 9s Js]
354a07bb: checks
Hero: bets $0.16
354a07bb: calls $0.16
*** TURN *** [3d 9s Js] [4c]
354a07bb: checks
Hero: bets $0.32
354a07bb: calls $0.32
*** RIVER *** [3d 9s Js 4c] [2s]
354a07bb: checks
Hero: checks
354a07bb: shows [5s 5c] (Pair of Fives)
Hero: shows [Ks Jh] (Pair of Jacks)
*** SHOWDOWN ***
Hero collected $1.21 from pot
*** SUMMARY ***
Total pot $1.27 | Rake $0.06 | Jackpot $0 | Bingo $0 | Fortune $0 | Tax $0
Board [3d 9s Js 4c 2s]
Seat 1: Hero (button) showed [Ks Jh] and won ($1.21) with Pair of Jacks
Seat 2: 354a07bb (small blind) showed [5s 5c] and lost with Pair of Fives
Seat 3: 4ab8a557 (big blind) folded before Flop
Seat 4: 76a1de63 folded before Flop (didn't bet)
Seat 5: 73f6d035 folded before Flop (didn't bet)
Seat 6: b61f5bde folded before Flop (didn't bet)


Poker Hand #RC2078536014: Hold'em No Limit ($0.02/$0.05) - 2023/12/22 21:45:45
Table 'RushAndCash797744' 6-max Seat #1 is the button
Seat 1: 93683449 ($6.74 in chips)
Seat 2: acefe839 ($13.56 in chips)
Seat 3: 6fcfcac0 ($6.41 in chips)
Seat 4: Hero ($10.42 in chips)
Seat 5: 4fcbfbdc ($8.4 in chips)
Seat 6: 2f160a64 ($5.48 in chips)
acefe839: posts small blind $0.02
6fcfcac0: posts big blind $0.05
*** HOLE CARDS ***
Dealt to 93683449 
Dealt to acefe839 
Dealt to 6fcfcac0 
Dealt to Hero [5c Ac]
Dealt to 4fcbfbdc 
Dealt to 2f160a64 
Hero: raises $0.05 to $0.1
4fcbfbdc: folds
2f160a64: folds
93683449: folds
acefe839: folds
6fcfcac0: folds
Uncalled bet ($0.05) returned to Hero
*** SHOWDOWN ***
Hero collected $0.12 from pot
*** SUMMARY ***
Total pot $0.12 | Rake $0 | Jackpot $0 | Bingo $0 | Fortune $0 | Tax $0
Seat 1: 93683449 (button) folded before Flop (didn't bet)
Seat 2: acefe839 (small blind) folded before Flop
Seat 3: 6fcfcac0 (big blind) folded before Flop
Seat 4: Hero collected ($0.12)
Seat 5: 4fcbfbdc folded before Flop (didn't bet)
Seat 6: 2f160a64 folded before Flop (didn't bet)


Poker Hand #RC2078535835: Hold'em No Limit ($0.02/$0.05) - 2023/12/22 21:45:35
Table 'RushAndCash797657' 6-max Seat #1 is the button
Seat 1: c2973f0 ($7.11 in chips)
Seat 2: 18c8fa56 ($7.36 in chips)
Seat 3: Hero ($10.4 in chips)
Seat 4: 8369fc6c ($6.41 in chips)
Seat 5: eb944e6 ($5.46 in chips)
Seat 6: 1826138f ($5.07 in chips)
18c8fa56: posts small blind $0.02
Hero: posts big blind $0.05
*** HOLE CARDS ***
Dealt to c2973f0 
Dealt to 18c8fa56 
Dealt to Hero [2d 5c]
Dealt to 8369fc6c 
Dealt to eb944e6 
Dealt to 1826138f 
8369fc6c: folds
eb944e6: folds
1826138f: folds
c2973f0: folds
18c8fa56: folds
Uncalled bet ($0.03) returned to Hero
*** SHOWDOWN ***
Hero collected $0.04 from pot
*** SUMMARY ***
Total pot $0.04 | Rake $0 | Jackpot $0 | Bingo $0 | Fortune $0 | Tax $0
Seat 1: c2973f0 (button) folded before Flop (didn't bet)
Seat 2: 18c8fa56 (small blind) folded before Flop
Seat 3: Hero (big blind) collected ($0.04)
Seat 4: 8369fc6c folded before Flop (didn't bet)
Seat 5: eb944e6 folded before Flop (didn't bet)
Seat 6: 1826138f folded before Flop (didn't bet)


Poker Hand #RC2078535686: Hold'em No Limit ($0.02/$0.05) - 2023/12/22 21:45:27
Table 'RushAndCash797585' 6-max Seat #1 is the button
Seat 1: ac89ef05 ($4.46 in chips)
Seat 2: Hero ($10.42 in chips)
Seat 3: b77cfdca ($5 in chips)
Seat 4: 8a94bd25 ($5.07 in chips)
Seat 5: 6551e7ca ($5.75 in chips)
Seat 6: 33091f5 ($5.43 in chips)
Hero: posts small blind $0.02
b77cfdca: posts big blind $0.05
*** HOLE CARDS ***
Dealt to ac89ef05 
Dealt to Hero [Ks 6h]
Dealt to b77cfdca 
Dealt to 8a94bd25 
Dealt to 6551e7ca 
Dealt to 33091f5 
8a94bd25: folds
6551e7ca: folds
33091f5: raises $0.07 to $0.12
ac89ef05: folds
Hero: folds
b77cfdca: folds
Uncalled bet ($0.07) returned to 33091f5
*** SHOWDOWN ***
33091f5 collected $0.12 from pot
*** SUMMARY ***
Total pot $0.12 | Rake $0 | Jackpot $0 | Bingo $0 | Fortune $0 | Tax $0
Seat 1: ac89ef05 (button) folded before Flop (didn't bet)
Seat 2: Hero (small blind) folded before Flop
Seat 3: b77cfdca (big blind) folded before Flop
Seat 4: 8a94bd25 folded before Flop (didn't bet)
Seat 5: 6551e7ca folded before Flop (didn't bet)
Seat 6: 33091f5 collected ($0.12)


Poker Hand #RC2078535315: Hold'em No Limit ($0.02/$0.05) - 2023/12/22 21:45:07
Table 'RushAndCash797403' 6-max Seat #1 is the button
Seat 1: 9b2d2337 ($22.97 in chips)
Seat 2: ba86452d ($3.77 in chips)
Seat 3: 47ecc871 ($2.59 in chips)
Seat 4: bc118b95 ($5.02 in chips)
Seat 5: d50b3b7c ($6.23 in chips)
Seat 6: Hero ($10.42 in chips)
ba86452d: posts small blind $0.02
47ecc871: posts big blind $0.05
*** HOLE CARDS ***
Dealt to 9b2d2337 
Dealt to ba86452d 
Dealt to 47ecc871 
Dealt to bc118b95 
Dealt to d50b3b7c 
Dealt to Hero [9d Td]
bc118b95: folds
d50b3b7c: raises $0.06 to $0.11
Hero: folds
9b2d2337: folds
ba86452d: raises $0.44 to $0.55
47ecc871: folds
d50b3b7c: folds
Uncalled bet ($0.44) returned to ba86452d
*** SHOWDOWN ***
ba86452d collected $0.26 from pot
*** SUMMARY ***
Total pot $0.27 | Rake $0.01 | Jackpot $0 | Bingo $0 | Fortune $0 | Tax $0
Seat 1: 9b2d2337 (button) folded before Flop (didn't bet)
Seat 2: ba86452d (small blind) collected ($0.26)
Seat 3: 47ecc871 (big blind) folded before Flop
Seat 4: bc118b95 folded before Flop (didn't bet)
Seat 5: d50b3b7c folded before Flop
Seat 6: Hero folded before Flop (didn't bet)


Poker Hand #RC2078535231: Hold'em No Limit ($0.02/$0.05) - 2023/12/22 21:45:03
Table 'RushAndCash797364' 6-max Seat #1 is the button
Seat 1: e789f462 ($2.45 in chips)
Seat 2: 7728b936 ($5 in chips)
Seat 3: 548ecbec ($6.99 in chips)
Seat 4: 78c7aa39 ($5.04 in chips)
Seat 5: 5cb14769 ($8.97 in chips)
Seat 6: Hero ($10.42 in chips)
7728b936: posts small blind $0.02
548ecbec: posts big blind $0.05
*** HOLE CARDS ***
Dealt to e789f462 
Dealt to 7728b936 
Dealt to 548ecbec 
Dealt to 78c7aa39 
Dealt to 5cb14769 
Dealt to Hero [9s 4c]
78c7aa39: raises $0.05 to $0.1
5cb14769: folds
Hero: folds
e789f462: folds
7728b936: folds
548ecbec: calls $0.05
*** FLOP *** [Kd 6c 6d]
548ecbec: checks
78c7aa39: bets $0.11
548ecbec: calls $0.11
*** TURN *** [Kd 6c 6d] [9c]
548ecbec: checks
78c7aa39: bets $0.33
548ecbec: calls $0.33
*** RIVER *** [Kd 6c 6d 9c] [9d]
548ecbec: bets $0.55
78c7aa39: folds
Uncalled bet ($0.55) returned to 548ecbec
*** SHOWDOWN ***
548ecbec collected $1.05 from pot
*** SUMMARY ***
Total pot $1.1 | Rake $0.05 | Jackpot $0 | Bingo $0 | Fortune $0 | Tax $0
Board [Kd 6c 6d 9c 9d]
Seat 1: e789f462 (button) folded before Flop (didn't bet)
Seat 2: 7728b936 (small blind) folded before Flop
Seat 3: 548ecbec (big blind) won ($1.05)
Seat 4: 78c7aa39 folded on the River
Seat 5: 5cb14769 folded before Flop (didn't bet)
Seat 6: Hero folded before Flop (didn't bet)


Poker Hand #RC2078523959: Hold'em No Limit ($0.02/$0.05) - 2023/12/22 21:43:50
Table 'RushAndCash796736' 6-max Seat #1 is the button
Seat 1: 548ecbec ($5.28 in chips)
Seat 2: Hero ($12.17 in chips)
Seat 3: 1c1fc2a1 ($7.83 in chips)
Seat 4: 141790ab ($4.55 in chips)
Seat 5: 538e953f ($5.02 in chips)
Seat 6: 659f7656 ($5.07 in chips)
Hero: posts small blind $0.02
1c1fc2a1: posts big blind $0.05
*** HOLE CARDS ***
Dealt to 548ecbec 
Dealt to Hero [Jc Js]
Dealt to 1c1fc2a1 
Dealt to 141790ab 
Dealt to 538e953f 
Dealt to 659f7656 
141790ab: folds
538e953f: folds
659f7656: raises $0.08 to $0.13
548ecbec: raises $0.33 to $0.46
Hero: calls $0.44
1c1fc2a1: folds
659f7656: folds
*** FLOP *** [2c 3d Qc]
Hero: checks
548ecbec: bets $0.37
Hero: calls $0.37
*** TURN *** [2c 3d Qc] [8c]
Hero: checks
548ecbec: bets $0.92
Hero: calls $0.92
*** RIVER *** [2c 3d Qc 8c] [9c]
Hero: checks
548ecbec: bets $3.53 and is all-in
Hero: folds
Uncalled bet ($3.53) returned to 548ecbec
*** SHOWDOWN ***
548ecbec collected $3.46 from pot
*** SUMMARY ***
Total pot $3.68 | Rake $0.15 | Jackpot $0.07 | Bingo $0 | Fortune $0 | Tax $0
Board [2c 3d Qc 8c 9c]
Seat 1: 548ecbec (button) won ($3.46)
Seat 2: Hero (small blind) folded on the River
Seat 3: 1c1fc2a1 (big blind) folded before Flop
Seat 4: 141790ab folded before Flop (didn't bet)
Seat 5: 538e953f folded before Flop (didn't bet)
Seat 6: 659f7656 folded before Flop


Poker Hand #RC2078523897: Hold'em No Limit ($0.02/$0.05) - 2023/12/22 21:43:47
Table 'RushAndCash796705' 6-max Seat #1 is the button
Seat 1: b179aebd ($5.78 in chips)
Seat 2: bfc64a4a ($5 in chips)
Seat 3: 39b51503 ($5.07 in chips)
Seat 4: Hero ($12.17 in chips)
Seat 5: 49a9584 ($5 in chips)
Seat 6: 6bc8336e ($5.35 in chips)
bfc64a4a: posts small blind $0.02
39b51503: posts big blind $0.05
*** HOLE CARDS ***
Dealt to b179aebd 
Dealt to bfc64a4a 
Dealt to 39b51503 
Dealt to Hero [2h 8c]
Dealt to 49a9584 
Dealt to 6bc8336e 
Hero: folds
49a9584: folds
6bc8336e: folds
b179aebd: raises $0.07 to $0.12
bfc64a4a: folds
39b51503: folds
Uncalled bet ($0.07) returned to b179aebd
*** SHOWDOWN ***
b179aebd collected $0.12 from pot
*** SUMMARY ***
Total pot $0.12 | Rake $0 | Jackpot $0 | Bingo $0 | Fortune $0 | Tax $0
Seat 1: b179aebd (button) collected ($0.12)
Seat 2: bfc64a4a (small blind) folded before Flop
Seat 3: 39b51503 (big blind) folded before Flop
Seat 4: Hero folded before Flop (didn't bet)
Seat 5: 49a9584 folded before Flop (didn't bet)
Seat 6: 6bc8336e folded before Flop (didn't bet)


Poker Hand #RC2078523530: Hold'em No Limit ($0.02/$0.05) - 2023/12/22 21:43:26
Table 'RushAndCash796525' 6-max Seat #1 is the button
Seat 1: Hero ($12.01 in chips)
Seat 2: 3d292096 ($9.26 in chips)
Seat 3: eadbd152 ($5.58 in chips)
Seat 4: a20c0bea ($5.63 in chips)
Seat 5: 7095bc76 ($5.07 in chips)
Seat 6: 93d5c821 ($6.39 in chips)
3d292096: posts small blind $0.02
eadbd152: posts big blind $0.05
*** HOLE CARDS ***
Dealt to Hero [Ad Jd]
Dealt to 3d292096 
Dealt to eadbd152 
Dealt to a20c0bea 
Dealt to 7095bc76 
Dealt to 93d5c821 
a20c0bea: folds
7095bc76: raises $0.05 to $0.1
93d5c821: folds
Hero: raises $0.32 to $0.42
3d292096: folds
eadbd152: folds
7095bc76: folds
Uncalled bet ($0.32) returned to Hero
*** SHOWDOWN ***
Hero collected $0.26 from pot
*** SUMMARY ***
Total pot $0.27 | Rake $0.01 | Jackpot $0 | Bingo $0 | Fortune $0 | Tax $0
Seat 1: Hero (button) collected ($0.26)
Seat 2: 3d292096 (small blind) folded before Flop
Seat 3: eadbd152 (big blind) folded before Flop
Seat 4: a20c0bea folded before Flop (didn't bet)
Seat 5: 7095bc76 folded before Flop
Seat 6: 93d5c821 folded before Flop (didn't bet)


Poker Hand #RC2078523391: Hold'em No Limit ($0.02/$0.05) - 2023/12/22 21:43:19
Table 'RushAndCash796459' 6-max Seat #1 is the button
Seat 1: 4520f334 ($4.87 in chips)
Seat 2: 3f112fc ($4.66 in chips)
Seat 3: Hero ($11.99 in chips)
Seat 4: ac89ef05 ($4.93 in chips)
Seat 5: 9e4b1c03 ($6.81 in chips)
Seat 6: 9a957500 ($1.9 in chips)
3f112fc: posts small blind $0.02
Hero: posts big blind $0.05
*** HOLE CARDS ***
Dealt to 4520f334 
Dealt to 3f112fc 
Dealt to Hero [8h Qc]
Dealt to ac89ef05 
Dealt to 9e4b1c03 
Dealt to 9a957500 
ac89ef05: folds
9e4b1c03: folds
9a957500: folds
4520f334: folds
3f112fc: folds
Uncalled bet ($0.03) returned to Hero
*** SHOWDOWN ***
Hero collected $0.04 from pot
*** SUMMARY ***
Total pot $0.04 | Rake $0 | Jackpot $0 | Bingo $0 | Fortune $0 | Tax $0
Seat 1: 4520f334 (button) folded before Flop (didn't bet)
Seat 2: 3f112fc (small blind) folded before Flop
Seat 3: Hero (big blind) collected ($0.04)
Seat 4: ac89ef05 folded before Flop (didn't bet)
Seat 5: 9e4b1c03 folded before Flop (didn't bet)
Seat 6: 9a957500 folded before Flop (didn't bet)


Poker Hand #RC2078523195: Hold'em No Limit ($0.02/$0.05) - 2023/12/22 21:43:08
Table 'RushAndCash796367' 6-max Seat #1 is the button
Seat 1: 869465ff ($18.85 in chips)
Seat 2: 36acf706 ($5 in chips)
Seat 3: dee599cb ($5.89 in chips)
Seat 4: 6c75362e ($10.56 in chips)
Seat 5: Hero ($11.99 in chips)
Seat 6: 800a902f ($4.18 in chips)
36acf706: posts small blind $0.02
dee599cb: posts big blind $0.05
*** HOLE CARDS ***
Dealt to 869465ff 
Dealt to 36acf706 
Dealt to dee599cb 
Dealt to 6c75362e 
Dealt to Hero [7c Ac]
Dealt to 800a902f 
6c75362e: raises $0.1 to $0.15
Hero: folds
800a902f: folds
869465ff: folds
36acf706: folds
dee599cb: folds
Uncalled bet ($0.1) returned to 6c75362e
*** SHOWDOWN ***
6c75362e collected $0.12 from pot
*** SUMMARY ***
Total pot $0.12 | Rake $0 | Jackpot $0 | Bingo $0 | Fortune $0 | Tax $0
Seat 1: 869465ff (button) folded before Flop (didn't bet)
Seat 2: 36acf706 (small blind) folded before Flop
Seat 3: dee599cb (big blind) folded before Flop
Seat 4: 6c75362e collected ($0.12)
Seat 5: Hero folded before Flop (didn't bet)
Seat 6: 800a902f folded before Flop (didn't bet)


Poker Hand #RC2078521842: Hold'em No Limit ($0.02/$0.05) - 2023/12/22 21:41:52
Table 'RushAndCash795726' 6-max Seat #1 is the button
Seat 1: 4cfc823 ($5.35 in chips)
Seat 2: 7b271292 ($6.34 in chips)
Seat 3: cddd79e8 ($5.11 in chips)
Seat 4: Hero ($12.59 in chips)
Seat 5: 6c75362e ($8.81 in chips)
Seat 6: 800a902f ($5.48 in chips)
7b271292: posts small blind $0.02
cddd79e8: posts big blind $0.05
*** HOLE CARDS ***
Dealt to 4cfc823 
Dealt to 7b271292 
Dealt to cddd79e8 
Dealt to Hero [Ts Td]
Dealt to 6c75362e 
Dealt to 800a902f 
Hero: raises $0.05 to $0.1
6c75362e: calls $0.1
800a902f: raises $0.05 to $0.15
4cfc823: folds
7b271292: folds
cddd79e8: folds
Hero: calls $0.05
6c75362e: raises $0.45 to $0.6
800a902f: calls $0.45
Hero: calls $0.45
*** FLOP *** [3d 4s Ah]
Hero: checks
6c75362e: checks
800a902f: checks
*** TURN *** [3d 4s Ah] [8c]
Hero: checks
6c75362e: bets $0.7
800a902f: calls $0.7
Hero: folds
*** RIVER *** [3d 4s Ah 8c] [6d]
6c75362e: bets $0.85
800a902f: folds
Uncalled bet ($0.85) returned to 6c75362e
*** SHOWDOWN ***
6c75362e collected $3.05 from pot
*** SUMMARY ***
Total pot $3.27 | Rake $0.15 | Jackpot $0.07 | Bingo $0 | Fortune $0 | Tax $0
Board [3d 4s Ah 8c 6d]
Seat 1: 4cfc823 (button) folded before Flop (didn't bet)
Seat 2: 7b271292 (small blind) folded before Flop
Seat 3: cddd79e8 (big blind) folded before Flop
Seat 4: Hero folded on the Turn
Seat 5: 6c75362e won ($3.05)
Seat 6: 800a902f folded on the River


Poker Hand #RC2078521640: Hold'em No Limit ($0.02/$0.05) - 2023/12/22 21:41:40
Table 'RushAndCash795626' 6-max Seat #1 is the button
Seat 1: Hero ($12.59 in chips)
Seat 2: bc26f2e1 ($6.2 in chips)
Seat 3: 78c7aa39 ($4.19 in chips)
Seat 4: 2d4acc60 ($4.53 in chips)
Seat 5: 65bf0e13 ($5 in chips)
Seat 6: 73f6d035 ($7.7 in chips)
bc26f2e1: posts small blind $0.02
78c7aa39: posts big blind $0.05
*** HOLE CARDS ***
Dealt to Hero [5d Jc]
Dealt to bc26f2e1 
Dealt to 78c7aa39 
Dealt to 2d4acc60 
Dealt to 65bf0e13 
Dealt to 73f6d035 
2d4acc60: folds
65bf0e13: folds
73f6d035: folds
Hero: folds
bc26f2e1: folds
Uncalled bet ($0.03) returned to 78c7aa39
*** SHOWDOWN ***
78c7aa39 collected $0.04 from pot
*** SUMMARY ***
Total pot $0.04 | Rake $0 | Jackpot $0 | Bingo $0 | Fortune $0 | Tax $0
Seat 1: Hero (button) folded before Flop (didn't bet)
Seat 2: bc26f2e1 (small blind) folded before Flop
Seat 3: 78c7aa39 (big blind) collected ($0.04)
Seat 4: 2d4acc60 folded before Flop (didn't bet)
Seat 5: 65bf0e13 folded before Flop (didn't bet)
Seat 6: 73f6d035 folded before Flop (didn't bet)


Poker Hand #RC2078521186: Hold'em No Limit ($0.02/$0.05) - 2023/12/22 21:41:15
Table 'RushAndCash795410' 6-max Seat #1 is the button
Seat 1: 78c7aa39 ($4.7 in chips)
Seat 2: Hero ($12.08 in chips)
Seat 3: e8886428 ($41.5 in chips)
Seat 4: 6c88f65e ($4.06 in chips)
Seat 5: 5d8c8da0 ($5.56 in chips)
Seat 6: ddbe951e ($15.56 in chips)
Hero: posts small blind $0.02
e8886428: posts big blind $0.05
*** HOLE CARDS ***
Dealt to 78c7aa39 
Dealt to Hero [Ah Kd]
Dealt to e8886428 
Dealt to 6c88f65e 
Dealt to 5d8c8da0 
Dealt to ddbe951e 
6c88f65e: folds
5d8c8da0: folds
ddbe951e: folds
78c7aa39: raises $0.07 to $0.12
Hero: raises $0.39 to $0.51
e8886428: folds
78c7aa39: calls $0.39
*** FLOP *** [Js Td As]
Hero: bets $0.36
78c7aa39: folds
Uncalled bet ($0.36) returned to Hero
*** SHOWDOWN ***
Hero collected $1.02 from pot
*** SUMMARY ***
Total pot $1.07 | Rake $0.05 | Jackpot $0 | Bingo $0 | Fortune $0 | Tax $0
Board [Js Td As]
Seat 1: 78c7aa39 (button) folded on the Flop
Seat 2: Hero (small blind) won ($1.02)
Seat 3: e8886428 (big blind) folded before Flop
Seat 4: 6c88f65e folded before Flop (didn't bet)
Seat 5: 5d8c8da0 folded before Flop (didn't bet)
Seat 6: ddbe951e folded before Flop (didn't bet)


Poker Hand #RC2078520480: Hold'em No Limit ($0.02/$0.05) - 2023/12/22 21:40:36
Table 'RushAndCash795072' 6-max Seat #1 is the button
Seat 1: f0e3b048 ($4.93 in chips)
Seat 2: 8a94bd25 ($5.02 in chips)
Seat 3: Hero ($12.36 in chips)
Seat 4: deb19c7 ($4.92 in chips)
Seat 5: d1da4b9d ($5.31 in chips)
Seat 6: ddbe951e ($15.28 in chips)
8a94bd25: posts small blind $0.02
Hero: posts big blind $0.05
*** HOLE CARDS ***
Dealt to f0e3b048 
Dealt to 8a94bd25 
Dealt to Hero [Ac Jh]
Dealt to deb19c7 
Dealt to d1da4b9d 
Dealt to ddbe951e 
deb19c7: folds
d1da4b9d: folds
ddbe951e: raises $0.08 to $0.13
f0e3b048: folds
8a94bd25: folds
Hero: calls $0.08
*** FLOP *** [5d Kc 7d]
Hero: checks
ddbe951e: bets $0.15
Hero: calls $0.15
*** TURN *** [5d Kc 7d] [Ks]
Hero: checks
ddbe951e: bets $0.3
Hero: folds
Uncalled bet ($0.3) returned to ddbe951e
*** SHOWDOWN ***
ddbe951e collected $0.56 from pot
*** SUMMARY ***
Total pot $0.58 | Rake $0.02 | Jackpot $0 | Bingo $0 | Fortune $0 | Tax $0
Board [5d Kc 7d Ks]
Seat 1: f0e3b048 (button) folded before Flop (didn't bet)
Seat 2: 8a94bd25 (small blind) folded before Flop
Seat 3: Hero (big blind) folded on the Turn
Seat 4: deb19c7 folded before Flop (didn't bet)
Seat 5: d1da4b9d folded before Flop (didn't bet)
Seat 6: ddbe951e won ($0.56)


Poker Hand #RC2078520242: Hold'em No Limit ($0.02/$0.05) - 2023/12/22 21:40:23
Table 'RushAndCash794958' 6-max Seat #1 is the button
Seat 1: ce803d2b ($5.03 in chips)
Seat 2: 2b3cf2e3 ($2.49 in chips)
Seat 3: 18c8fa56 ($5 in chips)
Seat 4: 834fcc3f ($7.72 in chips)
Seat 5: fbeaaad2 ($15.6 in chips)
Seat 6: Hero ($12.29 in chips)
2b3cf2e3: posts small blind $0.02
18c8fa56: posts big blind $0.05
*** HOLE CARDS ***
Dealt to ce803d2b 
Dealt to 2b3cf2e3 
Dealt to 18c8fa56 
Dealt to 834fcc3f 
Dealt to fbeaaad2 
Dealt to Hero [8h 7h]
834fcc3f: folds
fbeaaad2: folds
Hero: raises $0.05 to $0.1
ce803d2b: folds
2b3cf2e3: folds
18c8fa56: folds
Uncalled bet ($0.05) returned to Hero
*** SHOWDOWN ***
Hero collected $0.12 from pot
*** SUMMARY ***
Total pot $0.12 | Rake $0 | Jackpot $0 | Bingo $0 | Fortune $0 | Tax $0
Seat 1: ce803d2b (button) folded before Flop (didn't bet)
Seat 2: 2b3cf2e3 (small blind) folded before Flop
Seat 3: 18c8fa56 (big blind) folded before Flop
Seat 4: 834fcc3f folded before Flop (didn't bet)
Seat 5: fbeaaad2 folded before Flop (didn't bet)
Seat 6: Hero collected ($0.12)


Poker Hand #RC2078520170: Hold'em No Limit ($0.02/$0.05) - 2023/12/22 21:40:19
Table 'RushAndCash794928' 6-max Seat #1 is the button
Seat 1: 45aa7628 ($6.43 in chips)
Seat 2: e6f6623d ($4.5 in chips)
Seat 3: 81c1abec ($10.23 in chips)
Seat 4: Hero ($12.29 in chips)
Seat 5: a2346b7c ($4.51 in chips)
Seat 6: 3056048f ($5.55 in chips)
e6f6623d: posts small blind $0.02
81c1abec: posts big blind $0.05
*** HOLE CARDS ***
Dealt to 45aa7628 
Dealt to e6f6623d 
Dealt to 81c1abec 
Dealt to Hero [2c 7h]
Dealt to a2346b7c 
Dealt to 3056048f 
Hero: folds
a2346b7c: folds
3056048f: folds
45aa7628: raises $0.08 to $0.13
e6f6623d: folds
81c1abec: calls $0.08
*** FLOP *** [6s 3d 8d]
81c1abec: checks
45aa7628: checks
*** TURN *** [6s 3d 8d] [5d]
81c1abec: bets $0.14
45aa7628: folds
Uncalled bet ($0.14) returned to 81c1abec
*** SHOWDOWN ***
81c1abec collected $0.27 from pot
*** SUMMARY ***
Total pot $0.28 | Rake $0.01 | Jackpot $0 | Bingo $0 | Fortune $0 | Tax $0
Board [6s 3d 8d 5d]
Seat 1: 45aa7628 (button) folded on the Turn
Seat 2: e6f6623d (small blind) folded before Flop
Seat 3: 81c1abec (big blind) won ($0.27)
Seat 4: Hero folded before Flop (didn't bet)
Seat 5: a2346b7c folded before Flop (didn't bet)
Seat 6: 3056048f folded before Flop (didn't bet)


Poker Hand #RC2078520117: Hold'em No Limit ($0.02/$0.05) - 2023/12/22 21:40:16
Table 'RushAndCash794901' 6-max Seat #1 is the button
Seat 1: 2c867a7e ($11.41 in chips)
Seat 2: a420712c ($6.04 in chips)
Seat 3: d50b3b7c ($5 in chips)
Seat 4: eeb37e34 ($9.67 in chips)
Seat 5: Hero ($12.29 in chips)
Seat 6: da0c89bc ($7.32 in chips)
a420712c: posts small blind $0.02
d50b3b7c: posts big blind $0.05
*** HOLE CARDS ***
Dealt to 2c867a7e 
Dealt to a420712c 
Dealt to d50b3b7c 
Dealt to eeb37e34 
Dealt to Hero [2d 5d]
Dealt to da0c89bc 
eeb37e34: raises $0.08 to $0.13
Hero: folds
da0c89bc: folds
2c867a7e: folds
a420712c: folds
d50b3b7c: folds
Uncalled bet ($0.08) returned to eeb37e34
*** SHOWDOWN ***
eeb37e34 collected $0.12 from pot
*** SUMMARY ***
Total pot $0.12 | Rake $0 | Jackpot $0 | Bingo $0 | Fortune $0 | Tax $0
Seat 1: 2c867a7e (button) folded before Flop (didn't bet)
Seat 2: a420712c (small blind) folded before Flop
Seat 3: d50b3b7c (big blind) folded before Flop
Seat 4: eeb37e34 collected ($0.12)
Seat 5: Hero folded before Flop (didn't bet)
Seat 6: da0c89bc folded before Flop (didn't bet)


Poker Hand #RC2078520054: Hold'em No Limit ($0.02/$0.05) - 2023/12/22 21:40:12
Table 'RushAndCash794872' 6-max Seat #1 is the button
Seat 1: b88dbe00 ($5.94 in chips)
Seat 2: 59a39874 ($11.42 in chips)
Seat 3: a69f279d ($9.76 in chips)
Seat 4: 72f7386e ($16.56 in chips)
Seat 5: Hero ($12.29 in chips)
Seat 6: 2c867a7e ($11.41 in chips)
59a39874: posts small blind $0.02
a69f279d: posts big blind $0.05
*** HOLE CARDS ***
Dealt to b88dbe00 
Dealt to 59a39874 
Dealt to a69f279d 
Dealt to 72f7386e 
Dealt to Hero [4d 6d]
Dealt to 2c867a7e 
72f7386e: folds
Hero: folds
2c867a7e: folds
b88dbe00: raises $0.07 to $0.12
59a39874: folds
a69f279d: folds
Uncalled bet ($0.07) returned to b88dbe00
*** SHOWDOWN ***
b88dbe00 collected $0.12 from pot
*** SUMMARY ***
Total pot $0.12 | Rake $0 | Jackpot $0 | Bingo $0 | Fortune $0 | Tax $0
Seat 1: b88dbe00 (button) collected ($0.12)
Seat 2: 59a39874 (small blind) folded before Flop
Seat 3: a69f279d (big blind) folded before Flop
Seat 4: 72f7386e folded before Flop (didn't bet)
Seat 5: Hero folded before Flop (didn't bet)
Seat 6: 2c867a7e folded before Flop (didn't bet)


Poker Hand #RC2078519961: Hold'em No Limit ($0.02/$0.05) - 2023/12/22 21:40:07
Table 'RushAndCash794824' 6-max Seat #1 is the button
Seat 1: 5df9a842 ($9.89 in chips)
Seat 2: 2f2fbc2 ($1.65 in chips)
Seat 3: 5126c2bf ($5.17 in chips)
Seat 4: 7728b936 ($5.07 in chips)
Seat 5: Hero ($12.29 in chips)
Seat 6: 5cb14769 ($9.22 in chips)
2f2fbc2: posts small blind $0.02
5126c2bf: posts big blind $0.05
*** HOLE CARDS ***
Dealt to 5df9a842 
Dealt to 2f2fbc2 
Dealt to 5126c2bf 
Dealt to 7728b936 
Dealt to Hero [As 5c]
Dealt to 5cb14769 
7728b936: folds
Hero: folds
5cb14769: folds
5df9a842: folds
2f2fbc2: calls $0.03
5126c2bf: raises $0.15 to $0.2
2f2fbc2: folds
Uncalled bet ($0.15) returned to 5126c2bf
*** SHOWDOWN ***
5126c2bf collected $0.1 from pot
*** SUMMARY ***
Total pot $0.1 | Rake $0 | Jackpot $0 | Bingo $0 | Fortune $0 | Tax $0
Seat 1: 5df9a842 (button) folded before Flop (didn't bet)
Seat 2: 2f2fbc2 (small blind) folded before Flop
Seat 3: 5126c2bf (big blind) collected ($0.1)
Seat 4: 7728b936 folded before Flop (didn't bet)
Seat 5: Hero folded before Flop (didn't bet)
Seat 6: 5cb14769 folded before Flop (didn't bet)


Poker Hand #RC2078519755: Hold'em No Limit ($0.02/$0.05) - 2023/12/22 21:39:56
Table 'RushAndCash794725' 6-max Seat #1 is the button
Seat 1: 44681c1f ($11.85 in chips)
Seat 2: Hero ($12.31 in chips)
Seat 3: f2833e42 ($5.95 in chips)
Seat 4: bc26f2e1 ($6.32 in chips)
Seat 5: 37e2503b ($5.62 in chips)
Seat 6: 51c82b66 ($5.52 in chips)
Hero: posts small blind $0.02
f2833e42: posts big blind $0.05
*** HOLE CARDS ***
Dealt to 44681c1f 
Dealt to Hero [Ks 5d]
Dealt to f2833e42 
Dealt to bc26f2e1 
Dealt to 37e2503b 
Dealt to 51c82b66 
bc26f2e1: folds
37e2503b: folds
51c82b66: folds
44681c1f: raises $0.08 to $0.13
Hero: folds
f2833e42: folds
Uncalled bet ($0.08) returned to 44681c1f
*** SHOWDOWN ***
44681c1f collected $0.12 from pot
*** SUMMARY ***
Total pot $0.12 | Rake $0 | Jackpot $0 | Bingo $0 | Fortune $0 | Tax $0
Seat 1: 44681c1f (button) collected ($0.12)
Seat 2: Hero (small blind) folded before Flop
Seat 3: f2833e42 (big blind) folded before Flop
Seat 4: bc26f2e1 folded before Flop (didn't bet)
Seat 5: 37e2503b folded before Flop (didn't bet)
Seat 6: 51c82b66 folded before Flop (didn't bet)


Poker Hand #RC2078519582: Hold'em No Limit ($0.02/$0.05) - 2023/12/22 21:39:46
Table 'RushAndCash794634' 6-max Seat #1 is the button
Seat 1: e69446ee ($10.47 in chips)
Seat 2: b9870dbd ($5.4 in chips)
Seat 3: Hero ($12.36 in chips)
Seat 4: 2d4acc60 ($4.53 in chips)
Seat 5: a2a9ef51 ($5 in chips)
Seat 6: 5f11c3da ($15.43 in chips)
b9870dbd: posts small blind $0.02
Hero: posts big blind $0.05
*** HOLE CARDS ***
Dealt to e69446ee 
Dealt to b9870dbd 
Dealt to Hero [3s Kd]
Dealt to 2d4acc60 
Dealt to a2a9ef51 
Dealt to 5f11c3da 
2d4acc60: folds
a2a9ef51: folds
5f11c3da: raises $0.08 to $0.13
e69446ee: folds
b9870dbd: folds
Hero: folds
Uncalled bet ($0.08) returned to 5f11c3da
*** SHOWDOWN ***
5f11c3da collected $0.12 from pot
*** SUMMARY ***
Total pot $0.12 | Rake $0 | Jackpot $0 | Bingo $0 | Fortune $0 | Tax $0
Seat 1: e69446ee (button) folded before Flop (didn't bet)
Seat 2: b9870dbd (small blind) folded before Flop
Seat 3: Hero (big blind) folded before Flop
Seat 4: 2d4acc60 folded before Flop (didn't bet)
Seat 5: a2a9ef51 folded before Flop (didn't bet)
Seat 6: 5f11c3da collected ($0.12)


Poker Hand #RC2078519459: Hold'em No Limit ($0.02/$0.05) - 2023/12/22 21:39:39
Table 'RushAndCash794575' 6-max Seat #1 is the button
Seat 1: Hero ($12.36 in chips)
Seat 2: 72f7386e ($17.04 in chips)
Seat 3: 9b2d2337 ($23.49 in chips)
Seat 4: acc9d31d ($5.37 in chips)
Seat 5: 8ad5eb6 ($5.61 in chips)
Seat 6: b88dbe00 ($5.94 in chips)
72f7386e: posts small blind $0.02
9b2d2337: posts big blind $0.05
*** HOLE CARDS ***
Dealt to Hero [2d Jh]
Dealt to 72f7386e 
Dealt to 9b2d2337 
Dealt to acc9d31d 
Dealt to 8ad5eb6 
Dealt to b88dbe00 
acc9d31d: folds
8ad5eb6: raises $0.05 to $0.1
b88dbe00: folds
Hero: folds
72f7386e: raises $0.38 to $0.48
9b2d2337: folds
8ad5eb6: raises $1.01 to $1.49
72f7386e: folds
Uncalled bet ($1.01) returned to 8ad5eb6
*** SHOWDOWN ***
8ad5eb6 collected $0.96 from pot
*** SUMMARY ***
Total pot $1.01 | Rake $0.05 | Jackpot $0 | Bingo $0 | Fortune $0 | Tax $0
Seat 1: Hero (button) folded before Flop (didn't bet)
Seat 2: 72f7386e (small blind) folded before Flop
Seat 3: 9b2d2337 (big blind) folded before Flop
Seat 4: acc9d31d folded before Flop (didn't bet)
Seat 5: 8ad5eb6 collected ($0.96)
Seat 6: b88dbe00 folded before Flop (didn't bet)


Poker Hand #RC2078519334: Hold'em No Limit ($0.02/$0.05) - 2023/12/22 21:39:33
Table 'RushAndCash794514' 6-max Seat #1 is the button
Seat 1: 9601129f ($6.3 in chips)
Seat 2: b8e0eed ($5.38 in chips)
Seat 3: 35f7fbd3 ($9.76 in chips)
Seat 4: eb03c338 ($7.5 in chips)
Seat 5: Hero ($12.36 in chips)
Seat 6: b6052383 ($5.85 in chips)
b8e0eed: posts small blind $0.02
35f7fbd3: posts big blind $0.05
*** HOLE CARDS ***
Dealt to 9601129f 
Dealt to b8e0eed 
Dealt to 35f7fbd3 
Dealt to eb03c338 
Dealt to Hero [Ah 2c]
Dealt to b6052383 
eb03c338: folds
Hero: folds
b6052383: folds
9601129f: folds
b8e0eed: folds
Uncalled bet ($0.03) returned to 35f7fbd3
*** SHOWDOWN ***
35f7fbd3 collected $0.04 from pot
*** SUMMARY ***
Total pot $0.04 | Rake $0 | Jackpot $0 | Bingo $0 | Fortune $0 | Tax $0
Seat 1: 9601129f (button) folded before Flop (didn't bet)
Seat 2: b8e0eed (small blind) folded before Flop
Seat 3: 35f7fbd3 (big blind) collected ($0.04)
Seat 4: eb03c338 folded before Flop (didn't bet)
Seat 5: Hero folded before Flop (didn't bet)
Seat 6: b6052383 folded before Flop (didn't bet)


Poker Hand #RC2078519200: Hold'em No Limit ($0.02/$0.05) - 2023/12/22 21:39:26
Table 'RushAndCash794448' 6-max Seat #1 is the button
Seat 1: 59846dec ($10.05 in chips)
Seat 2: d9ec3117 ($5.13 in chips)
Seat 3: Hero ($12.41 in chips)
Seat 4: a7076373 ($9.94 in chips)
Seat 5: 177da66b ($4.14 in chips)
Seat 6: f9adeea ($5 in chips)
d9ec3117: posts small blind $0.02
Hero: posts big blind $0.05
*** HOLE CARDS ***
Dealt to 59846dec 
Dealt to d9ec3117 
Dealt to Hero [Jd 4s]
Dealt to a7076373 
Dealt to 177da66b 
Dealt to f9adeea 
a7076373: folds
177da66b: folds
f9adeea: folds
59846dec: raises $0.1 to $0.15
d9ec3117: folds
Hero: folds
Uncalled bet ($0.1) returned to 59846dec
*** SHOWDOWN ***
59846dec collected $0.12 from pot
*** SUMMARY ***
Total pot $0.12 | Rake $0 | Jackpot $0 | Bingo $0 | Fortune $0 | Tax $0
Seat 1: 59846dec (button) collected ($0.12)
Seat 2: d9ec3117 (small blind) folded before Flop
Seat 3: Hero (big blind) folded before Flop
Seat 4: a7076373 folded before Flop (didn't bet)
Seat 5: 177da66b folded before Flop (didn't bet)
Seat 6: f9adeea folded before Flop (didn't bet)


Poker Hand #RC2078518339: Hold'em No Limit ($0.02/$0.05) - 2023/12/22 21:38:40
Table 'RushAndCash794043' 6-max Seat #1 is the button
Seat 1: 189da7f1 ($9.48 in chips)
Seat 2: 59846dec ($10.15 in chips)
Seat 3: 7ea98c69 ($5 in chips)
Seat 4: 6a898db1 ($4.64 in chips)
Seat 5: Hero ($12.27 in chips)
Seat 6: d2739eda ($3.62 in chips)
59846dec: posts small blind $0.02
7ea98c69: posts big blind $0.05
*** HOLE CARDS ***
Dealt to 189da7f1 
Dealt to 59846dec 
Dealt to 7ea98c69 
Dealt to 6a898db1 
Dealt to Hero [Ad Ks]
Dealt to d2739eda 
6a898db1: folds
Hero: raises $0.05 to $0.1
d2739eda: folds
189da7f1: folds
59846dec: calls $0.08
7ea98c69: folds
*** FLOP *** [Ac 5c 4d]
59846dec: checks
Hero: checks
*** TURN *** [Ac 5c 4d] [4s]
59846dec: checks
Hero: bets $0.13
59846dec: folds
Uncalled bet ($0.13) returned to Hero
*** SHOWDOWN ***
Hero collected $0.24 from pot
*** SUMMARY ***
Total pot $0.25 | Rake $0.01 | Jackpot $0 | Bingo $0 | Fortune $0 | Tax $0
Board [Ac 5c 4d 4s]
Seat 1: 189da7f1 (button) folded before Flop (didn't bet)
Seat 2: 59846dec (small blind) folded on the Turn
Seat 3: 7ea98c69 (big blind) folded before Flop
Seat 4: 6a898db1 folded before Flop (didn't bet)
Seat 5: Hero won ($0.24)
Seat 6: d2739eda folded before Flop (didn't bet)


Poker Hand #RC2078517700: Hold'em No Limit ($0.02/$0.05) - 2023/12/22 21:38:05
Table 'RushAndCash793740' 6-max Seat #1 is the button
Seat 1: Hero ($10.99 in chips)
Seat 2: d45bc7f3 ($5 in chips)
Seat 3: 924de653 ($2 in chips)
Seat 4: 6a898db1 ($6.06 in chips)
Seat 5: 360d3b25 ($5.02 in chips)
Seat 6: 80af7fe3 ($5.21 in chips)
d45bc7f3: posts small blind $0.02
924de653: posts big blind $0.05
*** HOLE CARDS ***
Dealt to Hero [Ks Kc]
Dealt to d45bc7f3 
Dealt to 924de653 
Dealt to 6a898db1 
Dealt to 360d3b25 
Dealt to 80af7fe3 
6a898db1: raises $0.06 to $0.11
360d3b25: folds
80af7fe3: folds
Hero: raises $0.29 to $0.4
d45bc7f3: folds
924de653: folds
6a898db1: calls $0.29
*** FLOP *** [Ad Ah 6h]
6a898db1: bets $0.29
Hero: calls $0.29
*** TURN *** [Ad Ah 6h] [Qd]
6a898db1: bets $0.73
Hero: calls $0.73
*** RIVER *** [Ad Ah 6h Qd] [3c]
6a898db1: checks
Hero: checks
6a898db1: shows [Qh Kh] (Pair of Aces and Pair of Queens)
Hero: shows [Ks Kc] (Pair of Aces and Pair of Kings)
*** SHOWDOWN ***
Hero collected $2.7 from pot
*** SUMMARY ***
Total pot $2.91 | Rake $0.14 | Jackpot $0.07 | Bingo $0 | Fortune $0 | Tax $0
Board [Ad Ah 6h Qd 3c]
Seat 1: Hero (button) showed [Ks Kc] and won ($2.7) with Pair of Aces and Pair of Kings
Seat 2: d45bc7f3 (small blind) folded before Flop
Seat 3: 924de653 (big blind) folded before Flop
Seat 4: 6a898db1 showed [Qh Kh] and lost with Pair of Aces and Pair of Queens
Seat 5: 360d3b25 folded before Flop (didn't bet)
Seat 6: 80af7fe3 folded before Flop (didn't bet)


Poker Hand #RC2078517594: Hold'em No Limit ($0.02/$0.05) - 2023/12/22 21:37:59
Table 'RushAndCash793689' 6-max Seat #1 is the button
Seat 1: 7b271292 ($4.15 in chips)
Seat 2: Hero ($11.01 in chips)
Seat 3: 8d15f06b ($11.5 in chips)
Seat 4: aeeb0181 ($6.7 in chips)
Seat 5: b01c40bf ($20.16 in chips)
Seat 6: b49a0d77 ($5 in chips)
Hero: posts small blind $0.02
8d15f06b: posts big blind $0.05
*** HOLE CARDS ***
Dealt to 7b271292 
Dealt to Hero [9s 6c]
Dealt to 8d15f06b 
Dealt to aeeb0181 
Dealt to b01c40bf 
Dealt to b49a0d77 
aeeb0181: folds
b01c40bf: raises $0.06 to $0.11
b49a0d77: folds
7b271292: folds
Hero: folds
8d15f06b: folds
Uncalled bet ($0.06) returned to b01c40bf
*** SHOWDOWN ***
b01c40bf collected $0.12 from pot
*** SUMMARY ***
Total pot $0.12 | Rake $0 | Jackpot $0 | Bingo $0 | Fortune $0 | Tax $0
Seat 1: 7b271292 (button) folded before Flop (didn't bet)
Seat 2: Hero (small blind) folded before Flop
Seat 3: 8d15f06b (big blind) folded before Flop
Seat 4: aeeb0181 folded before Flop (didn't bet)
Seat 5: b01c40bf collected ($0.12)
Seat 6: b49a0d77 folded before Flop (didn't bet)


Poker Hand #RC2078517523: Hold'em No Limit ($0.02/$0.05) - 2023/12/22 21:37:55
Table 'RushAndCash793656' 6-max Seat #1 is the button
Seat 1: 1fc1f571 ($13.66 in chips)
Seat 2: f71b25e9 ($7.81 in chips)
Seat 3: 6e8725eb ($5 in chips)
Seat 4: Hero ($11.01 in chips)
Seat 5: 45bb3f0f ($5 in chips)
Seat 6: d25e9ff3 ($5.99 in chips)
f71b25e9: posts small blind $0.02
6e8725eb: posts big blind $0.05
*** HOLE CARDS ***
Dealt to 1fc1f571 
Dealt to f71b25e9 
Dealt to 6e8725eb 
Dealt to Hero [Kc Js]
Dealt to 45bb3f0f 
Dealt to d25e9ff3 
Hero: folds
45bb3f0f: folds
d25e9ff3: folds
1fc1f571: folds
f71b25e9: raises $0.07 to $0.12
6e8725eb: calls $0.07
*** FLOP *** [3d 8h Qh]
f71b25e9: checks
6e8725eb: bets $0.24
f71b25e9: folds
Uncalled bet ($0.24) returned to 6e8725eb
*** SHOWDOWN ***
6e8725eb collected $0.23 from pot
*** SUMMARY ***
Total pot $0.24 | Rake $0.01 | Jackpot $0 | Bingo $0 | Fortune $0 | Tax $0
Board [3d 8h Qh]
Seat 1: 1fc1f571 (button) folded before Flop (didn't bet)
Seat 2: f71b25e9 (small blind) folded on the Flop
Seat 3: 6e8725eb (big blind) won ($0.23)
Seat 4: Hero folded before Flop (didn't bet)
Seat 5: 45bb3f0f folded before Flop (didn't bet)
Seat 6: d25e9ff3 folded before Flop (didn't bet)


Poker Hand #RC2078517401: Hold'em No Limit ($0.02/$0.05) - 2023/12/22 21:37:49
Table 'RushAndCash793595' 6-max Seat #1 is the button
Seat 1: 3fc56396 ($5.05 in chips)
Seat 2: 9a957500 ($1.54 in chips)
Seat 3: 5d17419b ($5.55 in chips)
Seat 4: 993ccadb ($14.51 in chips)
Seat 5: Hero ($11.01 in chips)
Seat 6: 976fcde7 ($5.27 in chips)
9a957500: posts small blind $0.02
5d17419b: posts big blind $0.05
*** HOLE CARDS ***
Dealt to 3fc56396 
Dealt to 9a957500 
Dealt to 5d17419b 
Dealt to 993ccadb 
Dealt to Hero [9c 7h]
Dealt to 976fcde7 
993ccadb: raises $0.08 to $0.13
Hero: folds
976fcde7: folds
3fc56396: raises $0.26 to $0.39
9a957500: folds
5d17419b: folds
993ccadb: folds
Uncalled bet ($0.26) returned to 3fc56396
*** SHOWDOWN ***
3fc56396 collected $0.32 from pot
*** SUMMARY ***
Total pot $0.33 | Rake $0.01 | Jackpot $0 | Bingo $0 | Fortune $0 | Tax $0
Seat 1: 3fc56396 (button) collected ($0.32)
Seat 2: 9a957500 (small blind) folded before Flop
Seat 3: 5d17419b (big blind) folded before Flop
Seat 4: 993ccadb folded before Flop
Seat 5: Hero folded before Flop (didn't bet)
Seat 6: 976fcde7 folded before Flop (didn't bet)


Poker Hand #RC2078517307: Hold'em No Limit ($0.02/$0.05) - 2023/12/22 21:37:44
Table 'RushAndCash793547' 6-max Seat #1 is the button
Seat 1: 7b437e57 ($5 in chips)
Seat 2: a8629ffc ($2.31 in chips)
Seat 3: 17be45ec ($5.87 in chips)
Seat 4: b9aa0c94 ($14.55 in chips)
Seat 5: Hero ($11.01 in chips)
Seat 6: c9dcc850 ($6.27 in chips)
a8629ffc: posts small blind $0.02
17be45ec: posts big blind $0.05
*** HOLE CARDS ***
Dealt to 7b437e57 
Dealt to a8629ffc 
Dealt to 17be45ec 
Dealt to b9aa0c94 
Dealt to Hero [4c 3s]
Dealt to c9dcc850 
b9aa0c94: raises $0.05 to $0.1
Hero: folds
c9dcc850: calls $0.1
7b437e57: folds
a8629ffc: calls $0.08
17be45ec: calls $0.05
*** FLOP *** [9c Ad 8h]
a8629ffc: checks
17be45ec: checks
b9aa0c94: checks
c9dcc850: checks
*** TURN *** [9c Ad 8h] [7h]
a8629ffc: bets $0.2
17be45ec: calls $0.2
b9aa0c94: folds
c9dcc850: folds
*** RIVER *** [9c Ad 8h 7h] [6h]
a8629ffc: bets $0.6
17be45ec: calls $0.6
a8629ffc: shows [Js Tc] (Jacks-High Straight)
17be45ec: shows [As Qd] (Pair of Aces)
*** SHOWDOWN ***
a8629ffc collected $1.84 from pot
*** SUMMARY ***
Total pot $2 | Rake $0.09 | Jackpot $0.07 | Bingo $0 | Fortune $0 | Tax $0
Board [9c Ad 8h 7h 6h]
Seat 1: 7b437e57 (button) folded before Flop (didn't bet)
Seat 2: a8629ffc (small blind) showed [Js Tc] and won ($1.84) with Jacks-High Straight
Seat 3: 17be45ec (big blind) showed [As Qd] and lost with Pair of Aces
Seat 4: b9aa0c94 folded on the Turn
Seat 5: Hero folded before Flop (didn't bet)
Seat 6: c9dcc850 folded on the Turn


Poker Hand #RC2078516539: Hold'em No Limit ($0.02/$0.05) - 2023/12/22 21:37:00
Table 'RushAndCash793180' 6-max Seat #1 is the button
Seat 1: Hero ($5.96 in chips)
Seat 2: d50b3b7c ($5.12 in chips)
Seat 3: c4c1c89a ($5 in chips)
Seat 4: f677406 ($12.42 in chips)
Seat 5: bd5964be ($5.37 in chips)
Seat 6: 891938bf ($5.52 in chips)
d50b3b7c: posts small blind $0.02
c4c1c89a: posts big blind $0.05
*** HOLE CARDS ***
Dealt to Hero [Qh Qs]
Dealt to d50b3b7c 
Dealt to c4c1c89a 
Dealt to f677406 
Dealt to bd5964be 
Dealt to 891938bf 
f677406: raises $0.05 to $0.1
bd5964be: folds
891938bf: folds
Hero: raises $0.37 to $0.47
d50b3b7c: raises $0.88 to $1.35
c4c1c89a: folds
f677406: folds
Hero: raises $4.61 to $5.96 and is all-in
d50b3b7c: calls $3.77 and is all-in
Uncalled bet ($0.84) returned to Hero
Hero: shows [Qh Qs]
d50b3b7c: shows [Kh Ah]
*** FLOP *** [9s 9c 3h]
*** TURN *** [9s 9c 3h] [8s]
*** RIVER *** [9s 9c 3h 8s] [9h]
*** SHOWDOWN ***
Hero collected $10.17 from pot
*** SUMMARY ***
Total pot $10.39 | Rake $0.15 | Jackpot $0.07 | Bingo $0 | Fortune $0 | Tax $0
Board [9s 9c 3h 8s 9h]
Seat 1: Hero (button) showed [Qh Qs] and won ($10.17) with Nines Full over Queens
Seat 2: d50b3b7c (small blind) showed [Kh Ah] and lost with Three Nines
Seat 3: c4c1c89a (big blind) folded before Flop
Seat 4: f677406 folded before Flop
Seat 5: bd5964be folded before Flop (didn't bet)
Seat 6: 891938bf folded before Flop (didn't bet)


Poker Hand #RC2078516371: Hold'em No Limit ($0.02/$0.05) - 2023/12/22 21:36:50
Table 'RushAndCash793109' 6-max Seat #1 is the button
Seat 1: 22751e36 ($16.42 in chips)
Seat 2: adc999b ($17.1 in chips)
Seat 3: Hero ($6.01 in chips)
Seat 4: c7bcf41c ($5.18 in chips)
Seat 5: df439f39 ($5.89 in chips)
Seat 6: b2bf2645 ($5.42 in chips)
adc999b: posts small blind $0.02
Hero: posts big blind $0.05
*** HOLE CARDS ***
Dealt to 22751e36 
Dealt to adc999b 
Dealt to Hero [6s Kh]
Dealt to c7bcf41c 
Dealt to df439f39 
Dealt to b2bf2645 
c7bcf41c: folds
df439f39: raises $0.06 to $0.11
b2bf2645: calls $0.11
22751e36: raises $0.4 to $0.51
adc999b: folds
Hero: folds
df439f39: calls $0.4
b2bf2645: calls $0.4
*** FLOP *** [Qd 8s Td]
df439f39: checks
b2bf2645: checks
22751e36: bets $0.8
df439f39: folds
b2bf2645: folds
Uncalled bet ($0.8) returned to 22751e36
*** SHOWDOWN ***
22751e36 collected $1.46 from pot
*** SUMMARY ***
Total pot $1.6 | Rake $0.07 | Jackpot $0.07 | Bingo $0 | Fortune $0 | Tax $0
Board [Qd 8s Td]
Seat 1: 22751e36 (button) won ($1.46)
Seat 2: adc999b (small blind) folded before Flop
Seat 3: Hero (big blind) folded before Flop
Seat 4: c7bcf41c folded before Flop (didn't bet)
Seat 5: df439f39 folded on the Flop
Seat 6: b2bf2645 folded on the Flop


Poker Hand #RC2078516246: Hold'em No Limit ($0.02/$0.05) - 2023/12/22 21:36:43
Table 'RushAndCash793059' 6-max Seat #1 is the button
Seat 1: f1f11b26 ($11.01 in chips)
Seat 2: Hero ($6.03 in chips)
Seat 3: 5261fe21 ($6.57 in chips)
Seat 4: 5a6bcca5 ($10.59 in chips)
Seat 5: dc7cff29 ($9.81 in chips)
Seat 6: ff6f425f ($6.52 in chips)
Hero: posts small blind $0.02
5261fe21: posts big blind $0.05
*** HOLE CARDS ***
Dealt to f1f11b26 
Dealt to Hero [Tc 9d]
Dealt to 5261fe21 
Dealt to 5a6bcca5 
Dealt to dc7cff29 
Dealt to ff6f425f 
5a6bcca5: folds
dc7cff29: folds
ff6f425f: folds
f1f11b26: raises $0.08 to $0.13
Hero: folds
5261fe21: folds
Uncalled bet ($0.08) returned to f1f11b26
*** SHOWDOWN ***
f1f11b26 collected $0.12 from pot
*** SUMMARY ***
Total pot $0.12 | Rake $0 | Jackpot $0 | Bingo $0 | Fortune $0 | Tax $0
Seat 1: f1f11b26 (button) collected ($0.12)
Seat 2: Hero (small blind) folded before Flop
Seat 3: 5261fe21 (big blind) folded before Flop
Seat 4: 5a6bcca5 folded before Flop (didn't bet)
Seat 5: dc7cff29 folded before Flop (didn't bet)
Seat 6: ff6f425f folded before Flop (didn't bet)


Poker Hand #RC2078515988: Hold'em No Limit ($0.02/$0.05) - 2023/12/22 21:36:29
Table 'RushAndCash792947' 6-max Seat #1 is the button
Seat 1: f93190a6 ($5 in chips)
Seat 2: 525db62f ($15.62 in chips)
Seat 3: 3160ff3c ($12.71 in chips)
Seat 4: baed300a ($5.14 in chips)
Seat 5: Hero ($5.96 in chips)
Seat 6: 80af7fe3 ($5.47 in chips)
525db62f: posts small blind $0.02
3160ff3c: posts big blind $0.05
*** HOLE CARDS ***
Dealt to f93190a6 
Dealt to 525db62f 
Dealt to 3160ff3c 
Dealt to baed300a 
Dealt to Hero [Th Ks]
Dealt to 80af7fe3 
baed300a: folds
Hero: raises $0.05 to $0.1
80af7fe3: folds
f93190a6: folds
525db62f: folds
3160ff3c: folds
Uncalled bet ($0.05) returned to Hero
*** SHOWDOWN ***
Hero collected $0.12 from pot
*** SUMMARY ***
Total pot $0.12 | Rake $0 | Jackpot $0 | Bingo $0 | Fortune $0 | Tax $0
Seat 1: f93190a6 (button) folded before Flop (didn't bet)
Seat 2: 525db62f (small blind) folded before Flop
Seat 3: 3160ff3c (big blind) folded before Flop
Seat 4: baed300a folded before Flop (didn't bet)
Seat 5: Hero collected ($0.12)
Seat 6: 80af7fe3 folded before Flop (didn't bet)


Poker Hand #RC2078515534: Hold'em No Limit ($0.02/$0.05) - 2023/12/22 21:36:04
Table 'RushAndCash792738' 6-max Seat #1 is the button
Seat 1: e1380a89 ($5.4 in chips)
Seat 2: baed300a ($5 in chips)
Seat 3: 52f74b76 ($5 in chips)
Seat 4: faf7185e ($1.99 in chips)
Seat 5: Hero ($6.06 in chips)
Seat 6: ed53cde8 ($5.7 in chips)
baed300a: posts small blind $0.02
52f74b76: posts big blind $0.05
*** HOLE CARDS ***
Dealt to e1380a89 
Dealt to baed300a 
Dealt to 52f74b76 
Dealt to faf7185e 
Dealt to Hero [Ts 9s]
Dealt to ed53cde8 
faf7185e: folds
Hero: raises $0.05 to $0.1
ed53cde8: folds
e1380a89: folds
baed300a: raises $0.5 to $0.6
52f74b76: folds
Hero: folds
Uncalled bet ($0.5) returned to baed300a
*** SHOWDOWN ***
baed300a collected $0.24 from pot
*** SUMMARY ***
Total pot $0.25 | Rake $0.01 | Jackpot $0 | Bingo $0 | Fortune $0 | Tax $0
Seat 1: e1380a89 (button) folded before Flop (didn't bet)
Seat 2: baed300a (small blind) collected ($0.24)
Seat 3: 52f74b76 (big blind) folded before Flop
Seat 4: faf7185e folded before Flop (didn't bet)
Seat 5: Hero folded before Flop
Seat 6: ed53cde8 folded before Flop (didn't bet)


Poker Hand #RC2078515468: Hold'em No Limit ($0.02/$0.05) - 2023/12/22 21:36:00
Table 'RushAndCash792708' 6-max Seat #1 is the button
Seat 1: Hero ($6.06 in chips)
Seat 2: ab5dffec ($8.89 in chips)
Seat 3: 806c9c64 ($3.03 in chips)
Seat 4: 56d0ca9d ($6.2 in chips)
Seat 5: 3160ff3c ($12.66 in chips)
Seat 6: c2881b52 ($10.48 in chips)
ab5dffec: posts small blind $0.02
806c9c64: posts big blind $0.05
*** HOLE CARDS ***
Dealt to Hero [Tc 2h]
Dealt to ab5dffec 
Dealt to 806c9c64 
Dealt to 56d0ca9d 
Dealt to 3160ff3c 
Dealt to c2881b52 
56d0ca9d: folds
3160ff3c: folds
c2881b52: folds
Hero: folds
ab5dffec: folds
Uncalled bet ($0.03) returned to 806c9c64
*** SHOWDOWN ***
806c9c64 collected $0.04 from pot
*** SUMMARY ***
Total pot $0.04 | Rake $0 | Jackpot $0 | Bingo $0 | Fortune $0 | Tax $0
Seat 1: Hero (button) folded before Flop (didn't bet)
Seat 2: ab5dffec (small blind) folded before Flop
Seat 3: 806c9c64 (big blind) collected ($0.04)
Seat 4: 56d0ca9d folded before Flop (didn't bet)
Seat 5: 3160ff3c folded before Flop (didn't bet)
Seat 6: c2881b52 folded before Flop (didn't bet)


Poker Hand #RC2078515349: Hold'em No Limit ($0.02/$0.05) - 2023/12/22 21:35:54
Table 'RushAndCash792655' 6-max Seat #1 is the button
Seat 1: 7095bc76 ($5 in chips)
Seat 2: 972d9171 ($4.95 in chips)
Seat 3: 91937678 ($4.69 in chips)
Seat 4: 47ecc871 ($3.64 in chips)
Seat 5: ed53cde8 ($5.72 in chips)
Seat 6: Hero ($6.06 in chips)
972d9171: posts small blind $0.02
91937678: posts big blind $0.05
*** HOLE CARDS ***
Dealt to 7095bc76 
Dealt to 972d9171 
Dealt to 91937678 
Dealt to 47ecc871 
Dealt to ed53cde8 
Dealt to Hero [5c Qs]
47ecc871: folds
ed53cde8: folds
Hero: folds
7095bc76: raises $0.07 to $0.12
972d9171: calls $0.1
91937678: folds
*** FLOP *** [2c 4c Tc]
972d9171: bets $0.1
7095bc76: calls $0.1
*** TURN *** [2c 4c Tc] [2s]
972d9171: checks
7095bc76: checks
*** RIVER *** [2c 4c Tc 2s] [8h]
972d9171: bets $0.17
7095bc76: folds
Uncalled bet ($0.17) returned to 972d9171
*** SHOWDOWN ***
972d9171 collected $0.47 from pot
*** SUMMARY ***
Total pot $0.49 | Rake $0.02 | Jackpot $0 | Bingo $0 | Fortune $0 | Tax $0
Board [2c 4c Tc 2s 8h]
Seat 1: 7095bc76 (button) folded on the River
Seat 2: 972d9171 (small blind) won ($0.47)
Seat 3: 91937678 (big blind) folded before Flop
Seat 4: 47ecc871 folded before Flop (didn't bet)
Seat 5: ed53cde8 folded before Flop (didn't bet)
Seat 6: Hero folded before Flop (didn't bet)


Poker Hand #RC2078515253: Hold'em No Limit ($0.02/$0.05) - 2023/12/22 21:35:48
Table 'RushAndCash792615' 6-max Seat #1 is the button
Seat 1: 70f1d0b3 ($6.71 in chips)
Seat 2: Hero ($6.08 in chips)
Seat 3: c4c1c89a ($5 in chips)
Seat 4: 2bb677ff ($3.11 in chips)
Seat 5: e3ae7589 ($5.62 in chips)
Seat 6: 5d732d5e ($5.28 in chips)
Hero: posts small blind $0.02
c4c1c89a: posts big blind $0.05
*** HOLE CARDS ***
Dealt to 70f1d0b3 
Dealt to Hero [7h Qs]
Dealt to c4c1c89a 
Dealt to 2bb677ff 
Dealt to e3ae7589 
Dealt to 5d732d5e 
2bb677ff: folds
e3ae7589: folds
5d732d5e: folds
70f1d0b3: folds
Hero: folds
Uncalled bet ($0.03) returned to c4c1c89a
*** SHOWDOWN ***
c4c1c89a collected $0.04 from pot
*** SUMMARY ***
Total pot $0.04 | Rake $0 | Jackpot $0 | Bingo $0 | Fortune $0 | Tax $0
Seat 1: 70f1d0b3 (button) folded before Flop (didn't bet)
Seat 2: Hero (small blind) folded before Flop
Seat 3: c4c1c89a (big blind) collected ($0.04)
Seat 4: 2bb677ff folded before Flop (didn't bet)
Seat 5: e3ae7589 folded before Flop (didn't bet)
Seat 6: 5d732d5e folded before Flop (didn't bet)


Poker Hand #RC2078515173: Hold'em No Limit ($0.02/$0.05) - 2023/12/22 21:35:44
Table 'RushAndCash792576' 6-max Seat #1 is the button
Seat 1: 90a9fad4 ($46.22 in chips)
Seat 2: c7bcf41c ($5 in chips)
Seat 3: Hero ($6.13 in chips)
Seat 4: 9fd86997 ($21.7 in chips)
Seat 5: 254bcf9e ($5 in chips)
Seat 6: 6551e7ca ($5.9 in chips)
c7bcf41c: posts small blind $0.02
Hero: posts big blind $0.05
*** HOLE CARDS ***
Dealt to 90a9fad4 
Dealt to c7bcf41c 
Dealt to Hero [8s Td]
Dealt to 9fd86997 
Dealt to 254bcf9e 
Dealt to 6551e7ca 
9fd86997: folds
254bcf9e: raises $0.05 to $0.1
6551e7ca: raises $0.38 to $0.48
90a9fad4: folds
c7bcf41c: folds
Hero: folds
254bcf9e: raises $0.6 to $1.08
6551e7ca: calls $0.6
*** FLOP *** [9h 9d 8c]
254bcf9e: bets $0.79
6551e7ca: calls $0.79
*** TURN *** [9h 9d 8c] [8d]
254bcf9e: checks
6551e7ca: checks
*** RIVER *** [9h 9d 8c 8d] [Jh]
254bcf9e: checks
6551e7ca: bets $4.03 and is all-in
254bcf9e: calls $3.13 and is all-in
Uncalled bet ($0.9) returned to 6551e7ca
6551e7ca: shows [Kc Qc] (Pair of Nines and Pair of Eights)
254bcf9e: shows [Ac Kh] (Pair of Nines and Pair of Eights)
*** SHOWDOWN ***
254bcf9e collected $9.85 from pot
*** SUMMARY ***
Total pot $10.07 | Rake $0.15 | Jackpot $0.07 | Bingo $0 | Fortune $0 | Tax $0
Board [9h 9d 8c 8d Jh]
Seat 1: 90a9fad4 (button) folded before Flop (didn't bet)
Seat 2: c7bcf41c (small blind) folded before Flop
Seat 3: Hero (big blind) folded before Flop
Seat 4: 9fd86997 folded before Flop (didn't bet)
Seat 5: 254bcf9e showed [Ac Kh] and won ($9.85) with Pair of Nines and Pair of Eights
Seat 6: 6551e7ca showed [Kc Qc] and lost with Pair of Nines and Pair of Eights


Poker Hand #RC2078515099: Hold'em No Limit ($0.02/$0.05) - 2023/12/22 21:35:40
Table 'RushAndCash792542' 6-max Seat #1 is the button
Seat 1: 37b9c97 ($5.66 in chips)
Seat 2: 7c10f852 ($29.96 in chips)
Seat 3: 34ce5e3 ($5 in chips)
Seat 4: e3ae7589 ($5.62 in chips)
Seat 5: 42a3def4 ($2.23 in chips)
Seat 6: Hero ($6.13 in chips)
7c10f852: posts small blind $0.02
34ce5e3: posts big blind $0.05
*** HOLE CARDS ***
Dealt to 37b9c97 
Dealt to 7c10f852 
Dealt to 34ce5e3 
Dealt to e3ae7589 
Dealt to 42a3def4 
Dealt to Hero [Qd 5c]
e3ae7589: folds
42a3def4: folds
Hero: folds
37b9c97: raises $0.05 to $0.1
7c10f852: folds
34ce5e3: folds
Uncalled bet ($0.05) returned to 37b9c97
*** SHOWDOWN ***
37b9c97 collected $0.12 from pot
*** SUMMARY ***
Total pot $0.12 | Rake $0 | Jackpot $0 | Bingo $0 | Fortune $0 | Tax $0
Seat 1: 37b9c97 (button) collected ($0.12)
Seat 2: 7c10f852 (small blind) folded before Flop
Seat 3: 34ce5e3 (big blind) folded before Flop
Seat 4: e3ae7589 folded before Flop (didn't bet)
Seat 5: 42a3def4 folded before Flop (didn't bet)
Seat 6: Hero folded before Flop (didn't bet)


Poker Hand #RC2078515022: Hold'em No Limit ($0.02/$0.05) - 2023/12/22 21:35:36
Table 'RushAndCash792504' 6-max Seat #1 is the button
Seat 1: bc26f2e1 ($5.39 in chips)
Seat 2: 8ad5eb6 ($4.67 in chips)
Seat 3: 7095bc76 ($5 in chips)
Seat 4: 271c38e0 ($5.09 in chips)
Seat 5: Hero ($6.13 in chips)
Seat 6: 983d74a ($11.87 in chips)
8ad5eb6: posts small blind $0.02
7095bc76: posts big blind $0.05
*** HOLE CARDS ***
Dealt to bc26f2e1 
Dealt to 8ad5eb6 
Dealt to 7095bc76 
Dealt to 271c38e0 
Dealt to Hero [2h Th]
Dealt to 983d74a 
271c38e0: raises $0.1 to $0.15
Hero: folds
983d74a: folds
bc26f2e1: calls $0.15
8ad5eb6: folds
7095bc76: folds
*** FLOP *** [7c 7s 4s]
271c38e0: bets $0.13
bc26f2e1: calls $0.13
*** TURN *** [7c 7s 4s] [8c]
271c38e0: bets $0.53
bc26f2e1: raises $0.73 to $1.26
271c38e0: folds
Uncalled bet ($0.73) returned to bc26f2e1
*** SHOWDOWN ***
bc26f2e1 collected $1.54 from pot
*** SUMMARY ***
Total pot $1.69 | Rake $0.08 | Jackpot $0.07 | Bingo $0 | Fortune $0 | Tax $0
Board [7c 7s 4s 8c]
Seat 1: bc26f2e1 (button) won ($1.54)
Seat 2: 8ad5eb6 (small blind) folded before Flop
Seat 3: 7095bc76 (big blind) folded before Flop
Seat 4: 271c38e0 folded on the Turn
Seat 5: Hero folded before Flop (didn't bet)
Seat 6: 983d74a folded before Flop (didn't bet)


Poker Hand #RC2078514957: Hold'em No Limit ($0.02/$0.05) - 2023/12/22 21:35:32
Table 'RushAndCash792473' 6-max Seat #1 is the button
Seat 1: 2e44f78e ($13.6 in chips)
Seat 2: eeb37e34 ($9.77 in chips)
Seat 3: bd80f413 ($9.4 in chips)
Seat 4: 8a9decd1 ($5 in chips)
Seat 5: Hero ($6.13 in chips)
Seat 6: 48d31a27 ($5 in chips)
eeb37e34: posts small blind $0.02
bd80f413: posts big blind $0.05
*** HOLE CARDS ***
Dealt to 2e44f78e 
Dealt to eeb37e34 
Dealt to bd80f413 
Dealt to 8a9decd1 
Dealt to Hero [9c Th]
Dealt to 48d31a27 
8a9decd1: raises $0.06 to $0.11
Hero: folds
48d31a27: folds
2e44f78e: folds
eeb37e34: folds
bd80f413: calls $0.06
*** FLOP *** [Jc 9d Ts]
bd80f413: bets $0.12
8a9decd1: folds
Uncalled bet ($0.12) returned to bd80f413
*** SHOWDOWN ***
bd80f413 collected $0.23 from pot
*** SUMMARY ***
Total pot $0.24 | Rake $0.01 | Jackpot $0 | Bingo $0 | Fortune $0 | Tax $0
Board [Jc 9d Ts]
Seat 1: 2e44f78e (button) folded before Flop (didn't bet)
Seat 2: eeb37e34 (small blind) folded before Flop
Seat 3: bd80f413 (big blind) won ($0.23)
Seat 4: 8a9decd1 folded on the Flop
Seat 5: Hero folded before Flop (didn't bet)
Seat 6: 48d31a27 folded before Flop (didn't bet)


Poker Hand #RC2078514876: Hold'em No Limit ($0.02/$0.05) - 2023/12/22 21:35:27
Table 'RushAndCash792435' 6-max Seat #1 is the button
Seat 1: Hero ($6.13 in chips)
Seat 2: f6aba64b ($5.91 in chips)
Seat 3: 3e164086 ($5.66 in chips)
Seat 4: 6bc8336e ($5.56 in chips)
Seat 5: 45ce1aed ($5 in chips)
Seat 6: 72f7386e ($11.88 in chips)
f6aba64b: posts small blind $0.02
3e164086: posts big blind $0.05
*** HOLE CARDS ***
Dealt to Hero [Ts 3c]
Dealt to f6aba64b 
Dealt to 3e164086 
Dealt to 6bc8336e 
Dealt to 45ce1aed 
Dealt to 72f7386e 
6bc8336e: folds
45ce1aed: folds
72f7386e: raises $0.07 to $0.12
Hero: folds
f6aba64b: folds
3e164086: raises $0.13 to $0.25
72f7386e: calls $0.13
*** FLOP *** [Jd Ks 5c]
3e164086: checks
72f7386e: bets $0.32
3e164086: raises $0.32 to $0.64
72f7386e: raises $1.8 to $2.44
3e164086: raises $2.97 to $5.41 and is all-in
72f7386e: calls $2.97
3e164086: shows [As Kc] (Pair of Kings)
72f7386e: shows [Kh Kd] (Three Kings)
*** TURN *** [Jd Ks 5c] [Ah]
*** RIVER *** [Jd Ks 5c Ah] [9s]
*** SHOWDOWN ***
72f7386e collected $11.12 from pot
*** SUMMARY ***
Total pot $11.34 | Rake $0.15 | Jackpot $0.07 | Bingo $0 | Fortune $0 | Tax $0
Board [Jd Ks 5c Ah 9s]
Seat 1: Hero (button) folded before Flop (didn't bet)
Seat 2: f6aba64b (small blind) folded before Flop
Seat 3: 3e164086 (big blind) showed [As Kc] and lost with Pair of Aces and Pair of Kings
Seat 4: 6bc8336e folded before Flop (didn't bet)
Seat 5: 45ce1aed folded before Flop (didn't bet)
Seat 6: 72f7386e showed [Kh Kd] and won ($11.12) with Three Kings


Poker Hand #RC2078514803: Hold'em No Limit ($0.02/$0.05) - 2023/12/22 21:35:24
Table 'RushAndCash792399' 6-max Seat #1 is the button
Seat 1: 391fe85a ($5.14 in chips)
Seat 2: Hero ($6.15 in chips)
Seat 3: d6c4e270 ($3.25 in chips)
Seat 4: 37b9c97 ($5.66 in chips)
Seat 5: 954d1f7b ($13.28 in chips)
Seat 6: 56a5ef7f ($5.07 in chips)
Hero: posts small blind $0.02
d6c4e270: posts big blind $0.05
*** HOLE CARDS ***
Dealt to 391fe85a 
Dealt to Hero [6c Qd]
Dealt to d6c4e270 
Dealt to 37b9c97 
Dealt to 954d1f7b 
Dealt to 56a5ef7f 
37b9c97: folds
954d1f7b: folds
56a5ef7f: folds
391fe85a: folds
Hero: folds
Uncalled bet ($0.03) returned to d6c4e270
*** SHOWDOWN ***
d6c4e270 collected $0.04 from pot
*** SUMMARY ***
Total pot $0.04 | Rake $0 | Jackpot $0 | Bingo $0 | Fortune $0 | Tax $0
Seat 1: 391fe85a (button) folded before Flop (didn't bet)
Seat 2: Hero (small blind) folded before Flop
Seat 3: d6c4e270 (big blind) collected ($0.04)
Seat 4: 37b9c97 folded before Flop (didn't bet)
Seat 5: 954d1f7b folded before Flop (didn't bet)
Seat 6: 56a5ef7f folded before Flop (didn't bet)


Poker Hand #RC2078514634: Hold'em No Limit ($0.02/$0.05) - 2023/12/22 21:35:14
Table 'RushAndCash792319' 6-max Seat #1 is the button
Seat 1: de1c7123 ($5.51 in chips)
Seat 2: 5f11c3da ($15.7 in chips)
Seat 3: Hero ($6.13 in chips)
Seat 4: 1f7caee2 ($3.45 in chips)
Seat 5: b1f568c0 ($12.52 in chips)
Seat 6: 1be6b9fd ($15.77 in chips)
5f11c3da: posts small blind $0.02
Hero: posts big blind $0.05
*** HOLE CARDS ***
Dealt to de1c7123 
Dealt to 5f11c3da 
Dealt to Hero [3h 9d]
Dealt to 1f7caee2 
Dealt to b1f568c0 
Dealt to 1be6b9fd 
1f7caee2: folds
b1f568c0: folds
1be6b9fd: folds
de1c7123: folds
5f11c3da: folds
Uncalled bet ($0.03) returned to Hero
*** SHOWDOWN ***
Hero collected $0.04 from pot
*** SUMMARY ***
Total pot $0.04 | Rake $0 | Jackpot $0 | Bingo $0 | Fortune $0 | Tax $0
Seat 1: de1c7123 (button) folded before Flop (didn't bet)
Seat 2: 5f11c3da (small blind) folded before Flop
Seat 3: Hero (big blind) collected ($0.04)
Seat 4: 1f7caee2 folded before Flop (didn't bet)
Seat 5: b1f568c0 folded before Flop (didn't bet)
Seat 6: 1be6b9fd folded before Flop (didn't bet)


Poker Hand #RC2078514564: Hold'em No Limit ($0.02/$0.05) - 2023/12/22 21:35:10
Table 'RushAndCash792288' 6-max Seat #1 is the button
Seat 1: 7c950e30 ($9.91 in chips)
Seat 2: a615a9f6 ($12.97 in chips)
Seat 3: 3580bebf ($13.35 in chips)
Seat 4: 8acef960 ($4.07 in chips)
Seat 5: Hero ($6.13 in chips)
Seat 6: cb9a7609 ($5 in chips)
a615a9f6: posts small blind $0.02
3580bebf: posts big blind $0.05
*** HOLE CARDS ***
Dealt to 7c950e30 
Dealt to a615a9f6 
Dealt to 3580bebf 
Dealt to 8acef960 
Dealt to Hero [3c Td]
Dealt to cb9a7609 
8acef960: folds
Hero: folds
cb9a7609: raises $0.08 to $0.13
7c950e30: folds
a615a9f6: calls $0.11
3580bebf: folds
*** FLOP *** [6d 5c Kc]
a615a9f6: checks
cb9a7609: checks
*** TURN *** [6d 5c Kc] [Jh]
a615a9f6: checks
cb9a7609: checks
*** RIVER *** [6d 5c Kc Jh] [Qd]
a615a9f6: checks
cb9a7609: bets $0.46
a615a9f6: calls $0.46
cb9a7609: shows [As Tc] (Aces-High Straight)
a615a9f6: shows [Qh Js] (Pair of Queens and Pair of Jacks)
*** SHOWDOWN ***
cb9a7609 collected $1.16 from pot
*** SUMMARY ***
Total pot $1.23 | Rake $0.07 | Jackpot $0 | Bingo $0 | Fortune $0 | Tax $0
Board [6d 5c Kc Jh Qd]
Seat 1: 7c950e30 (button) folded before Flop (didn't bet)
Seat 2: a615a9f6 (small blind) showed [Qh Js] and lost with Pair of Queens and Pair of Jacks
Seat 3: 3580bebf (big blind) folded before Flop
Seat 4: 8acef960 folded before Flop (didn't bet)
Seat 5: Hero folded before Flop (didn't bet)
Seat 6: cb9a7609 showed [As Tc] and won ($1.16) with Aces-High Straight


Poker Hand #RC2078514487: Hold'em No Limit ($0.02/$0.05) - 2023/12/22 21:35:06
Table 'RushAndCash792257' 6-max Seat #1 is the button
Seat 1: 11612373 ($12.06 in chips)
Seat 2: 91e6539a ($5 in chips)
Seat 3: b88dbe00 ($6.39 in chips)
Seat 4: Hero ($6.13 in chips)
Seat 5: 28e8fd4 ($2.63 in chips)
Seat 6: b5f4d20f ($5.05 in chips)
91e6539a: posts small blind $0.02
b88dbe00: posts big blind $0.05
*** HOLE CARDS ***
Dealt to 11612373 
Dealt to 91e6539a 
Dealt to b88dbe00 
Dealt to Hero [3c Kh]
Dealt to 28e8fd4 
Dealt to b5f4d20f 
Hero: folds
28e8fd4: folds
b5f4d20f: folds
11612373: folds
91e6539a: folds
Uncalled bet ($0.03) returned to b88dbe00
*** SHOWDOWN ***
b88dbe00 collected $0.04 from pot
*** SUMMARY ***
Total pot $0.04 | Rake $0 | Jackpot $0 | Bingo $0 | Fortune $0 | Tax $0
Seat 1: 11612373 (button) folded before Flop (didn't bet)
Seat 2: 91e6539a (small blind) folded before Flop
Seat 3: b88dbe00 (big blind) collected ($0.04)
Seat 4: Hero folded before Flop (didn't bet)
Seat 5: 28e8fd4 folded before Flop (didn't bet)
Seat 6: b5f4d20f folded before Flop (didn't bet)


Poker Hand #RC2078514421: Hold'em No Limit ($0.02/$0.05) - 2023/12/22 21:35:02
Table 'RushAndCash792227' 6-max Seat #1 is the button
Seat 1: 1e3d103d ($9.91 in chips)
Seat 2: 869465ff ($17.44 in chips)
Seat 3: 1fac6fbb ($4.9 in chips)
Seat 4: 12953fac ($10.07 in chips)
Seat 5: fbeaaad2 ($18.53 in chips)
Seat 6: Hero ($6.13 in chips)
869465ff: posts small blind $0.02
1fac6fbb: posts big blind $0.05
*** HOLE CARDS ***
Dealt to 1e3d103d 
Dealt to 869465ff 
Dealt to 1fac6fbb 
Dealt to 12953fac 
Dealt to fbeaaad2 
Dealt to Hero [7d 6s]
12953fac: folds
fbeaaad2: folds
Hero: folds
1e3d103d: folds
869465ff: raises $0.06 to $0.11
1fac6fbb: calls $0.06
*** FLOP *** [6c Qc 4h]
869465ff: bets $0.08
1fac6fbb: calls $0.08
*** TURN *** [6c Qc 4h] [Kh]
869465ff: bets $0.29
1fac6fbb: folds
Uncalled bet ($0.29) returned to 869465ff
*** SHOWDOWN ***
869465ff collected $0.37 from pot
*** SUMMARY ***
Total pot $0.38 | Rake $0.01 | Jackpot $0 | Bingo $0 | Fortune $0 | Tax $0
Board [6c Qc 4h Kh]
Seat 1: 1e3d103d (button) folded before Flop (didn't bet)
Seat 2: 869465ff (small blind) won ($0.37)
Seat 3: 1fac6fbb (big blind) folded on the Turn
Seat 4: 12953fac folded before Flop (didn't bet)
Seat 5: fbeaaad2 folded before Flop (didn't bet)
Seat 6: Hero folded before Flop (didn't bet)


Poker Hand #RC2078514352: Hold'em No Limit ($0.02/$0.05) - 2023/12/22 21:34:59
Table 'RushAndCash792193' 6-max Seat #1 is the button
Seat 1: Hero ($6.13 in chips)
Seat 2: 548ecbec ($5.06 in chips)
Seat 3: 59da0131 ($18.25 in chips)
Seat 4: fa93749b ($8.58 in chips)
Seat 5: 37e2503b ($6.29 in chips)
Seat 6: 1fac6fbb ($4.9 in chips)
548ecbec: posts small blind $0.02
59da0131: posts big blind $0.05
*** HOLE CARDS ***
Dealt to Hero [Ks 4h]
Dealt to 548ecbec 
Dealt to 59da0131 
Dealt to fa93749b 
Dealt to 37e2503b 
Dealt to 1fac6fbb 
fa93749b: folds
37e2503b: folds
1fac6fbb: folds
Hero: folds
548ecbec: folds
Uncalled bet ($0.03) returned to 59da0131
*** SHOWDOWN ***
59da0131 collected $0.04 from pot
*** SUMMARY ***
Total pot $0.04 | Rake $0 | Jackpot $0 | Bingo $0 | Fortune $0 | Tax $0
Seat 1: Hero (button) folded before Flop (didn't bet)
Seat 2: 548ecbec (small blind) folded before Flop
Seat 3: 59da0131 (big blind) collected ($0.04)
Seat 4: fa93749b folded before Flop (didn't bet)
Seat 5: 37e2503b folded before Flop (didn't bet)
Seat 6: 1fac6fbb folded before Flop (didn't bet)


Poker Hand #RC2078514160: Hold'em No Limit ($0.02/$0.05) - 2023/12/22 21:34:48
Table 'RushAndCash792103' 6-max Seat #1 is the button
Seat 1: 19915c5a ($8.57 in chips)
Seat 2: Hero ($6.15 in chips)
Seat 3: 4fedcb8f ($5.87 in chips)
Seat 4: 48d31a27 ($5 in chips)
Seat 5: 93d5c821 ($5.9 in chips)
Seat 6: 8f71af3 ($5.64 in chips)
Hero: posts small blind $0.02
4fedcb8f: posts big blind $0.05
*** HOLE CARDS ***
Dealt to 19915c5a 
Dealt to Hero [Qc Ks]
Dealt to 4fedcb8f 
Dealt to 48d31a27 
Dealt to 93d5c821 
Dealt to 8f71af3 
48d31a27: raises $0.05 to $0.1
93d5c821: folds
8f71af3: folds
19915c5a: raises $0.21 to $0.31
Hero: folds
4fedcb8f: folds
48d31a27: calls $0.21
*** FLOP *** [Kd 3h 8h]
48d31a27: checks
19915c5a: bets $0.26
48d31a27: calls $0.26
*** TURN *** [Kd 3h 8h] [6d]
48d31a27: checks
19915c5a: bets $0.5
48d31a27: folds
Uncalled bet ($0.5) returned to 19915c5a
*** SHOWDOWN ***
19915c5a collected $1.15 from pot
*** SUMMARY ***
Total pot $1.21 | Rake $0.06 | Jackpot $0 | Bingo $0 | Fortune $0 | Tax $0
Board [Kd 3h 8h 6d]
Seat 1: 19915c5a (button) won ($1.15)
Seat 2: Hero (small blind) folded before Flop
Seat 3: 4fedcb8f (big blind) folded before Flop
Seat 4: 48d31a27 folded on the Turn
Seat 5: 93d5c821 folded before Flop (didn't bet)
Seat 6: 8f71af3 folded before Flop (didn't bet)


Poker Hand #RC2078513898: Hold'em No Limit ($0.02/$0.05) - 2023/12/22 21:34:32
Table 'RushAndCash791983' 6-max Seat #1 is the button
Seat 1: 469c47cc ($9.54 in chips)
Seat 2: 175b9638 ($6.69 in chips)
Seat 3: Hero ($6.2 in chips)
Seat 4: f57c6794 ($5.25 in chips)
Seat 5: b8cfe296 ($3.83 in chips)
Seat 6: baed300a ($5.11 in chips)
175b9638: posts small blind $0.02
Hero: posts big blind $0.05
*** HOLE CARDS ***
Dealt to 469c47cc 
Dealt to 175b9638 
Dealt to Hero [8c Ad]
Dealt to f57c6794 
Dealt to b8cfe296 
Dealt to baed300a 
f57c6794: folds
b8cfe296: calls $0.05
baed300a: raises $0.17 to $0.22
469c47cc: folds
175b9638: folds
Hero: folds
b8cfe296: calls $0.17
*** FLOP *** [Ac Qd 9d]
b8cfe296: checks
baed300a: bets $0.17
b8cfe296: folds
Uncalled bet ($0.17) returned to baed300a
*** SHOWDOWN ***
baed300a collected $0.49 from pot
*** SUMMARY ***
Total pot $0.51 | Rake $0.02 | Jackpot $0 | Bingo $0 | Fortune $0 | Tax $0
Board [Ac Qd 9d]
Seat 1: 469c47cc (button) folded before Flop (didn't bet)
Seat 2: 175b9638 (small blind) folded before Flop
Seat 3: Hero (big blind) folded before Flop
Seat 4: f57c6794 folded before Flop (didn't bet)
Seat 5: b8cfe296 folded on the Flop
Seat 6: baed300a won ($0.49)


Poker Hand #RC2078513764: Hold'em No Limit ($0.02/$0.05) - 2023/12/22 21:34:24
Table 'RushAndCash791919' 6-max Seat #1 is the button
Seat 1: d23c04d ($7.62 in chips)
Seat 2: 5d55167a ($8.04 in chips)
Seat 3: bf955ffb ($5 in chips)
Seat 4: 6ea11ecf ($7.75 in chips)
Seat 5: 9f59b76d ($5.23 in chips)
Seat 6: Hero ($6.2 in chips)
5d55167a: posts small blind $0.02
bf955ffb: posts big blind $0.05
*** HOLE CARDS ***
Dealt to d23c04d 
Dealt to 5d55167a 
Dealt to bf955ffb 
Dealt to 6ea11ecf 
Dealt to 9f59b76d 
Dealt to Hero [2d Jh]
6ea11ecf: folds
9f59b76d: folds
Hero: folds
d23c04d: raises $0.1 to $0.15
5d55167a: folds
bf955ffb: raises $0.3 to $0.45
d23c04d: calls $0.3
*** FLOP *** [3h 9c Ks]
bf955ffb: bets $0.23
d23c04d: calls $0.23
*** TURN *** [3h 9c Ks] [6c]
bf955ffb: checks
d23c04d: bets $1.1
bf955ffb: folds
Uncalled bet ($1.1) returned to d23c04d
*** SHOWDOWN ***
d23c04d collected $1.32 from pot
*** SUMMARY ***
Total pot $1.38 | Rake $0.06 | Jackpot $0 | Bingo $0 | Fortune $0 | Tax $0
Board [3h 9c Ks 6c]
Seat 1: d23c04d (button) won ($1.32)
Seat 2: 5d55167a (small blind) folded before Flop
Seat 3: bf955ffb (big blind) folded on the Turn
Seat 4: 6ea11ecf folded before Flop (didn't bet)
Seat 5: 9f59b76d folded before Flop (didn't bet)
Seat 6: Hero folded before Flop (didn't bet)


Poker Hand #RC2078513651: Hold'em No Limit ($0.02/$0.05) - 2023/12/22 21:34:19
Table 'RushAndCash791863' 6-max Seat #1 is the button
Seat 1: 7157dd36 ($7.51 in chips)
Seat 2: 3d929f9f ($10.37 in chips)
Seat 3: b2bf2645 ($5.4 in chips)
Seat 4: Hero ($6.2 in chips)
Seat 5: 6c424f5a ($6.22 in chips)
Seat 6: e24a2fed ($11.08 in chips)
3d929f9f: posts small blind $0.02
b2bf2645: posts big blind $0.05
*** HOLE CARDS ***
Dealt to 7157dd36 
Dealt to 3d929f9f 
Dealt to b2bf2645 
Dealt to Hero [Kh 2c]
Dealt to 6c424f5a 
Dealt to e24a2fed 
Hero: folds
6c424f5a: folds
e24a2fed: folds
7157dd36: folds
3d929f9f: folds
Uncalled bet ($0.03) returned to b2bf2645
*** SHOWDOWN ***
b2bf2645 collected $0.04 from pot
*** SUMMARY ***
Total pot $0.04 | Rake $0 | Jackpot $0 | Bingo $0 | Fortune $0 | Tax $0
Seat 1: 7157dd36 (button) folded before Flop (didn't bet)
Seat 2: 3d929f9f (small blind) folded before Flop
Seat 3: b2bf2645 (big blind) collected ($0.04)
Seat 4: Hero folded before Flop (didn't bet)
Seat 5: 6c424f5a folded before Flop (didn't bet)
Seat 6: e24a2fed folded before Flop (didn't bet)


Poker Hand #RC2078513582: Hold'em No Limit ($0.02/$0.05) - 2023/12/22 21:34:14
Table 'RushAndCash791831' 6-max Seat #1 is the button
Seat 1: ef1573b1 ($6.54 in chips)
Seat 2: 8a6d1b ($7.99 in chips)
Seat 3: ac89ef05 ($4.85 in chips)
Seat 4: Hero ($6.2 in chips)
Seat 5: 1c1fc2a1 ($3.82 in chips)
Seat 6: 8db2745e ($5 in chips)
8a6d1b: posts small blind $0.02
ac89ef05: posts big blind $0.05
*** HOLE CARDS ***
Dealt to ef1573b1 
Dealt to 8a6d1b 
Dealt to ac89ef05 
Dealt to Hero [8h 2c]
Dealt to 1c1fc2a1 
Dealt to 8db2745e 
Hero: folds
1c1fc2a1: folds
8db2745e: folds
ef1573b1: raises $0.05 to $0.1
8a6d1b: folds
ac89ef05: calls $0.05
*** FLOP *** [3c 9c 2h]
ac89ef05: checks
ef1573b1: checks
*** TURN *** [3c 9c 2h] [5s]
ac89ef05: checks
ef1573b1: checks
*** RIVER *** [3c 9c 2h 5s] [7c]
ac89ef05: checks
ef1573b1: checks
ac89ef05: shows [4s 2s] (Pair of Twos)
ef1573b1: shows [8s Js] (Jack-High)
*** SHOWDOWN ***
ac89ef05 collected $0.21 from pot
*** SUMMARY ***
Total pot $0.22 | Rake $0.01 | Jackpot $0 | Bingo $0 | Fortune $0 | Tax $0
Board [3c 9c 2h 5s 7c]
Seat 1: ef1573b1 (button) showed [8s Js] and lost with Jack-High
Seat 2: 8a6d1b (small blind) folded before Flop
Seat 3: ac89ef05 (big blind) showed [4s 2s] and won ($0.21) with Pair of Twos
Seat 4: Hero folded before Flop (didn't bet)
Seat 5: 1c1fc2a1 folded before Flop (didn't bet)
Seat 6: 8db2745e folded before Flop (didn't bet)


Poker Hand #RC2078513386: Hold'em No Limit ($0.02/$0.05) - 2023/12/22 21:34:03
Table 'RushAndCash791738' 6-max Seat #1 is the button
Seat 1: Hero ($6.13 in chips)
Seat 2: 7b437e57 ($5.1 in chips)
Seat 3: cf8a8e96 ($7.65 in chips)
Seat 4: b8e0eed ($5 in chips)
Seat 5: c5b816d3 ($5.61 in chips)
Seat 6: 548ecbec ($5 in chips)
7b437e57: posts small blind $0.02
cf8a8e96: posts big blind $0.05
*** HOLE CARDS ***
Dealt to Hero [Ac Td]
Dealt to 7b437e57 
Dealt to cf8a8e96 
Dealt to b8e0eed 
Dealt to c5b816d3 
Dealt to 548ecbec 
b8e0eed: folds
c5b816d3: folds
548ecbec: folds
Hero: raises $0.08 to $0.13
7b437e57: folds
cf8a8e96: folds
Uncalled bet ($0.08) returned to Hero
*** SHOWDOWN ***
Hero collected $0.12 from pot
*** SUMMARY ***
Total pot $0.12 | Rake $0 | Jackpot $0 | Bingo $0 | Fortune $0 | Tax $0
Seat 1: Hero (button) collected ($0.12)
Seat 2: 7b437e57 (small blind) folded before Flop
Seat 3: cf8a8e96 (big blind) folded before Flop
Seat 4: b8e0eed folded before Flop (didn't bet)
Seat 5: c5b816d3 folded before Flop (didn't bet)
Seat 6: 548ecbec folded before Flop (didn't bet)


Poker Hand #RC2078513267: Hold'em No Limit ($0.02/$0.05) - 2023/12/22 21:33:55
Table 'RushAndCash791679' 6-max Seat #1 is the button
Seat 1: f88f8e87 ($7.21 in chips)
Seat 2: 4c81be2e ($8.45 in chips)
Seat 3: Hero ($6.11 in chips)
Seat 4: 6a898db1 ($5.35 in chips)
Seat 5: b88dbe00 ($6.37 in chips)
Seat 6: 72f7386e ($12.31 in chips)
4c81be2e: posts small blind $0.02
Hero: posts big blind $0.05
*** HOLE CARDS ***
Dealt to f88f8e87 
Dealt to 4c81be2e 
Dealt to Hero [8h Kd]
Dealt to 6a898db1 
Dealt to b88dbe00 
Dealt to 72f7386e 
6a898db1: folds
b88dbe00: folds
72f7386e: folds
f88f8e87: folds
4c81be2e: folds
Uncalled bet ($0.03) returned to Hero
*** SHOWDOWN ***
Hero collected $0.04 from pot
*** SUMMARY ***
Total pot $0.04 | Rake $0 | Jackpot $0 | Bingo $0 | Fortune $0 | Tax $0
Seat 1: f88f8e87 (button) folded before Flop (didn't bet)
Seat 2: 4c81be2e (small blind) folded before Flop
Seat 3: Hero (big blind) collected ($0.04)
Seat 4: 6a898db1 folded before Flop (didn't bet)
Seat 5: b88dbe00 folded before Flop (didn't bet)
Seat 6: 72f7386e folded before Flop (didn't bet)


Poker Hand #RC2078513190: Hold'em No Limit ($0.02/$0.05) - 2023/12/22 21:33:50
Table 'RushAndCash791642' 6-max Seat #1 is the button
Seat 1: bd5964be ($5 in chips)
Seat 2: Hero ($6.13 in chips)
Seat 3: 6b2f8b43 ($4.43 in chips)
Seat 4: f9c8784e ($12.14 in chips)
Seat 5: 7b437e57 ($5.1 in chips)
Seat 6: d3564cc0 ($7.76 in chips)
Hero: posts small blind $0.02
6b2f8b43: posts big blind $0.05
*** HOLE CARDS ***
Dealt to bd5964be 
Dealt to Hero [4c Qh]
Dealt to 6b2f8b43 
Dealt to f9c8784e 
Dealt to 7b437e57 
Dealt to d3564cc0 
f9c8784e: folds
7b437e57: folds
d3564cc0: folds
bd5964be: folds
Hero: folds
Uncalled bet ($0.03) returned to 6b2f8b43
*** SHOWDOWN ***
6b2f8b43 collected $0.04 from pot
*** SUMMARY ***
Total pot $0.04 | Rake $0 | Jackpot $0 | Bingo $0 | Fortune $0 | Tax $0
Seat 1: bd5964be (button) folded before Flop (didn't bet)
Seat 2: Hero (small blind) folded before Flop
Seat 3: 6b2f8b43 (big blind) collected ($0.04)
Seat 4: f9c8784e folded before Flop (didn't bet)
Seat 5: 7b437e57 folded before Flop (didn't bet)
Seat 6: d3564cc0 folded before Flop (didn't bet)


Poker Hand #RC2078513087: Hold'em No Limit ($0.02/$0.05) - 2023/12/22 21:33:45
Table 'RushAndCash791590' 6-max Seat #1 is the button
Seat 1: c6813ed5 ($5.27 in chips)
Seat 2: 2e20f1d7 ($4.14 in chips)
Seat 3: 7c9c11 ($5.49 in chips)
Seat 4: 80af7fe3 ($4.33 in chips)
Seat 5: Hero ($6.13 in chips)
Seat 6: 7c950e30 ($9.42 in chips)
2e20f1d7: posts small blind $0.02
7c9c11: posts big blind $0.05
*** HOLE CARDS ***
Dealt to c6813ed5 
Dealt to 2e20f1d7 
Dealt to 7c9c11 
Dealt to 80af7fe3 
Dealt to Hero [Ks 4s]
Dealt to 7c950e30 
80af7fe3: folds
Hero: folds
7c950e30: raises $0.06 to $0.11
c6813ed5: folds
2e20f1d7: folds
7c9c11: folds
Uncalled bet ($0.06) returned to 7c950e30
*** SHOWDOWN ***
7c950e30 collected $0.12 from pot
*** SUMMARY ***
Total pot $0.12 | Rake $0 | Jackpot $0 | Bingo $0 | Fortune $0 | Tax $0
Seat 1: c6813ed5 (button) folded before Flop (didn't bet)
Seat 2: 2e20f1d7 (small blind) folded before Flop
Seat 3: 7c9c11 (big blind) folded before Flop
Seat 4: 80af7fe3 folded before Flop (didn't bet)
Seat 5: Hero folded before Flop (didn't bet)
Seat 6: 7c950e30 collected ($0.12)


Poker Hand #RC2078512949: Hold'em No Limit ($0.02/$0.05) - 2023/12/22 21:33:37
Table 'RushAndCash791521' 6-max Seat #1 is the button
Seat 1: e527ebf4 ($7.64 in chips)
Seat 2: 21f1ca58 ($10.3 in chips)
Seat 3: a4acbc26 ($2 in chips)
Seat 4: 94798446 ($6.21 in chips)
Seat 5: 7016689e ($5.1 in chips)
Seat 6: Hero ($6.13 in chips)
21f1ca58: posts small blind $0.02
a4acbc26: posts big blind $0.05
*** HOLE CARDS ***
Dealt to e527ebf4 
Dealt to 21f1ca58 
Dealt to a4acbc26 
Dealt to 94798446 
Dealt to 7016689e 
Dealt to Hero [Jc 5s]
94798446: folds
7016689e: raises $0.08 to $0.13
Hero: folds
e527ebf4: folds
21f1ca58: folds
a4acbc26: raises $0.28 to $0.41
7016689e: folds
Uncalled bet ($0.28) returned to a4acbc26
*** SHOWDOWN ***
a4acbc26 collected $0.27 from pot
*** SUMMARY ***
Total pot $0.28 | Rake $0.01 | Jackpot $0 | Bingo $0 | Fortune $0 | Tax $0
Seat 1: e527ebf4 (button) folded before Flop (didn't bet)
Seat 2: 21f1ca58 (small blind) folded before Flop
Seat 3: a4acbc26 (big blind) collected ($0.27)
Seat 4: 94798446 folded before Flop (didn't bet)
Seat 5: 7016689e folded before Flop
Seat 6: Hero folded before Flop (didn't bet)


Poker Hand #RC2078512851: Hold'em No Limit ($0.02/$0.05) - 2023/12/22 21:33:32
Table 'RushAndCash791478' 6-max Seat #1 is the button
Seat 1: f4da6166 ($2.19 in chips)
Seat 2: 7c2eba4e ($7.31 in chips)
Seat 3: 8a8eafe4 ($4.92 in chips)
Seat 4: 933d69ee ($7.82 in chips)
Seat 5: d2e52b8d ($20.83 in chips)
Seat 6: Hero ($6.13 in chips)
7c2eba4e: posts small blind $0.02
8a8eafe4: posts big blind $0.05
*** HOLE CARDS ***
Dealt to f4da6166 
Dealt to 7c2eba4e 
Dealt to 8a8eafe4 
Dealt to 933d69ee 
Dealt to d2e52b8d 
Dealt to Hero [5c 8c]
933d69ee: folds
d2e52b8d: folds
Hero: folds
f4da6166: folds
7c2eba4e: folds
Uncalled bet ($0.03) returned to 8a8eafe4
*** SHOWDOWN ***
8a8eafe4 collected $0.04 from pot
*** SUMMARY ***
Total pot $0.04 | Rake $0 | Jackpot $0 | Bingo $0 | Fortune $0 | Tax $0
Seat 1: f4da6166 (button) folded before Flop (didn't bet)
Seat 2: 7c2eba4e (small blind) folded before Flop
Seat 3: 8a8eafe4 (big blind) collected ($0.04)
Seat 4: 933d69ee folded before Flop (didn't bet)
Seat 5: d2e52b8d folded before Flop (didn't bet)
Seat 6: Hero folded before Flop (didn't bet)


Poker Hand #RC2078512597: Hold'em No Limit ($0.02/$0.05) - 2023/12/22 21:33:18
Table 'RushAndCash791364' 6-max Seat #1 is the button
Seat 1: Hero ($6.06 in chips)
Seat 2: cf8a8e96 ($8.2 in chips)
Seat 3: 3160ff3c ($12.75 in chips)
Seat 4: 869465ff ($17.3 in chips)
Seat 5: 177da66b ($4.8 in chips)
Seat 6: 9b0ec3a ($13.4 in chips)
cf8a8e96: posts small blind $0.02
3160ff3c: posts big blind $0.05
*** HOLE CARDS ***
Dealt to Hero [7c Kh]
Dealt to cf8a8e96 
Dealt to 3160ff3c 
Dealt to 869465ff 
Dealt to 177da66b 
Dealt to 9b0ec3a 
869465ff: folds
177da66b: folds
9b0ec3a: folds
Hero: raises $0.08 to $0.13
cf8a8e96: folds
3160ff3c: folds
Uncalled bet ($0.08) returned to Hero
*** SHOWDOWN ***
Hero collected $0.12 from pot
*** SUMMARY ***
Total pot $0.12 | Rake $0 | Jackpot $0 | Bingo $0 | Fortune $0 | Tax $0
Seat 1: Hero (button) collected ($0.12)
Seat 2: cf8a8e96 (small blind) folded before Flop
Seat 3: 3160ff3c (big blind) folded before Flop
Seat 4: 869465ff folded before Flop (didn't bet)
Seat 5: 177da66b folded before Flop (didn't bet)
Seat 6: 9b0ec3a folded before Flop (didn't bet)


Poker Hand #RC2078512309: Hold'em No Limit ($0.02/$0.05) - 2023/12/22 21:33:01
Table 'RushAndCash791226' 6-max Seat #1 is the button
Seat 1: 3580bebf ($13.21 in chips)
Seat 2: Hero ($6.08 in chips)
Seat 3: ce1aa7a ($5.62 in chips)
Seat 4: bd80f413 ($5.02 in chips)
Seat 5: f4b75c57 ($6.49 in chips)
Seat 6: db5367a6 ($10.63 in chips)
Hero: posts small blind $0.02
ce1aa7a: posts big blind $0.05
*** HOLE CARDS ***
Dealt to 3580bebf 
Dealt to Hero [Ad 6s]
Dealt to ce1aa7a 
Dealt to bd80f413 
Dealt to f4b75c57 
Dealt to db5367a6 
bd80f413: folds
f4b75c57: raises $0.1 to $0.15
db5367a6: raises $0.19 to $0.34
3580bebf: folds
Hero: folds
ce1aa7a: folds
f4b75c57: calls $0.19
*** FLOP *** [Kd Js 3c]
f4b75c57: checks
db5367a6: checks
*** TURN *** [Kd Js 3c] [5s]
f4b75c57: bets $0.38
db5367a6: calls $0.38
*** RIVER *** [Kd Js 3c 5s] [Jh]
f4b75c57: bets $0.5
db5367a6: folds
Uncalled bet ($0.5) returned to f4b75c57
*** SHOWDOWN ***
f4b75c57 collected $1.37 from pot
*** SUMMARY ***
Total pot $1.51 | Rake $0.07 | Jackpot $0.07 | Bingo $0 | Fortune $0 | Tax $0
Board [Kd Js 3c 5s Jh]
Seat 1: 3580bebf (button) folded before Flop (didn't bet)
Seat 2: Hero (small blind) folded before Flop
Seat 3: ce1aa7a (big blind) folded before Flop
Seat 4: bd80f413 folded before Flop (didn't bet)
Seat 5: f4b75c57 won ($1.37)
Seat 6: db5367a6 folded on the River


Poker Hand #RC2078512175: Hold'em No Limit ($0.02/$0.05) - 2023/12/22 21:32:53
Table 'RushAndCash791165' 6-max Seat #1 is the button
Seat 1: d45bc7f3 ($6.55 in chips)
Seat 2: c4c1c89a ($5.31 in chips)
Seat 3: Hero ($6.13 in chips)
Seat 4: cb16bb03 ($5.07 in chips)
Seat 5: c9dcc850 ($7.37 in chips)
Seat 6: 3cf310b ($9.19 in chips)
c4c1c89a: posts small blind $0.02
Hero: posts big blind $0.05
*** HOLE CARDS ***
Dealt to d45bc7f3 
Dealt to c4c1c89a 
Dealt to Hero [2s Qs]
Dealt to cb16bb03 
Dealt to c9dcc850 
Dealt to 3cf310b 
cb16bb03: folds
c9dcc850: folds
3cf310b: folds
d45bc7f3: raises $0.08 to $0.13
c4c1c89a: folds
Hero: folds
Uncalled bet ($0.08) returned to d45bc7f3
*** SHOWDOWN ***
d45bc7f3 collected $0.12 from pot
*** SUMMARY ***
Total pot $0.12 | Rake $0 | Jackpot $0 | Bingo $0 | Fortune $0 | Tax $0
Seat 1: d45bc7f3 (button) collected ($0.12)
Seat 2: c4c1c89a (small blind) folded before Flop
Seat 3: Hero (big blind) folded before Flop
Seat 4: cb16bb03 folded before Flop (didn't bet)
Seat 5: c9dcc850 folded before Flop (didn't bet)
Seat 6: 3cf310b folded before Flop (didn't bet)


Poker Hand #RC2078512087: Hold'em No Limit ($0.02/$0.05) - 2023/12/22 21:32:49
Table 'RushAndCash791123' 6-max Seat #1 is the button
Seat 1: f804ce50 ($12.18 in chips)
Seat 2: 9ed981cc ($2.63 in chips)
Seat 3: e068fd71 ($2.29 in chips)
Seat 4: 9b243c ($5.33 in chips)
Seat 5: c4c1c89a ($5.31 in chips)
Seat 6: Hero ($6.13 in chips)
9ed981cc: posts small blind $0.02
e068fd71: posts big blind $0.05
*** HOLE CARDS ***
Dealt to f804ce50 
Dealt to 9ed981cc 
Dealt to e068fd71 
Dealt to 9b243c 
Dealt to c4c1c89a 
Dealt to Hero [Ac 4h]
9b243c: folds
c4c1c89a: folds
Hero: folds
f804ce50: raises $0.05 to $0.1
9ed981cc: folds
e068fd71: calls $0.05
*** FLOP *** [9s Js Ad]
e068fd71: checks
f804ce50: bets $0.13
e068fd71: folds
Uncalled bet ($0.13) returned to f804ce50
*** SHOWDOWN ***
f804ce50 collected $0.21 from pot
*** SUMMARY ***
Total pot $0.22 | Rake $0.01 | Jackpot $0 | Bingo $0 | Fortune $0 | Tax $0
Board [9s Js Ad]
Seat 1: f804ce50 (button) won ($0.21)
Seat 2: 9ed981cc (small blind) folded before Flop
Seat 3: e068fd71 (big blind) folded on the Flop
Seat 4: 9b243c folded before Flop (didn't bet)
Seat 5: c4c1c89a folded before Flop (didn't bet)
Seat 6: Hero folded before Flop (didn't bet)


Poker Hand #RC2078512016: Hold'em No Limit ($0.02/$0.05) - 2023/12/22 21:32:44
Table 'RushAndCash791089' 6-max Seat #1 is the button
Seat 1: 3721b8cb ($7.03 in chips)
Seat 2: 66605bf3 ($6.21 in chips)
Seat 3: 829aa739 ($6.39 in chips)
Seat 4: Hero ($6.13 in chips)
Seat 5: 749b142c ($5.31 in chips)
Seat 6: 834fcc3f ($5.19 in chips)
66605bf3: posts small blind $0.02
829aa739: posts big blind $0.05
*** HOLE CARDS ***
Dealt to 3721b8cb 
Dealt to 66605bf3 
Dealt to 829aa739 
Dealt to Hero [Td 9s]
Dealt to 749b142c 
Dealt to 834fcc3f 
Hero: folds
749b142c: folds
834fcc3f: raises $0.07 to $0.12
3721b8cb: folds
66605bf3: folds
829aa739: calls $0.07
*** FLOP *** [7h 6h 7s]
829aa739: checks
834fcc3f: checks
*** TURN *** [7h 6h 7s] [5s]
829aa739: bets $0.2
834fcc3f: calls $0.2
*** RIVER *** [7h 6h 7s 5s] [Qc]
829aa739: checks
834fcc3f: bets $0.22
829aa739: calls $0.22
834fcc3f: shows [Ks Qs] (Pair of Queens and Pair of Sevens)
829aa739: shows [4h 5h] (Pair of Sevens and Pair of Fives)
*** SHOWDOWN ***
834fcc3f collected $1.05 from pot
*** SUMMARY ***
Total pot $1.1 | Rake $0.05 | Jackpot $0 | Bingo $0 | Fortune $0 | Tax $0
Board [7h 6h 7s 5s Qc]
Seat 1: 3721b8cb (button) folded before Flop (didn't bet)
Seat 2: 66605bf3 (small blind) folded before Flop
Seat 3: 829aa739 (big blind) showed [4h 5h] and lost with Pair of Sevens and Pair of Fives
Seat 4: Hero folded before Flop (didn't bet)
Seat 5: 749b142c folded before Flop (didn't bet)
Seat 6: 834fcc3f showed [Ks Qs] and won ($1.05) with Pair of Queens and Pair of Sevens


Poker Hand #RC2078511955: Hold'em No Limit ($0.02/$0.05) - 2023/12/22 21:32:41
Table 'RushAndCash791062' 6-max Seat #1 is the button
Seat 1: Hero ($6.13 in chips)
Seat 2: 9a957500 ($4.9 in chips)
Seat 3: f677406 ($12.54 in chips)
Seat 4: 3721b8cb ($7.03 in chips)
Seat 5: bc118b95 ($7.06 in chips)
Seat 6: a1dfe2ad ($10.04 in chips)
9a957500: posts small blind $0.02
f677406: posts big blind $0.05
*** HOLE CARDS ***
Dealt to Hero [3s 5s]
Dealt to 9a957500 
Dealt to f677406 
Dealt to 3721b8cb 
Dealt to bc118b95 
Dealt to a1dfe2ad 
3721b8cb: folds
bc118b95: raises $0.08 to $0.13
a1dfe2ad: raises $0.25 to $0.38
Hero: folds
9a957500: folds
f677406: folds
bc118b95: raises $0.72 to $1.1
a1dfe2ad: raises $8.94 to $10.04 and is all-in
bc118b95: folds
Uncalled bet ($8.94) returned to a1dfe2ad
*** SHOWDOWN ***
a1dfe2ad collected $2.09 from pot
*** SUMMARY ***
Total pot $2.27 | Rake $0.11 | Jackpot $0.07 | Bingo $0 | Fortune $0 | Tax $0
Seat 1: Hero (button) folded before Flop (didn't bet)
Seat 2: 9a957500 (small blind) folded before Flop
Seat 3: f677406 (big blind) folded before Flop
Seat 4: 3721b8cb folded before Flop (didn't bet)
Seat 5: bc118b95 folded before Flop
Seat 6: a1dfe2ad collected ($2.09)


Poker Hand #RC2078511895: Hold'em No Limit ($0.02/$0.05) - 2023/12/22 21:32:37
Table 'RushAndCash791035' 6-max Seat #1 is the button
Seat 1: c2f3e299 ($6.67 in chips)
Seat 2: 605ca6ae ($11.57 in chips)
Seat 3: f804ce50 ($12.23 in chips)
Seat 4: d01821aa ($5.14 in chips)
Seat 5: Hero ($6.13 in chips)
Seat 6: 548ecbec ($5 in chips)
605ca6ae: posts small blind $0.02
f804ce50: posts big blind $0.05
*** HOLE CARDS ***
Dealt to c2f3e299 
Dealt to 605ca6ae 
Dealt to f804ce50 
Dealt to d01821aa 
Dealt to Hero [Ks 8c]
Dealt to 548ecbec 
d01821aa: folds
Hero: folds
548ecbec: folds
c2f3e299: raises $0.07 to $0.12
605ca6ae: folds
f804ce50: folds
Uncalled bet ($0.07) returned to c2f3e299
*** SHOWDOWN ***
c2f3e299 collected $0.12 from pot
*** SUMMARY ***
Total pot $0.12 | Rake $0 | Jackpot $0 | Bingo $0 | Fortune $0 | Tax $0
Seat 1: c2f3e299 (button) collected ($0.12)
Seat 2: 605ca6ae (small blind) folded before Flop
Seat 3: f804ce50 (big blind) folded before Flop
Seat 4: d01821aa folded before Flop (didn't bet)
Seat 5: Hero folded before Flop (didn't bet)
Seat 6: 548ecbec folded before Flop (didn't bet)


Poker Hand #RC2078511663: Hold'em No Limit ($0.02/$0.05) - 2023/12/22 21:32:25
Table 'RushAndCash790924' 6-max Seat #1 is the button
Seat 1: eb03c338 ($4.58 in chips)
Seat 2: Hero ($6.08 in chips)
Seat 3: c5b816d3 ($5.25 in chips)
Seat 4: 1d69050a ($5 in chips)
Seat 5: a9db0c00 ($15.49 in chips)
Seat 6: 91937678 ($5.1 in chips)
Hero: posts small blind $0.02
c5b816d3: posts big blind $0.05
*** HOLE CARDS ***
Dealt to eb03c338 
Dealt to Hero [Qd Js]
Dealt to c5b816d3 
Dealt to 1d69050a 
Dealt to a9db0c00 
Dealt to 91937678 
1d69050a: folds
a9db0c00: folds
91937678: folds
eb03c338: folds
Hero: raises $0.1 to $0.15
c5b816d3: folds
Uncalled bet ($0.1) returned to Hero
*** SHOWDOWN ***
Hero collected $0.1 from pot
*** SUMMARY ***
Total pot $0.1 | Rake $0 | Jackpot $0 | Bingo $0 | Fortune $0 | Tax $0
Seat 1: eb03c338 (button) folded before Flop (didn't bet)
Seat 2: Hero (small blind) collected ($0.1)
Seat 3: c5b816d3 (big blind) folded before Flop
Seat 4: 1d69050a folded before Flop (didn't bet)
Seat 5: a9db0c00 folded before Flop (didn't bet)
Seat 6: 91937678 folded before Flop (didn't bet)


Poker Hand #RC2078511377: Hold'em No Limit ($0.02/$0.05) - 2023/12/22 21:32:08
Table 'RushAndCash790784' 6-max Seat #1 is the button
Seat 1: 6d3488f1 ($5.72 in chips)
Seat 2: 6ea11ecf ($7.69 in chips)
Seat 3: Hero ($6.13 in chips)
Seat 4: 610bd7fc ($11.22 in chips)
Seat 5: c581b38e ($6.25 in chips)
Seat 6: 824c2e76 ($5 in chips)
6ea11ecf: posts small blind $0.02
Hero: posts big blind $0.05
*** HOLE CARDS ***
Dealt to 6d3488f1 
Dealt to 6ea11ecf 
Dealt to Hero [5h 3h]
Dealt to 610bd7fc 
Dealt to c581b38e 
Dealt to 824c2e76 
610bd7fc: folds
c581b38e: folds
824c2e76: raises $0.05 to $0.1
6d3488f1: raises $0.14 to $0.24
6ea11ecf: folds
Hero: folds
824c2e76: calls $0.14
*** FLOP *** [Kd 6c Td]
824c2e76: bets $0.05
6d3488f1: calls $0.05
*** TURN *** [Kd 6c Td] [8h]
824c2e76: bets $0.05
6d3488f1: calls $0.05
*** RIVER *** [Kd 6c Td 8h] [7d]
824c2e76: bets $0.38
6d3488f1: folds
Uncalled bet ($0.38) returned to 824c2e76
*** SHOWDOWN ***
824c2e76 collected $0.72 from pot
*** SUMMARY ***
Total pot $0.75 | Rake $0.03 | Jackpot $0 | Bingo $0 | Fortune $0 | Tax $0
Board [Kd 6c Td 8h 7d]
Seat 1: 6d3488f1 (button) folded on the River
Seat 2: 6ea11ecf (small blind) folded before Flop
Seat 3: Hero (big blind) folded before Flop
Seat 4: 610bd7fc folded before Flop (didn't bet)
Seat 5: c581b38e folded before Flop (didn't bet)
Seat 6: 824c2e76 won ($0.72)


Poker Hand #RC2078511263: Hold'em No Limit ($0.02/$0.05) - 2023/12/22 21:32:01
Table 'RushAndCash790731' 6-max Seat #1 is the button
Seat 1: 18f0f05c ($9.78 in chips)
Seat 2: 641aff0 ($6.37 in chips)
Seat 3: 8da33d79 ($15.2 in chips)
Seat 4: 7728b936 ($5.14 in chips)
Seat 5: 84043875 ($5.07 in chips)
Seat 6: Hero ($6.13 in chips)
641aff0: posts small blind $0.02
8da33d79: posts big blind $0.05
*** HOLE CARDS ***
Dealt to 18f0f05c 
Dealt to 641aff0 
Dealt to 8da33d79 
Dealt to 7728b936 
Dealt to 84043875 
Dealt to Hero [5c Kd]
7728b936: folds
84043875: raises $0.06 to $0.11
Hero: folds
18f0f05c: folds
641aff0: raises $0.27 to $0.38
8da33d79: folds
84043875: folds
Uncalled bet ($0.27) returned to 641aff0
*** SHOWDOWN ***
641aff0 collected $0.26 from pot
*** SUMMARY ***
Total pot $0.27 | Rake $0.01 | Jackpot $0 | Bingo $0 | Fortune $0 | Tax $0
Seat 1: 18f0f05c (button) folded before Flop (didn't bet)
Seat 2: 641aff0 (small blind) collected ($0.26)
Seat 3: 8da33d79 (big blind) folded before Flop
Seat 4: 7728b936 folded before Flop (didn't bet)
Seat 5: 84043875 folded before Flop
Seat 6: Hero folded before Flop (didn't bet)


Poker Hand #RC2078511193: Hold'em No Limit ($0.02/$0.05) - 2023/12/22 21:31:57
Table 'RushAndCash790697' 6-max Seat #1 is the button
Seat 1: 82e9c1ba ($18.96 in chips)
Seat 2: 525db62f ($11.23 in chips)
Seat 3: d71ab80c ($6.96 in chips)
Seat 4: d3564cc0 ($5.82 in chips)
Seat 5: 8a8eafe4 ($5.61 in chips)
Seat 6: Hero ($6.13 in chips)
525db62f: posts small blind $0.02
d71ab80c: posts big blind $0.05
*** HOLE CARDS ***
Dealt to 82e9c1ba 
Dealt to 525db62f 
Dealt to d71ab80c 
Dealt to d3564cc0 
Dealt to 8a8eafe4 
Dealt to Hero [7c 2c]
d3564cc0: folds
8a8eafe4: folds
Hero: folds
82e9c1ba: raises $0.08 to $0.13
525db62f: folds
d71ab80c: folds
Uncalled bet ($0.08) returned to 82e9c1ba
*** SHOWDOWN ***
82e9c1ba collected $0.12 from pot
*** SUMMARY ***
Total pot $0.12 | Rake $0 | Jackpot $0 | Bingo $0 | Fortune $0 | Tax $0
Seat 1: 82e9c1ba (button) collected ($0.12)
Seat 2: 525db62f (small blind) folded before Flop
Seat 3: d71ab80c (big blind) folded before Flop
Seat 4: d3564cc0 folded before Flop (didn't bet)
Seat 5: 8a8eafe4 folded before Flop (didn't bet)
Seat 6: Hero folded before Flop (didn't bet)


Poker Hand #RC2078511094: Hold'em No Limit ($0.02/$0.05) - 2023/12/22 21:31:52
Table 'RushAndCash790650' 6-max Seat #1 is the button
Seat 1: 30a2950b ($5.95 in chips)
Seat 2: 5a6bcca5 ($10.76 in chips)
Seat 3: 3928912e ($5.05 in chips)
Seat 4: b61f5bde ($10.64 in chips)
Seat 5: Hero ($6.13 in chips)
Seat 6: d6126048 ($8.67 in chips)
5a6bcca5: posts small blind $0.02
3928912e: posts big blind $0.05
*** HOLE CARDS ***
Dealt to 30a2950b 
Dealt to 5a6bcca5 
Dealt to 3928912e 
Dealt to b61f5bde 
Dealt to Hero [6h 4c]
Dealt to d6126048 
b61f5bde: folds
Hero: folds
d6126048: folds
30a2950b: raises $0.05 to $0.1
5a6bcca5: folds
3928912e: calls $0.05
*** FLOP *** [3d Ad Ac]
3928912e: checks
30a2950b: bets $0.08
3928912e: folds
Uncalled bet ($0.08) returned to 30a2950b
*** SHOWDOWN ***
30a2950b collected $0.21 from pot
*** SUMMARY ***
Total pot $0.22 | Rake $0.01 | Jackpot $0 | Bingo $0 | Fortune $0 | Tax $0
Board [3d Ad Ac]
Seat 1: 30a2950b (button) won ($0.21)
Seat 2: 5a6bcca5 (small blind) folded before Flop
Seat 3: 3928912e (big blind) folded on the Flop
Seat 4: b61f5bde folded before Flop (didn't bet)
Seat 5: Hero folded before Flop (didn't bet)
Seat 6: d6126048 folded before Flop (didn't bet)


Poker Hand #RC2078510917: Hold'em No Limit ($0.02/$0.05) - 2023/12/22 21:31:42
Table 'RushAndCash790562' 6-max Seat #1 is the button
Seat 1: 3e2e2010 ($6.72 in chips)
Seat 2: d3564cc0 ($5.86 in chips)
Seat 3: a2a9ef51 ($5 in chips)
Seat 4: 6d679d40 ($5 in chips)
Seat 5: 3cf310b ($9.13 in chips)
Seat 6: Hero ($6.06 in chips)
d3564cc0: posts small blind $0.02
a2a9ef51: posts big blind $0.05
*** HOLE CARDS ***
Dealt to 3e2e2010 
Dealt to d3564cc0 
Dealt to a2a9ef51 
Dealt to 6d679d40 
Dealt to 3cf310b 
Dealt to Hero [Ad Kh]
6d679d40: folds
3cf310b: folds
Hero: raises $0.05 to $0.1
3e2e2010: folds
d3564cc0: folds
a2a9ef51: folds
Uncalled bet ($0.05) returned to Hero
*** SHOWDOWN ***
Hero collected $0.12 from pot
*** SUMMARY ***
Total pot $0.12 | Rake $0 | Jackpot $0 | Bingo $0 | Fortune $0 | Tax $0
Seat 1: 3e2e2010 (button) folded before Flop (didn't bet)
Seat 2: d3564cc0 (small blind) folded before Flop
Seat 3: a2a9ef51 (big blind) folded before Flop
Seat 4: 6d679d40 folded before Flop (didn't bet)
Seat 5: 3cf310b folded before Flop (didn't bet)
Seat 6: Hero collected ($0.12)


Poker Hand #RC2078509992: Hold'em No Limit ($0.02/$0.05) - 2023/12/22 21:30:49
Table 'RushAndCash790118' 6-max Seat #1 is the button
Seat 1: Hero ($5 in chips)
Seat 2: e732401c ($5.08 in chips)
Seat 3: 47ecc871 ($4.25 in chips)
Seat 4: f0e3b048 ($6.01 in chips)
Seat 5: 8da33d79 ($16.15 in chips)
Seat 6: acefe34e ($5 in chips)
e732401c: posts small blind $0.02
47ecc871: posts big blind $0.05
*** HOLE CARDS ***
Dealt to Hero [Jd Js]
Dealt to e732401c 
Dealt to 47ecc871 
Dealt to f0e3b048 
Dealt to 8da33d79 
Dealt to acefe34e 
f0e3b048: folds
8da33d79: folds
acefe34e: folds
Hero: raises $0.08 to $0.13
e732401c: raises $0.24 to $0.37
47ecc871: folds
Hero: calls $0.24
*** FLOP *** [Qc Ts 2s]
e732401c: bets $0.21
Hero: calls $0.21
*** TURN *** [Qc Ts 2s] [9c]
e732401c: bets $0.61
Hero: calls $0.61
*** RIVER *** [Qc Ts 2s 9c] [Qs]
e732401c: checks
Hero: checks
e732401c: shows [8d 7s] (Pair of Queens)
Hero: shows [Jd Js] (Pair of Queens and Pair of Jacks)
*** SHOWDOWN ***
Hero collected $2.25 from pot
*** SUMMARY ***
Total pot $2.43 | Rake $0.11 | Jackpot $0.07 | Bingo $0 | Fortune $0 | Tax $0
Board [Qc Ts 2s 9c Qs]
Seat 1: Hero (button) showed [Jd Js] and won ($2.25) with Pair of Queens and Pair of Jacks
Seat 2: e732401c (small blind) showed [8d 7s] and lost with Pair of Queens
Seat 3: 47ecc871 (big blind) folded before Flop
Seat 4: f0e3b048 folded before Flop (didn't bet)
Seat 5: 8da33d79 folded before Flop (didn't bet)
Seat 6: acefe34e folded before Flop (didn't bet)


Poker Hand #RC2078509906: Hold'em No Limit ($0.02/$0.05) - 2023/12/22 21:30:44
Table 'RushAndCash790071' 6-max Seat #1 is the button
Seat 1: 52f74b76 ($5.07 in chips)
Seat 2: b5f4d20f ($5.11 in chips)
Seat 3: Hero ($5 in chips)
Seat 4: ae32912c ($5.37 in chips)
Seat 5: f9adeea ($5.06 in chips)
Seat 6: e65ad772 ($13.35 in chips)
b5f4d20f: posts small blind $0.02
Hero: posts big blind $0.05
*** HOLE CARDS ***
Dealt to 52f74b76 
Dealt to b5f4d20f 
Dealt to Hero [Ac 7h]
Dealt to ae32912c 
Dealt to f9adeea 
Dealt to e65ad772 
ae32912c: folds
f9adeea: raises $0.05 to $0.1
e65ad772: folds
52f74b76: folds
b5f4d20f: folds
Hero: folds
Uncalled bet ($0.05) returned to f9adeea
*** SHOWDOWN ***
f9adeea collected $0.12 from pot
*** SUMMARY ***
Total pot $0.12 | Rake $0 | Jackpot $0 | Bingo $0 | Fortune $0 | Tax $0
Seat 1: 52f74b76 (button) folded before Flop (didn't bet)
Seat 2: b5f4d20f (small blind) folded before Flop
Seat 3: Hero (big blind) folded before Flop
Seat 4: ae32912c folded before Flop (didn't bet)
Seat 5: f9adeea collected ($0.12)
Seat 6: e65ad772 folded before Flop (didn't bet)


Poker Hand #RC2078509706: Hold'em No Limit ($0.02/$0.05) - 2023/12/22 21:30:32
Table 'RushAndCash789970' 6-max Seat #1 is the button
Seat 1: 5d732d5e ($5.01 in chips)
Seat 2: Hero ($5 in chips)
Seat 3: 9dc69999 ($8.34 in chips)
Seat 4: 6e872e9c ($17.15 in chips)
Seat 5: ed53cde8 ($5 in chips)
Seat 6: 28e8fd4 ($2.57 in chips)
Hero: posts small blind $0.02
9dc69999: posts big blind $0.05
*** HOLE CARDS ***
Dealt to 5d732d5e 
Dealt to Hero [Jd Tc]
Dealt to 9dc69999 
Dealt to 6e872e9c 
Dealt to ed53cde8 
Dealt to 28e8fd4 
6e872e9c: folds
ed53cde8: raises $0.06 to $0.11
28e8fd4: folds
5d732d5e: folds
Hero: folds
9dc69999: folds
Uncalled bet ($0.06) returned to ed53cde8
*** SHOWDOWN ***
ed53cde8 collected $0.12 from pot
*** SUMMARY ***
Total pot $0.12 | Rake $0 | Jackpot $0 | Bingo $0 | Fortune $0 | Tax $0
Seat 1: 5d732d5e (button) folded before Flop (didn't bet)
Seat 2: Hero (small blind) folded before Flop
Seat 3: 9dc69999 (big blind) folded before Flop
Seat 4: 6e872e9c folded before Flop (didn't bet)
Seat 5: ed53cde8 collected ($0.12)
Seat 6: 28e8fd4 folded before Flop (didn't bet)


Poker Hand #RC2078509640: Hold'em No Limit ($0.02/$0.05) - 2023/12/22 21:30:28
Table 'RushAndCash789938' 6-max Seat #1 is the button
Seat 1: e8df5901 ($8.22 in chips)
Seat 2: 1be6b9fd ($10.66 in chips)
Seat 3: 42e18915 ($4.08 in chips)
Seat 4: 6e872e9c ($17.15 in chips)
Seat 5: Hero ($5 in chips)
Seat 6: a3f6014b ($5.45 in chips)
1be6b9fd: posts small blind $0.02
42e18915: posts big blind $0.05
*** HOLE CARDS ***
Dealt to e8df5901 
Dealt to 1be6b9fd 
Dealt to 42e18915 
Dealt to 6e872e9c 
Dealt to Hero [8c 5c]
Dealt to a3f6014b 
6e872e9c: folds
Hero: folds
a3f6014b: folds
e8df5901: folds
1be6b9fd: folds
Uncalled bet ($0.03) returned to 42e18915
*** SHOWDOWN ***
42e18915 collected $0.04 from pot
*** SUMMARY ***
Total pot $0.04 | Rake $0 | Jackpot $0 | Bingo $0 | Fortune $0 | Tax $0
Seat 1: e8df5901 (button) folded before Flop (didn't bet)
Seat 2: 1be6b9fd (small blind) folded before Flop
Seat 3: 42e18915 (big blind) collected ($0.04)
Seat 4: 6e872e9c folded before Flop (didn't bet)
Seat 5: Hero folded before Flop (didn't bet)
Seat 6: a3f6014b folded before Flop (didn't bet)


Poker Hand #RC2078509480: Hold'em No Limit ($0.02/$0.05) - 2023/12/22 21:30:20
Table 'RushAndCash789859' 6-max Seat #1 is the button
Seat 1: ad0bb92a ($4.58 in chips)
Seat 2: 70f1d0b3 ($5 in chips)
Seat 3: 3d929f9f ($8.3 in chips)
Seat 4: 954d1f7b ($7.23 in chips)
Seat 5: Hero ($5 in chips)
Seat 6: 44795538 ($4.92 in chips)
70f1d0b3: posts small blind $0.02
3d929f9f: posts big blind $0.05
*** HOLE CARDS ***
Dealt to ad0bb92a 
Dealt to 70f1d0b3 
Dealt to 3d929f9f 
Dealt to 954d1f7b 
Dealt to Hero [7h Tc]
Dealt to 44795538 
954d1f7b: folds
Hero: folds
44795538: raises $0.05 to $0.1
ad0bb92a: folds
70f1d0b3: folds
3d929f9f: calls $0.05
*** FLOP *** [Qd Kd 4d]
3d929f9f: checks
44795538: bets $0.11
3d929f9f: folds
Uncalled bet ($0.11) returned to 44795538
*** SHOWDOWN ***
44795538 collected $0.21 from pot
*** SUMMARY ***
Total pot $0.22 | Rake $0.01 | Jackpot $0 | Bingo $0 | Fortune $0 | Tax $0
Board [Qd Kd 4d]
Seat 1: ad0bb92a (button) folded before Flop (didn't bet)
Seat 2: 70f1d0b3 (small blind) folded before Flop
Seat 3: 3d929f9f (big blind) folded on the Flop
Seat 4: 954d1f7b folded before Flop (didn't bet)
Seat 5: Hero folded before Flop (didn't bet)
Seat 6: 44795538 won ($0.21)


Poker Hand #RC2078509364: Hold'em No Limit ($0.02/$0.05) - 2023/12/22 21:30:13
Table 'RushAndCash789804' 6-max Seat #1 is the button
Seat 1: 6c424f5a ($5.21 in chips)
Seat 2: ec80eef8 ($9.63 in chips)
Seat 3: 130f7150 ($5.7 in chips)
Seat 4: 1c28bbd5 ($4.84 in chips)
Seat 5: Hero ($5 in chips)
Seat 6: 1f9b16cf ($6.25 in chips)
ec80eef8: posts small blind $0.02
130f7150: posts big blind $0.05
*** HOLE CARDS ***
Dealt to 6c424f5a 
Dealt to ec80eef8 
Dealt to 130f7150 
Dealt to 1c28bbd5 
Dealt to Hero [9h Kc]
Dealt to 1f9b16cf 
1c28bbd5: folds
Hero: folds
1f9b16cf: folds
6c424f5a: folds
ec80eef8: folds
Uncalled bet ($0.03) returned to 130f7150
*** SHOWDOWN ***
130f7150 collected $0.04 from pot
*** SUMMARY ***
Total pot $0.04 | Rake $0 | Jackpot $0 | Bingo $0 | Fortune $0 | Tax $0
Seat 1: 6c424f5a (button) folded before Flop (didn't bet)
Seat 2: ec80eef8 (small blind) folded before Flop
Seat 3: 130f7150 (big blind) collected ($0.04)
Seat 4: 1c28bbd5 folded before Flop (didn't bet)
Seat 5: Hero folded before Flop (didn't bet)
Seat 6: 1f9b16cf folded before Flop (didn't bet)


Poker Hand #RC2078509132: Hold'em No Limit ($0.02/$0.05) - 2023/12/22 21:30:00
Table 'RushAndCash789691' 6-max Seat #1 is the button
Seat 1: e1380a89 ($4.65 in chips)
Seat 2: Hero ($5 in chips)
Seat 3: 3fc56396 ($5.12 in chips)
Seat 4: 1dd4f962 ($6.46 in chips)
Seat 5: 886872c9 ($7.07 in chips)
Seat 6: c9c293e2 ($5.81 in chips)
Hero: posts small blind $0.02
3fc56396: posts big blind $0.05
*** HOLE CARDS ***
Dealt to e1380a89 
Dealt to Hero [As 2d]
Dealt to 3fc56396 
Dealt to 1dd4f962 
Dealt to 886872c9 
Dealt to c9c293e2 
1dd4f962: raises $0.12 to $0.17
886872c9: folds
c9c293e2: folds
e1380a89: folds
Hero: folds
3fc56396: folds
Uncalled bet ($0.12) returned to 1dd4f962
*** SHOWDOWN ***
1dd4f962 collected $0.12 from pot
*** SUMMARY ***
Total pot $0.12 | Rake $0 | Jackpot $0 | Bingo $0 | Fortune $0 | Tax $0
Seat 1: e1380a89 (button) folded before Flop (didn't bet)
Seat 2: Hero (small blind) folded before Flop
Seat 3: 3fc56396 (big blind) folded before Flop
Seat 4: 1dd4f962 collected ($0.12)
Seat 5: 886872c9 folded before Flop (didn't bet)
Seat 6: c9c293e2 folded before Flop (didn't bet)


Poker Hand #RC2078508962: Hold'em No Limit ($0.02/$0.05) - 2023/12/22 21:29:50
Table 'RushAndCash789609' 6-max Seat #1 is the button
Seat 1: 221172f3 ($5.23 in chips)
Seat 2: 9942b4df ($7.54 in chips)
Seat 3: Hero ($5 in chips)
Seat 4: b976716a ($17.21 in chips)
Seat 5: 6abef4c5 ($5.08 in chips)
Seat 6: b01c40bf ($18.61 in chips)
9942b4df: posts small blind $0.02
Hero: posts big blind $0.05
*** HOLE CARDS ***
Dealt to 221172f3 
Dealt to 9942b4df 
Dealt to Hero [As 4d]
Dealt to b976716a 
Dealt to 6abef4c5 
Dealt to b01c40bf 
b976716a: folds
6abef4c5: folds
b01c40bf: raises $0.06 to $0.11
221172f3: raises $0.21 to $0.32
9942b4df: folds
Hero: folds
b01c40bf: calls $0.21
*** FLOP *** [6h 8h 2h]
b01c40bf: checks
221172f3: bets $0.24
b01c40bf: folds
Uncalled bet ($0.24) returned to 221172f3
*** SHOWDOWN ***
221172f3 collected $0.68 from pot
*** SUMMARY ***
Total pot $0.71 | Rake $0.03 | Jackpot $0 | Bingo $0 | Fortune $0 | Tax $0
Board [6h 8h 2h]
Seat 1: 221172f3 (button) won ($0.68)
Seat 2: 9942b4df (small blind) folded before Flop
Seat 3: Hero (big blind) folded before Flop
Seat 4: b976716a folded before Flop (didn't bet)
Seat 5: 6abef4c5 folded before Flop (didn't bet)
Seat 6: b01c40bf folded on the Flop


Poker Hand #RC2078508895: Hold'em No Limit ($0.02/$0.05) - 2023/12/22 21:29:47
Table 'RushAndCash789576' 6-max Seat #1 is the button
Seat 1: Hero ($5 in chips)
Seat 2: 998574b7 ($5.34 in chips)
Seat 3: f57c6794 ($5 in chips)
Seat 4: 1f9b16cf ($6.25 in chips)
Seat 5: 37e2503b ($5.23 in chips)
Seat 6: abe64b92 ($6.95 in chips)
998574b7: posts small blind $0.02
f57c6794: posts big blind $0.05
*** HOLE CARDS ***
Dealt to Hero [Kc 3d]
Dealt to 998574b7 
Dealt to f57c6794 
Dealt to 1f9b16cf 
Dealt to 37e2503b 
Dealt to abe64b92 
1f9b16cf: folds
37e2503b: folds
abe64b92: folds
Hero: folds
998574b7: folds
Uncalled bet ($0.03) returned to f57c6794
*** SHOWDOWN ***
f57c6794 collected $0.04 from pot
*** SUMMARY ***
Total pot $0.04 | Rake $0 | Jackpot $0 | Bingo $0 | Fortune $0 | Tax $0
Seat 1: Hero (button) folded before Flop (didn't bet)
Seat 2: 998574b7 (small blind) folded before Flop
Seat 3: f57c6794 (big blind) collected ($0.04)
Seat 4: 1f9b16cf folded before Flop (didn't bet)
Seat 5: 37e2503b folded before Flop (didn't bet)
Seat 6: abe64b92 folded before Flop (didn't bet)


Poker Hand #RC2078508843: Hold'em No Limit ($0.02/$0.05) - 2023/12/22 21:29:43
Table 'RushAndCash789549' 6-max Seat #1 is the button
Seat 1: 6029883b ($5.52 in chips)
Seat 2: 42b55ba4 ($5.61 in chips)
Seat 3: 11811683 ($5.26 in chips)
Seat 4: Hero ($5 in chips)
Seat 5: 8c701e69 ($5.26 in chips)
Seat 6: 70f1d0b3 ($5 in chips)
42b55ba4: posts small blind $0.02
11811683: posts big blind $0.05
*** HOLE CARDS ***
Dealt to 6029883b 
Dealt to 42b55ba4 
Dealt to 11811683 
Dealt to Hero [4h Ac]
Dealt to 8c701e69 
Dealt to 70f1d0b3 
Hero: folds
8c701e69: folds
70f1d0b3: raises $0.08 to $0.13
6029883b: raises $0.25 to $0.38
42b55ba4: folds
11811683: folds
70f1d0b3: folds
Uncalled bet ($0.25) returned to 6029883b
*** SHOWDOWN ***
6029883b collected $0.31 from pot
*** SUMMARY ***
Total pot $0.33 | Rake $0.02 | Jackpot $0 | Bingo $0 | Fortune $0 | Tax $0
Seat 1: 6029883b (button) collected ($0.31)
Seat 2: 42b55ba4 (small blind) folded before Flop
Seat 3: 11811683 (big blind) folded before Flop
Seat 4: Hero folded before Flop (didn't bet)
Seat 5: 8c701e69 folded before Flop (didn't bet)
Seat 6: 70f1d0b3 folded before Flop


Poker Hand #RC2078508780: Hold'em No Limit ($0.02/$0.05) - 2023/12/22 21:29:40
Table 'RushAndCash789518' 6-max Seat #1 is the button
Seat 1: aba41704 ($1.59 in chips)
Seat 2: a6b917ce ($2.78 in chips)
Seat 3: d6126048 ($8.87 in chips)
Seat 4: 3d582dec ($6.13 in chips)
Seat 5: edb6154b ($6.37 in chips)
Seat 6: Hero ($5 in chips)
a6b917ce: posts small blind $0.02
d6126048: posts big blind $0.05
*** HOLE CARDS ***
Dealt to aba41704 
Dealt to a6b917ce 
Dealt to d6126048 
Dealt to 3d582dec 
Dealt to edb6154b 
Dealt to Hero [2h 4d]
3d582dec: folds
edb6154b: raises $0.08 to $0.13
Hero: folds
aba41704: folds
a6b917ce: folds
d6126048: calls $0.08
*** FLOP *** [9s 2c Ah]
d6126048: checks
edb6154b: bets $0.1
d6126048: folds
Uncalled bet ($0.1) returned to edb6154b
*** SHOWDOWN ***
edb6154b collected $0.27 from pot
*** SUMMARY ***
Total pot $0.28 | Rake $0.01 | Jackpot $0 | Bingo $0 | Fortune $0 | Tax $0
Board [9s 2c Ah]
Seat 1: aba41704 (button) folded before Flop (didn't bet)
Seat 2: a6b917ce (small blind) folded before Flop
Seat 3: d6126048 (big blind) folded on the Flop
Seat 4: 3d582dec folded before Flop (didn't bet)
Seat 5: edb6154b won ($0.27)
Seat 6: Hero folded before Flop (didn't bet)


Poker Hand #RC2078508713: Hold'em No Limit ($0.02/$0.05) - 2023/12/22 21:29:36
Table 'RushAndCash789485' 6-max Seat #1 is the button
Seat 1: Hero ($5 in chips)
Seat 2: 1259a422 ($5.44 in chips)
Seat 3: eb944e6 ($5.42 in chips)
Seat 4: d2e52b8d ($20.55 in chips)
Seat 5: aba41704 ($1.59 in chips)
Seat 6: 34ce5e3 ($5 in chips)
1259a422: posts small blind $0.02
eb944e6: posts big blind $0.05
*** HOLE CARDS ***
Dealt to Hero [5d Kh]
Dealt to 1259a422 
Dealt to eb944e6 
Dealt to d2e52b8d 
Dealt to aba41704 
Dealt to 34ce5e3 
d2e52b8d: folds
aba41704: folds
34ce5e3: folds
Hero: folds
1259a422: folds
Uncalled bet ($0.03) returned to eb944e6
*** SHOWDOWN ***
eb944e6 collected $0.04 from pot
*** SUMMARY ***
Total pot $0.04 | Rake $0 | Jackpot $0 | Bingo $0 | Fortune $0 | Tax $0
Seat 1: Hero (button) folded before Flop (didn't bet)
Seat 2: 1259a422 (small blind) folded before Flop
Seat 3: eb944e6 (big blind) collected ($0.04)
Seat 4: d2e52b8d folded before Flop (didn't bet)
Seat 5: aba41704 folded before Flop (didn't bet)
Seat 6: 34ce5e3 folded before Flop (didn't bet)


Poker Hand #RC2078508507: Hold'em No Limit ($0.02/$0.05) - 2023/12/22 21:29:24
Table 'RushAndCash789385' 6-max Seat #1 is the button
Seat 1: ce1aa7a ($5.71 in chips)
Seat 2: Hero ($5 in chips)
Seat 3: 3cf310b ($9.07 in chips)
Seat 4: 177da66b ($4.72 in chips)
Seat 5: 81f09a8e ($7.19 in chips)
Seat 6: 3288926 ($9.38 in chips)
Hero: posts small blind $0.02
3cf310b: posts big blind $0.05
*** HOLE CARDS ***
Dealt to ce1aa7a 
Dealt to Hero [Kc 8s]
Dealt to 3cf310b 
Dealt to 177da66b 
Dealt to 81f09a8e 
Dealt to 3288926 
177da66b: folds
81f09a8e: folds
3288926: raises $0.08 to $0.13
ce1aa7a: folds
Hero: folds
3cf310b: calls $0.08
*** FLOP *** [4s 2h Ts]
3cf310b: checks
3288926: bets $0.1
3cf310b: folds
Uncalled bet ($0.1) returned to 3288926
*** SHOWDOWN ***
3288926 collected $0.27 from pot
*** SUMMARY ***
Total pot $0.28 | Rake $0.01 | Jackpot $0 | Bingo $0 | Fortune $0 | Tax $0
Board [4s 2h Ts]
Seat 1: ce1aa7a (button) folded before Flop (didn't bet)
Seat 2: Hero (small blind) folded before Flop
Seat 3: 3cf310b (big blind) folded on the Flop
Seat 4: 177da66b folded before Flop (didn't bet)
Seat 5: 81f09a8e folded before Flop (didn't bet)
Seat 6: 3288926 won ($0.27)


Poker Hand #RC2078507330: Hold'em No Limit ($0.02/$0.05) - 2023/12/22 21:28:14
Table 'RushAndCash788835' 6-max Seat #1 is the button
Seat 1: c5b816d3 ($5 in chips)
Seat 2: 288f5ff9 ($5.61 in chips)
Seat 3: Hero ($5 in chips)
Seat 4: 494d7c43 ($7.09 in chips)
Seat 5: 53442c3b ($10.87 in chips)
Seat 6: 2e44f78e ($13.84 in chips)
288f5ff9: posts small blind $0.02
Hero: posts big blind $0.05
*** HOLE CARDS ***
Dealt to c5b816d3 
Dealt to 288f5ff9 
Dealt to Hero [Td Ts]
Dealt to 494d7c43 
Dealt to 53442c3b 
Dealt to 2e44f78e 
494d7c43: folds
53442c3b: raises $0.1 to $0.15
2e44f78e: folds
c5b816d3: folds
288f5ff9: calls $0.13
Hero: raises $0.39 to $0.54
53442c3b: folds
288f5ff9: calls $0.39
*** FLOP *** [Kd 7s 3h]
288f5ff9: checks
Hero: bets $0.41
288f5ff9: calls $0.41
*** TURN *** [Kd 7s 3h] [9h]
288f5ff9: checks
Hero: checks
*** RIVER *** [Kd 7s 3h 9h] [7d]
288f5ff9: bets $1.64
Hero: folds
Uncalled bet ($1.64) returned to 288f5ff9
*** SHOWDOWN ***
288f5ff9 collected $1.89 from pot
*** SUMMARY ***
Total pot $2.05 | Rake $0.09 | Jackpot $0.07 | Bingo $0 | Fortune $0 | Tax $0
Board [Kd 7s 3h 9h 7d]
Seat 1: c5b816d3 (button) folded before Flop (didn't bet)
Seat 2: 288f5ff9 (small blind) won ($1.89)
Seat 3: Hero (big blind) folded on the River
Seat 4: 494d7c43 folded before Flop (didn't bet)
Seat 5: 53442c3b folded before Flop
Seat 6: 2e44f78e folded before Flop (didn't bet)


Poker Hand #RC2078507230: Hold'em No Limit ($0.02/$0.05) - 2023/12/22 21:28:08
Table 'RushAndCash788791' 6-max Seat #1 is the button
Seat 1: c7be9492 ($5.75 in chips)
Seat 2: 257cb6ea ($5.34 in chips)
Seat 3: 7451ad28 ($8.82 in chips)
Seat 4: 52956fa5 ($5.07 in chips)
Seat 5: Hero ($5 in chips)
Seat 6: a420712c ($10.78 in chips)
257cb6ea: posts small blind $0.02
7451ad28: posts big blind $0.05
*** HOLE CARDS ***
Dealt to c7be9492 
Dealt to 257cb6ea 
Dealt to 7451ad28 
Dealt to 52956fa5 
Dealt to Hero [8c 3s]
Dealt to a420712c 
52956fa5: folds
Hero: folds
a420712c: folds
c7be9492: folds
257cb6ea: folds
Uncalled bet ($0.03) returned to 7451ad28
*** SHOWDOWN ***
7451ad28 collected $0.04 from pot
*** SUMMARY ***
Total pot $0.04 | Rake $0 | Jackpot $0 | Bingo $0 | Fortune $0 | Tax $0
Seat 1: c7be9492 (button) folded before Flop (didn't bet)
Seat 2: 257cb6ea (small blind) folded before Flop
Seat 3: 7451ad28 (big blind) collected ($0.04)
Seat 4: 52956fa5 folded before Flop (didn't bet)
Seat 5: Hero folded before Flop (didn't bet)
Seat 6: a420712c folded before Flop (didn't bet)


Poker Hand #RC2078507167: Hold'em No Limit ($0.02/$0.05) - 2023/12/22 21:28:04
Table 'RushAndCash788763' 6-max Seat #1 is the button
Seat 1: ff6f425f ($5.34 in chips)
Seat 2: c7592cbf ($11.11 in chips)
Seat 3: 73c8f8b5 ($5.07 in chips)
Seat 4: 5cb14769 ($5 in chips)
Seat 5: 90511c4f ($7.06 in chips)
Seat 6: Hero ($5 in chips)
c7592cbf: posts small blind $0.02
73c8f8b5: posts big blind $0.05
*** HOLE CARDS ***
Dealt to ff6f425f 
Dealt to c7592cbf 
Dealt to 73c8f8b5 
Dealt to 5cb14769 
Dealt to 90511c4f 
Dealt to Hero [4h 8s]
5cb14769: folds
90511c4f: folds
Hero: folds
ff6f425f: folds
c7592cbf: folds
Uncalled bet ($0.03) returned to 73c8f8b5
*** SHOWDOWN ***
73c8f8b5 collected $0.04 from pot
*** SUMMARY ***
Total pot $0.04 | Rake $0 | Jackpot $0 | Bingo $0 | Fortune $0 | Tax $0
Seat 1: ff6f425f (button) folded before Flop (didn't bet)
Seat 2: c7592cbf (small blind) folded before Flop
Seat 3: 73c8f8b5 (big blind) collected ($0.04)
Seat 4: 5cb14769 folded before Flop (didn't bet)
Seat 5: 90511c4f folded before Flop (didn't bet)
Seat 6: Hero folded before Flop (didn't bet)


Poker Hand #RC2078507070: Hold'em No Limit ($0.02/$0.05) - 2023/12/22 21:27:59
Table 'RushAndCash788721' 6-max Seat #1 is the button
Seat 1: 53442c3b ($10.87 in chips)
Seat 2: c68e2737 ($8.76 in chips)
Seat 3: 787a5651 ($5 in chips)
Seat 4: 610bd7fc ($11.87 in chips)
Seat 5: ce3dc143 ($4.25 in chips)
Seat 6: Hero ($5 in chips)
c68e2737: posts small blind $0.02
787a5651: posts big blind $0.05
*** HOLE CARDS ***
Dealt to 53442c3b 
Dealt to c68e2737 
Dealt to 787a5651 
Dealt to 610bd7fc 
Dealt to ce3dc143 
Dealt to Hero [5c 8c]
610bd7fc: folds
ce3dc143: raises $0.08 to $0.13
Hero: folds
53442c3b: folds
c68e2737: raises $0.41 to $0.54
787a5651: folds
ce3dc143: raises $0.78 to $1.32
c68e2737: folds
Uncalled bet ($0.78) returned to ce3dc143
*** SHOWDOWN ***
ce3dc143 collected $1.07 from pot
*** SUMMARY ***
Total pot $1.13 | Rake $0.06 | Jackpot $0 | Bingo $0 | Fortune $0 | Tax $0
Seat 1: 53442c3b (button) folded before Flop (didn't bet)
Seat 2: c68e2737 (small blind) folded before Flop
Seat 3: 787a5651 (big blind) folded before Flop
Seat 4: 610bd7fc folded before Flop (didn't bet)
Seat 5: ce3dc143 collected ($1.07)
Seat 6: Hero folded before Flop (didn't bet)


Poker Hand #RC2078507007: Hold'em No Limit ($0.02/$0.05) - 2023/12/22 21:27:55
Table 'RushAndCash788694' 6-max Seat #1 is the button
Seat 1: Hero ($5 in chips)
Seat 2: a420712c ($10.85 in chips)
Seat 3: e194bfc6 ($5.36 in chips)
Seat 4: 61dc9b78 ($4.65 in chips)
Seat 5: 610bd7fc ($11.87 in chips)
Seat 6: c54f63b8 ($6.35 in chips)
a420712c: posts small blind $0.02
e194bfc6: posts big blind $0.05
*** HOLE CARDS ***
Dealt to Hero [2h 4d]
Dealt to a420712c 
Dealt to e194bfc6 
Dealt to 61dc9b78 
Dealt to 610bd7fc 
Dealt to c54f63b8 
61dc9b78: raises $0.08 to $0.13
610bd7fc: folds
c54f63b8: folds
Hero: folds
a420712c: folds
e194bfc6: folds
Uncalled bet ($0.08) returned to 61dc9b78
*** SHOWDOWN ***
61dc9b78 collected $0.12 from pot
*** SUMMARY ***
Total pot $0.12 | Rake $0 | Jackpot $0 | Bingo $0 | Fortune $0 | Tax $0
Seat 1: Hero (button) folded before Flop (didn't bet)
Seat 2: a420712c (small blind) folded before Flop
Seat 3: e194bfc6 (big blind) folded before Flop
Seat 4: 61dc9b78 collected ($0.12)
Seat 5: 610bd7fc folded before Flop (didn't bet)
Seat 6: c54f63b8 folded before Flop (didn't bet)


Poker Hand #RC2078506190: Hold'em No Limit ($0.02/$0.05) - 2023/12/22 21:27:07
Table 'RushAndCash788316' 6-max Seat #1 is the button
Seat 1: f751acea ($7.02 in chips)
Seat 2: Hero ($5.25 in chips)
Seat 3: 3a20c3a ($10.63 in chips)
Seat 4: 3169aec8 ($5.11 in chips)
Seat 5: 1be6b9fd ($10.57 in chips)
Seat 6: 59ef18cb ($1.62 in chips)
Hero: posts small blind $0.02
3a20c3a: posts big blind $0.05
*** HOLE CARDS ***
Dealt to f751acea 
Dealt to Hero [Kd Qd]
Dealt to 3a20c3a 
Dealt to 3169aec8 
Dealt to 1be6b9fd 
Dealt to 59ef18cb 
3169aec8: folds
1be6b9fd: raises $0.05 to $0.1
59ef18cb: folds
f751acea: folds
Hero: calls $0.08
3a20c3a: calls $0.05
*** FLOP *** [7s 6c Jd]
Hero: checks
3a20c3a: checks
1be6b9fd: checks
*** TURN *** [7s 6c Jd] [Td]
Hero: checks
3a20c3a: bets $0.2
1be6b9fd: folds
Hero: calls $0.2
*** RIVER *** [7s 6c Jd Td] [3s]
Hero: checks
3a20c3a: checks
Hero: shows [Kd Qd] (King-High)
3a20c3a: shows [Js Qs] (Pair of Jacks)
*** SHOWDOWN ***
3a20c3a collected $0.67 from pot
*** SUMMARY ***
Total pot $0.7 | Rake $0.03 | Jackpot $0 | Bingo $0 | Fortune $0 | Tax $0
Board [7s 6c Jd Td 3s]
Seat 1: f751acea (button) folded before Flop (didn't bet)
Seat 2: Hero (small blind) showed [Kd Qd] and lost with King-High
Seat 3: 3a20c3a (big blind) showed [Js Qs] and won ($0.67) with Pair of Jacks
Seat 4: 3169aec8 folded before Flop (didn't bet)
Seat 5: 1be6b9fd folded on the Turn
Seat 6: 59ef18cb folded before Flop (didn't bet)


Poker Hand #RC2078506001: Hold'em No Limit ($0.02/$0.05) - 2023/12/22 21:26:56
Table 'RushAndCash788230' 6-max Seat #1 is the button
Seat 1: a420712c ($11.03 in chips)
Seat 2: 7faa6e20 ($7.34 in chips)
Seat 3: Hero ($5.3 in chips)
Seat 4: 18f0f05c ($9.78 in chips)
Seat 5: f73ad9cd ($5.36 in chips)
Seat 6: f43dd94b ($5.24 in chips)
7faa6e20: posts small blind $0.02
Hero: posts big blind $0.05
*** HOLE CARDS ***
Dealt to a420712c 
Dealt to 7faa6e20 
Dealt to Hero [Ts 7d]
Dealt to 18f0f05c 
Dealt to f73ad9cd 
Dealt to f43dd94b 
18f0f05c: folds
f73ad9cd: folds
f43dd94b: raises $0.08 to $0.13
a420712c: calls $0.13
7faa6e20: calls $0.11
Hero: folds
*** FLOP *** [6c 8s Ks]
7faa6e20: bets $0.22
f43dd94b: raises $0.49 to $0.71
a420712c: folds
7faa6e20: calls $0.49
*** TURN *** [6c 8s Ks] [2c]
7faa6e20: bets $0.93
f43dd94b: raises $3.47 to $4.4 and is all-in
7faa6e20: calls $3.47
f43dd94b: shows [6h 6d] (Three Sixes)
7faa6e20: shows [8c 9c] (Pair of Eights)
*** FIRST RIVER *** [6c 8s Ks 2c] [Qc]
*** SECOND RIVER *** [6c 8s Ks 2c] [As]
*** FIRST SHOWDOWN ***
7faa6e20 collected $5.23 from pot
*** SECOND SHOWDOWN ***
f43dd94b collected $5.22 from pot
*** SUMMARY ***
Total pot $10.66 | Rake $0.14 | Jackpot $0.07 | Bingo $0 | Fortune $0 | Tax $0
Hand was run two times
FIRST Board [6c 8s Ks 2c Qc]
SECOND Board [As]
Seat 1: a420712c (button) folded on the Flop
Seat 2: 7faa6e20 (small blind) showed [8c 9c] and won ($5.23) with Queen High Flush, and lost
Seat 3: Hero (big blind) folded before Flop
Seat 4: 18f0f05c folded before Flop (didn't bet)
Seat 5: f73ad9cd folded before Flop (didn't bet)
Seat 6: f43dd94b showed [6h 6d] and lost with Three Sixes, and won ($5.22)


Poker Hand #RC2078505353: Hold'em No Limit ($0.02/$0.05) - 2023/12/22 21:26:20
Table 'RushAndCash787928' 6-max Seat #1 is the button
Seat 1: cbfe1acc ($5.85 in chips)
Seat 2: 1cfe329a ($12.91 in chips)
Seat 3: 13f0d1ae ($2.95 in chips)
Seat 4: Hero ($5 in chips)
Seat 5: 220b0aae ($11.21 in chips)
Seat 6: fdc2d3ba ($13.92 in chips)
1cfe329a: posts small blind $0.02
13f0d1ae: posts big blind $0.05
*** HOLE CARDS ***
Dealt to cbfe1acc 
Dealt to 1cfe329a 
Dealt to 13f0d1ae 
Dealt to Hero [Jd Ah]
Dealt to 220b0aae 
Dealt to fdc2d3ba 
Hero: raises $0.05 to $0.1
220b0aae: folds
fdc2d3ba: folds
cbfe1acc: folds
1cfe329a: folds
13f0d1ae: calls $0.05
*** FLOP *** [7c Ad 6s]
13f0d1ae: bets $0.05
Hero: calls $0.05
*** TURN *** [7c Ad 6s] [5h]
13f0d1ae: checks
Hero: bets $0.16
13f0d1ae: calls $0.16
*** RIVER *** [7c Ad 6s 5h] [Tc]
13f0d1ae: checks
Hero: checks
13f0d1ae: shows [Kc 8c] (Ace-High)
Hero: shows [Jd Ah] (Pair of Aces)
*** SHOWDOWN ***
Hero collected $0.61 from pot
*** SUMMARY ***
Total pot $0.64 | Rake $0.03 | Jackpot $0 | Bingo $0 | Fortune $0 | Tax $0
Board [7c Ad 6s 5h Tc]
Seat 1: cbfe1acc (button) folded before Flop (didn't bet)
Seat 2: 1cfe329a (small blind) folded before Flop
Seat 3: 13f0d1ae (big blind) showed [Kc 8c] and lost with Ace-High
Seat 4: Hero showed [Jd Ah] and won ($0.61) with Pair of Aces
Seat 5: 220b0aae folded before Flop (didn't bet)
Seat 6: fdc2d3ba folded before Flop (didn't bet)


Poker Hand #RC2078505252: Hold'em No Limit ($0.02/$0.05) - 2023/12/22 21:26:15
Table 'RushAndCash787881' 6-max Seat #1 is the button
Seat 1: 168ef649 ($5.67 in chips)
Seat 2: c7bcf41c ($5.29 in chips)
Seat 3: 8d94440d ($5 in chips)
Seat 4: 875f34a0 ($27.87 in chips)
Seat 5: Hero ($5 in chips)
Seat 6: 317ccf77 ($1.64 in chips)
c7bcf41c: posts small blind $0.02
8d94440d: posts big blind $0.05
*** HOLE CARDS ***
Dealt to 168ef649 
Dealt to c7bcf41c 
Dealt to 8d94440d 
Dealt to 875f34a0 
Dealt to Hero [8c Ts]
Dealt to 317ccf77 
875f34a0: folds
Hero: folds
317ccf77: folds
168ef649: folds
c7bcf41c: folds
Uncalled bet ($0.03) returned to 8d94440d
*** SHOWDOWN ***
8d94440d collected $0.04 from pot
*** SUMMARY ***
Total pot $0.04 | Rake $0 | Jackpot $0 | Bingo $0 | Fortune $0 | Tax $0
Seat 1: 168ef649 (button) folded before Flop (didn't bet)
Seat 2: c7bcf41c (small blind) folded before Flop
Seat 3: 8d94440d (big blind) collected ($0.04)
Seat 4: 875f34a0 folded before Flop (didn't bet)
Seat 5: Hero folded before Flop (didn't bet)
Seat 6: 317ccf77 folded before Flop (didn't bet)


Poker Hand #RC2078505182: Hold'em No Limit ($0.02/$0.05) - 2023/12/22 21:26:11
Table 'RushAndCash787848' 6-max Seat #1 is the button
Seat 1: 875f34a0 ($27.87 in chips)
Seat 2: c3c9a58d ($10.57 in chips)
Seat 3: c9c293e2 ($7.28 in chips)
Seat 4: 93570c4 ($4.43 in chips)
Seat 5: ae32912c ($5 in chips)
Seat 6: Hero ($5 in chips)
c3c9a58d: posts small blind $0.02
c9c293e2: posts big blind $0.05
*** HOLE CARDS ***
Dealt to 875f34a0 
Dealt to c3c9a58d 
Dealt to c9c293e2 
Dealt to 93570c4 
Dealt to ae32912c 
Dealt to Hero [8d 6s]
93570c4: folds
ae32912c: raises $0.08 to $0.13
Hero: folds
875f34a0: folds
c3c9a58d: raises $0.31 to $0.44
c9c293e2: folds
ae32912c: calls $0.31
*** FLOP *** [6h 8c 9d]
c3c9a58d: checks
ae32912c: bets $0.62
c3c9a58d: raises $0.62 to $1.24
ae32912c: folds
Uncalled bet ($0.62) returned to c3c9a58d
*** SHOWDOWN ***
c3c9a58d collected $2 from pot
*** SUMMARY ***
Total pot $2.17 | Rake $0.1 | Jackpot $0.07 | Bingo $0 | Fortune $0 | Tax $0
Board [6h 8c 9d]
Seat 1: 875f34a0 (button) folded before Flop (didn't bet)
Seat 2: c3c9a58d (small blind) won ($2)
Seat 3: c9c293e2 (big blind) folded before Flop
Seat 4: 93570c4 folded before Flop (didn't bet)
Seat 5: ae32912c folded on the Flop
Seat 6: Hero folded before Flop (didn't bet)


Poker Hand #RC2078505086: Hold'em No Limit ($0.02/$0.05) - 2023/12/22 21:26:05
Table 'RushAndCash787799' 6-max Seat #1 is the button
Seat 1: 875f34a0 ($27.87 in chips)
Seat 2: bd4a4d17 ($19.76 in chips)
Seat 3: 81f9a1e6 ($16.84 in chips)
Seat 4: 3056048f ($5.74 in chips)
Seat 5: 1719c1d9 ($5.14 in chips)
Seat 6: Hero ($5 in chips)
bd4a4d17: posts small blind $0.02
81f9a1e6: posts big blind $0.05
*** HOLE CARDS ***
Dealt to 875f34a0 
Dealt to bd4a4d17 
Dealt to 81f9a1e6 
Dealt to 3056048f 
Dealt to 1719c1d9 
Dealt to Hero [7h Jc]
3056048f: folds
1719c1d9: folds
Hero: folds
875f34a0: folds
bd4a4d17: calls $0.03
81f9a1e6: raises $0.13 to $0.18
bd4a4d17: calls $0.13
*** FLOP *** [2c 7d Kc]
bd4a4d17: checks
81f9a1e6: bets $0.12
bd4a4d17: raises $0.46 to $0.58
81f9a1e6: folds
Uncalled bet ($0.46) returned to bd4a4d17
*** SHOWDOWN ***
bd4a4d17 collected $0.58 from pot
*** SUMMARY ***
Total pot $0.6 | Rake $0.02 | Jackpot $0 | Bingo $0 | Fortune $0 | Tax $0
Board [2c 7d Kc]
Seat 1: 875f34a0 (button) folded before Flop (didn't bet)
Seat 2: bd4a4d17 (small blind) won ($0.58)
Seat 3: 81f9a1e6 (big blind) folded on the Flop
Seat 4: 3056048f folded before Flop (didn't bet)
Seat 5: 1719c1d9 folded before Flop (didn't bet)
Seat 6: Hero folded before Flop (didn't bet)


Poker Hand #RC2078504944: Hold'em No Limit ($0.02/$0.05) - 2023/12/22 21:25:57
Table 'RushAndCash787728' 6-max Seat #1 is the button
Seat 1: Hero ($5 in chips)
Seat 2: 89a27c2 ($4.95 in chips)
Seat 3: 341cb855 ($4.13 in chips)
Seat 4: 53b6f5a9 ($5.22 in chips)
Seat 5: 6186df3d ($6 in chips)
Seat 6: b37d4c72 ($5.14 in chips)
89a27c2: posts small blind $0.02
341cb855: posts big blind $0.05
*** HOLE CARDS ***
Dealt to Hero [9s 5h]
Dealt to 89a27c2 
Dealt to 341cb855 
Dealt to 53b6f5a9 
Dealt to 6186df3d 
Dealt to b37d4c72 
53b6f5a9: folds
6186df3d: folds
b37d4c72: raises $0.05 to $0.1
Hero: folds
89a27c2: folds
341cb855: calls $0.05
*** FLOP *** [8s 8c 8d]
341cb855: checks
b37d4c72: checks
*** TURN *** [8s 8c 8d] [4c]
341cb855: checks
b37d4c72: checks
*** RIVER *** [8s 8c 8d 4c] [3d]
341cb855: bets $0.22
b37d4c72: folds
Uncalled bet ($0.22) returned to 341cb855
*** SHOWDOWN ***
341cb855 collected $0.21 from pot
*** SUMMARY ***
Total pot $0.22 | Rake $0.01 | Jackpot $0 | Bingo $0 | Fortune $0 | Tax $0
Board [8s 8c 8d 4c 3d]
Seat 1: Hero (button) folded before Flop (didn't bet)
Seat 2: 89a27c2 (small blind) folded before Flop
Seat 3: 341cb855 (big blind) won ($0.21)
Seat 4: 53b6f5a9 folded before Flop (didn't bet)
Seat 5: 6186df3d folded before Flop (didn't bet)
Seat 6: b37d4c72 folded on the River


Poker Hand #RC2078484449: Hold'em No Limit ($0.02/$0.05) - 2023/12/22 21:25:29
Table 'RushAndCash787503' 6-max Seat #1 is the button
Seat 1: 4b60b73d ($6.18 in chips)
Seat 2: Hero ($5 in chips)
Seat 3: 36f9aaa1 ($7.53 in chips)
Seat 4: 9dcfc86d ($3.89 in chips)
Seat 5: c0d3508b ($5.16 in chips)
Seat 6: 1d1c20e8 ($5.55 in chips)
Hero: posts small blind $0.02
36f9aaa1: posts big blind $0.05
*** HOLE CARDS ***
Dealt to 4b60b73d 
Dealt to Hero [Kd Qd]
Dealt to 36f9aaa1 
Dealt to 9dcfc86d 
Dealt to c0d3508b 
Dealt to 1d1c20e8 
9dcfc86d: raises $0.1 to $0.15
c0d3508b: folds
1d1c20e8: folds
4b60b73d: calls $0.15
Hero: calls $0.13
36f9aaa1: folds
*** FLOP *** [As 4s Js]
Hero: checks
9dcfc86d: checks
4b60b73d: bets $0.25
Hero: folds
9dcfc86d: calls $0.25
*** TURN *** [As 4s Js] [Ks]
9dcfc86d: checks
4b60b73d: checks
*** RIVER *** [As 4s Js Ks] [2c]
9dcfc86d: checks
4b60b73d: bets $0.65
9dcfc86d: calls $0.65
4b60b73d: shows [9s Ts] (Ace High Flush)
9dcfc86d: shows [Kh Ad] (Pair of Aces and Pair of Kings)
*** SHOWDOWN ***
4b60b73d collected $2.12 from pot
*** SUMMARY ***
Total pot $2.3 | Rake $0.11 | Jackpot $0.07 | Bingo $0 | Fortune $0 | Tax $0
Board [As 4s Js Ks 2c]
Seat 1: 4b60b73d (button) showed [9s Ts] and won ($2.12) with Ace High Flush
Seat 2: Hero (small blind) folded on the Flop
Seat 3: 36f9aaa1 (big blind) folded before Flop
Seat 4: 9dcfc86d showed [Kh Ad] and lost with Pair of Aces and Pair of Kings
Seat 5: c0d3508b folded before Flop (didn't bet)
Seat 6: 1d1c20e8 folded before Flop (didn't bet)


Poker Hand #RC2078484257: Hold'em No Limit ($0.02/$0.05) - 2023/12/22 21:25:19
Table 'RushAndCash787420' 6-max Seat #1 is the button
Seat 1: a3926d8e ($4.66 in chips)
Seat 2: 8e0f056d ($7.75 in chips)
Seat 3: Hero ($5 in chips)
Seat 4: a2edfbd1 ($2.54 in chips)
Seat 5: ebbe3f50 ($5.07 in chips)
Seat 6: 391fe85a ($5 in chips)
8e0f056d: posts small blind $0.02
Hero: posts big blind $0.05
*** HOLE CARDS ***
Dealt to a3926d8e 
Dealt to 8e0f056d 
Dealt to Hero [4h 3c]
Dealt to a2edfbd1 
Dealt to ebbe3f50 
Dealt to 391fe85a 
a2edfbd1: folds
ebbe3f50: folds
391fe85a: raises $0.1 to $0.15
a3926d8e: folds
8e0f056d: folds
Hero: folds
Uncalled bet ($0.1) returned to 391fe85a
*** SHOWDOWN ***
391fe85a collected $0.12 from pot
*** SUMMARY ***
Total pot $0.12 | Rake $0 | Jackpot $0 | Bingo $0 | Fortune $0 | Tax $0
Seat 1: a3926d8e (button) folded before Flop (didn't bet)
Seat 2: 8e0f056d (small blind) folded before Flop
Seat 3: Hero (big blind) folded before Flop
Seat 4: a2edfbd1 folded before Flop (didn't bet)
Seat 5: ebbe3f50 folded before Flop (didn't bet)
Seat 6: 391fe85a collected ($0.12)


