Poker Hand #RC2078483093: Hold'em No Limit ($0.02/$0.05) - 2023/12/22 21:24:11
Table 'RushAndCash786869' 6-max Seat #1 is the button
Seat 1: e194bfc6 ($4.8 in chips)
Seat 2: 7732abf7 ($23.2 in chips)
Seat 3: Hero ($5 in chips)
Seat 4: 1b7b574c ($5 in chips)
Seat 5: 63c93090 ($7.14 in chips)
Seat 6: e8df5901 ($7.68 in chips)
7732abf7: posts small blind $0.02
Hero: posts big blind $0.05
*** HOLE CARDS ***
Dealt to e194bfc6 
Dealt to 7732abf7 
Dealt to Hero [Ts Kd]
Dealt to 1b7b574c 
Dealt to 63c93090 
Dealt to e8df5901 
1b7b574c: calls $0.05
63c93090: folds
e8df5901: folds
e194bfc6: folds
7732abf7: folds
Hero: checks
*** FLOP *** [Qh Qc 5c]
Hero: checks
1b7b574c: checks
*** TURN *** [Qh Qc 5c] [5h]
Hero: checks
1b7b574c: checks
*** RIVER *** [Qh Qc 5c 5h] [4c]
Hero: checks
1b7b574c: checks
Hero: shows [Ts Kd] (Pair of Queens and Pair of Fives)
1b7b574c: shows [3c Jh] (Pair of Queens and Pair of Fives)
*** SHOWDOWN ***
Hero collected $0.12 from pot
*** SUMMARY ***
Total pot $0.12 | Rake $0 | Jackpot $0 | Bingo $0 | Fortune $0 | Tax $0
Board [Qh Qc 5c 5h 4c]
Seat 1: e194bfc6 (button) folded before Flop (didn't bet)
Seat 2: 7732abf7 (small blind) folded before Flop
Seat 3: Hero (big blind) showed [Ts Kd] and won ($0.12) with Pair of Queens and Pair of Fives
Seat 4: 1b7b574c showed [3c Jh] and lost with Pair of Queens and Pair of Fives
Seat 5: 63c93090 folded before Flop (didn't bet)
Seat 6: e8df5901 folded before Flop (didn't bet)


Poker Hand #RC2078482947: Hold'em No Limit ($0.02/$0.05) - 2023/12/22 21:24:03
Table 'RushAndCash786807' 6-max Seat #1 is the button
Seat 1: 84497676 ($16.07 in chips)
Seat 2: Hero ($5.02 in chips)
Seat 3: 3c03eb6e ($6.36 in chips)
Seat 4: 604de4fe ($5.23 in chips)
Seat 5: 45bb3f0f ($5.16 in chips)
Seat 6: d51e5ac3 ($5 in chips)
Hero: posts small blind $0.02
3c03eb6e: posts big blind $0.05
*** HOLE CARDS ***
Dealt to 84497676 
Dealt to Hero [7d 2c]
Dealt to 3c03eb6e 
Dealt to 604de4fe 
Dealt to 45bb3f0f 
Dealt to d51e5ac3 
604de4fe: folds
45bb3f0f: folds
d51e5ac3: folds
84497676: raises $0.08 to $0.13
Hero: folds
3c03eb6e: calls $0.08
*** FLOP *** [7h 5d Ac]
3c03eb6e: checks
84497676: bets $0.14
3c03eb6e: calls $0.14
*** TURN *** [7h 5d Ac] [Ad]
3c03eb6e: checks
84497676: bets $0.28
3c03eb6e: calls $0.28
*** RIVER *** [7h 5d Ac Ad] [5h]
3c03eb6e: bets $5.81 and is all-in
84497676: folds
Uncalled bet ($5.81) returned to 3c03eb6e
*** SHOWDOWN ***
3c03eb6e collected $1.07 from pot
*** SUMMARY ***
Total pot $1.12 | Rake $0.05 | Jackpot $0 | Bingo $0 | Fortune $0 | Tax $0
Board [7h 5d Ac Ad 5h]
Seat 1: 84497676 (button) folded on the River
Seat 2: Hero (small blind) folded before Flop
Seat 3: 3c03eb6e (big blind) won ($1.07)
Seat 4: 604de4fe folded before Flop (didn't bet)
Seat 5: 45bb3f0f folded before Flop (didn't bet)
Seat 6: d51e5ac3 folded before Flop (didn't bet)


Poker Hand #RC2078482878: Hold'em No Limit ($0.02/$0.05) - 2023/12/22 21:23:59
Table 'RushAndCash786775' 6-max Seat #1 is the button
Seat 1: b88dbe00 ($4.98 in chips)
Seat 2: a77b7df9 ($1.96 in chips)
Seat 3: 3b6e2f77 ($5.02 in chips)
Seat 4: Hero ($5.02 in chips)
Seat 5: 130f7150 ($5.08 in chips)
Seat 6: e1380a89 ($5.36 in chips)
a77b7df9: posts small blind $0.02
3b6e2f77: posts big blind $0.05
*** HOLE CARDS ***
Dealt to b88dbe00 
Dealt to a77b7df9 
Dealt to 3b6e2f77 
Dealt to Hero [9d Qd]
Dealt to 130f7150 
Dealt to e1380a89 
Hero: folds
130f7150: folds
e1380a89: folds
b88dbe00: folds
a77b7df9: folds
Uncalled bet ($0.03) returned to 3b6e2f77
*** SHOWDOWN ***
3b6e2f77 collected $0.04 from pot
*** SUMMARY ***
Total pot $0.04 | Rake $0 | Jackpot $0 | Bingo $0 | Fortune $0 | Tax $0
Seat 1: b88dbe00 (button) folded before Flop (didn't bet)
Seat 2: a77b7df9 (small blind) folded before Flop
Seat 3: 3b6e2f77 (big blind) collected ($0.04)
Seat 4: Hero folded before Flop (didn't bet)
Seat 5: 130f7150 folded before Flop (didn't bet)
Seat 6: e1380a89 folded before Flop (didn't bet)


Poker Hand #RC2078482817: Hold'em No Limit ($0.02/$0.05) - 2023/12/22 21:23:55
Table 'RushAndCash786747' 6-max Seat #1 is the button
Seat 1: c2ec7797 ($5.54 in chips)
Seat 2: 919daa51 ($4.29 in chips)
Seat 3: 59a39874 ($9.96 in chips)
Seat 4: 801c157f ($23.11 in chips)
Seat 5: Hero ($5.02 in chips)
Seat 6: 869465ff ($17.21 in chips)
919daa51: posts small blind $0.02
59a39874: posts big blind $0.05
*** HOLE CARDS ***
Dealt to c2ec7797 
Dealt to 919daa51 
Dealt to 59a39874 
Dealt to 801c157f 
Dealt to Hero [6c 4c]
Dealt to 869465ff 
801c157f: folds
Hero: folds
869465ff: folds
c2ec7797: raises $0.08 to $0.13
919daa51: folds
59a39874: calls $0.08
*** FLOP *** [7s 7c 9d]
59a39874: checks
c2ec7797: bets $0.1
59a39874: folds
Uncalled bet ($0.1) returned to c2ec7797
*** SHOWDOWN ***
c2ec7797 collected $0.27 from pot
*** SUMMARY ***
Total pot $0.28 | Rake $0.01 | Jackpot $0 | Bingo $0 | Fortune $0 | Tax $0
Board [7s 7c 9d]
Seat 1: c2ec7797 (button) won ($0.27)
Seat 2: 919daa51 (small blind) folded before Flop
Seat 3: 59a39874 (big blind) folded on the Flop
Seat 4: 801c157f folded before Flop (didn't bet)
Seat 5: Hero folded before Flop (didn't bet)
Seat 6: 869465ff folded before Flop (didn't bet)


Poker Hand #RC2078482700: Hold'em No Limit ($0.02/$0.05) - 2023/12/22 21:23:49
Table 'RushAndCash786690' 6-max Seat #1 is the button
Seat 1: d2739eda ($4.6 in chips)
Seat 2: 9942b4df ($8.09 in chips)
Seat 3: 1d1c20e8 ($4.16 in chips)
Seat 4: c2881b52 ($12.46 in chips)
Seat 5: Hero ($5.02 in chips)
Seat 6: dcd1ce07 ($20.33 in chips)
9942b4df: posts small blind $0.02
1d1c20e8: posts big blind $0.05
*** HOLE CARDS ***
Dealt to d2739eda 
Dealt to 9942b4df 
Dealt to 1d1c20e8 
Dealt to c2881b52 
Dealt to Hero [2h 8c]
Dealt to dcd1ce07 
c2881b52: folds
Hero: folds
dcd1ce07: folds
d2739eda: folds
9942b4df: raises $0.1 to $0.15
1d1c20e8: calls $0.1
*** FLOP *** [Jc 7h 3h]
9942b4df: bets $0.15
1d1c20e8: raises $0.3 to $0.45
9942b4df: calls $0.3
*** TURN *** [Jc 7h 3h] [4d]
9942b4df: checks
1d1c20e8: bets $0.53
9942b4df: folds
Uncalled bet ($0.53) returned to 1d1c20e8
*** SHOWDOWN ***
1d1c20e8 collected $1.14 from pot
*** SUMMARY ***
Total pot $1.2 | Rake $0.06 | Jackpot $0 | Bingo $0 | Fortune $0 | Tax $0
Board [Jc 7h 3h 4d]
Seat 1: d2739eda (button) folded before Flop (didn't bet)
Seat 2: 9942b4df (small blind) folded on the Turn
Seat 3: 1d1c20e8 (big blind) won ($1.14)
Seat 4: c2881b52 folded before Flop (didn't bet)
Seat 5: Hero folded before Flop (didn't bet)
Seat 6: dcd1ce07 folded before Flop (didn't bet)


Poker Hand #RC2078482528: Hold'em No Limit ($0.02/$0.05) - 2023/12/22 21:23:38
Table 'RushAndCash786606' 6-max Seat #1 is the button
Seat 1: 2c867a7e ($13.29 in chips)
Seat 2: 84572dc4 ($1.98 in chips)
Seat 3: Hero ($5 in chips)
Seat 4: 9119f364 ($5.59 in chips)
Seat 5: 8b0c9357 ($5 in chips)
Seat 6: 20a35d2e ($11.06 in chips)
84572dc4: posts small blind $0.02
Hero: posts big blind $0.05
*** HOLE CARDS ***
Dealt to 2c867a7e 
Dealt to 84572dc4 
Dealt to Hero [Ts 4h]
Dealt to 9119f364 
Dealt to 8b0c9357 
Dealt to 20a35d2e 
9119f364: folds
8b0c9357: folds
20a35d2e: folds
2c867a7e: folds
84572dc4: folds
Uncalled bet ($0.03) returned to Hero
*** SHOWDOWN ***
Hero collected $0.04 from pot
*** SUMMARY ***
Total pot $0.04 | Rake $0 | Jackpot $0 | Bingo $0 | Fortune $0 | Tax $0
Seat 1: 2c867a7e (button) folded before Flop (didn't bet)
Seat 2: 84572dc4 (small blind) folded before Flop
Seat 3: Hero (big blind) collected ($0.04)
Seat 4: 9119f364 folded before Flop (didn't bet)
Seat 5: 8b0c9357 folded before Flop (didn't bet)
Seat 6: 20a35d2e folded before Flop (didn't bet)


Poker Hand #RC2078482224: Hold'em No Limit ($0.02/$0.05) - 2023/12/22 21:23:20
Table 'RushAndCash786468' 6-max Seat #1 is the button
Seat 1: 7418c0c4 ($5 in chips)
Seat 2: Hero ($5 in chips)
Seat 3: 257cb6ea ($5.05 in chips)
Seat 4: adc999b ($15.59 in chips)
Seat 5: eac1a90f ($5.42 in chips)
Seat 6: 54daf47b ($9.55 in chips)
Hero: posts small blind $0.02
257cb6ea: posts big blind $0.05
*** HOLE CARDS ***
Dealt to 7418c0c4 
Dealt to Hero [4d Ac]
Dealt to 257cb6ea 
Dealt to adc999b 
Dealt to eac1a90f 
Dealt to 54daf47b 
adc999b: folds
eac1a90f: folds
54daf47b: folds
7418c0c4: raises $0.07 to $0.12
Hero: folds
257cb6ea: folds
Uncalled bet ($0.07) returned to 7418c0c4
*** SHOWDOWN ***
7418c0c4 collected $0.12 from pot
*** SUMMARY ***
Total pot $0.12 | Rake $0 | Jackpot $0 | Bingo $0 | Fortune $0 | Tax $0
Seat 1: 7418c0c4 (button) collected ($0.12)
Seat 2: Hero (small blind) folded before Flop
Seat 3: 257cb6ea (big blind) folded before Flop
Seat 4: adc999b folded before Flop (didn't bet)
Seat 5: eac1a90f folded before Flop (didn't bet)
Seat 6: 54daf47b folded before Flop (didn't bet)


Poker Hand #RC2078482095: Hold'em No Limit ($0.02/$0.05) - 2023/12/22 21:23:13
Table 'RushAndCash786410' 6-max Seat #1 is the button
Seat 1: Hero ($5 in chips)
Seat 2: bd4a4d17 ($20.01 in chips)
Seat 3: b01c40bf ($18.41 in chips)
Seat 4: 67d4b163 ($10.91 in chips)
Seat 5: 25f07be0 ($5.13 in chips)
Seat 6: 20a136d7 ($6.18 in chips)
bd4a4d17: posts small blind $0.02
b01c40bf: posts big blind $0.05
*** HOLE CARDS ***
Dealt to Hero [Kh Ts]
Dealt to bd4a4d17 
Dealt to b01c40bf 
Dealt to 67d4b163 
Dealt to 25f07be0 
Dealt to 20a136d7 
67d4b163: raises $0.15 to $0.2
25f07be0: calls $0.2
20a136d7: folds
Hero: folds
bd4a4d17: folds
b01c40bf: folds
*** FLOP *** [3c 4d 9s]
67d4b163: bets $0.36
25f07be0: folds
Uncalled bet ($0.36) returned to 67d4b163
*** SHOWDOWN ***
67d4b163 collected $0.45 from pot
*** SUMMARY ***
Total pot $0.47 | Rake $0.02 | Jackpot $0 | Bingo $0 | Fortune $0 | Tax $0
Board [3c 4d 9s]
Seat 1: Hero (button) folded before Flop (didn't bet)
Seat 2: bd4a4d17 (small blind) folded before Flop
Seat 3: b01c40bf (big blind) folded before Flop
Seat 4: 67d4b163 won ($0.45)
Seat 5: 25f07be0 folded on the Flop
Seat 6: 20a136d7 folded before Flop (didn't bet)


Poker Hand #RC2078482032: Hold'em No Limit ($0.02/$0.05) - 2023/12/22 21:23:09
Table 'RushAndCash786383' 6-max Seat #1 is the button
Seat 1: f88f8e87 ($5.12 in chips)
Seat 2: a1dfe2ad ($9.61 in chips)
Seat 3: 1adb19a8 ($3.78 in chips)
Seat 4: bc118b95 ($5.87 in chips)
Seat 5: Hero ($5 in chips)
Seat 6: 29b0f5be ($5.46 in chips)
a1dfe2ad: posts small blind $0.02
1adb19a8: posts big blind $0.05
*** HOLE CARDS ***
Dealt to f88f8e87 
Dealt to a1dfe2ad 
Dealt to 1adb19a8 
Dealt to bc118b95 
Dealt to Hero [4h Qd]
Dealt to 29b0f5be 
bc118b95: folds
Hero: folds
29b0f5be: folds
f88f8e87: folds
a1dfe2ad: raises $0.08 to $0.13
1adb19a8: raises $0.37 to $0.5
a1dfe2ad: folds
Uncalled bet ($0.37) returned to 1adb19a8
*** SHOWDOWN ***
1adb19a8 collected $0.25 from pot
*** SUMMARY ***
Total pot $0.26 | Rake $0.01 | Jackpot $0 | Bingo $0 | Fortune $0 | Tax $0
Seat 1: f88f8e87 (button) folded before Flop (didn't bet)
Seat 2: a1dfe2ad (small blind) folded before Flop
Seat 3: 1adb19a8 (big blind) collected ($0.25)
Seat 4: bc118b95 folded before Flop (didn't bet)
Seat 5: Hero folded before Flop (didn't bet)
Seat 6: 29b0f5be folded before Flop (didn't bet)


Poker Hand #RC2078481975: Hold'em No Limit ($0.02/$0.05) - 2023/12/22 21:23:06
Table 'RushAndCash786357' 6-max Seat #1 is the button
Seat 1: 3928912e ($5.16 in chips)
Seat 2: 373bc096 ($5.57 in chips)
Seat 3: 412701ed ($6.05 in chips)
Seat 4: 68c6c5e7 ($25.52 in chips)
Seat 5: d0b2d784 ($8.56 in chips)
Seat 6: Hero ($5 in chips)
373bc096: posts small blind $0.02
412701ed: posts big blind $0.05
*** HOLE CARDS ***
Dealt to 3928912e 
Dealt to 373bc096 
Dealt to 412701ed 
Dealt to 68c6c5e7 
Dealt to d0b2d784 
Dealt to Hero [Tc 3s]
68c6c5e7: folds
d0b2d784: folds
Hero: folds
3928912e: folds
373bc096: raises $0.1 to $0.15
412701ed: folds
Uncalled bet ($0.1) returned to 373bc096
*** SHOWDOWN ***
373bc096 collected $0.1 from pot
*** SUMMARY ***
Total pot $0.1 | Rake $0 | Jackpot $0 | Bingo $0 | Fortune $0 | Tax $0
Seat 1: 3928912e (button) folded before Flop (didn't bet)
Seat 2: 373bc096 (small blind) collected ($0.1)
Seat 3: 412701ed (big blind) folded before Flop
Seat 4: 68c6c5e7 folded before Flop (didn't bet)
Seat 5: d0b2d784 folded before Flop (didn't bet)
Seat 6: Hero folded before Flop (didn't bet)


Poker Hand #RC2078481099: Hold'em No Limit ($0.02/$0.05) - 2023/12/22 21:22:15
Table 'RushAndCash785935' 6-max Seat #1 is the button
Seat 1: edb6154b ($6.05 in chips)
Seat 2: Hero ($5 in chips)
Seat 3: f5180b51 ($8.8 in chips)
Seat 4: 4b60b73d ($6.62 in chips)
Seat 5: 963f3a1f ($2.36 in chips)
Seat 6: 822842b3 ($8.02 in chips)
Hero: posts small blind $0.02
f5180b51: posts big blind $0.05
*** HOLE CARDS ***
Dealt to edb6154b 
Dealt to Hero [Ac 4h]
Dealt to f5180b51 
Dealt to 4b60b73d 
Dealt to 963f3a1f 
Dealt to 822842b3 
4b60b73d: folds
963f3a1f: folds
822842b3: folds
edb6154b: folds
Hero: raises $0.1 to $0.15
f5180b51: calls $0.1
*** FLOP *** [Ad 8d 5s]
Hero: checks
f5180b51: bets $0.23
Hero: calls $0.23
*** TURN *** [Ad 8d 5s] [Kc]
Hero: checks
f5180b51: bets $0.57
Hero: calls $0.57
*** RIVER *** [Ad 8d 5s Kc] [5c]
Hero: checks
f5180b51: bets $1.9
Hero: folds
Uncalled bet ($1.9) returned to f5180b51
*** SHOWDOWN ***
f5180b51 collected $1.74 from pot
*** SUMMARY ***
Total pot $1.9 | Rake $0.09 | Jackpot $0.07 | Bingo $0 | Fortune $0 | Tax $0
Board [Ad 8d 5s Kc 5c]
Seat 1: edb6154b (button) folded before Flop (didn't bet)
Seat 2: Hero (small blind) folded on the River
Seat 3: f5180b51 (big blind) won ($1.74)
Seat 4: 4b60b73d folded before Flop (didn't bet)
Seat 5: 963f3a1f folded before Flop (didn't bet)
Seat 6: 822842b3 folded before Flop (didn't bet)


Poker Hand #RC2078480468: Hold'em No Limit ($0.02/$0.05) - 2023/12/22 21:21:37
Table 'RushAndCash785622' 6-max Seat #1 is the button
Seat 1: 7732abf7 ($23.44 in chips)
Seat 2: 9758b493 ($5 in chips)
Seat 3: 6c7c67da ($5 in chips)
Seat 4: 33908c77 ($5.45 in chips)
Seat 5: Hero ($5 in chips)
Seat 6: f1f11b26 ($5.07 in chips)
9758b493: posts small blind $0.02
6c7c67da: posts big blind $0.05
*** HOLE CARDS ***
Dealt to 7732abf7 
Dealt to 9758b493 
Dealt to 6c7c67da 
Dealt to 33908c77 
Dealt to Hero [Ad Jh]
Dealt to f1f11b26 
33908c77: folds
Hero: raises $0.05 to $0.1
f1f11b26: folds
7732abf7: folds
9758b493: folds
6c7c67da: calls $0.05
*** FLOP *** [8s 5d 9c]
6c7c67da: checks
Hero: checks
*** TURN *** [8s 5d 9c] [7d]
6c7c67da: bets $0.08
Hero: folds
Uncalled bet ($0.08) returned to 6c7c67da
*** SHOWDOWN ***
6c7c67da collected $0.21 from pot
*** SUMMARY ***
Total pot $0.22 | Rake $0.01 | Jackpot $0 | Bingo $0 | Fortune $0 | Tax $0
Board [8s 5d 9c 7d]
Seat 1: 7732abf7 (button) folded before Flop (didn't bet)
Seat 2: 9758b493 (small blind) folded before Flop
Seat 3: 6c7c67da (big blind) won ($0.21)
Seat 4: 33908c77 folded before Flop (didn't bet)
Seat 5: Hero folded on the Turn
Seat 6: f1f11b26 folded before Flop (didn't bet)


Poker Hand #RC2078480358: Hold'em No Limit ($0.02/$0.05) - 2023/12/22 21:21:31
Table 'RushAndCash785573' 6-max Seat #1 is the button
Seat 1: Hero ($5 in chips)
Seat 2: 4af1c8bb ($3.2 in chips)
Seat 3: 23c96099 ($8.27 in chips)
Seat 4: 3b055a50 ($6.69 in chips)
Seat 5: 4cfc823 ($5 in chips)
Seat 6: 872860d ($8.38 in chips)
4af1c8bb: posts small blind $0.02
23c96099: posts big blind $0.05
*** HOLE CARDS ***
Dealt to Hero [2h 5d]
Dealt to 4af1c8bb 
Dealt to 23c96099 
Dealt to 3b055a50 
Dealt to 4cfc823 
Dealt to 872860d 
3b055a50: folds
4cfc823: folds
872860d: folds
Hero: folds
4af1c8bb: calls $0.03
23c96099: checks
*** FLOP *** [8d 5h Jh]
4af1c8bb: checks
23c96099: checks
*** TURN *** [8d 5h Jh] [Jc]
4af1c8bb: checks
23c96099: checks
*** RIVER *** [8d 5h Jh Jc] [8s]
4af1c8bb: checks
23c96099: checks
4af1c8bb: shows [9h Kd] (Pair of Jacks and Pair of Eights)
23c96099: shows [Ts 6c] (Pair of Jacks and Pair of Eights)
*** SHOWDOWN ***
4af1c8bb collected $0.1 from pot
*** SUMMARY ***
Total pot $0.1 | Rake $0 | Jackpot $0 | Bingo $0 | Fortune $0 | Tax $0
Board [8d 5h Jh Jc 8s]
Seat 1: Hero (button) folded before Flop (didn't bet)
Seat 2: 4af1c8bb (small blind) showed [9h Kd] and won ($0.1) with Pair of Jacks and Pair of Eights
Seat 3: 23c96099 (big blind) showed [Ts 6c] and lost with Pair of Jacks and Pair of Eights
Seat 4: 3b055a50 folded before Flop (didn't bet)
Seat 5: 4cfc823 folded before Flop (didn't bet)
Seat 6: 872860d folded before Flop (didn't bet)


Poker Hand #RC2078480122: Hold'em No Limit ($0.02/$0.05) - 2023/12/22 21:21:18
Table 'RushAndCash785463' 6-max Seat #1 is the button
Seat 1: 40810c68 ($5 in chips)
Seat 2: 919daa51 ($4.43 in chips)
Seat 3: Hero ($5 in chips)
Seat 4: 6ef00a1b ($15.21 in chips)
Seat 5: 59c7f4b1 ($6.39 in chips)
Seat 6: 4ee77832 ($5 in chips)
919daa51: posts small blind $0.02
Hero: posts big blind $0.05
*** HOLE CARDS ***
Dealt to 40810c68 
Dealt to 919daa51 
Dealt to Hero [2c Td]
Dealt to 6ef00a1b 
Dealt to 59c7f4b1 
Dealt to 4ee77832 
6ef00a1b: raises $0.08 to $0.13
59c7f4b1: folds
4ee77832: folds
40810c68: folds
919daa51: folds
Hero: folds
Uncalled bet ($0.08) returned to 6ef00a1b
*** SHOWDOWN ***
6ef00a1b collected $0.12 from pot
*** SUMMARY ***
Total pot $0.12 | Rake $0 | Jackpot $0 | Bingo $0 | Fortune $0 | Tax $0
Seat 1: 40810c68 (button) folded before Flop (didn't bet)
Seat 2: 919daa51 (small blind) folded before Flop
Seat 3: Hero (big blind) folded before Flop
Seat 4: 6ef00a1b collected ($0.12)
Seat 5: 59c7f4b1 folded before Flop (didn't bet)
Seat 6: 4ee77832 folded before Flop (didn't bet)


Poker Hand #RC2078480019: Hold'em No Limit ($0.02/$0.05) - 2023/12/22 21:21:12
Table 'RushAndCash785415' 6-max Seat #1 is the button
Seat 1: 8e4ad426 ($5.31 in chips)
Seat 2: 30a2950b ($7.9 in chips)
Seat 3: ec80eef8 ($6.87 in chips)
Seat 4: f275cf48 ($9 in chips)
Seat 5: Hero ($5 in chips)
Seat 6: 618f8ec9 ($5.19 in chips)
30a2950b: posts small blind $0.02
ec80eef8: posts big blind $0.05
*** HOLE CARDS ***
Dealt to 8e4ad426 
Dealt to 30a2950b 
Dealt to ec80eef8 
Dealt to f275cf48 
Dealt to Hero [3s 4s]
Dealt to 618f8ec9 
f275cf48: folds
Hero: folds
618f8ec9: folds
8e4ad426: folds
30a2950b: raises $0.07 to $0.12
ec80eef8: calls $0.07
*** FLOP *** [Th 2c Qs]
30a2950b: bets $0.08
ec80eef8: calls $0.08
*** TURN *** [Th 2c Qs] [Qc]
30a2950b: checks
ec80eef8: checks
*** RIVER *** [Th 2c Qs Qc] [3d]
30a2950b: checks
ec80eef8: bets $0.14
30a2950b: folds
Uncalled bet ($0.14) returned to ec80eef8
*** SHOWDOWN ***
ec80eef8 collected $0.38 from pot
*** SUMMARY ***
Total pot $0.4 | Rake $0.02 | Jackpot $0 | Bingo $0 | Fortune $0 | Tax $0
Board [Th 2c Qs Qc 3d]
Seat 1: 8e4ad426 (button) folded before Flop (didn't bet)
Seat 2: 30a2950b (small blind) folded on the River
Seat 3: ec80eef8 (big blind) won ($0.38)
Seat 4: f275cf48 folded before Flop (didn't bet)
Seat 5: Hero folded before Flop (didn't bet)
Seat 6: 618f8ec9 folded before Flop (didn't bet)


Poker Hand #RC2078479942: Hold'em No Limit ($0.02/$0.05) - 2023/12/22 21:21:08
Table 'RushAndCash785380' 6-max Seat #1 is the button
Seat 1: 4810f2d7 ($5.47 in chips)
Seat 2: dee599cb ($4.91 in chips)
Seat 3: f94de4b0 ($5.24 in chips)
Seat 4: 79b83c66 ($2.65 in chips)
Seat 5: 30a2950b ($7.9 in chips)
Seat 6: Hero ($5 in chips)
dee599cb: posts small blind $0.02
f94de4b0: posts big blind $0.05
*** HOLE CARDS ***
Dealt to 4810f2d7 
Dealt to dee599cb 
Dealt to f94de4b0 
Dealt to 79b83c66 
Dealt to 30a2950b 
Dealt to Hero [6d 9h]
79b83c66: folds
30a2950b: folds
Hero: folds
4810f2d7: folds
dee599cb: folds
Uncalled bet ($0.03) returned to f94de4b0
*** SHOWDOWN ***
f94de4b0 collected $0.04 from pot
*** SUMMARY ***
Total pot $0.04 | Rake $0 | Jackpot $0 | Bingo $0 | Fortune $0 | Tax $0
Seat 1: 4810f2d7 (button) folded before Flop (didn't bet)
Seat 2: dee599cb (small blind) folded before Flop
Seat 3: f94de4b0 (big blind) collected ($0.04)
Seat 4: 79b83c66 folded before Flop (didn't bet)
Seat 5: 30a2950b folded before Flop (didn't bet)
Seat 6: Hero folded before Flop (didn't bet)


Poker Hand #RC2078479277: Hold'em No Limit ($0.02/$0.05) - 2023/12/22 21:20:30
Table 'RushAndCash785067' 6-max Seat #1 is the button
Seat 1: f2f8c789 ($20.13 in chips)
Seat 2: 2e44f78e ($13.55 in chips)
Seat 3: Hero ($5 in chips)
Seat 4: 8927103f ($4.77 in chips)
Seat 5: 44795538 ($5.23 in chips)
Seat 6: 44231a0a ($13.33 in chips)
2e44f78e: posts small blind $0.02
Hero: posts big blind $0.05
*** HOLE CARDS ***
Dealt to f2f8c789 
Dealt to 2e44f78e 
Dealt to Hero [2c 4c]
Dealt to 8927103f 
Dealt to 44795538 
Dealt to 44231a0a 
8927103f: folds
44795538: folds
44231a0a: raises $0.07 to $0.12
f2f8c789: folds
2e44f78e: folds
Hero: calls $0.07
*** FLOP *** [Ac 3s Jc]
Hero: checks
44231a0a: bets $0.13
Hero: calls $0.13
*** TURN *** [Ac 3s Jc] [8s]
Hero: checks
44231a0a: bets $0.52
Hero: folds
Uncalled bet ($0.52) returned to 44231a0a
*** SHOWDOWN ***
44231a0a collected $0.5 from pot
*** SUMMARY ***
Total pot $0.52 | Rake $0.02 | Jackpot $0 | Bingo $0 | Fortune $0 | Tax $0
Board [Ac 3s Jc 8s]
Seat 1: f2f8c789 (button) folded before Flop (didn't bet)
Seat 2: 2e44f78e (small blind) folded before Flop
Seat 3: Hero (big blind) folded on the Turn
Seat 4: 8927103f folded before Flop (didn't bet)
Seat 5: 44795538 folded before Flop (didn't bet)
Seat 6: 44231a0a won ($0.5)


Poker Hand #RC2078479220: Hold'em No Limit ($0.02/$0.05) - 2023/12/22 21:20:26
Table 'RushAndCash785039' 6-max Seat #1 is the button
Seat 1: Hero ($5 in chips)
Seat 2: b7c101a2 ($12.61 in chips)
Seat 3: 6c75362e ($6.44 in chips)
Seat 4: 24503504 ($7.55 in chips)
Seat 5: 3a35e9f5 ($18.85 in chips)
Seat 6: e519a9e8 ($20.05 in chips)
b7c101a2: posts small blind $0.02
6c75362e: posts big blind $0.05
*** HOLE CARDS ***
Dealt to Hero [7d 8c]
Dealt to b7c101a2 
Dealt to 6c75362e 
Dealt to 24503504 
Dealt to 3a35e9f5 
Dealt to e519a9e8 
24503504: folds
3a35e9f5: folds
e519a9e8: folds
Hero: folds
b7c101a2: raises $0.07 to $0.12
6c75362e: folds
Uncalled bet ($0.07) returned to b7c101a2
*** SHOWDOWN ***
b7c101a2 collected $0.1 from pot
*** SUMMARY ***
Total pot $0.1 | Rake $0 | Jackpot $0 | Bingo $0 | Fortune $0 | Tax $0
Seat 1: Hero (button) folded before Flop (didn't bet)
Seat 2: b7c101a2 (small blind) collected ($0.1)
Seat 3: 6c75362e (big blind) folded before Flop
Seat 4: 24503504 folded before Flop (didn't bet)
Seat 5: 3a35e9f5 folded before Flop (didn't bet)
Seat 6: e519a9e8 folded before Flop (didn't bet)


Poker Hand #RC2078479155: Hold'em No Limit ($0.02/$0.05) - 2023/12/22 21:20:22
Table 'RushAndCash785006' 6-max Seat #1 is the button
Seat 1: f86836aa ($5 in chips)
Seat 2: 5d55167a ($8.94 in chips)
Seat 3: 67297113 ($5 in chips)
Seat 4: Hero ($5 in chips)
Seat 5: f1f11b26 ($5.01 in chips)
Seat 6: 3a8a7513 ($5.41 in chips)
5d55167a: posts small blind $0.02
67297113: posts big blind $0.05
*** HOLE CARDS ***
Dealt to f86836aa 
Dealt to 5d55167a 
Dealt to 67297113 
Dealt to Hero [Jh 3c]
Dealt to f1f11b26 
Dealt to 3a8a7513 
Hero: folds
f1f11b26: raises $0.08 to $0.13
3a8a7513: folds
f86836aa: raises $0.27 to $0.4
5d55167a: folds
67297113: folds
f1f11b26: raises $0.66 to $1.06
f86836aa: calls $0.66
*** FLOP *** [6h 5s Ah]
f1f11b26: checks
f86836aa: checks
*** TURN *** [6h 5s Ah] [6c]
f1f11b26: checks
f86836aa: bets $0.7
f1f11b26: folds
Uncalled bet ($0.7) returned to f86836aa
*** SHOWDOWN ***
f86836aa collected $2.02 from pot
*** SUMMARY ***
Total pot $2.19 | Rake $0.1 | Jackpot $0.07 | Bingo $0 | Fortune $0 | Tax $0
Board [6h 5s Ah 6c]
Seat 1: f86836aa (button) won ($2.02)
Seat 2: 5d55167a (small blind) folded before Flop
Seat 3: 67297113 (big blind) folded before Flop
Seat 4: Hero folded before Flop (didn't bet)
Seat 5: f1f11b26 folded on the Turn
Seat 6: 3a8a7513 folded before Flop (didn't bet)


Poker Hand #RC2078479084: Hold'em No Limit ($0.02/$0.05) - 2023/12/22 21:20:18
Table 'RushAndCash784970' 6-max Seat #1 is the button
Seat 1: e44205f6 ($5.07 in chips)
Seat 2: Hero ($5 in chips)
Seat 3: c2ec7797 ($5 in chips)
Seat 4: ae32912c ($5 in chips)
Seat 5: e732401c ($5.01 in chips)
Seat 6: e3579d61 ($5.08 in chips)
Hero: posts small blind $0.02
c2ec7797: posts big blind $0.05
*** HOLE CARDS ***
Dealt to e44205f6 
Dealt to Hero [Jh Tc]
Dealt to c2ec7797 
Dealt to ae32912c 
Dealt to e732401c 
Dealt to e3579d61 
ae32912c: folds
e732401c: folds
e3579d61: folds
e44205f6: raises $0.07 to $0.12
Hero: folds
c2ec7797: calls $0.07
*** FLOP *** [7d 6c 2h]
c2ec7797: checks
e44205f6: checks
*** TURN *** [7d 6c 2h] [3s]
c2ec7797: checks
e44205f6: bets $0.09
c2ec7797: folds
Uncalled bet ($0.09) returned to e44205f6
*** SHOWDOWN ***
e44205f6 collected $0.25 from pot
*** SUMMARY ***
Total pot $0.26 | Rake $0.01 | Jackpot $0 | Bingo $0 | Fortune $0 | Tax $0
Board [7d 6c 2h 3s]
Seat 1: e44205f6 (button) won ($0.25)
Seat 2: Hero (small blind) folded before Flop
Seat 3: c2ec7797 (big blind) folded on the Turn
Seat 4: ae32912c folded before Flop (didn't bet)
Seat 5: e732401c folded before Flop (didn't bet)
Seat 6: e3579d61 folded before Flop (didn't bet)


Poker Hand #RC2078477844: Hold'em No Limit ($0.02/$0.05) - 2023/12/22 21:19:06
Table 'RushAndCash784378' 6-max Seat #1 is the button
Seat 1: 5fea4bbc ($13.44 in chips)
Seat 2: 5d55167a ($9.43 in chips)
Seat 3: Hero ($5.02 in chips)
Seat 4: 59218957 ($12.68 in chips)
Seat 5: 886872c9 ($5.33 in chips)
Seat 6: f9adeea ($5.02 in chips)
5d55167a: posts small blind $0.02
Hero: posts big blind $0.05
*** HOLE CARDS ***
Dealt to 5fea4bbc 
Dealt to 5d55167a 
Dealt to Hero [Ah 2s]
Dealt to 59218957 
Dealt to 886872c9 
Dealt to f9adeea 
59218957: folds
886872c9: folds
f9adeea: folds
5fea4bbc: raises $0.08 to $0.13
5d55167a: folds
Hero: calls $0.08
*** FLOP *** [3h Td 4h]
Hero: checks
5fea4bbc: bets $0.14
Hero: folds
Uncalled bet ($0.14) returned to 5fea4bbc
*** SHOWDOWN ***
5fea4bbc collected $0.27 from pot
*** SUMMARY ***
Total pot $0.28 | Rake $0.01 | Jackpot $0 | Bingo $0 | Fortune $0 | Tax $0
Board [3h Td 4h]
Seat 1: 5fea4bbc (button) won ($0.27)
Seat 2: 5d55167a (small blind) folded before Flop
Seat 3: Hero (big blind) folded on the Flop
Seat 4: 59218957 folded before Flop (didn't bet)
Seat 5: 886872c9 folded before Flop (didn't bet)
Seat 6: f9adeea folded before Flop (didn't bet)


Poker Hand #RC2078477790: Hold'em No Limit ($0.02/$0.05) - 2023/12/22 21:19:02
Table 'RushAndCash784350' 6-max Seat #1 is the button
Seat 1: e734080a ($14.58 in chips)
Seat 2: c320c189 ($6.79 in chips)
Seat 3: 36f9aaa1 ($5.07 in chips)
Seat 4: f266e6e1 ($5.51 in chips)
Seat 5: cea6060f ($5.23 in chips)
Seat 6: Hero ($5.02 in chips)
c320c189: posts small blind $0.02
36f9aaa1: posts big blind $0.05
*** HOLE CARDS ***
Dealt to e734080a 
Dealt to c320c189 
Dealt to 36f9aaa1 
Dealt to f266e6e1 
Dealt to cea6060f 
Dealt to Hero [9h Js]
f266e6e1: folds
cea6060f: folds
Hero: folds
e734080a: raises $0.1 to $0.15
c320c189: folds
36f9aaa1: folds
Uncalled bet ($0.1) returned to e734080a
*** SHOWDOWN ***
e734080a collected $0.12 from pot
*** SUMMARY ***
Total pot $0.12 | Rake $0 | Jackpot $0 | Bingo $0 | Fortune $0 | Tax $0
Seat 1: e734080a (button) collected ($0.12)
Seat 2: c320c189 (small blind) folded before Flop
Seat 3: 36f9aaa1 (big blind) folded before Flop
Seat 4: f266e6e1 folded before Flop (didn't bet)
Seat 5: cea6060f folded before Flop (didn't bet)
Seat 6: Hero folded before Flop (didn't bet)


Poker Hand #RC2078477650: Hold'em No Limit ($0.02/$0.05) - 2023/12/22 21:18:54
Table 'RushAndCash784282' 6-max Seat #1 is the button
Seat 1: 835e8518 ($5 in chips)
Seat 2: c0d3508b ($5.29 in chips)
Seat 3: 810a2de ($5.64 in chips)
Seat 4: 806c9c64 ($4.02 in chips)
Seat 5: 67d4b163 ($15.33 in chips)
Seat 6: Hero ($5.02 in chips)
c0d3508b: posts small blind $0.02
810a2de: posts big blind $0.05
*** HOLE CARDS ***
Dealt to 835e8518 
Dealt to c0d3508b 
Dealt to 810a2de 
Dealt to 806c9c64 
Dealt to 67d4b163 
Dealt to Hero [3d 7d]
806c9c64: folds
67d4b163: folds
Hero: folds
835e8518: raises $0.05 to $0.1
c0d3508b: folds
810a2de: folds
Uncalled bet ($0.05) returned to 835e8518
*** SHOWDOWN ***
835e8518 collected $0.12 from pot
*** SUMMARY ***
Total pot $0.12 | Rake $0 | Jackpot $0 | Bingo $0 | Fortune $0 | Tax $0
Seat 1: 835e8518 (button) collected ($0.12)
Seat 2: c0d3508b (small blind) folded before Flop
Seat 3: 810a2de (big blind) folded before Flop
Seat 4: 806c9c64 folded before Flop (didn't bet)
Seat 5: 67d4b163 folded before Flop (didn't bet)
Seat 6: Hero folded before Flop (didn't bet)


Poker Hand #RC2078477558: Hold'em No Limit ($0.02/$0.05) - 2023/12/22 21:18:48
Table 'RushAndCash784233' 6-max Seat #1 is the button
Seat 1: 875f34a0 ($23.82 in chips)
Seat 2: 73c8f8b5 ($5.06 in chips)
Seat 3: 102e4185 ($5 in chips)
Seat 4: f9c6a467 ($23 in chips)
Seat 5: 63c93090 ($4.06 in chips)
Seat 6: Hero ($5.02 in chips)
73c8f8b5: posts small blind $0.02
102e4185: posts big blind $0.05
*** HOLE CARDS ***
Dealt to 875f34a0 
Dealt to 73c8f8b5 
Dealt to 102e4185 
Dealt to f9c6a467 
Dealt to 63c93090 
Dealt to Hero [5s 2s]
f9c6a467: folds
63c93090: folds
Hero: folds
875f34a0: folds
73c8f8b5: raises $0.1 to $0.15
102e4185: calls $0.1
*** FLOP *** [7s Td Ac]
73c8f8b5: checks
102e4185: checks
*** TURN *** [7s Td Ac] [Ad]
73c8f8b5: checks
102e4185: checks
*** RIVER *** [7s Td Ac Ad] [9c]
73c8f8b5: checks
102e4185: checks
73c8f8b5: shows [Jh Kd] (Pair of Aces)
102e4185: shows [Ks 9s] (Pair of Aces and Pair of Nines)
*** SHOWDOWN ***
102e4185 collected $0.29 from pot
*** SUMMARY ***
Total pot $0.3 | Rake $0.01 | Jackpot $0 | Bingo $0 | Fortune $0 | Tax $0
Board [7s Td Ac Ad 9c]
Seat 1: 875f34a0 (button) folded before Flop (didn't bet)
Seat 2: 73c8f8b5 (small blind) showed [Jh Kd] and lost with Pair of Aces
Seat 3: 102e4185 (big blind) showed [Ks 9s] and won ($0.29) with Pair of Aces and Pair of Nines
Seat 4: f9c6a467 folded before Flop (didn't bet)
Seat 5: 63c93090 folded before Flop (didn't bet)
Seat 6: Hero folded before Flop (didn't bet)


Poker Hand #RC2078477426: Hold'em No Limit ($0.02/$0.05) - 2023/12/22 21:18:41
Table 'RushAndCash784166' 6-max Seat #1 is the button
Seat 1: ce5771af ($5.11 in chips)
Seat 2: Hero ($5.04 in chips)
Seat 3: b0446474 ($5 in chips)
Seat 4: c4c1c89a ($5.48 in chips)
Seat 5: ae12e969 ($5 in chips)
Seat 6: 1c8d5419 ($8.51 in chips)
Hero: posts small blind $0.02
b0446474: posts big blind $0.05
*** HOLE CARDS ***
Dealt to ce5771af 
Dealt to Hero [Qh 2d]
Dealt to b0446474 
Dealt to c4c1c89a 
Dealt to ae12e969 
Dealt to 1c8d5419 
c4c1c89a: folds
ae12e969: raises $0.06 to $0.11
1c8d5419: folds
ce5771af: folds
Hero: folds
b0446474: folds
Uncalled bet ($0.06) returned to ae12e969
*** SHOWDOWN ***
ae12e969 collected $0.12 from pot
*** SUMMARY ***
Total pot $0.12 | Rake $0 | Jackpot $0 | Bingo $0 | Fortune $0 | Tax $0
Seat 1: ce5771af (button) folded before Flop (didn't bet)
Seat 2: Hero (small blind) folded before Flop
Seat 3: b0446474 (big blind) folded before Flop
Seat 4: c4c1c89a folded before Flop (didn't bet)
Seat 5: ae12e969 collected ($0.12)
Seat 6: 1c8d5419 folded before Flop (didn't bet)


Poker Hand #RC2078477303: Hold'em No Limit ($0.02/$0.05) - 2023/12/22 21:18:34
Table 'RushAndCash784102' 6-max Seat #1 is the button
Seat 1: 257cb6ea ($5.27 in chips)
Seat 2: 365a060c ($4.03 in chips)
Seat 3: a4c64da ($10.38 in chips)
Seat 4: f73ad9cd ($5 in chips)
Seat 5: a4441de9 ($6.6 in chips)
Seat 6: Hero ($5.04 in chips)
365a060c: posts small blind $0.02
a4c64da: posts big blind $0.05
*** HOLE CARDS ***
Dealt to 257cb6ea 
Dealt to 365a060c 
Dealt to a4c64da 
Dealt to f73ad9cd 
Dealt to a4441de9 
Dealt to Hero [9s Kc]
f73ad9cd: folds
a4441de9: folds
Hero: folds
257cb6ea: raises $0.06 to $0.11
365a060c: calls $0.09
a4c64da: calls $0.06
*** FLOP *** [6d 4s Th]
365a060c: checks
a4c64da: checks
257cb6ea: bets $0.17
365a060c: raises $0.67 to $0.84
a4c64da: folds
257cb6ea: folds
Uncalled bet ($0.67) returned to 365a060c
*** SHOWDOWN ***
365a060c collected $0.64 from pot
*** SUMMARY ***
Total pot $0.67 | Rake $0.03 | Jackpot $0 | Bingo $0 | Fortune $0 | Tax $0
Board [6d 4s Th]
Seat 1: 257cb6ea (button) folded on the Flop
Seat 2: 365a060c (small blind) won ($0.64)
Seat 3: a4c64da (big blind) folded on the Flop
Seat 4: f73ad9cd folded before Flop (didn't bet)
Seat 5: a4441de9 folded before Flop (didn't bet)
Seat 6: Hero folded before Flop (didn't bet)


Poker Hand #RC2078477203: Hold'em No Limit ($0.02/$0.05) - 2023/12/22 21:18:29
Table 'RushAndCash784050' 6-max Seat #1 is the button
Seat 1: 97e7da6 ($5.5 in chips)
Seat 2: c0a415e7 ($3.34 in chips)
Seat 3: 5d8c8da0 ($4.83 in chips)
Seat 4: a20c0bea ($6.16 in chips)
Seat 5: 4a4c34d3 ($4.84 in chips)
Seat 6: Hero ($5.04 in chips)
c0a415e7: posts small blind $0.02
5d8c8da0: posts big blind $0.05
*** HOLE CARDS ***
Dealt to 97e7da6 
Dealt to c0a415e7 
Dealt to 5d8c8da0 
Dealt to a20c0bea 
Dealt to 4a4c34d3 
Dealt to Hero [Kd Th]
a20c0bea: folds
4a4c34d3: folds
Hero: folds
97e7da6: folds
c0a415e7: raises $0.05 to $0.1
5d8c8da0: folds
Uncalled bet ($0.05) returned to c0a415e7
*** SHOWDOWN ***
c0a415e7 collected $0.1 from pot
*** SUMMARY ***
Total pot $0.1 | Rake $0 | Jackpot $0 | Bingo $0 | Fortune $0 | Tax $0
Seat 1: 97e7da6 (button) folded before Flop (didn't bet)
Seat 2: c0a415e7 (small blind) collected ($0.1)
Seat 3: 5d8c8da0 (big blind) folded before Flop
Seat 4: a20c0bea folded before Flop (didn't bet)
Seat 5: 4a4c34d3 folded before Flop (didn't bet)
Seat 6: Hero folded before Flop (didn't bet)


Poker Hand #RC2078477144: Hold'em No Limit ($0.02/$0.05) - 2023/12/22 21:18:25
Table 'RushAndCash784019' 6-max Seat #1 is the button
Seat 1: Hero ($5.04 in chips)
Seat 2: 2ece180e ($5.7 in chips)
Seat 3: c8f603a8 ($4.3 in chips)
Seat 4: 395dbfbb ($6.99 in chips)
Seat 5: ce3dc143 ($4.04 in chips)
Seat 6: 4ab8a557 ($8.82 in chips)
2ece180e: posts small blind $0.02
c8f603a8: posts big blind $0.05
*** HOLE CARDS ***
Dealt to Hero [6d Kc]
Dealt to 2ece180e 
Dealt to c8f603a8 
Dealt to 395dbfbb 
Dealt to ce3dc143 
Dealt to 4ab8a557 
395dbfbb: folds
ce3dc143: folds
4ab8a557: raises $0.06 to $0.11
Hero: folds
2ece180e: folds
c8f603a8: folds
Uncalled bet ($0.06) returned to 4ab8a557
*** SHOWDOWN ***
4ab8a557 collected $0.12 from pot
*** SUMMARY ***
Total pot $0.12 | Rake $0 | Jackpot $0 | Bingo $0 | Fortune $0 | Tax $0
Seat 1: Hero (button) folded before Flop (didn't bet)
Seat 2: 2ece180e (small blind) folded before Flop
Seat 3: c8f603a8 (big blind) folded before Flop
Seat 4: 395dbfbb folded before Flop (didn't bet)
Seat 5: ce3dc143 folded before Flop (didn't bet)
Seat 6: 4ab8a557 collected ($0.12)


Poker Hand #RC2078476992: Hold'em No Limit ($0.02/$0.05) - 2023/12/22 21:18:16
Table 'RushAndCash783943' 6-max Seat #1 is the button
Seat 1: a4c64da ($10.2 in chips)
Seat 2: Hero ($5.06 in chips)
Seat 3: 4497bce1 ($3.23 in chips)
Seat 4: d7f451d5 ($8.59 in chips)
Seat 5: 525db62f ($6.66 in chips)
Seat 6: 72f7386e ($12.26 in chips)
Hero: posts small blind $0.02
4497bce1: posts big blind $0.05
*** HOLE CARDS ***
Dealt to a4c64da 
Dealt to Hero [2c 7d]
Dealt to 4497bce1 
Dealt to d7f451d5 
Dealt to 525db62f 
Dealt to 72f7386e 
d7f451d5: folds
525db62f: folds
72f7386e: raises $0.07 to $0.12
a4c64da: raises $0.24 to $0.36
Hero: folds
4497bce1: folds
72f7386e: folds
Uncalled bet ($0.24) returned to a4c64da
*** SHOWDOWN ***
a4c64da collected $0.3 from pot
*** SUMMARY ***
Total pot $0.31 | Rake $0.01 | Jackpot $0 | Bingo $0 | Fortune $0 | Tax $0
Seat 1: a4c64da (button) collected ($0.3)
Seat 2: Hero (small blind) folded before Flop
Seat 3: 4497bce1 (big blind) folded before Flop
Seat 4: d7f451d5 folded before Flop (didn't bet)
Seat 5: 525db62f folded before Flop (didn't bet)
Seat 6: 72f7386e folded before Flop


Poker Hand #RC2078476931: Hold'em No Limit ($0.02/$0.05) - 2023/12/22 21:18:12
Table 'RushAndCash783913' 6-max Seat #1 is the button
Seat 1: 2c88a657 ($6.04 in chips)
Seat 2: 24503504 ($10.04 in chips)
Seat 3: f9c6a467 ($22.98 in chips)
Seat 4: Hero ($5.06 in chips)
Seat 5: e61ec3f2 ($5 in chips)
Seat 6: 4497bce1 ($3.23 in chips)
24503504: posts small blind $0.02
f9c6a467: posts big blind $0.05
*** HOLE CARDS ***
Dealt to 2c88a657 
Dealt to 24503504 
Dealt to f9c6a467 
Dealt to Hero [4s Qs]
Dealt to e61ec3f2 
Dealt to 4497bce1 
Hero: folds
e61ec3f2: folds
4497bce1: folds
2c88a657: folds
24503504: folds
Uncalled bet ($0.03) returned to f9c6a467
*** SHOWDOWN ***
f9c6a467 collected $0.04 from pot
*** SUMMARY ***
Total pot $0.04 | Rake $0 | Jackpot $0 | Bingo $0 | Fortune $0 | Tax $0
Seat 1: 2c88a657 (button) folded before Flop (didn't bet)
Seat 2: 24503504 (small blind) folded before Flop
Seat 3: f9c6a467 (big blind) collected ($0.04)
Seat 4: Hero folded before Flop (didn't bet)
Seat 5: e61ec3f2 folded before Flop (didn't bet)
Seat 6: 4497bce1 folded before Flop (didn't bet)


Poker Hand #RC2078475600: Hold'em No Limit ($0.02/$0.05) - 2023/12/22 21:16:56
Table 'RushAndCash783272' 6-max Seat #1 is the button
Seat 1: f9c6a467 ($22.56 in chips)
Seat 2: 23c96099 ($5.32 in chips)
Seat 3: Hero ($5.35 in chips)
Seat 4: 35939716 ($5.71 in chips)
Seat 5: d32741ba ($10.45 in chips)
Seat 6: a615a9f6 ($13.56 in chips)
23c96099: posts small blind $0.02
Hero: posts big blind $0.05
*** HOLE CARDS ***
Dealt to f9c6a467 
Dealt to 23c96099 
Dealt to Hero [Qh Js]
Dealt to 35939716 
Dealt to d32741ba 
Dealt to a615a9f6 
35939716: folds
d32741ba: folds
a615a9f6: calls $0.05
f9c6a467: raises $0.09 to $0.14
23c96099: folds
Hero: calls $0.09
a615a9f6: calls $0.09
*** FLOP *** [9d 9h 8h]
Hero: checks
a615a9f6: checks
f9c6a467: bets $0.15
Hero: calls $0.15
a615a9f6: folds
*** TURN *** [9d 9h 8h] [Jh]
Hero: checks
f9c6a467: checks
*** RIVER *** [9d 9h 8h Jh] [3c]
Hero: checks
f9c6a467: bets $0.57
Hero: folds
Uncalled bet ($0.57) returned to f9c6a467
*** SHOWDOWN ***
f9c6a467 collected $0.71 from pot
*** SUMMARY ***
Total pot $0.74 | Rake $0.03 | Jackpot $0 | Bingo $0 | Fortune $0 | Tax $0
Board [9d 9h 8h Jh 3c]
Seat 1: f9c6a467 (button) won ($0.71)
Seat 2: 23c96099 (small blind) folded before Flop
Seat 3: Hero (big blind) folded on the River
Seat 4: 35939716 folded before Flop (didn't bet)
Seat 5: d32741ba folded before Flop (didn't bet)
Seat 6: a615a9f6 folded on the Flop


Poker Hand #RC2078475452: Hold'em No Limit ($0.02/$0.05) - 2023/12/22 21:16:47
Table 'RushAndCash783199' 6-max Seat #1 is the button
Seat 1: f266e6e1 ($5.76 in chips)
Seat 2: 688f0ff0 ($5.47 in chips)
Seat 3: 3cf310b ($7.74 in chips)
Seat 4: 59ef18cb ($2.2 in chips)
Seat 5: e69446ee ($6.18 in chips)
Seat 6: Hero ($5.28 in chips)
688f0ff0: posts small blind $0.02
3cf310b: posts big blind $0.05
*** HOLE CARDS ***
Dealt to f266e6e1 
Dealt to 688f0ff0 
Dealt to 3cf310b 
Dealt to 59ef18cb 
Dealt to e69446ee 
Dealt to Hero [3s 3h]
59ef18cb: folds
e69446ee: folds
Hero: raises $0.05 to $0.1
f266e6e1: folds
688f0ff0: folds
3cf310b: folds
Uncalled bet ($0.05) returned to Hero
*** SHOWDOWN ***
Hero collected $0.12 from pot
*** SUMMARY ***
Total pot $0.12 | Rake $0 | Jackpot $0 | Bingo $0 | Fortune $0 | Tax $0
Seat 1: f266e6e1 (button) folded before Flop (didn't bet)
Seat 2: 688f0ff0 (small blind) folded before Flop
Seat 3: 3cf310b (big blind) folded before Flop
Seat 4: 59ef18cb folded before Flop (didn't bet)
Seat 5: e69446ee folded before Flop (didn't bet)
Seat 6: Hero collected ($0.12)


Poker Hand #RC2078475376: Hold'em No Limit ($0.02/$0.05) - 2023/12/22 21:16:43
Table 'RushAndCash783161' 6-max Seat #1 is the button
Seat 1: Hero ($5.28 in chips)
Seat 2: 59c7f4b1 ($6.95 in chips)
Seat 3: 467db7f7 ($3.18 in chips)
Seat 4: 9d4c1c85 ($6.34 in chips)
Seat 5: 8a8eafe4 ($8.16 in chips)
Seat 6: 4c691fe1 ($3.84 in chips)
59c7f4b1: posts small blind $0.02
467db7f7: posts big blind $0.05
*** HOLE CARDS ***
Dealt to Hero [9h 5d]
Dealt to 59c7f4b1 
Dealt to 467db7f7 
Dealt to 9d4c1c85 
Dealt to 8a8eafe4 
Dealt to 4c691fe1 
9d4c1c85: folds
8a8eafe4: folds
4c691fe1: folds
Hero: folds
59c7f4b1: folds
Uncalled bet ($0.03) returned to 467db7f7
*** SHOWDOWN ***
467db7f7 collected $0.04 from pot
*** SUMMARY ***
Total pot $0.04 | Rake $0 | Jackpot $0 | Bingo $0 | Fortune $0 | Tax $0
Seat 1: Hero (button) folded before Flop (didn't bet)
Seat 2: 59c7f4b1 (small blind) folded before Flop
Seat 3: 467db7f7 (big blind) collected ($0.04)
Seat 4: 9d4c1c85 folded before Flop (didn't bet)
Seat 5: 8a8eafe4 folded before Flop (didn't bet)
Seat 6: 4c691fe1 folded before Flop (didn't bet)


Poker Hand #RC2078475301: Hold'em No Limit ($0.02/$0.05) - 2023/12/22 21:16:38
Table 'RushAndCash783121' 6-max Seat #1 is the button
Seat 1: a9abc4b1 ($7.79 in chips)
Seat 2: d2739eda ($2.38 in chips)
Seat 3: aa6d4c49 ($15.92 in chips)
Seat 4: 18f0f05c ($9.45 in chips)
Seat 5: Hero ($5.28 in chips)
Seat 6: eb03c338 ($4.55 in chips)
d2739eda: posts small blind $0.02
aa6d4c49: posts big blind $0.05
*** HOLE CARDS ***
Dealt to a9abc4b1 
Dealt to d2739eda 
Dealt to aa6d4c49 
Dealt to 18f0f05c 
Dealt to Hero [Th 5c]
Dealt to eb03c338 
18f0f05c: folds
Hero: folds
eb03c338: raises $0.08 to $0.13
a9abc4b1: folds
d2739eda: calls $0.11
aa6d4c49: folds
*** FLOP *** [7c 4s 8s]
d2739eda: checks
eb03c338: checks
*** TURN *** [7c 4s 8s] [8h]
d2739eda: bets $0.12
eb03c338: folds
Uncalled bet ($0.12) returned to d2739eda
*** SHOWDOWN ***
d2739eda collected $0.3 from pot
*** SUMMARY ***
Total pot $0.31 | Rake $0.01 | Jackpot $0 | Bingo $0 | Fortune $0 | Tax $0
Board [7c 4s 8s 8h]
Seat 1: a9abc4b1 (button) folded before Flop (didn't bet)
Seat 2: d2739eda (small blind) won ($0.3)
Seat 3: aa6d4c49 (big blind) folded before Flop
Seat 4: 18f0f05c folded before Flop (didn't bet)
Seat 5: Hero folded before Flop (didn't bet)
Seat 6: eb03c338 folded on the Turn


Poker Hand #RC2078474945: Hold'em No Limit ($0.02/$0.05) - 2023/12/22 21:16:18
Table 'RushAndCash782944' 6-max Seat #1 is the button
Seat 1: c7be9492 ($5.27 in chips)
Seat 2: Hero ($5.43 in chips)
Seat 3: d2739eda ($2.24 in chips)
Seat 4: 365a060c ($4.7 in chips)
Seat 5: 8818ba78 ($7.64 in chips)
Seat 6: de3b84bb ($25.24 in chips)
Hero: posts small blind $0.02
d2739eda: posts big blind $0.05
*** HOLE CARDS ***
Dealt to c7be9492 
Dealt to Hero [Ah 5d]
Dealt to d2739eda 
Dealt to 365a060c 
Dealt to 8818ba78 
Dealt to de3b84bb 
365a060c: folds
8818ba78: folds
de3b84bb: folds
c7be9492: folds
Hero: raises $0.1 to $0.15
d2739eda: raises $0.15 to $0.3
Hero: folds
Uncalled bet ($0.15) returned to d2739eda
*** SHOWDOWN ***
d2739eda collected $0.29 from pot
*** SUMMARY ***
Total pot $0.3 | Rake $0.01 | Jackpot $0 | Bingo $0 | Fortune $0 | Tax $0
Seat 1: c7be9492 (button) folded before Flop (didn't bet)
Seat 2: Hero (small blind) folded before Flop
Seat 3: d2739eda (big blind) collected ($0.29)
Seat 4: 365a060c folded before Flop (didn't bet)
Seat 5: 8818ba78 folded before Flop (didn't bet)
Seat 6: de3b84bb folded before Flop (didn't bet)


Poker Hand #RC2078474884: Hold'em No Limit ($0.02/$0.05) - 2023/12/22 21:16:14
Table 'RushAndCash782914' 6-max Seat #1 is the button
Seat 1: c71b7029 ($9.03 in chips)
Seat 2: b9aa0c94 ($11.74 in chips)
Seat 3: ce3dc143 ($4.8 in chips)
Seat 4: 4c691fe1 ($3.68 in chips)
Seat 5: Hero ($5.43 in chips)
Seat 6: 8818ba78 ($7.64 in chips)
b9aa0c94: posts small blind $0.02
ce3dc143: posts big blind $0.05
*** HOLE CARDS ***
Dealt to c71b7029 
Dealt to b9aa0c94 
Dealt to ce3dc143 
Dealt to 4c691fe1 
Dealt to Hero [Qd 7h]
Dealt to 8818ba78 
4c691fe1: folds
Hero: folds
8818ba78: folds
c71b7029: folds
b9aa0c94: raises $0.1 to $0.15
ce3dc143: folds
Uncalled bet ($0.1) returned to b9aa0c94
*** SHOWDOWN ***
b9aa0c94 collected $0.1 from pot
*** SUMMARY ***
Total pot $0.1 | Rake $0 | Jackpot $0 | Bingo $0 | Fortune $0 | Tax $0
Seat 1: c71b7029 (button) folded before Flop (didn't bet)
Seat 2: b9aa0c94 (small blind) collected ($0.1)
Seat 3: ce3dc143 (big blind) folded before Flop
Seat 4: 4c691fe1 folded before Flop (didn't bet)
Seat 5: Hero folded before Flop (didn't bet)
Seat 6: 8818ba78 folded before Flop (didn't bet)


Poker Hand #RC2078474825: Hold'em No Limit ($0.02/$0.05) - 2023/12/22 21:16:10
Table 'RushAndCash782886' 6-max Seat #1 is the button
Seat 1: Hero ($5.43 in chips)
Seat 2: 6e872e9c ($19.53 in chips)
Seat 3: 311eeba4 ($7.25 in chips)
Seat 4: b9aa0c94 ($11.74 in chips)
Seat 5: 84572dc4 ($7.13 in chips)
Seat 6: 750a6baa ($5 in chips)
6e872e9c: posts small blind $0.02
311eeba4: posts big blind $0.05
*** HOLE CARDS ***
Dealt to Hero [5c Ah]
Dealt to 6e872e9c 
Dealt to 311eeba4 
Dealt to b9aa0c94 
Dealt to 84572dc4 
Dealt to 750a6baa 
b9aa0c94: folds
84572dc4: folds
750a6baa: folds
Hero: folds
6e872e9c: folds
Uncalled bet ($0.03) returned to 311eeba4
*** SHOWDOWN ***
311eeba4 collected $0.04 from pot
*** SUMMARY ***
Total pot $0.04 | Rake $0 | Jackpot $0 | Bingo $0 | Fortune $0 | Tax $0
Seat 1: Hero (button) folded before Flop (didn't bet)
Seat 2: 6e872e9c (small blind) folded before Flop
Seat 3: 311eeba4 (big blind) collected ($0.04)
Seat 4: b9aa0c94 folded before Flop (didn't bet)
Seat 5: 84572dc4 folded before Flop (didn't bet)
Seat 6: 750a6baa folded before Flop (didn't bet)


Poker Hand #RC2078474753: Hold'em No Limit ($0.02/$0.05) - 2023/12/22 21:16:06
Table 'RushAndCash782850' 6-max Seat #1 is the button
Seat 1: f275cf48 ($5.06 in chips)
Seat 2: b729a06d ($1.89 in chips)
Seat 3: 919daa51 ($4.22 in chips)
Seat 4: 72e47b5b ($2.99 in chips)
Seat 5: Hero ($5.43 in chips)
Seat 6: a20c0bea ($6.47 in chips)
b729a06d: posts small blind $0.02
919daa51: posts big blind $0.05
*** HOLE CARDS ***
Dealt to f275cf48 
Dealt to b729a06d 
Dealt to 919daa51 
Dealt to 72e47b5b 
Dealt to Hero [3s 5h]
Dealt to a20c0bea 
72e47b5b: raises $0.1 to $0.15
Hero: folds
a20c0bea: folds
f275cf48: calls $0.15
b729a06d: calls $0.13
919daa51: folds
*** FLOP *** [7c Kc 3c]
b729a06d: bets $0.5
72e47b5b: folds
f275cf48: calls $0.5
*** TURN *** [7c Kc 3c] [Ts]
b729a06d: bets $1.24 and is all-in
f275cf48: calls $1.24
b729a06d: shows [Qc 8s] (King-High)
f275cf48: shows [Kd Jh] (Pair of Kings)
*** FIRST RIVER *** [7c Kc 3c Ts] [9s]
*** SECOND RIVER *** [7c Kc 3c Ts] [As]
*** FIRST SHOWDOWN ***
f275cf48 collected $1.89 from pot
*** SECOND SHOWDOWN ***
f275cf48 collected $1.88 from pot
*** SUMMARY ***
Total pot $3.98 | Rake $0.14 | Jackpot $0.07 | Bingo $0 | Fortune $0 | Tax $0
Hand was run two times
FIRST Board [7c Kc 3c Ts 9s]
SECOND Board [As]
Seat 1: f275cf48 (button) showed [Kd Jh] and won ($1.89) with Pair of Kings, and won ($1.88)
Seat 2: b729a06d (small blind) showed [Qc 8s] and lost with King-High, and lost
Seat 3: 919daa51 (big blind) folded before Flop
Seat 4: 72e47b5b folded on the Flop
Seat 5: Hero folded before Flop (didn't bet)
Seat 6: a20c0bea folded before Flop (didn't bet)


Poker Hand #RC2078454398: Hold'em No Limit ($0.02/$0.05) - 2023/12/22 21:15:45
Table 'RushAndCash782678' 6-max Seat #1 is the button
Seat 1: Hero ($5.56 in chips)
Seat 2: 75daa184 ($9.19 in chips)
Seat 3: 11676b65 ($4.3 in chips)
Seat 4: 11612373 ($11.43 in chips)
Seat 5: 11a726d0 ($8.22 in chips)
Seat 6: 20a35d2e ($12.7 in chips)
75daa184: posts small blind $0.02
11676b65: posts big blind $0.05
*** HOLE CARDS ***
Dealt to Hero [3d 3h]
Dealt to 75daa184 
Dealt to 11676b65 
Dealt to 11612373 
Dealt to 11a726d0 
Dealt to 20a35d2e 
11612373: folds
11a726d0: raises $0.08 to $0.13
20a35d2e: calls $0.13
Hero: calls $0.13
75daa184: raises $0.47 to $0.6
11676b65: folds
11a726d0: calls $0.47
20a35d2e: folds
Hero: folds
*** FLOP *** [5d Ah As]
75daa184: checks
11a726d0: checks
*** TURN *** [5d Ah As] [Kh]
75daa184: bets $0.5
11a726d0: folds
Uncalled bet ($0.5) returned to 75daa184
*** SHOWDOWN ***
75daa184 collected $1.37 from pot
*** SUMMARY ***
Total pot $1.51 | Rake $0.07 | Jackpot $0.07 | Bingo $0 | Fortune $0 | Tax $0
Board [5d Ah As Kh]
Seat 1: Hero (button) folded before Flop
Seat 2: 75daa184 (small blind) won ($1.37)
Seat 3: 11676b65 (big blind) folded before Flop
Seat 4: 11612373 folded before Flop (didn't bet)
Seat 5: 11a726d0 folded on the Turn
Seat 6: 20a35d2e folded before Flop


Poker Hand #RC2078453894: Hold'em No Limit ($0.02/$0.05) - 2023/12/22 21:15:16
Table 'RushAndCash782438' 6-max Seat #1 is the button
Seat 1: 4c699d7 ($2.05 in chips)
Seat 2: 11612373 ($11.63 in chips)
Seat 3: Hero ($5.38 in chips)
Seat 4: 25f07be0 ($5.31 in chips)
Seat 5: 8572ffde ($1.15 in chips)
Seat 6: e4d2f8b7 ($5 in chips)
11612373: posts small blind $0.02
Hero: posts big blind $0.05
*** HOLE CARDS ***
Dealt to 4c699d7 
Dealt to 11612373 
Dealt to Hero [As 7h]
Dealt to 25f07be0 
Dealt to 8572ffde 
Dealt to e4d2f8b7 
25f07be0: folds
8572ffde: folds
e4d2f8b7: folds
4c699d7: folds
11612373: raises $0.05 to $0.1
Hero: calls $0.05
*** FLOP *** [6h Ah 8d]
11612373: checks
Hero: checks
*** TURN *** [6h Ah 8d] [Td]
11612373: bets $0.1
Hero: calls $0.1
*** RIVER *** [6h Ah 8d Td] [Ts]
11612373: checks
Hero: checks
11612373: shows [Jd Qd] (Pair of Tens)
Hero: shows [As 7h] (Pair of Aces and Pair of Tens)
*** SHOWDOWN ***
Hero collected $0.38 from pot
*** SUMMARY ***
Total pot $0.4 | Rake $0.02 | Jackpot $0 | Bingo $0 | Fortune $0 | Tax $0
Board [6h Ah 8d Td Ts]
Seat 1: 4c699d7 (button) folded before Flop (didn't bet)
Seat 2: 11612373 (small blind) showed [Jd Qd] and lost with Pair of Tens
Seat 3: Hero (big blind) showed [As 7h] and won ($0.38) with Pair of Aces and Pair of Tens
Seat 4: 25f07be0 folded before Flop (didn't bet)
Seat 5: 8572ffde folded before Flop (didn't bet)
Seat 6: e4d2f8b7 folded before Flop (didn't bet)


Poker Hand #RC2078453768: Hold'em No Limit ($0.02/$0.05) - 2023/12/22 21:15:08
Table 'RushAndCash782378' 6-max Seat #1 is the button
Seat 1: 72e47b5b ($2.64 in chips)
Seat 2: 494d7c43 ($5.89 in chips)
Seat 3: 7d406e41 ($10.31 in chips)
Seat 4: e674731e ($5.05 in chips)
Seat 5: Hero ($5.38 in chips)
Seat 6: b18917a1 ($5.09 in chips)
494d7c43: posts small blind $0.02
7d406e41: posts big blind $0.05
*** HOLE CARDS ***
Dealt to 72e47b5b 
Dealt to 494d7c43 
Dealt to 7d406e41 
Dealt to e674731e 
Dealt to Hero [9s 6c]
Dealt to b18917a1 
e674731e: raises $0.06 to $0.11
Hero: folds
b18917a1: folds
72e47b5b: calls $0.11
494d7c43: folds
7d406e41: folds
*** FLOP *** [9d 9c Kh]
e674731e: bets $0.15
72e47b5b: folds
Uncalled bet ($0.15) returned to e674731e
*** SHOWDOWN ***
e674731e collected $0.28 from pot
*** SUMMARY ***
Total pot $0.29 | Rake $0.01 | Jackpot $0 | Bingo $0 | Fortune $0 | Tax $0
Board [9d 9c Kh]
Seat 1: 72e47b5b (button) folded on the Flop
Seat 2: 494d7c43 (small blind) folded before Flop
Seat 3: 7d406e41 (big blind) folded before Flop
Seat 4: e674731e won ($0.28)
Seat 5: Hero folded before Flop (didn't bet)
Seat 6: b18917a1 folded before Flop (didn't bet)


Poker Hand #RC2078453504: Hold'em No Limit ($0.02/$0.05) - 2023/12/22 21:14:54
Table 'RushAndCash782259' 6-max Seat #1 is the button
Seat 1: 38e42730 ($5.14 in chips)
Seat 2: Hero ($5.4 in chips)
Seat 3: 9d4c1c85 ($5.85 in chips)
Seat 4: f9c6a467 ($21.93 in chips)
Seat 5: 7f067c94 ($42.21 in chips)
Seat 6: 7e84e7dc ($16.16 in chips)
Hero: posts small blind $0.02
9d4c1c85: posts big blind $0.05
*** HOLE CARDS ***
Dealt to 38e42730 
Dealt to Hero [3s 7s]
Dealt to 9d4c1c85 
Dealt to f9c6a467 
Dealt to 7f067c94 
Dealt to 7e84e7dc 
f9c6a467: folds
7f067c94: folds
7e84e7dc: folds
38e42730: folds
Hero: folds
Uncalled bet ($0.03) returned to 9d4c1c85
*** SHOWDOWN ***
9d4c1c85 collected $0.04 from pot
*** SUMMARY ***
Total pot $0.04 | Rake $0 | Jackpot $0 | Bingo $0 | Fortune $0 | Tax $0
Seat 1: 38e42730 (button) folded before Flop (didn't bet)
Seat 2: Hero (small blind) folded before Flop
Seat 3: 9d4c1c85 (big blind) collected ($0.04)
Seat 4: f9c6a467 folded before Flop (didn't bet)
Seat 5: 7f067c94 folded before Flop (didn't bet)
Seat 6: 7e84e7dc folded before Flop (didn't bet)


Poker Hand #RC2078453348: Hold'em No Limit ($0.02/$0.05) - 2023/12/22 21:14:45
Table 'RushAndCash782188' 6-max Seat #1 is the button
Seat 1: 6b8a648f ($6.04 in chips)
Seat 2: 9b2d2337 ($19.95 in chips)
Seat 3: Hero ($5.38 in chips)
Seat 4: b4aaf9de ($8.58 in chips)
Seat 5: 605ca6ae ($10.18 in chips)
Seat 6: 38bb8e26 ($5.8 in chips)
9b2d2337: posts small blind $0.02
Hero: posts big blind $0.05
*** HOLE CARDS ***
Dealt to 6b8a648f 
Dealt to 9b2d2337 
Dealt to Hero [8h Kc]
Dealt to b4aaf9de 
Dealt to 605ca6ae 
Dealt to 38bb8e26 
b4aaf9de: folds
605ca6ae: folds
38bb8e26: folds
6b8a648f: folds
9b2d2337: folds
Uncalled bet ($0.03) returned to Hero
*** SHOWDOWN ***
Hero collected $0.04 from pot
*** SUMMARY ***
Total pot $0.04 | Rake $0 | Jackpot $0 | Bingo $0 | Fortune $0 | Tax $0
Seat 1: 6b8a648f (button) folded before Flop (didn't bet)
Seat 2: 9b2d2337 (small blind) folded before Flop
Seat 3: Hero (big blind) collected ($0.04)
Seat 4: b4aaf9de folded before Flop (didn't bet)
Seat 5: 605ca6ae folded before Flop (didn't bet)
Seat 6: 38bb8e26 folded before Flop (didn't bet)


Poker Hand #RC2078453285: Hold'em No Limit ($0.02/$0.05) - 2023/12/22 21:14:41
Table 'RushAndCash782156' 6-max Seat #1 is the button
Seat 1: 9b2d2337 ($19.95 in chips)
Seat 2: 5692960b ($3.02 in chips)
Seat 3: 886872c9 ($5.51 in chips)
Seat 4: Hero ($5.38 in chips)
Seat 5: a2ebb3c7 ($5.51 in chips)
Seat 6: 3e2e2010 ($7.25 in chips)
5692960b: posts small blind $0.02
886872c9: posts big blind $0.05
*** HOLE CARDS ***
Dealt to 9b2d2337 
Dealt to 5692960b 
Dealt to 886872c9 
Dealt to Hero [7d 4h]
Dealt to a2ebb3c7 
Dealt to 3e2e2010 
Hero: folds
a2ebb3c7: folds
3e2e2010: raises $0.07 to $0.12
9b2d2337: folds
5692960b: folds
886872c9: folds
Uncalled bet ($0.07) returned to 3e2e2010
*** SHOWDOWN ***
3e2e2010 collected $0.12 from pot
*** SUMMARY ***
Total pot $0.12 | Rake $0 | Jackpot $0 | Bingo $0 | Fortune $0 | Tax $0
Seat 1: 9b2d2337 (button) folded before Flop (didn't bet)
Seat 2: 5692960b (small blind) folded before Flop
Seat 3: 886872c9 (big blind) folded before Flop
Seat 4: Hero folded before Flop (didn't bet)
Seat 5: a2ebb3c7 folded before Flop (didn't bet)
Seat 6: 3e2e2010 collected ($0.12)


Poker Hand #RC2078453227: Hold'em No Limit ($0.02/$0.05) - 2023/12/22 21:14:37
Table 'RushAndCash782129' 6-max Seat #1 is the button
Seat 1: 59846dec ($2.9 in chips)
Seat 2: d6c4e270 ($2.78 in chips)
Seat 3: 49ea92ea ($9.61 in chips)
Seat 4: 42b55ba4 ($5.9 in chips)
Seat 5: e6f6623d ($4.07 in chips)
Seat 6: Hero ($5.38 in chips)
d6c4e270: posts small blind $0.02
49ea92ea: posts big blind $0.05
*** HOLE CARDS ***
Dealt to 59846dec 
Dealt to d6c4e270 
Dealt to 49ea92ea 
Dealt to 42b55ba4 
Dealt to e6f6623d 
Dealt to Hero [Th 2d]
42b55ba4: raises $0.05 to $0.1
e6f6623d: folds
Hero: folds
59846dec: folds
d6c4e270: calls $0.08
49ea92ea: folds
*** FLOP *** [9s 7s Ts]
d6c4e270: bets $0.09
42b55ba4: calls $0.09
*** TURN *** [9s 7s Ts] [Qh]
d6c4e270: bets $0.15
42b55ba4: calls $0.15
*** RIVER *** [9s 7s Ts Qh] [3d]
d6c4e270: bets $0.25
42b55ba4: calls $0.25
d6c4e270: shows [Jh Jc] (Pair of Jacks)
42b55ba4: shows [Qs Kh] (Pair of Queens)
*** SHOWDOWN ***
42b55ba4 collected $1.17 from pot
*** SUMMARY ***
Total pot $1.23 | Rake $0.06 | Jackpot $0 | Bingo $0 | Fortune $0 | Tax $0
Board [9s 7s Ts Qh 3d]
Seat 1: 59846dec (button) folded before Flop (didn't bet)
Seat 2: d6c4e270 (small blind) showed [Jh Jc] and lost with Pair of Jacks
Seat 3: 49ea92ea (big blind) folded before Flop
Seat 4: 42b55ba4 showed [Qs Kh] and won ($1.17) with Pair of Queens
Seat 5: e6f6623d folded before Flop (didn't bet)
Seat 6: Hero folded before Flop (didn't bet)


Poker Hand #RC2078453165: Hold'em No Limit ($0.02/$0.05) - 2023/12/22 21:14:33
Table 'RushAndCash782099' 6-max Seat #1 is the button
Seat 1: 6029883b ($5.21 in chips)
Seat 2: 59ef18cb ($2.37 in chips)
Seat 3: 5b2bf61b ($5 in chips)
Seat 4: Hero ($5.38 in chips)
Seat 5: 89dad04f ($9.2 in chips)
Seat 6: 9d4c1c85 ($5.85 in chips)
59ef18cb: posts small blind $0.02
5b2bf61b: posts big blind $0.05
*** HOLE CARDS ***
Dealt to 6029883b 
Dealt to 59ef18cb 
Dealt to 5b2bf61b 
Dealt to Hero [6s 9c]
Dealt to 89dad04f 
Dealt to 9d4c1c85 
Hero: folds
89dad04f: folds
9d4c1c85: folds
6029883b: folds
59ef18cb: raises $0.1 to $0.15
5b2bf61b: folds
Uncalled bet ($0.1) returned to 59ef18cb
*** SHOWDOWN ***
59ef18cb collected $0.1 from pot
*** SUMMARY ***
Total pot $0.1 | Rake $0 | Jackpot $0 | Bingo $0 | Fortune $0 | Tax $0
Seat 1: 6029883b (button) folded before Flop (didn't bet)
Seat 2: 59ef18cb (small blind) collected ($0.1)
Seat 3: 5b2bf61b (big blind) folded before Flop
Seat 4: Hero folded before Flop (didn't bet)
Seat 5: 89dad04f folded before Flop (didn't bet)
Seat 6: 9d4c1c85 folded before Flop (didn't bet)


Poker Hand #RC2078453090: Hold'em No Limit ($0.02/$0.05) - 2023/12/22 21:14:29
Table 'RushAndCash782062' 6-max Seat #1 is the button
Seat 1: d42ee966 ($5 in chips)
Seat 2: 3dbf95c1 ($8.65 in chips)
Seat 3: 42b297d3 ($3.17 in chips)
Seat 4: 52f74b76 ($5.56 in chips)
Seat 5: Hero ($5.38 in chips)
Seat 6: 45bb3f0f ($5.07 in chips)
3dbf95c1: posts small blind $0.02
42b297d3: posts big blind $0.05
*** HOLE CARDS ***
Dealt to d42ee966 
Dealt to 3dbf95c1 
Dealt to 42b297d3 
Dealt to 52f74b76 
Dealt to Hero [3c 5h]
Dealt to 45bb3f0f 
52f74b76: folds
Hero: folds
45bb3f0f: folds
d42ee966: raises $0.08 to $0.13
3dbf95c1: folds
42b297d3: calls $0.08
*** FLOP *** [Qh 7h 9h]
42b297d3: checks
d42ee966: checks
*** TURN *** [Qh 7h 9h] [2c]
42b297d3: checks
d42ee966: checks
*** RIVER *** [Qh 7h 9h 2c] [5c]
42b297d3: bets $0.21
d42ee966: calls $0.21
42b297d3: shows [8s 6h] (Nines-High Straight)
d42ee966: shows [Kd 7d] (Pair of Sevens)
*** SHOWDOWN ***
42b297d3 collected $0.67 from pot
*** SUMMARY ***
Total pot $0.7 | Rake $0.03 | Jackpot $0 | Bingo $0 | Fortune $0 | Tax $0
Board [Qh 7h 9h 2c 5c]
Seat 1: d42ee966 (button) showed [Kd 7d] and lost with Pair of Sevens
Seat 2: 3dbf95c1 (small blind) folded before Flop
Seat 3: 42b297d3 (big blind) showed [8s 6h] and won ($0.67) with Nines-High Straight
Seat 4: 52f74b76 folded before Flop (didn't bet)
Seat 5: Hero folded before Flop (didn't bet)
Seat 6: 45bb3f0f folded before Flop (didn't bet)


Poker Hand #RC2078452992: Hold'em No Limit ($0.02/$0.05) - 2023/12/22 21:14:23
Table 'RushAndCash782017' 6-max Seat #1 is the button
Seat 1: aa356882 ($3.94 in chips)
Seat 2: 92b246ad ($9.46 in chips)
Seat 3: 1d1c20e8 ($5.83 in chips)
Seat 4: 9ab125dd ($11.88 in chips)
Seat 5: 8aaa95a5 ($3.94 in chips)
Seat 6: Hero ($5.38 in chips)
92b246ad: posts small blind $0.02
1d1c20e8: posts big blind $0.05
*** HOLE CARDS ***
Dealt to aa356882 
Dealt to 92b246ad 
Dealt to 1d1c20e8 
Dealt to 9ab125dd 
Dealt to 8aaa95a5 
Dealt to Hero [Jd 6c]
9ab125dd: folds
8aaa95a5: folds
Hero: folds
aa356882: folds
92b246ad: folds
Uncalled bet ($0.03) returned to 1d1c20e8
*** SHOWDOWN ***
1d1c20e8 collected $0.04 from pot
*** SUMMARY ***
Total pot $0.04 | Rake $0 | Jackpot $0 | Bingo $0 | Fortune $0 | Tax $0
Seat 1: aa356882 (button) folded before Flop (didn't bet)
Seat 2: 92b246ad (small blind) folded before Flop
Seat 3: 1d1c20e8 (big blind) collected ($0.04)
Seat 4: 9ab125dd folded before Flop (didn't bet)
Seat 5: 8aaa95a5 folded before Flop (didn't bet)
Seat 6: Hero folded before Flop (didn't bet)


Poker Hand #RC2078452507: Hold'em No Limit ($0.02/$0.05) - 2023/12/22 21:13:56
Table 'RushAndCash781781' 6-max Seat #1 is the button
Seat 1: Hero ($5 in chips)
Seat 2: 4d8d4585 ($5 in chips)
Seat 3: a92141ad ($3.89 in chips)
Seat 4: 91937678 ($5.07 in chips)
Seat 5: 3b87467 ($7.54 in chips)
Seat 6: fb772588 ($5.07 in chips)
4d8d4585: posts small blind $0.02
a92141ad: posts big blind $0.05
*** HOLE CARDS ***
Dealt to Hero [7s 9s]
Dealt to 4d8d4585 
Dealt to a92141ad 
Dealt to 91937678 
Dealt to 3b87467 
Dealt to fb772588 
91937678: folds
3b87467: folds
fb772588: folds
Hero: raises $0.08 to $0.13
4d8d4585: raises $0.24 to $0.37
a92141ad: folds
Hero: raises $0.65 to $1.02
4d8d4585: folds
Uncalled bet ($0.65) returned to Hero
*** SHOWDOWN ***
Hero collected $0.75 from pot
*** SUMMARY ***
Total pot $0.79 | Rake $0.04 | Jackpot $0 | Bingo $0 | Fortune $0 | Tax $0
Seat 1: Hero (button) collected ($0.75)
Seat 2: 4d8d4585 (small blind) folded before Flop
Seat 3: a92141ad (big blind) folded before Flop
Seat 4: 91937678 folded before Flop (didn't bet)
Seat 5: 3b87467 folded before Flop (didn't bet)
Seat 6: fb772588 folded before Flop (didn't bet)


Poker Hand #RC2078452293: Hold'em No Limit ($0.02/$0.05) - 2023/12/22 21:13:44
Table 'RushAndCash781677' 6-max Seat #1 is the button
Seat 1: 6524c228 ($5.33 in chips)
Seat 2: 6bf9020c ($5 in chips)
Seat 3: Hero ($5 in chips)
Seat 4: 5712a0aa ($2.29 in chips)
Seat 5: 5fea4bbc ($13.23 in chips)
Seat 6: 81ecaac5 ($5.83 in chips)
6bf9020c: posts small blind $0.02
Hero: posts big blind $0.05
*** HOLE CARDS ***
Dealt to 6524c228 
Dealt to 6bf9020c 
Dealt to Hero [Js 2d]
Dealt to 5712a0aa 
Dealt to 5fea4bbc 
Dealt to 81ecaac5 
5712a0aa: folds
5fea4bbc: folds
81ecaac5: folds
6524c228: folds
6bf9020c: raises $0.1 to $0.15
Hero: folds
Uncalled bet ($0.1) returned to 6bf9020c
*** SHOWDOWN ***
6bf9020c collected $0.1 from pot
*** SUMMARY ***
Total pot $0.1 | Rake $0 | Jackpot $0 | Bingo $0 | Fortune $0 | Tax $0
Seat 1: 6524c228 (button) folded before Flop (didn't bet)
Seat 2: 6bf9020c (small blind) collected ($0.1)
Seat 3: Hero (big blind) folded before Flop
Seat 4: 5712a0aa folded before Flop (didn't bet)
Seat 5: 5fea4bbc folded before Flop (didn't bet)
Seat 6: 81ecaac5 folded before Flop (didn't bet)


Poker Hand #RC2078452231: Hold'em No Limit ($0.02/$0.05) - 2023/12/22 21:13:41
Table 'RushAndCash781647' 6-max Seat #1 is the button
Seat 1: f938f1e ($5 in chips)
Seat 2: d2739eda ($1.69 in chips)
Seat 3: 463feb61 ($4.41 in chips)
Seat 4: 67d4b163 ($13.27 in chips)
Seat 5: Hero ($5 in chips)
Seat 6: 7c19951 ($5.52 in chips)
d2739eda: posts small blind $0.02
463feb61: posts big blind $0.05
*** HOLE CARDS ***
Dealt to f938f1e 
Dealt to d2739eda 
Dealt to 463feb61 
Dealt to 67d4b163 
Dealt to Hero [8d 6s]
Dealt to 7c19951 
67d4b163: folds
Hero: folds
7c19951: raises $0.05 to $0.1
f938f1e: folds
d2739eda: folds
463feb61: calls $0.05
*** FLOP *** [8h 6c Jd]
463feb61: checks
7c19951: checks
*** TURN *** [8h 6c Jd] [Ah]
463feb61: checks
7c19951: bets $0.28
463feb61: folds
Uncalled bet ($0.28) returned to 7c19951
*** SHOWDOWN ***
7c19951 collected $0.21 from pot
*** SUMMARY ***
Total pot $0.22 | Rake $0.01 | Jackpot $0 | Bingo $0 | Fortune $0 | Tax $0
Board [8h 6c Jd Ah]
Seat 1: f938f1e (button) folded before Flop (didn't bet)
Seat 2: d2739eda (small blind) folded before Flop
Seat 3: 463feb61 (big blind) folded on the Turn
Seat 4: 67d4b163 folded before Flop (didn't bet)
Seat 5: Hero folded before Flop (didn't bet)
Seat 6: 7c19951 won ($0.21)


Poker Hand #RC2078451057: Hold'em No Limit ($0.02/$0.05) - 2023/12/22 21:12:31
Table 'RushAndCash781082' 6-max Seat #1 is the button
Seat 1: 8eb71456 ($8.78 in chips)
Seat 2: Hero ($5 in chips)
Seat 3: f9c6a467 ($20.61 in chips)
Seat 4: fbeaaad2 ($16.46 in chips)
Seat 5: f3b8bc9d ($10.62 in chips)
Seat 6: 5692960b ($3.65 in chips)
Hero: posts small blind $0.02
f9c6a467: posts big blind $0.05
*** HOLE CARDS ***
Dealt to 8eb71456 
Dealt to Hero [Qh Kd]
Dealt to f9c6a467 
Dealt to fbeaaad2 
Dealt to f3b8bc9d 
Dealt to 5692960b 
fbeaaad2: folds
f3b8bc9d: folds
5692960b: raises $0.1 to $0.15
8eb71456: folds
Hero: calls $0.13
f9c6a467: calls $0.1
*** FLOP *** [4d Qc 8c]
Hero: bets $0.2
f9c6a467: calls $0.2
5692960b: folds
*** TURN *** [4d Qc 8c] [3d]
Hero: bets $0.43
f9c6a467: calls $0.43
*** RIVER *** [4d Qc 8c 3d] [5d]
Hero: bets $0.57
f9c6a467: raises $19.26 to $19.83 and is all-in
Hero: folds
Uncalled bet ($19.26) returned to f9c6a467
*** SHOWDOWN ***
f9c6a467 collected $2.65 from pot
*** SUMMARY ***
Total pot $2.85 | Rake $0.13 | Jackpot $0.07 | Bingo $0 | Fortune $0 | Tax $0
Board [4d Qc 8c 3d 5d]
Seat 1: 8eb71456 (button) folded before Flop (didn't bet)
Seat 2: Hero (small blind) folded on the River
Seat 3: f9c6a467 (big blind) won ($2.65)
Seat 4: fbeaaad2 folded before Flop (didn't bet)
Seat 5: f3b8bc9d folded before Flop (didn't bet)
Seat 6: 5692960b folded on the Flop


Poker Hand #RC2078450916: Hold'em No Limit ($0.02/$0.05) - 2023/12/22 21:12:22
Table 'RushAndCash781021' 6-max Seat #1 is the button
Seat 1: Hero ($5 in chips)
Seat 2: 8b0c9357 ($5.48 in chips)
Seat 3: 919daa51 ($4.56 in chips)
Seat 4: a7076373 ($12.59 in chips)
Seat 5: 9b0ec3a ($12.49 in chips)
Seat 6: 561e5b01 ($5 in chips)
8b0c9357: posts small blind $0.02
919daa51: posts big blind $0.05
*** HOLE CARDS ***
Dealt to Hero [2h 6h]
Dealt to 8b0c9357 
Dealt to 919daa51 
Dealt to a7076373 
Dealt to 9b0ec3a 
Dealt to 561e5b01 
a7076373: folds
9b0ec3a: folds
561e5b01: folds
Hero: folds
8b0c9357: folds
Uncalled bet ($0.03) returned to 919daa51
*** SHOWDOWN ***
919daa51 collected $0.04 from pot
*** SUMMARY ***
Total pot $0.04 | Rake $0 | Jackpot $0 | Bingo $0 | Fortune $0 | Tax $0
Seat 1: Hero (button) folded before Flop (didn't bet)
Seat 2: 8b0c9357 (small blind) folded before Flop
Seat 3: 919daa51 (big blind) collected ($0.04)
Seat 4: a7076373 folded before Flop (didn't bet)
Seat 5: 9b0ec3a folded before Flop (didn't bet)
Seat 6: 561e5b01 folded before Flop (didn't bet)


Poker Hand #RC2078450816: Hold'em No Limit ($0.02/$0.05) - 2023/12/22 21:12:17
Table 'RushAndCash780976' 6-max Seat #1 is the button
Seat 1: 50cbc258 ($9.83 in chips)
Seat 2: Hero ($5 in chips)
Seat 3: a92141ad ($4.13 in chips)
Seat 4: 3580bebf ($14.8 in chips)
Seat 5: db5367a6 ($9.8 in chips)
Seat 6: 29e18081 ($5.45 in chips)
Hero: posts small blind $0.02
a92141ad: posts big blind $0.05
*** HOLE CARDS ***
Dealt to 50cbc258 
Dealt to Hero [Tc 4s]
Dealt to a92141ad 
Dealt to 3580bebf 
Dealt to db5367a6 
Dealt to 29e18081 
3580bebf: folds
db5367a6: raises $0.1 to $0.15
29e18081: folds
50cbc258: folds
Hero: folds
a92141ad: folds
Uncalled bet ($0.1) returned to db5367a6
*** SHOWDOWN ***
db5367a6 collected $0.12 from pot
*** SUMMARY ***
Total pot $0.12 | Rake $0 | Jackpot $0 | Bingo $0 | Fortune $0 | Tax $0
Seat 1: 50cbc258 (button) folded before Flop (didn't bet)
Seat 2: Hero (small blind) folded before Flop
Seat 3: a92141ad (big blind) folded before Flop
Seat 4: 3580bebf folded before Flop (didn't bet)
Seat 5: db5367a6 collected ($0.12)
Seat 6: 29e18081 folded before Flop (didn't bet)


Poker Hand #RC2078450166: Hold'em No Limit ($0.02/$0.05) - 2023/12/22 21:11:40
Table 'RushAndCash780667' 6-max Seat #1 is the button
Seat 1: 29e18081 ($5.06 in chips)
Seat 2: 8ced9a44 ($5.71 in chips)
Seat 3: Hero ($5.07 in chips)
Seat 4: 59ad445d ($7.29 in chips)
Seat 5: fc6fcf04 ($5.72 in chips)
Seat 6: 3928912e ($5.12 in chips)
8ced9a44: posts small blind $0.02
Hero: posts big blind $0.05
*** HOLE CARDS ***
Dealt to 29e18081 
Dealt to 8ced9a44 
Dealt to Hero [Qs 9d]
Dealt to 59ad445d 
Dealt to fc6fcf04 
Dealt to 3928912e 
59ad445d: folds
fc6fcf04: folds
3928912e: folds
29e18081: raises $0.08 to $0.13
8ced9a44: folds
Hero: calls $0.08
*** FLOP *** [Jd Ks 9c]
Hero: checks
29e18081: bets $0.09
Hero: raises $0.19 to $0.28
29e18081: calls $0.19
*** TURN *** [Jd Ks 9c] [6d]
Hero: checks
29e18081: checks
*** RIVER *** [Jd Ks 9c 6d] [5c]
Hero: checks
29e18081: checks
Hero: shows [Qs 9d] (Pair of Nines)
29e18081: shows [Qc Qd] (Pair of Queens)
*** SHOWDOWN ***
29e18081 collected $0.8 from pot
*** SUMMARY ***
Total pot $0.84 | Rake $0.04 | Jackpot $0 | Bingo $0 | Fortune $0 | Tax $0
Board [Jd Ks 9c 6d 5c]
Seat 1: 29e18081 (button) showed [Qc Qd] and won ($0.8) with Pair of Queens
Seat 2: 8ced9a44 (small blind) folded before Flop
Seat 3: Hero (big blind) showed [Qs 9d] and lost with Pair of Nines
Seat 4: 59ad445d folded before Flop (didn't bet)
Seat 5: fc6fcf04 folded before Flop (didn't bet)
Seat 6: 3928912e folded before Flop (didn't bet)


Poker Hand #RC2078450005: Hold'em No Limit ($0.02/$0.05) - 2023/12/22 21:11:30
Table 'RushAndCash780587' 6-max Seat #1 is the button
Seat 1: 5fea4bbc ($13.32 in chips)
Seat 2: 8acef960 ($2.99 in chips)
Seat 3: bc118b95 ($5.43 in chips)
Seat 4: 1ff063e8 ($8.26 in chips)
Seat 5: a0ef5108 ($5.49 in chips)
Seat 6: Hero ($5.07 in chips)
8acef960: posts small blind $0.02
bc118b95: posts big blind $0.05
*** HOLE CARDS ***
Dealt to 5fea4bbc 
Dealt to 8acef960 
Dealt to bc118b95 
Dealt to 1ff063e8 
Dealt to a0ef5108 
Dealt to Hero [Kh 9h]
1ff063e8: folds
a0ef5108: raises $0.1 to $0.15
Hero: folds
5fea4bbc: folds
8acef960: folds
bc118b95: folds
Uncalled bet ($0.1) returned to a0ef5108
*** SHOWDOWN ***
a0ef5108 collected $0.12 from pot
*** SUMMARY ***
Total pot $0.12 | Rake $0 | Jackpot $0 | Bingo $0 | Fortune $0 | Tax $0
Seat 1: 5fea4bbc (button) folded before Flop (didn't bet)
Seat 2: 8acef960 (small blind) folded before Flop
Seat 3: bc118b95 (big blind) folded before Flop
Seat 4: 1ff063e8 folded before Flop (didn't bet)
Seat 5: a0ef5108 collected ($0.12)
Seat 6: Hero folded before Flop (didn't bet)


Poker Hand #RC2078449940: Hold'em No Limit ($0.02/$0.05) - 2023/12/22 21:11:27
Table 'RushAndCash780558' 6-max Seat #1 is the button
Seat 1: 1f9b16cf ($5.26 in chips)
Seat 2: 25941725 ($3.69 in chips)
Seat 3: fbeaaad2 ($11.85 in chips)
Seat 4: 2c2cc68d ($12.13 in chips)
Seat 5: Hero ($5.07 in chips)
Seat 6: 699fc410 ($6.02 in chips)
25941725: posts small blind $0.02
fbeaaad2: posts big blind $0.05
*** HOLE CARDS ***
Dealt to 1f9b16cf 
Dealt to 25941725 
Dealt to fbeaaad2 
Dealt to 2c2cc68d 
Dealt to Hero [4h Qd]
Dealt to 699fc410 
2c2cc68d: folds
Hero: folds
699fc410: raises $0.06 to $0.11
1f9b16cf: folds
25941725: calls $0.09
fbeaaad2: folds
*** FLOP *** [5s 3d Kd]
25941725: checks
699fc410: bets $0.21
25941725: folds
Uncalled bet ($0.21) returned to 699fc410
*** SHOWDOWN ***
699fc410 collected $0.26 from pot
*** SUMMARY ***
Total pot $0.27 | Rake $0.01 | Jackpot $0 | Bingo $0 | Fortune $0 | Tax $0
Board [5s 3d Kd]
Seat 1: 1f9b16cf (button) folded before Flop (didn't bet)
Seat 2: 25941725 (small blind) folded on the Flop
Seat 3: fbeaaad2 (big blind) folded before Flop
Seat 4: 2c2cc68d folded before Flop (didn't bet)
Seat 5: Hero folded before Flop (didn't bet)
Seat 6: 699fc410 won ($0.26)


Poker Hand #RC2078449629: Hold'em No Limit ($0.02/$0.05) - 2023/12/22 21:11:07
Table 'RushAndCash780417' 6-max Seat #1 is the button
Seat 1: a187c666 ($5.27 in chips)
Seat 2: 19d300cc ($5 in chips)
Seat 3: b1f568c0 ($10.58 in chips)
Seat 4: Hero ($5 in chips)
Seat 5: 6b8a648f ($5.66 in chips)
Seat 6: e44205f6 ($5.46 in chips)
19d300cc: posts small blind $0.02
b1f568c0: posts big blind $0.05
*** HOLE CARDS ***
Dealt to a187c666 
Dealt to 19d300cc 
Dealt to b1f568c0 
Dealt to Hero [Qs Ks]
Dealt to 6b8a648f 
Dealt to e44205f6 
Hero: raises $0.05 to $0.1
6b8a648f: folds
e44205f6: folds
a187c666: folds
19d300cc: folds
b1f568c0: folds
Uncalled bet ($0.05) returned to Hero
*** SHOWDOWN ***
Hero collected $0.12 from pot
*** SUMMARY ***
Total pot $0.12 | Rake $0 | Jackpot $0 | Bingo $0 | Fortune $0 | Tax $0
Seat 1: a187c666 (button) folded before Flop (didn't bet)
Seat 2: 19d300cc (small blind) folded before Flop
Seat 3: b1f568c0 (big blind) folded before Flop
Seat 4: Hero collected ($0.12)
Seat 5: 6b8a648f folded before Flop (didn't bet)
Seat 6: e44205f6 folded before Flop (didn't bet)


Poker Hand #RC2078449560: Hold'em No Limit ($0.02/$0.05) - 2023/12/22 21:11:03
Table 'RushAndCash780384' 6-max Seat #1 is the button
Seat 1: 5b2bf61b ($5 in chips)
Seat 2: d71ab80c ($7.37 in chips)
Seat 3: ec033a10 ($5.34 in chips)
Seat 4: 3f112fc ($7 in chips)
Seat 5: 90511c4f ($5 in chips)
Seat 6: Hero ($5 in chips)
d71ab80c: posts small blind $0.02
ec033a10: posts big blind $0.05
*** HOLE CARDS ***
Dealt to 5b2bf61b 
Dealt to d71ab80c 
Dealt to ec033a10 
Dealt to 3f112fc 
Dealt to 90511c4f 
Dealt to Hero [7s 6c]
3f112fc: raises $0.05 to $0.1
90511c4f: folds
Hero: folds
5b2bf61b: folds
d71ab80c: folds
ec033a10: folds
Uncalled bet ($0.05) returned to 3f112fc
*** SHOWDOWN ***
3f112fc collected $0.12 from pot
*** SUMMARY ***
Total pot $0.12 | Rake $0 | Jackpot $0 | Bingo $0 | Fortune $0 | Tax $0
Seat 1: 5b2bf61b (button) folded before Flop (didn't bet)
Seat 2: d71ab80c (small blind) folded before Flop
Seat 3: ec033a10 (big blind) folded before Flop
Seat 4: 3f112fc collected ($0.12)
Seat 5: 90511c4f folded before Flop (didn't bet)
Seat 6: Hero folded before Flop (didn't bet)


Poker Hand #RC2078449488: Hold'em No Limit ($0.02/$0.05) - 2023/12/22 21:10:59
Table 'RushAndCash780350' 6-max Seat #1 is the button
Seat 1: d71ab80c ($7.37 in chips)
Seat 2: 5c16c35c ($11.9 in chips)
Seat 3: 21f1ca58 ($9.8 in chips)
Seat 4: d32741ba ($10.85 in chips)
Seat 5: 90511c4f ($5 in chips)
Seat 6: Hero ($5 in chips)
5c16c35c: posts small blind $0.02
21f1ca58: posts big blind $0.05
*** HOLE CARDS ***
Dealt to d71ab80c 
Dealt to 5c16c35c 
Dealt to 21f1ca58 
Dealt to d32741ba 
Dealt to 90511c4f 
Dealt to Hero [3c Ks]
d32741ba: folds
90511c4f: folds
Hero: folds
d71ab80c: folds
5c16c35c: raises $0.1 to $0.15
21f1ca58: raises $0.1 to $0.25
5c16c35c: calls $0.1
*** FLOP *** [2c 2s 8c]
5c16c35c: checks
21f1ca58: checks
*** TURN *** [2c 2s 8c] [Ts]
5c16c35c: checks
21f1ca58: bets $0.5
5c16c35c: calls $0.5
*** RIVER *** [2c 2s 8c Ts] [Jh]
5c16c35c: checks
21f1ca58: checks
5c16c35c: shows [Qc 7c] (Pair of Twos)
21f1ca58: shows [3s As] (Pair of Twos)
*** SHOWDOWN ***
21f1ca58 collected $1.36 from pot
*** SUMMARY ***
Total pot $1.5 | Rake $0.07 | Jackpot $0.07 | Bingo $0 | Fortune $0 | Tax $0
Board [2c 2s 8c Ts Jh]
Seat 1: d71ab80c (button) folded before Flop (didn't bet)
Seat 2: 5c16c35c (small blind) showed [Qc 7c] and lost with Pair of Twos
Seat 3: 21f1ca58 (big blind) showed [3s As] and won ($1.36) with Pair of Twos
Seat 4: d32741ba folded before Flop (didn't bet)
Seat 5: 90511c4f folded before Flop (didn't bet)
Seat 6: Hero folded before Flop (didn't bet)


Poker Hand #RC2078449306: Hold'em No Limit ($0.02/$0.05) - 2023/12/22 21:10:49
Table 'RushAndCash780266' 6-max Seat #1 is the button
Seat 1: 2c867a7e ($13.96 in chips)
Seat 2: Hero ($5 in chips)
Seat 3: 96eff031 ($1.77 in chips)
Seat 4: a87d0af2 ($4.29 in chips)
Seat 5: 8014c02 ($20.82 in chips)
Seat 6: 3a8a7513 ($5.12 in chips)
Hero: posts small blind $0.02
96eff031: posts big blind $0.05
*** HOLE CARDS ***
Dealt to 2c867a7e 
Dealt to Hero [Qc 8s]
Dealt to 96eff031 
Dealt to a87d0af2 
Dealt to 8014c02 
Dealt to 3a8a7513 
a87d0af2: raises $0.07 to $0.12
8014c02: folds
3a8a7513: folds
2c867a7e: folds
Hero: folds
96eff031: folds
Uncalled bet ($0.07) returned to a87d0af2
*** SHOWDOWN ***
a87d0af2 collected $0.12 from pot
*** SUMMARY ***
Total pot $0.12 | Rake $0 | Jackpot $0 | Bingo $0 | Fortune $0 | Tax $0
Seat 1: 2c867a7e (button) folded before Flop (didn't bet)
Seat 2: Hero (small blind) folded before Flop
Seat 3: 96eff031 (big blind) folded before Flop
Seat 4: a87d0af2 collected ($0.12)
Seat 5: 8014c02 folded before Flop (didn't bet)
Seat 6: 3a8a7513 folded before Flop (didn't bet)


Poker Hand #RC2078449220: Hold'em No Limit ($0.02/$0.05) - 2023/12/22 21:10:43
Table 'RushAndCash780226' 6-max Seat #1 is the button
Seat 1: 409f5cad ($5.7 in chips)
Seat 2: 3f0bf20a ($5 in chips)
Seat 3: 49ea92ea ($7.53 in chips)
Seat 4: Hero ($5 in chips)
Seat 5: a420712c ($10.33 in chips)
Seat 6: e519a9e8 ($21.13 in chips)
3f0bf20a: posts small blind $0.02
49ea92ea: posts big blind $0.05
*** HOLE CARDS ***
Dealt to 409f5cad 
Dealt to 3f0bf20a 
Dealt to 49ea92ea 
Dealt to Hero [9h 8d]
Dealt to a420712c 
Dealt to e519a9e8 
Hero: folds
a420712c: folds
e519a9e8: folds
409f5cad: folds
3f0bf20a: folds
Uncalled bet ($0.03) returned to 49ea92ea
*** SHOWDOWN ***
49ea92ea collected $0.04 from pot
*** SUMMARY ***
Total pot $0.04 | Rake $0 | Jackpot $0 | Bingo $0 | Fortune $0 | Tax $0
Seat 1: 409f5cad (button) folded before Flop (didn't bet)
Seat 2: 3f0bf20a (small blind) folded before Flop
Seat 3: 49ea92ea (big blind) collected ($0.04)
Seat 4: Hero folded before Flop (didn't bet)
Seat 5: a420712c folded before Flop (didn't bet)
Seat 6: e519a9e8 folded before Flop (didn't bet)


Poker Hand #RC2078449023: Hold'em No Limit ($0.02/$0.05) - 2023/12/22 21:10:31
Table 'RushAndCash780129' 6-max Seat #1 is the button
Seat 1: 14e83055 ($5.13 in chips)
Seat 2: bf955ffb ($5 in chips)
Seat 3: Hero ($5 in chips)
Seat 4: 3288926 ($5.07 in chips)
Seat 5: 8acef960 ($3.09 in chips)
Seat 6: 75cbe3d4 ($5 in chips)
bf955ffb: posts small blind $0.02
Hero: posts big blind $0.05
*** HOLE CARDS ***
Dealt to 14e83055 
Dealt to bf955ffb 
Dealt to Hero [Td 3d]
Dealt to 3288926 
Dealt to 8acef960 
Dealt to 75cbe3d4 
3288926: folds
8acef960: calls $0.05
75cbe3d4: raises $0.17 to $0.22
14e83055: folds
bf955ffb: folds
Hero: folds
8acef960: folds
Uncalled bet ($0.17) returned to 75cbe3d4
*** SHOWDOWN ***
75cbe3d4 collected $0.17 from pot
*** SUMMARY ***
Total pot $0.17 | Rake $0 | Jackpot $0 | Bingo $0 | Fortune $0 | Tax $0
Seat 1: 14e83055 (button) folded before Flop (didn't bet)
Seat 2: bf955ffb (small blind) folded before Flop
Seat 3: Hero (big blind) folded before Flop
Seat 4: 3288926 folded before Flop (didn't bet)
Seat 5: 8acef960 folded before Flop
Seat 6: 75cbe3d4 collected ($0.17)


Poker Hand #RC2078448962: Hold'em No Limit ($0.02/$0.05) - 2023/12/22 21:10:27
Table 'RushAndCash780098' 6-max Seat #1 is the button
Seat 1: Hero ($5 in chips)
Seat 2: 21196b97 ($8.53 in chips)
Seat 3: fdc2d3ba ($14.31 in chips)
Seat 4: 8acef960 ($3.09 in chips)
Seat 5: d56f57b9 ($6.35 in chips)
Seat 6: 67444c22 ($5.05 in chips)
21196b97: posts small blind $0.02
fdc2d3ba: posts big blind $0.05
*** HOLE CARDS ***
Dealt to Hero [3c Ad]
Dealt to 21196b97 
Dealt to fdc2d3ba 
Dealt to 8acef960 
Dealt to d56f57b9 
Dealt to 67444c22 
8acef960: folds
d56f57b9: folds
67444c22: folds
Hero: folds
21196b97: raises $0.1 to $0.15
fdc2d3ba: calls $0.1
*** FLOP *** [Js 9s Qh]
21196b97: checks
fdc2d3ba: checks
*** TURN *** [Js 9s Qh] [2d]
21196b97: bets $0.23
fdc2d3ba: raises $0.26 to $0.49
21196b97: calls $0.26
*** RIVER *** [Js 9s Qh 2d] [6c]
21196b97: checks
fdc2d3ba: checks
21196b97: shows [Ts Qs] (Pair of Queens)
fdc2d3ba: shows [9c Kc] (Pair of Nines)
*** SHOWDOWN ***
21196b97 collected $1.22 from pot
*** SUMMARY ***
Total pot $1.28 | Rake $0.06 | Jackpot $0 | Bingo $0 | Fortune $0 | Tax $0
Board [Js 9s Qh 2d 6c]
Seat 1: Hero (button) folded before Flop (didn't bet)
Seat 2: 21196b97 (small blind) showed [Ts Qs] and won ($1.22) with Pair of Queens
Seat 3: fdc2d3ba (big blind) showed [9c Kc] and lost with Pair of Nines
Seat 4: 8acef960 folded before Flop (didn't bet)
Seat 5: d56f57b9 folded before Flop (didn't bet)
Seat 6: 67444c22 folded before Flop (didn't bet)


Poker Hand #RC2078448427: Hold'em No Limit ($0.02/$0.05) - 2023/12/22 21:09:55
Table 'RushAndCash779840' 6-max Seat #1 is the button
Seat 1: b32e59c3 ($5.76 in chips)
Seat 2: 220b0aae ($10.37 in chips)
Seat 3: 2f160a64 ($5.14 in chips)
Seat 4: 4adecf0 ($5.54 in chips)
Seat 5: 3fc56396 ($5 in chips)
Seat 6: Hero ($5 in chips)
220b0aae: posts small blind $0.02
2f160a64: posts big blind $0.05
*** HOLE CARDS ***
Dealt to b32e59c3 
Dealt to 220b0aae 
Dealt to 2f160a64 
Dealt to 4adecf0 
Dealt to 3fc56396 
Dealt to Hero [5d 4d]
4adecf0: folds
3fc56396: folds
Hero: raises $0.05 to $0.1
b32e59c3: folds
220b0aae: folds
2f160a64: raises $0.45 to $0.55
Hero: folds
Uncalled bet ($0.45) returned to 2f160a64
*** SHOWDOWN ***
2f160a64 collected $0.21 from pot
*** SUMMARY ***
Total pot $0.22 | Rake $0.01 | Jackpot $0 | Bingo $0 | Fortune $0 | Tax $0
Seat 1: b32e59c3 (button) folded before Flop (didn't bet)
Seat 2: 220b0aae (small blind) folded before Flop
Seat 3: 2f160a64 (big blind) collected ($0.21)
Seat 4: 4adecf0 folded before Flop (didn't bet)
Seat 5: 3fc56396 folded before Flop (didn't bet)
Seat 6: Hero folded before Flop


Poker Hand #RC2078448269: Hold'em No Limit ($0.02/$0.05) - 2023/12/22 21:09:46
Table 'RushAndCash779767' 6-max Seat #1 is the button
Seat 1: beea6e5f ($8.74 in chips)
Seat 2: Hero ($5 in chips)
Seat 3: d2739eda ($0.8 in chips)
Seat 4: f71b25e9 ($5 in chips)
Seat 5: 91937678 ($5.11 in chips)
Seat 6: 3b6e2f77 ($5 in chips)
Hero: posts small blind $0.02
d2739eda: posts big blind $0.05
*** HOLE CARDS ***
Dealt to beea6e5f 
Dealt to Hero [5c 2c]
Dealt to d2739eda 
Dealt to f71b25e9 
Dealt to 91937678 
Dealt to 3b6e2f77 
f71b25e9: raises $0.05 to $0.1
91937678: raises $0.3 to $0.4
3b6e2f77: folds
beea6e5f: folds
Hero: folds
d2739eda: folds
f71b25e9: folds
Uncalled bet ($0.3) returned to 91937678
*** SHOWDOWN ***
91937678 collected $0.26 from pot
*** SUMMARY ***
Total pot $0.27 | Rake $0.01 | Jackpot $0 | Bingo $0 | Fortune $0 | Tax $0
Seat 1: beea6e5f (button) folded before Flop (didn't bet)
Seat 2: Hero (small blind) folded before Flop
Seat 3: d2739eda (big blind) folded before Flop
Seat 4: f71b25e9 folded before Flop
Seat 5: 91937678 collected ($0.26)
Seat 6: 3b6e2f77 folded before Flop (didn't bet)


Poker Hand #RC2078448163: Hold'em No Limit ($0.02/$0.05) - 2023/12/22 21:09:40
Table 'RushAndCash779718' 6-max Seat #1 is the button
Seat 1: 6d3488f1 ($5.5 in chips)
Seat 2: 71871718 ($2.45 in chips)
Seat 3: 36060128 ($9.1 in chips)
Seat 4: d6c4e270 ($2.17 in chips)
Seat 5: ddbe951e ($8.61 in chips)
Seat 6: Hero ($5 in chips)
71871718: posts small blind $0.02
36060128: posts big blind $0.05
*** HOLE CARDS ***
Dealt to 6d3488f1 
Dealt to 71871718 
Dealt to 36060128 
Dealt to d6c4e270 
Dealt to ddbe951e 
Dealt to Hero [Td 8d]
d6c4e270: folds
ddbe951e: folds
Hero: folds
6d3488f1: raises $0.1 to $0.15
71871718: folds
36060128: folds
Uncalled bet ($0.1) returned to 6d3488f1
*** SHOWDOWN ***
6d3488f1 collected $0.12 from pot
*** SUMMARY ***
Total pot $0.12 | Rake $0 | Jackpot $0 | Bingo $0 | Fortune $0 | Tax $0
Seat 1: 6d3488f1 (button) collected ($0.12)
Seat 2: 71871718 (small blind) folded before Flop
Seat 3: 36060128 (big blind) folded before Flop
Seat 4: d6c4e270 folded before Flop (didn't bet)
Seat 5: ddbe951e folded before Flop (didn't bet)
Seat 6: Hero folded before Flop (didn't bet)


Poker Hand #RC2078448073: Hold'em No Limit ($0.02/$0.05) - 2023/12/22 21:09:35
Table 'RushAndCash779677' 6-max Seat #1 is the button
Seat 1: c7b7c566 ($6 in chips)
Seat 2: 4d43d419 ($5.19 in chips)
Seat 3: 921e997e ($6.35 in chips)
Seat 4: 67d4b163 ($10.27 in chips)
Seat 5: Hero ($5 in chips)
Seat 6: dbf99aff ($4.74 in chips)
4d43d419: posts small blind $0.02
921e997e: posts big blind $0.05
*** HOLE CARDS ***
Dealt to c7b7c566 
Dealt to 4d43d419 
Dealt to 921e997e 
Dealt to 67d4b163 
Dealt to Hero [Qh Jd]
Dealt to dbf99aff 
67d4b163: raises $0.15 to $0.2
Hero: folds
dbf99aff: folds
c7b7c566: folds
4d43d419: folds
921e997e: calls $0.15
*** FLOP *** [8c Qd 8d]
921e997e: checks
67d4b163: bets $0.32
921e997e: calls $0.32
*** TURN *** [8c Qd 8d] [5s]
921e997e: checks
67d4b163: bets $0.8
921e997e: folds
Uncalled bet ($0.8) returned to 67d4b163
*** SHOWDOWN ***
67d4b163 collected $1.01 from pot
*** SUMMARY ***
Total pot $1.06 | Rake $0.05 | Jackpot $0 | Bingo $0 | Fortune $0 | Tax $0
Board [8c Qd 8d 5s]
Seat 1: c7b7c566 (button) folded before Flop (didn't bet)
Seat 2: 4d43d419 (small blind) folded before Flop
Seat 3: 921e997e (big blind) folded on the Turn
Seat 4: 67d4b163 won ($1.01)
Seat 5: Hero folded before Flop (didn't bet)
Seat 6: dbf99aff folded before Flop (didn't bet)


Poker Hand #RC2078447358: Hold'em No Limit ($0.02/$0.05) - 2023/12/22 21:08:55
Table 'RushAndCash779343' 6-max Seat #1 is the button
Seat 1: Hero ($5.07 in chips)
Seat 2: 509e9488 ($3.93 in chips)
Seat 3: 5c57b9e ($5.11 in chips)
Seat 4: 3c0cf28c ($5.05 in chips)
Seat 5: 360d3b25 ($5.04 in chips)
Seat 6: a1786def ($5.38 in chips)
509e9488: posts small blind $0.02
5c57b9e: posts big blind $0.05
*** HOLE CARDS ***
Dealt to Hero [Js 9s]
Dealt to 509e9488 
Dealt to 5c57b9e 
Dealt to 3c0cf28c 
Dealt to 360d3b25 
Dealt to a1786def 
3c0cf28c: folds
360d3b25: folds
a1786def: folds
Hero: raises $0.08 to $0.13
509e9488: calls $0.11
5c57b9e: calls $0.08
*** FLOP *** [Qh Qs 7h]
509e9488: checks
5c57b9e: checks
Hero: checks
*** TURN *** [Qh Qs 7h] [2h]
509e9488: bets $0.3
5c57b9e: calls $0.3
Hero: folds
*** RIVER *** [Qh Qs 7h 2h] [Ah]
509e9488: checks
5c57b9e: bets $0.8
509e9488: calls $0.8
5c57b9e: shows [3h 3s] (Ace High Flush)
509e9488: shows [4h 8h] (Ace High Flush)
*** SHOWDOWN ***
509e9488 collected $2.4 from pot
*** SUMMARY ***
Total pot $2.59 | Rake $0.12 | Jackpot $0.07 | Bingo $0 | Fortune $0 | Tax $0
Board [Qh Qs 7h 2h Ah]
Seat 1: Hero (button) folded on the Turn
Seat 2: 509e9488 (small blind) showed [4h 8h] and won ($2.4) with Ace High Flush
Seat 3: 5c57b9e (big blind) showed [3h 3s] and lost with Ace High Flush
Seat 4: 3c0cf28c folded before Flop (didn't bet)
Seat 5: 360d3b25 folded before Flop (didn't bet)
Seat 6: a1786def folded before Flop (didn't bet)


Poker Hand #RC2078447139: Hold'em No Limit ($0.02/$0.05) - 2023/12/22 21:08:42
Table 'RushAndCash779239' 6-max Seat #1 is the button
Seat 1: cabfa413 ($5 in chips)
Seat 2: 66605bf3 ($11.11 in chips)
Seat 3: Hero ($5.12 in chips)
Seat 4: 8818ba78 ($7.34 in chips)
Seat 5: f5ffb37c ($5.86 in chips)
Seat 6: 7e5f7d63 ($6.52 in chips)
66605bf3: posts small blind $0.02
Hero: posts big blind $0.05
*** HOLE CARDS ***
Dealt to cabfa413 
Dealt to 66605bf3 
Dealt to Hero [Kd 3d]
Dealt to 8818ba78 
Dealt to f5ffb37c 
Dealt to 7e5f7d63 
8818ba78: raises $0.05 to $0.1
f5ffb37c: folds
7e5f7d63: folds
cabfa413: folds
66605bf3: folds
Hero: folds
Uncalled bet ($0.05) returned to 8818ba78
*** SHOWDOWN ***
8818ba78 collected $0.12 from pot
*** SUMMARY ***
Total pot $0.12 | Rake $0 | Jackpot $0 | Bingo $0 | Fortune $0 | Tax $0
Seat 1: cabfa413 (button) folded before Flop (didn't bet)
Seat 2: 66605bf3 (small blind) folded before Flop
Seat 3: Hero (big blind) folded before Flop
Seat 4: 8818ba78 collected ($0.12)
Seat 5: f5ffb37c folded before Flop (didn't bet)
Seat 6: 7e5f7d63 folded before Flop (didn't bet)


Poker Hand #RC2078447029: Hold'em No Limit ($0.02/$0.05) - 2023/12/22 21:08:36
Table 'RushAndCash779182' 6-max Seat #1 is the button
Seat 1: 517da49 ($5.61 in chips)
Seat 2: 9f6ece19 ($4.81 in chips)
Seat 3: e869fe8f ($2.08 in chips)
Seat 4: 1e4a5551 ($2.44 in chips)
Seat 5: Hero ($5.12 in chips)
Seat 6: 8d0bca32 ($6.22 in chips)
9f6ece19: posts small blind $0.02
e869fe8f: posts big blind $0.05
*** HOLE CARDS ***
Dealt to 517da49 
Dealt to 9f6ece19 
Dealt to e869fe8f 
Dealt to 1e4a5551 
Dealt to Hero [Qd 9c]
Dealt to 8d0bca32 
1e4a5551: folds
Hero: folds
8d0bca32: folds
517da49: folds
9f6ece19: folds
Uncalled bet ($0.03) returned to e869fe8f
*** SHOWDOWN ***
e869fe8f collected $0.04 from pot
*** SUMMARY ***
Total pot $0.04 | Rake $0 | Jackpot $0 | Bingo $0 | Fortune $0 | Tax $0
Seat 1: 517da49 (button) folded before Flop (didn't bet)
Seat 2: 9f6ece19 (small blind) folded before Flop
Seat 3: e869fe8f (big blind) collected ($0.04)
Seat 4: 1e4a5551 folded before Flop (didn't bet)
Seat 5: Hero folded before Flop (didn't bet)
Seat 6: 8d0bca32 folded before Flop (didn't bet)


Poker Hand #RC2078446736: Hold'em No Limit ($0.02/$0.05) - 2023/12/22 21:08:18
Table 'RushAndCash779037' 6-max Seat #1 is the button
Seat 1: 38bb8e26 ($6.25 in chips)
Seat 2: a7286848 ($5.02 in chips)
Seat 3: 8e27e917 ($5 in chips)
Seat 4: Hero ($5.05 in chips)
Seat 5: 5da5ce8d ($19.38 in chips)
Seat 6: 7e84e7dc ($12.33 in chips)
a7286848: posts small blind $0.02
8e27e917: posts big blind $0.05
*** HOLE CARDS ***
Dealt to 38bb8e26 
Dealt to a7286848 
Dealt to 8e27e917 
Dealt to Hero [Ac Kd]
Dealt to 5da5ce8d 
Dealt to 7e84e7dc 
Hero: raises $0.05 to $0.1
5da5ce8d: folds
7e84e7dc: folds
38bb8e26: folds
a7286848: folds
8e27e917: folds
Uncalled bet ($0.05) returned to Hero
*** SHOWDOWN ***
Hero collected $0.12 from pot
*** SUMMARY ***
Total pot $0.12 | Rake $0 | Jackpot $0 | Bingo $0 | Fortune $0 | Tax $0
Seat 1: 38bb8e26 (button) folded before Flop (didn't bet)
Seat 2: a7286848 (small blind) folded before Flop
Seat 3: 8e27e917 (big blind) folded before Flop
Seat 4: Hero collected ($0.12)
Seat 5: 5da5ce8d folded before Flop (didn't bet)
Seat 6: 7e84e7dc folded before Flop (didn't bet)


Poker Hand #RC2078446672: Hold'em No Limit ($0.02/$0.05) - 2023/12/22 21:08:15
Table 'RushAndCash779005' 6-max Seat #1 is the button
Seat 1: 271c38e0 ($5.95 in chips)
Seat 2: Hero ($5.07 in chips)
Seat 3: 5f87768d ($5 in chips)
Seat 4: c54f63b8 ($5.13 in chips)
Seat 5: e8df5901 ($7.19 in chips)
Seat 6: 8fe58320 ($6.9 in chips)
Hero: posts small blind $0.02
5f87768d: posts big blind $0.05
*** HOLE CARDS ***
Dealt to 271c38e0 
Dealt to Hero [4h Td]
Dealt to 5f87768d 
Dealt to c54f63b8 
Dealt to e8df5901 
Dealt to 8fe58320 
c54f63b8: folds
e8df5901: raises $0.05 to $0.1
8fe58320: folds
271c38e0: folds
Hero: folds
5f87768d: folds
Uncalled bet ($0.05) returned to e8df5901
*** SHOWDOWN ***
e8df5901 collected $0.12 from pot
*** SUMMARY ***
Total pot $0.12 | Rake $0 | Jackpot $0 | Bingo $0 | Fortune $0 | Tax $0
Seat 1: 271c38e0 (button) folded before Flop (didn't bet)
Seat 2: Hero (small blind) folded before Flop
Seat 3: 5f87768d (big blind) folded before Flop
Seat 4: c54f63b8 folded before Flop (didn't bet)
Seat 5: e8df5901 collected ($0.12)
Seat 6: 8fe58320 folded before Flop (didn't bet)


Poker Hand #RC2078446368: Hold'em No Limit ($0.02/$0.05) - 2023/12/22 21:07:57
Table 'RushAndCash778854' 6-max Seat #1 is the button
Seat 1: a1dfe2ad ($4.48 in chips)
Seat 2: 8b0c9357 ($5.13 in chips)
Seat 3: Hero ($5.12 in chips)
Seat 4: 18f9cb34 ($6.13 in chips)
Seat 5: d03e1a8e ($9.59 in chips)
Seat 6: efaec7cf ($4.89 in chips)
8b0c9357: posts small blind $0.02
Hero: posts big blind $0.05
*** HOLE CARDS ***
Dealt to a1dfe2ad 
Dealt to 8b0c9357 
Dealt to Hero [Kh Jc]
Dealt to 18f9cb34 
Dealt to d03e1a8e 
Dealt to efaec7cf 
18f9cb34: raises $0.08 to $0.13
d03e1a8e: folds
efaec7cf: folds
a1dfe2ad: raises $0.51 to $0.64
8b0c9357: folds
Hero: folds
18f9cb34: folds
Uncalled bet ($0.51) returned to a1dfe2ad
*** SHOWDOWN ***
a1dfe2ad collected $0.32 from pot
*** SUMMARY ***
Total pot $0.33 | Rake $0.01 | Jackpot $0 | Bingo $0 | Fortune $0 | Tax $0
Seat 1: a1dfe2ad (button) collected ($0.32)
Seat 2: 8b0c9357 (small blind) folded before Flop
Seat 3: Hero (big blind) folded before Flop
Seat 4: 18f9cb34 folded before Flop
Seat 5: d03e1a8e folded before Flop (didn't bet)
Seat 6: efaec7cf folded before Flop (didn't bet)


Poker Hand #RC2078446311: Hold'em No Limit ($0.02/$0.05) - 2023/12/22 21:07:54
Table 'RushAndCash778827' 6-max Seat #1 is the button
Seat 1: Hero ($5.12 in chips)
Seat 2: 12953fac ($6.48 in chips)
Seat 3: 4c81be2e ($11.69 in chips)
Seat 4: 4d43d419 ($5.58 in chips)
Seat 5: 177da66b ($5.61 in chips)
Seat 6: f751acea ($5.03 in chips)
12953fac: posts small blind $0.02
4c81be2e: posts big blind $0.05
*** HOLE CARDS ***
Dealt to Hero [3h Ac]
Dealt to 12953fac 
Dealt to 4c81be2e 
Dealt to 4d43d419 
Dealt to 177da66b 
Dealt to f751acea 
4d43d419: raises $0.08 to $0.13
177da66b: folds
f751acea: calls $0.13
Hero: folds
12953fac: folds
4c81be2e: folds
*** FLOP *** [9c 3c Ad]
4d43d419: bets $0.08
f751acea: calls $0.08
*** TURN *** [9c 3c Ad] [Kc]
4d43d419: bets $0.2
f751acea: calls $0.2
*** RIVER *** [9c 3c Ad Kc] [Qd]
4d43d419: checks
f751acea: bets $0.15
4d43d419: folds
Uncalled bet ($0.15) returned to f751acea
*** SHOWDOWN ***
f751acea collected $0.85 from pot
*** SUMMARY ***
Total pot $0.89 | Rake $0.04 | Jackpot $0 | Bingo $0 | Fortune $0 | Tax $0
Board [9c 3c Ad Kc Qd]
Seat 1: Hero (button) folded before Flop (didn't bet)
Seat 2: 12953fac (small blind) folded before Flop
Seat 3: 4c81be2e (big blind) folded before Flop
Seat 4: 4d43d419 folded on the River
Seat 5: 177da66b folded before Flop (didn't bet)
Seat 6: f751acea won ($0.85)


Poker Hand #RC2078446236: Hold'em No Limit ($0.02/$0.05) - 2023/12/22 21:07:50
Table 'RushAndCash778790' 6-max Seat #1 is the button
Seat 1: c7592cbf ($12.15 in chips)
Seat 2: 54daf47b ($9.29 in chips)
Seat 3: 2867fe36 ($2.31 in chips)
Seat 4: 8f1c60bf ($8.16 in chips)
Seat 5: 84b095e9 ($3.99 in chips)
Seat 6: Hero ($5.12 in chips)
54daf47b: posts small blind $0.02
2867fe36: posts big blind $0.05
*** HOLE CARDS ***
Dealt to c7592cbf 
Dealt to 54daf47b 
Dealt to 2867fe36 
Dealt to 8f1c60bf 
Dealt to 84b095e9 
Dealt to Hero [Jh 8s]
8f1c60bf: raises $0.05 to $0.1
84b095e9: folds
Hero: folds
c7592cbf: folds
54daf47b: folds
2867fe36: folds
Uncalled bet ($0.05) returned to 8f1c60bf
*** SHOWDOWN ***
8f1c60bf collected $0.12 from pot
*** SUMMARY ***
Total pot $0.12 | Rake $0 | Jackpot $0 | Bingo $0 | Fortune $0 | Tax $0
Seat 1: c7592cbf (button) folded before Flop (didn't bet)
Seat 2: 54daf47b (small blind) folded before Flop
Seat 3: 2867fe36 (big blind) folded before Flop
Seat 4: 8f1c60bf collected ($0.12)
Seat 5: 84b095e9 folded before Flop (didn't bet)
Seat 6: Hero folded before Flop (didn't bet)


Poker Hand #RC2078446153: Hold'em No Limit ($0.02/$0.05) - 2023/12/22 21:07:46
Table 'RushAndCash778750' 6-max Seat #1 is the button
Seat 1: cff0b296 ($5.56 in chips)
Seat 2: cbfe1acc ($8.14 in chips)
Seat 3: de1c7123 ($2.64 in chips)
Seat 4: 44231a0a ($19.16 in chips)
Seat 5: 886872c9 ($5.09 in chips)
Seat 6: Hero ($5.12 in chips)
cbfe1acc: posts small blind $0.02
de1c7123: posts big blind $0.05
*** HOLE CARDS ***
Dealt to cff0b296 
Dealt to cbfe1acc 
Dealt to de1c7123 
Dealt to 44231a0a 
Dealt to 886872c9 
Dealt to Hero [Th 9s]
44231a0a: folds
886872c9: folds
Hero: folds
cff0b296: folds
cbfe1acc: raises $0.08 to $0.13
de1c7123: folds
Uncalled bet ($0.08) returned to cbfe1acc
*** SHOWDOWN ***
cbfe1acc collected $0.1 from pot
*** SUMMARY ***
Total pot $0.1 | Rake $0 | Jackpot $0 | Bingo $0 | Fortune $0 | Tax $0
Seat 1: cff0b296 (button) folded before Flop (didn't bet)
Seat 2: cbfe1acc (small blind) collected ($0.1)
Seat 3: de1c7123 (big blind) folded before Flop
Seat 4: 44231a0a folded before Flop (didn't bet)
Seat 5: 886872c9 folded before Flop (didn't bet)
Seat 6: Hero folded before Flop (didn't bet)


Poker Hand #RC2078446050: Hold'em No Limit ($0.02/$0.05) - 2023/12/22 21:07:40
Table 'RushAndCash778702' 6-max Seat #1 is the button
Seat 1: e2193a5c ($5.05 in chips)
Seat 2: cdd2600a ($2.94 in chips)
Seat 3: c0d3508b ($2.57 in chips)
Seat 4: 90b129bf ($9.4 in chips)
Seat 5: 8d15f06b ($11.79 in chips)
Seat 6: Hero ($5.12 in chips)
cdd2600a: posts small blind $0.02
c0d3508b: posts big blind $0.05
*** HOLE CARDS ***
Dealt to e2193a5c 
Dealt to cdd2600a 
Dealt to c0d3508b 
Dealt to 90b129bf 
Dealt to 8d15f06b 
Dealt to Hero [5h Qd]
90b129bf: folds
8d15f06b: folds
Hero: folds
e2193a5c: folds
cdd2600a: raises $0.05 to $0.1
c0d3508b: calls $0.05
*** FLOP *** [Ts Kh 8h]
cdd2600a: bets $0.15
c0d3508b: calls $0.15
*** TURN *** [Ts Kh 8h] [8c]
cdd2600a: bets $0.25
c0d3508b: calls $0.25
*** RIVER *** [Ts Kh 8h 8c] [6h]
cdd2600a: checks
c0d3508b: bets $0.75
cdd2600a: folds
Uncalled bet ($0.75) returned to c0d3508b
*** SHOWDOWN ***
c0d3508b collected $0.95 from pot
*** SUMMARY ***
Total pot $1 | Rake $0.05 | Jackpot $0 | Bingo $0 | Fortune $0 | Tax $0
Board [Ts Kh 8h 8c 6h]
Seat 1: e2193a5c (button) folded before Flop (didn't bet)
Seat 2: cdd2600a (small blind) folded on the River
Seat 3: c0d3508b (big blind) won ($0.95)
Seat 4: 90b129bf folded before Flop (didn't bet)
Seat 5: 8d15f06b folded before Flop (didn't bet)
Seat 6: Hero folded before Flop (didn't bet)


Poker Hand #RC2078445843: Hold'em No Limit ($0.02/$0.05) - 2023/12/22 21:07:29
Table 'RushAndCash778602' 6-max Seat #1 is the button
Seat 1: 1ff063e8 ($8.86 in chips)
Seat 2: Hero ($5.07 in chips)
Seat 3: 65669ebe ($5 in chips)
Seat 4: 4fedcb8f ($6.92 in chips)
Seat 5: c0d3508b ($2.57 in chips)
Seat 6: cff0b296 ($5.63 in chips)
Hero: posts small blind $0.02
65669ebe: posts big blind $0.05
*** HOLE CARDS ***
Dealt to 1ff063e8 
Dealt to Hero [5d Ad]
Dealt to 65669ebe 
Dealt to 4fedcb8f 
Dealt to c0d3508b 
Dealt to cff0b296 
4fedcb8f: folds
c0d3508b: folds
cff0b296: folds
1ff063e8: folds
Hero: raises $0.1 to $0.15
65669ebe: folds
Uncalled bet ($0.1) returned to Hero
*** SHOWDOWN ***
Hero collected $0.1 from pot
*** SUMMARY ***
Total pot $0.1 | Rake $0 | Jackpot $0 | Bingo $0 | Fortune $0 | Tax $0
Seat 1: 1ff063e8 (button) folded before Flop (didn't bet)
Seat 2: Hero (small blind) collected ($0.1)
Seat 3: 65669ebe (big blind) folded before Flop
Seat 4: 4fedcb8f folded before Flop (didn't bet)
Seat 5: c0d3508b folded before Flop (didn't bet)
Seat 6: cff0b296 folded before Flop (didn't bet)


Poker Hand #RC2078445479: Hold'em No Limit ($0.02/$0.05) - 2023/12/22 21:07:07
Table 'RushAndCash778442' 6-max Seat #1 is the button
Seat 1: 16153105 ($4.4 in chips)
Seat 2: a045ac51 ($5 in chips)
Seat 3: Hero ($5.12 in chips)
Seat 4: 52749f9e ($6.05 in chips)
Seat 5: 2a4364bc ($6.33 in chips)
Seat 6: fd07586a ($5 in chips)
a045ac51: posts small blind $0.02
Hero: posts big blind $0.05
*** HOLE CARDS ***
Dealt to 16153105 
Dealt to a045ac51 
Dealt to Hero [Td 4s]
Dealt to 52749f9e 
Dealt to 2a4364bc 
Dealt to fd07586a 
52749f9e: folds
2a4364bc: raises $0.07 to $0.12
fd07586a: folds
16153105: folds
a045ac51: folds
Hero: folds
Uncalled bet ($0.07) returned to 2a4364bc
*** SHOWDOWN ***
2a4364bc collected $0.12 from pot
*** SUMMARY ***
Total pot $0.12 | Rake $0 | Jackpot $0 | Bingo $0 | Fortune $0 | Tax $0
Seat 1: 16153105 (button) folded before Flop (didn't bet)
Seat 2: a045ac51 (small blind) folded before Flop
Seat 3: Hero (big blind) folded before Flop
Seat 4: 52749f9e folded before Flop (didn't bet)
Seat 5: 2a4364bc collected ($0.12)
Seat 6: fd07586a folded before Flop (didn't bet)


Poker Hand #RC2078445360: Hold'em No Limit ($0.02/$0.05) - 2023/12/22 21:07:01
Table 'RushAndCash778388' 6-max Seat #1 is the button
Seat 1: Hero ($5.12 in chips)
Seat 2: 2ec85018 ($3.43 in chips)
Seat 3: 81f09a8e ($7.52 in chips)
Seat 4: 2cae9604 ($9.9 in chips)
Seat 5: de3b84bb ($24.59 in chips)
Seat 6: 89ac50e8 ($13.16 in chips)
2ec85018: posts small blind $0.02
81f09a8e: posts big blind $0.05
*** HOLE CARDS ***
Dealt to Hero [Tc Ks]
Dealt to 2ec85018 
Dealt to 81f09a8e 
Dealt to 2cae9604 
Dealt to de3b84bb 
Dealt to 89ac50e8 
2cae9604: folds
de3b84bb: folds
89ac50e8: folds
Hero: folds
2ec85018: folds
Uncalled bet ($0.03) returned to 81f09a8e
*** SHOWDOWN ***
81f09a8e collected $0.04 from pot
*** SUMMARY ***
Total pot $0.04 | Rake $0 | Jackpot $0 | Bingo $0 | Fortune $0 | Tax $0
Seat 1: Hero (button) folded before Flop (didn't bet)
Seat 2: 2ec85018 (small blind) folded before Flop
Seat 3: 81f09a8e (big blind) collected ($0.04)
Seat 4: 2cae9604 folded before Flop (didn't bet)
Seat 5: de3b84bb folded before Flop (didn't bet)
Seat 6: 89ac50e8 folded before Flop (didn't bet)


Poker Hand #RC2078445292: Hold'em No Limit ($0.02/$0.05) - 2023/12/22 21:06:57
Table 'RushAndCash778355' 6-max Seat #1 is the button
Seat 1: c0d3508b ($2.52 in chips)
Seat 2: 829aa739 ($6.91 in chips)
Seat 3: e3589ec ($2.16 in chips)
Seat 4: e8886428 ($36.07 in chips)
Seat 5: Hero ($5.12 in chips)
Seat 6: f4ef789c ($10.59 in chips)
829aa739: posts small blind $0.02
e3589ec: posts big blind $0.05
*** HOLE CARDS ***
Dealt to c0d3508b 
Dealt to 829aa739 
Dealt to e3589ec 
Dealt to e8886428 
Dealt to Hero [3s Kc]
Dealt to f4ef789c 
e8886428: folds
Hero: folds
f4ef789c: folds
c0d3508b: folds
829aa739: raises $0.1 to $0.15
e3589ec: folds
Uncalled bet ($0.1) returned to 829aa739
*** SHOWDOWN ***
829aa739 collected $0.1 from pot
*** SUMMARY ***
Total pot $0.1 | Rake $0 | Jackpot $0 | Bingo $0 | Fortune $0 | Tax $0
Seat 1: c0d3508b (button) folded before Flop (didn't bet)
Seat 2: 829aa739 (small blind) collected ($0.1)
Seat 3: e3589ec (big blind) folded before Flop
Seat 4: e8886428 folded before Flop (didn't bet)
Seat 5: Hero folded before Flop (didn't bet)
Seat 6: f4ef789c folded before Flop (didn't bet)


Poker Hand #RC2078445219: Hold'em No Limit ($0.02/$0.05) - 2023/12/22 21:06:53
Table 'RushAndCash778319' 6-max Seat #1 is the button
Seat 1: 6ea11ecf ($5.85 in chips)
Seat 2: e8df5901 ($7.28 in chips)
Seat 3: b7c101a2 ($8.62 in chips)
Seat 4: Hero ($5.12 in chips)
Seat 5: 673162b7 ($9.89 in chips)
Seat 6: 59a39874 ($8.13 in chips)
e8df5901: posts small blind $0.02
b7c101a2: posts big blind $0.05
*** HOLE CARDS ***
Dealt to 6ea11ecf 
Dealt to e8df5901 
Dealt to b7c101a2 
Dealt to Hero [4c 5d]
Dealt to 673162b7 
Dealt to 59a39874 
Hero: folds
673162b7: folds
59a39874: folds
6ea11ecf: folds
e8df5901: folds
Uncalled bet ($0.03) returned to b7c101a2
*** SHOWDOWN ***
b7c101a2 collected $0.04 from pot
*** SUMMARY ***
Total pot $0.04 | Rake $0 | Jackpot $0 | Bingo $0 | Fortune $0 | Tax $0
Seat 1: 6ea11ecf (button) folded before Flop (didn't bet)
Seat 2: e8df5901 (small blind) folded before Flop
Seat 3: b7c101a2 (big blind) collected ($0.04)
Seat 4: Hero folded before Flop (didn't bet)
Seat 5: 673162b7 folded before Flop (didn't bet)
Seat 6: 59a39874 folded before Flop (didn't bet)


Poker Hand #RC2078445159: Hold'em No Limit ($0.02/$0.05) - 2023/12/22 21:06:50
Table 'RushAndCash778289' 6-max Seat #1 is the button
Seat 1: e69446ee ($5.15 in chips)
Seat 2: 3928912e ($5.02 in chips)
Seat 3: d20d8a42 ($4.51 in chips)
Seat 4: c44d0590 ($6.73 in chips)
Seat 5: f03c68f3 ($7.52 in chips)
Seat 6: Hero ($5.12 in chips)
3928912e: posts small blind $0.02
d20d8a42: posts big blind $0.05
*** HOLE CARDS ***
Dealt to e69446ee 
Dealt to 3928912e 
Dealt to d20d8a42 
Dealt to c44d0590 
Dealt to f03c68f3 
Dealt to Hero [6d Ah]
c44d0590: folds
f03c68f3: folds
Hero: folds
e69446ee: raises $0.08 to $0.13
3928912e: folds
d20d8a42: folds
Uncalled bet ($0.08) returned to e69446ee
*** SHOWDOWN ***
e69446ee collected $0.12 from pot
*** SUMMARY ***
Total pot $0.12 | Rake $0 | Jackpot $0 | Bingo $0 | Fortune $0 | Tax $0
Seat 1: e69446ee (button) collected ($0.12)
Seat 2: 3928912e (small blind) folded before Flop
Seat 3: d20d8a42 (big blind) folded before Flop
Seat 4: c44d0590 folded before Flop (didn't bet)
Seat 5: f03c68f3 folded before Flop (didn't bet)
Seat 6: Hero folded before Flop (didn't bet)


Poker Hand #RC2078445007: Hold'em No Limit ($0.02/$0.05) - 2023/12/22 21:06:41
Table 'RushAndCash778211' 6-max Seat #1 is the button
Seat 1: Hero ($5.12 in chips)
Seat 2: d7f451d5 ($12.43 in chips)
Seat 3: b8103a2d ($8.67 in chips)
Seat 4: 8e0f056d ($7.47 in chips)
Seat 5: 44231a0a ($19.94 in chips)
Seat 6: 875f34a0 ($9.71 in chips)
d7f451d5: posts small blind $0.02
b8103a2d: posts big blind $0.05
*** HOLE CARDS ***
Dealt to Hero [3s 2c]
Dealt to d7f451d5 
Dealt to b8103a2d 
Dealt to 8e0f056d 
Dealt to 44231a0a 
Dealt to 875f34a0 
8e0f056d: raises $0.05 to $0.1
44231a0a: calls $0.1
875f34a0: folds
Hero: folds
d7f451d5: folds
b8103a2d: folds
*** FLOP *** [9d 3d 6c]
8e0f056d: checks
44231a0a: bets $0.27
8e0f056d: calls $0.27
*** TURN *** [9d 3d 6c] [6d]
8e0f056d: checks
44231a0a: bets $0.41
8e0f056d: calls $0.41
*** RIVER *** [9d 3d 6c 6d] [3c]
8e0f056d: checks
44231a0a: checks
8e0f056d: shows [Qc Qd] (Pair of Queens and Pair of Sixes)
44231a0a: shows [Th 9h] (Pair of Nines and Pair of Sixes)
*** SHOWDOWN ***
8e0f056d collected $1.47 from pot
*** SUMMARY ***
Total pot $1.63 | Rake $0.09 | Jackpot $0.07 | Bingo $0 | Fortune $0 | Tax $0
Board [9d 3d 6c 6d 3c]
Seat 1: Hero (button) folded before Flop (didn't bet)
Seat 2: d7f451d5 (small blind) folded before Flop
Seat 3: b8103a2d (big blind) folded before Flop
Seat 4: 8e0f056d showed [Qc Qd] and won ($1.47) with Pair of Queens and Pair of Sixes
Seat 5: 44231a0a showed [Th 9h] and lost with Pair of Nines and Pair of Sixes
Seat 6: 875f34a0 folded before Flop (didn't bet)


Poker Hand #RC2078424683: Hold'em No Limit ($0.02/$0.05) - 2023/12/22 21:06:23
Table 'RushAndCash778058' 6-max Seat #1 is the button
Seat 1: f751acea ($6.03 in chips)
Seat 2: c87acea2 ($15.34 in chips)
Seat 3: Hero ($5.17 in chips)
Seat 4: c9faf803 ($11.56 in chips)
Seat 5: 688f0ff0 ($5.02 in chips)
Seat 6: 172eb8ad ($4.34 in chips)
c87acea2: posts small blind $0.02
Hero: posts big blind $0.05
*** HOLE CARDS ***
Dealt to f751acea 
Dealt to c87acea2 
Dealt to Hero [6c 9c]
Dealt to c9faf803 
Dealt to 688f0ff0 
Dealt to 172eb8ad 
c9faf803: raises $0.05 to $0.1
688f0ff0: folds
172eb8ad: raises $0.1 to $0.2
f751acea: folds
c87acea2: folds
Hero: folds
c9faf803: calls $0.1
*** FLOP *** [Ts Jc 3d]
c9faf803: checks
172eb8ad: checks
*** TURN *** [Ts Jc 3d] [Td]
c9faf803: checks
172eb8ad: checks
*** RIVER *** [Ts Jc 3d Td] [4s]
c9faf803: bets $0.36
172eb8ad: folds
Uncalled bet ($0.36) returned to c9faf803
*** SHOWDOWN ***
c9faf803 collected $0.45 from pot
*** SUMMARY ***
Total pot $0.47 | Rake $0.02 | Jackpot $0 | Bingo $0 | Fortune $0 | Tax $0
Board [Ts Jc 3d Td 4s]
Seat 1: f751acea (button) folded before Flop (didn't bet)
Seat 2: c87acea2 (small blind) folded before Flop
Seat 3: Hero (big blind) folded before Flop
Seat 4: c9faf803 won ($0.45)
Seat 5: 688f0ff0 folded before Flop (didn't bet)
Seat 6: 172eb8ad folded on the River


Poker Hand #RC2078424614: Hold'em No Limit ($0.02/$0.05) - 2023/12/22 21:06:19
Table 'RushAndCash778026' 6-max Seat #1 is the button
Seat 1: e27d5699 ($3.57 in chips)
Seat 2: Hero ($5.19 in chips)
Seat 3: c0d3508b ($2.57 in chips)
Seat 4: 86f62bb0 ($5 in chips)
Seat 5: b4aaf9de ($6.81 in chips)
Seat 6: 869465ff ($15.54 in chips)
Hero: posts small blind $0.02
c0d3508b: posts big blind $0.05
*** HOLE CARDS ***
Dealt to e27d5699 
Dealt to Hero [4s 2s]
Dealt to c0d3508b 
Dealt to 86f62bb0 
Dealt to b4aaf9de 
Dealt to 869465ff 
86f62bb0: folds
b4aaf9de: folds
869465ff: folds
e27d5699: raises $3.52 to $3.57 and is all-in
Hero: folds
c0d3508b: folds
Uncalled bet ($3.52) returned to e27d5699
*** SHOWDOWN ***
e27d5699 collected $0.12 from pot
*** SUMMARY ***
Total pot $0.12 | Rake $0 | Jackpot $0 | Bingo $0 | Fortune $0 | Tax $0
Seat 1: e27d5699 (button) collected ($0.12)
Seat 2: Hero (small blind) folded before Flop
Seat 3: c0d3508b (big blind) folded before Flop
Seat 4: 86f62bb0 folded before Flop (didn't bet)
Seat 5: b4aaf9de folded before Flop (didn't bet)
Seat 6: 869465ff folded before Flop (didn't bet)


Poker Hand #RC2078424545: Hold'em No Limit ($0.02/$0.05) - 2023/12/22 21:06:15
Table 'RushAndCash777990' 6-max Seat #1 is the button
Seat 1: c44d0590 ($6.71 in chips)
Seat 2: 3dbf95c1 ($7.88 in chips)
Seat 3: 84572dc4 ($5 in chips)
Seat 4: Hero ($5.19 in chips)
Seat 5: b4aaf9de ($6.81 in chips)
Seat 6: 9ab125dd ($9.61 in chips)
3dbf95c1: posts small blind $0.02
84572dc4: posts big blind $0.05
*** HOLE CARDS ***
Dealt to c44d0590 
Dealt to 3dbf95c1 
Dealt to 84572dc4 
Dealt to Hero [Ad 9h]
Dealt to b4aaf9de 
Dealt to 9ab125dd 
Hero: folds
b4aaf9de: folds
9ab125dd: folds
c44d0590: folds
3dbf95c1: folds
Uncalled bet ($0.03) returned to 84572dc4
*** SHOWDOWN ***
84572dc4 collected $0.04 from pot
*** SUMMARY ***
Total pot $0.04 | Rake $0 | Jackpot $0 | Bingo $0 | Fortune $0 | Tax $0
Seat 1: c44d0590 (button) folded before Flop (didn't bet)
Seat 2: 3dbf95c1 (small blind) folded before Flop
Seat 3: 84572dc4 (big blind) collected ($0.04)
Seat 4: Hero folded before Flop (didn't bet)
Seat 5: b4aaf9de folded before Flop (didn't bet)
Seat 6: 9ab125dd folded before Flop (didn't bet)


Poker Hand #RC2078424455: Hold'em No Limit ($0.02/$0.05) - 2023/12/22 21:06:10
Table 'RushAndCash777946' 6-max Seat #1 is the button
Seat 1: b8103a2d ($8.62 in chips)
Seat 2: 4868ae59 ($3.68 in chips)
Seat 3: 3d582dec ($5.72 in chips)
Seat 4: Hero ($5.19 in chips)
Seat 5: 59c7f4b1 ($8.4 in chips)
Seat 6: d0b2d784 ($6.57 in chips)
4868ae59: posts small blind $0.02
3d582dec: posts big blind $0.05
*** HOLE CARDS ***
Dealt to b8103a2d 
Dealt to 4868ae59 
Dealt to 3d582dec 
Dealt to Hero [Kc 9c]
Dealt to 59c7f4b1 
Dealt to d0b2d784 
Hero: folds
59c7f4b1: folds
d0b2d784: folds
b8103a2d: folds
4868ae59: calls $0.03
3d582dec: checks
*** FLOP *** [8c Ts 9d]
4868ae59: checks
3d582dec: bets $0.08
4868ae59: folds
Uncalled bet ($0.08) returned to 3d582dec
*** SHOWDOWN ***
3d582dec collected $0.1 from pot
*** SUMMARY ***
Total pot $0.1 | Rake $0 | Jackpot $0 | Bingo $0 | Fortune $0 | Tax $0
Board [8c Ts 9d]
Seat 1: b8103a2d (button) folded before Flop (didn't bet)
Seat 2: 4868ae59 (small blind) folded on the Flop
Seat 3: 3d582dec (big blind) won ($0.1)
Seat 4: Hero folded before Flop (didn't bet)
Seat 5: 59c7f4b1 folded before Flop (didn't bet)
Seat 6: d0b2d784 folded before Flop (didn't bet)


Poker Hand #RC2078423786: Hold'em No Limit ($0.02/$0.05) - 2023/12/22 21:05:32
Table 'RushAndCash777637' 6-max Seat #1 is the button
Seat 1: Hero ($5.12 in chips)
Seat 2: f677406 ($5 in chips)
Seat 3: 1adb19a8 ($3.97 in chips)
Seat 4: cbfe1acc ($7.71 in chips)
Seat 5: 3c41b7f8 ($5.23 in chips)
Seat 6: 999944fc ($3.12 in chips)
f677406: posts small blind $0.02
1adb19a8: posts big blind $0.05
*** HOLE CARDS ***
Dealt to Hero [8c 8s]
Dealt to f677406 
Dealt to 1adb19a8 
Dealt to cbfe1acc 
Dealt to 3c41b7f8 
Dealt to 999944fc 
cbfe1acc: folds
3c41b7f8: folds
999944fc: folds
Hero: raises $0.08 to $0.13
f677406: folds
1adb19a8: folds
Uncalled bet ($0.08) returned to Hero
*** SHOWDOWN ***
Hero collected $0.12 from pot
*** SUMMARY ***
Total pot $0.12 | Rake $0 | Jackpot $0 | Bingo $0 | Fortune $0 | Tax $0
Seat 1: Hero (button) collected ($0.12)
Seat 2: f677406 (small blind) folded before Flop
Seat 3: 1adb19a8 (big blind) folded before Flop
Seat 4: cbfe1acc folded before Flop (didn't bet)
Seat 5: 3c41b7f8 folded before Flop (didn't bet)
Seat 6: 999944fc folded before Flop (didn't bet)


Poker Hand #RC2078423721: Hold'em No Limit ($0.02/$0.05) - 2023/12/22 21:05:29
Table 'RushAndCash777609' 6-max Seat #1 is the button
Seat 1: 94b80c38 ($2.89 in chips)
Seat 2: c2881b52 ($13.46 in chips)
Seat 3: 622d6af4 ($5.24 in chips)
Seat 4: 44231a0a ($20.08 in chips)
Seat 5: 1f940f2d ($9.72 in chips)
Seat 6: Hero ($5.12 in chips)
c2881b52: posts small blind $0.02
622d6af4: posts big blind $0.05
*** HOLE CARDS ***
Dealt to 94b80c38 
Dealt to c2881b52 
Dealt to 622d6af4 
Dealt to 44231a0a 
Dealt to 1f940f2d 
Dealt to Hero [9s 2c]
44231a0a: folds
1f940f2d: folds
Hero: folds
94b80c38: raises $0.1 to $0.15
c2881b52: folds
622d6af4: folds
Uncalled bet ($0.1) returned to 94b80c38
*** SHOWDOWN ***
94b80c38 collected $0.12 from pot
*** SUMMARY ***
Total pot $0.12 | Rake $0 | Jackpot $0 | Bingo $0 | Fortune $0 | Tax $0
Seat 1: 94b80c38 (button) collected ($0.12)
Seat 2: c2881b52 (small blind) folded before Flop
Seat 3: 622d6af4 (big blind) folded before Flop
Seat 4: 44231a0a folded before Flop (didn't bet)
Seat 5: 1f940f2d folded before Flop (didn't bet)
Seat 6: Hero folded before Flop (didn't bet)


Poker Hand #RC2078423307: Hold'em No Limit ($0.02/$0.05) - 2023/12/22 21:05:06
Table 'RushAndCash777426' 6-max Seat #1 is the button
Seat 1: ca7e2c6d ($5.54 in chips)
Seat 2: Hero ($5 in chips)
Seat 3: f03725f ($12.09 in chips)
Seat 4: f59d97af ($8.65 in chips)
Seat 5: 16ecd29a ($10.92 in chips)
Seat 6: 27517d94 ($6.78 in chips)
Hero: posts small blind $0.02
f03725f: posts big blind $0.05
*** HOLE CARDS ***
Dealt to ca7e2c6d 
Dealt to Hero [8s Ac]
Dealt to f03725f 
Dealt to f59d97af 
Dealt to 16ecd29a 
Dealt to 27517d94 
f59d97af: folds
16ecd29a: folds
27517d94: folds
ca7e2c6d: folds
Hero: raises $0.1 to $0.15
f03725f: folds
Uncalled bet ($0.1) returned to Hero
*** SHOWDOWN ***
Hero collected $0.1 from pot
*** SUMMARY ***
Total pot $0.1 | Rake $0 | Jackpot $0 | Bingo $0 | Fortune $0 | Tax $0
Seat 1: ca7e2c6d (button) folded before Flop (didn't bet)
Seat 2: Hero (small blind) collected ($0.1)
Seat 3: f03725f (big blind) folded before Flop
Seat 4: f59d97af folded before Flop (didn't bet)
Seat 5: 16ecd29a folded before Flop (didn't bet)
Seat 6: 27517d94 folded before Flop (didn't bet)


Poker Hand #RC2078423234: Hold'em No Limit ($0.02/$0.05) - 2023/12/22 21:05:02
Table 'RushAndCash777394' 6-max Seat #1 is the button
Seat 1: 294b7dd8 ($7.18 in chips)
Seat 2: c44d0590 ($6.85 in chips)
Seat 3: Hero ($5 in chips)
Seat 4: f95c708 ($5.42 in chips)
Seat 5: 1cde4adf ($5.2 in chips)
Seat 6: 998574b7 ($5 in chips)
c44d0590: posts small blind $0.02
Hero: posts big blind $0.05
*** HOLE CARDS ***
Dealt to 294b7dd8 
Dealt to c44d0590 
Dealt to Hero [5c 4d]
Dealt to f95c708 
Dealt to 1cde4adf 
Dealt to 998574b7 
f95c708: folds
1cde4adf: folds
998574b7: folds
294b7dd8: folds
c44d0590: folds
Uncalled bet ($0.03) returned to Hero
*** SHOWDOWN ***
Hero collected $0.04 from pot
*** SUMMARY ***
Total pot $0.04 | Rake $0 | Jackpot $0 | Bingo $0 | Fortune $0 | Tax $0
Seat 1: 294b7dd8 (button) folded before Flop (didn't bet)
Seat 2: c44d0590 (small blind) folded before Flop
Seat 3: Hero (big blind) collected ($0.04)
Seat 4: f95c708 folded before Flop (didn't bet)
Seat 5: 1cde4adf folded before Flop (didn't bet)
Seat 6: 998574b7 folded before Flop (didn't bet)


Poker Hand #RC2078422280: Hold'em No Limit ($0.02/$0.05) - 2023/12/22 21:04:07
Table 'RushAndCash776969' 6-max Seat #1 is the button
Seat 1: 81ecaac5 ($5.13 in chips)
Seat 2: 5fea4bbc ($11.79 in chips)
Seat 3: 27517d94 ($7.18 in chips)
Seat 4: Hero ($5 in chips)
Seat 5: c8389234 ($14.67 in chips)
Seat 6: 919daa51 ($5.25 in chips)
5fea4bbc: posts small blind $0.02
27517d94: posts big blind $0.05
*** HOLE CARDS ***
Dealt to 81ecaac5 
Dealt to 5fea4bbc 
Dealt to 27517d94 
Dealt to Hero [Ks Kh]
Dealt to c8389234 
Dealt to 919daa51 
Hero: raises $0.05 to $0.1
c8389234: folds
919daa51: folds
81ecaac5: folds
5fea4bbc: raises $0.3 to $0.4
27517d94: calls $0.35
Hero: raises $0.6 to $1
5fea4bbc: raises $10.79 to $11.79 and is all-in
27517d94: folds
Hero: folds
Uncalled bet ($10.79) returned to 5fea4bbc
*** SHOWDOWN ***
5fea4bbc collected $2.22 from pot
*** SUMMARY ***
Total pot $2.4 | Rake $0.11 | Jackpot $0.07 | Bingo $0 | Fortune $0 | Tax $0
Seat 1: 81ecaac5 (button) folded before Flop (didn't bet)
Seat 2: 5fea4bbc (small blind) collected ($2.22)
Seat 3: 27517d94 (big blind) folded before Flop
Seat 4: Hero folded before Flop
Seat 5: c8389234 folded before Flop (didn't bet)
Seat 6: 919daa51 folded before Flop (didn't bet)


Poker Hand #RC2078422162: Hold'em No Limit ($0.02/$0.05) - 2023/12/22 21:04:01
Table 'RushAndCash776917' 6-max Seat #1 is the button
Seat 1: 8d09c020 ($5.41 in chips)
Seat 2: f1ad1c02 ($5.09 in chips)
Seat 3: ff6f425f ($11.64 in chips)
Seat 4: 3a44e48f ($5 in chips)
Seat 5: Hero ($5 in chips)
Seat 6: 801c157f ($15.52 in chips)
f1ad1c02: posts small blind $0.02
ff6f425f: posts big blind $0.05
*** HOLE CARDS ***
Dealt to 8d09c020 
Dealt to f1ad1c02 
Dealt to ff6f425f 
Dealt to 3a44e48f 
Dealt to Hero [Jd 8d]
Dealt to 801c157f 
3a44e48f: folds
Hero: folds
801c157f: folds
8d09c020: raises $0.12 to $0.17
f1ad1c02: folds
ff6f425f: folds
Uncalled bet ($0.12) returned to 8d09c020
*** SHOWDOWN ***
8d09c020 collected $0.12 from pot
*** SUMMARY ***
Total pot $0.12 | Rake $0 | Jackpot $0 | Bingo $0 | Fortune $0 | Tax $0
Seat 1: 8d09c020 (button) collected ($0.12)
Seat 2: f1ad1c02 (small blind) folded before Flop
Seat 3: ff6f425f (big blind) folded before Flop
Seat 4: 3a44e48f folded before Flop (didn't bet)
Seat 5: Hero folded before Flop (didn't bet)
Seat 6: 801c157f folded before Flop (didn't bet)


Poker Hand #RC2078421652: Hold'em No Limit ($0.02/$0.05) - 2023/12/22 21:03:33
Table 'RushAndCash776675' 6-max Seat #1 is the button
Seat 1: 5f87768d ($5 in chips)
Seat 2: 993ccadb ($13.14 in chips)
Seat 3: 9fd86997 ($19.19 in chips)
Seat 4: Hero ($5 in chips)
Seat 5: d04b341b ($4.83 in chips)
Seat 6: 6c88f65e ($2.07 in chips)
993ccadb: posts small blind $0.02
9fd86997: posts big blind $0.05
*** HOLE CARDS ***
Dealt to 5f87768d 
Dealt to 993ccadb 
Dealt to 9fd86997 
Dealt to Hero [4c 4s]
Dealt to d04b341b 
Dealt to 6c88f65e 
Hero: raises $0.05 to $0.1
d04b341b: folds
6c88f65e: folds
5f87768d: folds
993ccadb: raises $0.4 to $0.5
9fd86997: folds
Hero: folds
Uncalled bet ($0.4) returned to 993ccadb
*** SHOWDOWN ***
993ccadb collected $0.24 from pot
*** SUMMARY ***
Total pot $0.25 | Rake $0.01 | Jackpot $0 | Bingo $0 | Fortune $0 | Tax $0
Seat 1: 5f87768d (button) folded before Flop (didn't bet)
Seat 2: 993ccadb (small blind) collected ($0.24)
Seat 3: 9fd86997 (big blind) folded before Flop
Seat 4: Hero folded before Flop
Seat 5: d04b341b folded before Flop (didn't bet)
Seat 6: 6c88f65e folded before Flop (didn't bet)


Poker Hand #RC2078421518: Hold'em No Limit ($0.02/$0.05) - 2023/12/22 21:03:27
Table 'RushAndCash776613' 6-max Seat #1 is the button
Seat 1: Hero ($5 in chips)
Seat 2: 5bebfa04 ($5.96 in chips)
Seat 3: b427f11f ($1.73 in chips)
Seat 4: 8f87a7f3 ($5.31 in chips)
Seat 5: f4ef789c ($10.99 in chips)
Seat 6: 857de63c ($8.73 in chips)
5bebfa04: posts small blind $0.02
b427f11f: posts big blind $0.05
*** HOLE CARDS ***
Dealt to Hero [Jc 4h]
Dealt to 5bebfa04 
Dealt to b427f11f 
Dealt to 8f87a7f3 
Dealt to f4ef789c 
Dealt to 857de63c 
8f87a7f3: folds
f4ef789c: folds
857de63c: folds
Hero: folds
5bebfa04: folds
Uncalled bet ($0.03) returned to b427f11f
*** SHOWDOWN ***
b427f11f collected $0.04 from pot
*** SUMMARY ***
Total pot $0.04 | Rake $0 | Jackpot $0 | Bingo $0 | Fortune $0 | Tax $0
Seat 1: Hero (button) folded before Flop (didn't bet)
Seat 2: 5bebfa04 (small blind) folded before Flop
Seat 3: b427f11f (big blind) collected ($0.04)
Seat 4: 8f87a7f3 folded before Flop (didn't bet)
Seat 5: f4ef789c folded before Flop (didn't bet)
Seat 6: 857de63c folded before Flop (didn't bet)


Poker Hand #RC2078421336: Hold'em No Limit ($0.02/$0.05) - 2023/12/22 21:03:17
Table 'RushAndCash776531' 6-max Seat #1 is the button
Seat 1: c3c9a58d ($7.84 in chips)
Seat 2: b75ac6ee ($5 in chips)
Seat 3: Hero ($5.05 in chips)
Seat 4: e9650524 ($3.45 in chips)
Seat 5: af92dfc8 ($5.11 in chips)
Seat 6: c18ede1f ($5.37 in chips)
b75ac6ee: posts small blind $0.02
Hero: posts big blind $0.05
*** HOLE CARDS ***
Dealt to c3c9a58d 
Dealt to b75ac6ee 
Dealt to Hero [6h 5s]
Dealt to e9650524 
Dealt to af92dfc8 
Dealt to c18ede1f 
e9650524: raises $0.05 to $0.1
af92dfc8: calls $0.1
c18ede1f: folds
c3c9a58d: folds
b75ac6ee: folds
Hero: folds
*** FLOP *** [8h 3h 8d]
e9650524: checks
af92dfc8: checks
*** TURN *** [8h 3h 8d] [6d]
e9650524: checks
af92dfc8: checks
*** RIVER *** [8h 3h 8d 6d] [3d]
e9650524: checks
af92dfc8: bets $0.14
e9650524: folds
Uncalled bet ($0.14) returned to af92dfc8
*** SHOWDOWN ***
af92dfc8 collected $0.26 from pot
*** SUMMARY ***
Total pot $0.27 | Rake $0.01 | Jackpot $0 | Bingo $0 | Fortune $0 | Tax $0
Board [8h 3h 8d 6d 3d]
Seat 1: c3c9a58d (button) folded before Flop (didn't bet)
Seat 2: b75ac6ee (small blind) folded before Flop
Seat 3: Hero (big blind) folded before Flop
Seat 4: e9650524 folded on the River
Seat 5: af92dfc8 won ($0.26)
Seat 6: c18ede1f folded before Flop (didn't bet)


Poker Hand #RC2078421263: Hold'em No Limit ($0.02/$0.05) - 2023/12/22 21:03:13
Table 'RushAndCash776497' 6-max Seat #1 is the button
Seat 1: 20a35d2e ($8.59 in chips)
Seat 2: Hero ($5.07 in chips)
Seat 3: cc93ded5 ($4.93 in chips)
Seat 4: 7ddba90d ($5.28 in chips)
Seat 5: d56f57b9 ($5.48 in chips)
Seat 6: 816eac8 ($6.56 in chips)
Hero: posts small blind $0.02
cc93ded5: posts big blind $0.05
*** HOLE CARDS ***
Dealt to 20a35d2e 
Dealt to Hero [6s 7s]
Dealt to cc93ded5 
Dealt to 7ddba90d 
Dealt to d56f57b9 
Dealt to 816eac8 
7ddba90d: folds
d56f57b9: raises $0.06 to $0.11
816eac8: folds
20a35d2e: folds
Hero: folds
cc93ded5: folds
Uncalled bet ($0.06) returned to d56f57b9
*** SHOWDOWN ***
d56f57b9 collected $0.12 from pot
*** SUMMARY ***
Total pot $0.12 | Rake $0 | Jackpot $0 | Bingo $0 | Fortune $0 | Tax $0
Seat 1: 20a35d2e (button) folded before Flop (didn't bet)
Seat 2: Hero (small blind) folded before Flop
Seat 3: cc93ded5 (big blind) folded before Flop
Seat 4: 7ddba90d folded before Flop (didn't bet)
Seat 5: d56f57b9 collected ($0.12)
Seat 6: 816eac8 folded before Flop (didn't bet)


Poker Hand #RC2078421060: Hold'em No Limit ($0.02/$0.05) - 2023/12/22 21:03:02
Table 'RushAndCash776399' 6-max Seat #1 is the button
Seat 1: a8759ecd ($4.59 in chips)
Seat 2: 86f62bb0 ($5.14 in chips)
Seat 3: eeb37e34 ($5.8 in chips)
Seat 4: 409f5cad ($5.18 in chips)
Seat 5: a8ee5981 ($4.82 in chips)
Seat 6: Hero ($5 in chips)
86f62bb0: posts small blind $0.02
eeb37e34: posts big blind $0.05
*** HOLE CARDS ***
Dealt to a8759ecd 
Dealt to 86f62bb0 
Dealt to eeb37e34 
Dealt to 409f5cad 
Dealt to a8ee5981 
Dealt to Hero [Ad 3d]
409f5cad: folds
a8ee5981: folds
Hero: raises $0.05 to $0.1
a8759ecd: folds
86f62bb0: folds
eeb37e34: folds
Uncalled bet ($0.05) returned to Hero
*** SHOWDOWN ***
Hero collected $0.12 from pot
*** SUMMARY ***
Total pot $0.12 | Rake $0 | Jackpot $0 | Bingo $0 | Fortune $0 | Tax $0
Seat 1: a8759ecd (button) folded before Flop (didn't bet)
Seat 2: 86f62bb0 (small blind) folded before Flop
Seat 3: eeb37e34 (big blind) folded before Flop
Seat 4: 409f5cad folded before Flop (didn't bet)
Seat 5: a8ee5981 folded before Flop (didn't bet)
Seat 6: Hero collected ($0.12)


Poker Hand #RC2078420998: Hold'em No Limit ($0.02/$0.05) - 2023/12/22 21:02:58
Table 'RushAndCash776369' 6-max Seat #1 is the button
Seat 1: Hero ($5 in chips)
Seat 2: c6bf1d22 ($8.94 in chips)
Seat 3: d4c9514b ($5.3 in chips)
Seat 4: a04ab5b3 ($5.28 in chips)
Seat 5: 5c16c35c ($11.65 in chips)
Seat 6: 8818ba78 ($7.57 in chips)
c6bf1d22: posts small blind $0.02
d4c9514b: posts big blind $0.05
*** HOLE CARDS ***
Dealt to Hero [Jc 6h]
Dealt to c6bf1d22 
Dealt to d4c9514b 
Dealt to a04ab5b3 
Dealt to 5c16c35c 
Dealt to 8818ba78 
a04ab5b3: folds
5c16c35c: folds
8818ba78: folds
Hero: folds
c6bf1d22: folds
Uncalled bet ($0.03) returned to d4c9514b
*** SHOWDOWN ***
d4c9514b collected $0.04 from pot
*** SUMMARY ***
Total pot $0.04 | Rake $0 | Jackpot $0 | Bingo $0 | Fortune $0 | Tax $0
Seat 1: Hero (button) folded before Flop (didn't bet)
Seat 2: c6bf1d22 (small blind) folded before Flop
Seat 3: d4c9514b (big blind) collected ($0.04)
Seat 4: a04ab5b3 folded before Flop (didn't bet)
Seat 5: 5c16c35c folded before Flop (didn't bet)
Seat 6: 8818ba78 folded before Flop (didn't bet)


Poker Hand #RC2078420939: Hold'em No Limit ($0.02/$0.05) - 2023/12/22 21:02:55
Table 'RushAndCash776340' 6-max Seat #1 is the button
Seat 1: bf955ffb ($5 in chips)
Seat 2: 494d7c43 ($5.18 in chips)
Seat 3: 869465ff ($14.68 in chips)
Seat 4: Hero ($5 in chips)
Seat 5: b01c40bf ($14.07 in chips)
Seat 6: a04ab5b3 ($5.28 in chips)
494d7c43: posts small blind $0.02
869465ff: posts big blind $0.05
*** HOLE CARDS ***
Dealt to bf955ffb 
Dealt to 494d7c43 
Dealt to 869465ff 
Dealt to Hero [9c 4c]
Dealt to b01c40bf 
Dealt to a04ab5b3 
Hero: folds
b01c40bf: folds
a04ab5b3: folds
bf955ffb: folds
494d7c43: folds
Uncalled bet ($0.03) returned to 869465ff
*** SHOWDOWN ***
869465ff collected $0.04 from pot
*** SUMMARY ***
Total pot $0.04 | Rake $0 | Jackpot $0 | Bingo $0 | Fortune $0 | Tax $0
Seat 1: bf955ffb (button) folded before Flop (didn't bet)
Seat 2: 494d7c43 (small blind) folded before Flop
Seat 3: 869465ff (big blind) collected ($0.04)
Seat 4: Hero folded before Flop (didn't bet)
Seat 5: b01c40bf folded before Flop (didn't bet)
Seat 6: a04ab5b3 folded before Flop (didn't bet)


Poker Hand #RC2078420770: Hold'em No Limit ($0.02/$0.05) - 2023/12/22 21:02:45
Table 'RushAndCash776270' 6-max Seat #1 is the button
Seat 1: 7f11da5e ($2.12 in chips)
Seat 2: 89ac50e8 ($13.2 in chips)
Seat 3: Hero ($5 in chips)
Seat 4: f0337111 ($5 in chips)
Seat 5: c44d0590 ($5.07 in chips)
Seat 6: b8534e0 ($10.86 in chips)
89ac50e8: posts small blind $0.02
Hero: posts big blind $0.05
*** HOLE CARDS ***
Dealt to 7f11da5e 
Dealt to 89ac50e8 
Dealt to Hero [Jc Qs]
Dealt to f0337111 
Dealt to c44d0590 
Dealt to b8534e0 
f0337111: folds
c44d0590: folds
b8534e0: raises $0.08 to $0.13
7f11da5e: calls $0.13
89ac50e8: folds
Hero: folds
*** FLOP *** [7s 2c 2d]
b8534e0: bets $0.11
7f11da5e: calls $0.11
*** TURN *** [7s 2c 2d] [Jh]
b8534e0: checks
7f11da5e: bets $0.28
b8534e0: folds
Uncalled bet ($0.28) returned to 7f11da5e
*** SHOWDOWN ***
7f11da5e collected $0.53 from pot
*** SUMMARY ***
Total pot $0.55 | Rake $0.02 | Jackpot $0 | Bingo $0 | Fortune $0 | Tax $0
Board [7s 2c 2d Jh]
Seat 1: 7f11da5e (button) won ($0.53)
Seat 2: 89ac50e8 (small blind) folded before Flop
Seat 3: Hero (big blind) folded before Flop
Seat 4: f0337111 folded before Flop (didn't bet)
Seat 5: c44d0590 folded before Flop (didn't bet)
Seat 6: b8534e0 folded on the Turn


Poker Hand #RC2078420083: Hold'em No Limit ($0.02/$0.05) - 2023/12/22 21:02:06
Table 'RushAndCash775955' 6-max Seat #1 is the button
Seat 1: c7592cbf ($11.86 in chips)
Seat 2: Hero ($5 in chips)
Seat 3: e530eac5 ($5.3 in chips)
Seat 4: ebeb62f7 ($5.01 in chips)
Seat 5: 7810e6bd ($4.56 in chips)
Seat 6: f59d97af ($5.32 in chips)
Hero: posts small blind $0.02
e530eac5: posts big blind $0.05
*** HOLE CARDS ***
Dealt to c7592cbf 
Dealt to Hero [Jc Kd]
Dealt to e530eac5 
Dealt to ebeb62f7 
Dealt to 7810e6bd 
Dealt to f59d97af 
ebeb62f7: folds
7810e6bd: folds
f59d97af: folds
c7592cbf: folds
Hero: raises $0.1 to $0.15
e530eac5: calls $0.1
*** FLOP *** [3h 7d 6h]
Hero: checks
e530eac5: checks
*** TURN *** [3h 7d 6h] [8s]
Hero: checks
e530eac5: checks
*** RIVER *** [3h 7d 6h 8s] [As]
Hero: checks
e530eac5: checks
Hero: shows [Jc Kd] (Ace-High)
e530eac5: shows [Ad Th] (Pair of Aces)
*** SHOWDOWN ***
e530eac5 collected $0.29 from pot
*** SUMMARY ***
Total pot $0.3 | Rake $0.01 | Jackpot $0 | Bingo $0 | Fortune $0 | Tax $0
Board [3h 7d 6h 8s As]
Seat 1: c7592cbf (button) folded before Flop (didn't bet)
Seat 2: Hero (small blind) showed [Jc Kd] and lost with Ace-High
Seat 3: e530eac5 (big blind) showed [Ad Th] and won ($0.29) with Pair of Aces
Seat 4: ebeb62f7 folded before Flop (didn't bet)
Seat 5: 7810e6bd folded before Flop (didn't bet)
Seat 6: f59d97af folded before Flop (didn't bet)


Poker Hand #RC2078419294: Hold'em No Limit ($0.02/$0.05) - 2023/12/22 21:01:20
Table 'RushAndCash775576' 6-max Seat #1 is the button
Seat 1: 329a3fca ($3.17 in chips)
Seat 2: c4c1c89a ($5.24 in chips)
Seat 3: 35f7fbd3 ($5 in chips)
Seat 4: 8505bab2 ($5.15 in chips)
Seat 5: 3759e445 ($3.71 in chips)
Seat 6: Hero ($5 in chips)
c4c1c89a: posts small blind $0.02
35f7fbd3: posts big blind $0.05
*** HOLE CARDS ***
Dealt to 329a3fca 
Dealt to c4c1c89a 
Dealt to 35f7fbd3 
Dealt to 8505bab2 
Dealt to 3759e445 
Dealt to Hero [7s 7h]
8505bab2: folds
3759e445: raises $0.06 to $0.11
Hero: calls $0.11
329a3fca: folds
c4c1c89a: folds
35f7fbd3: calls $0.06
*** FLOP *** [Kc 4c 4h]
35f7fbd3: checks
3759e445: bets $0.07
Hero: calls $0.07
35f7fbd3: calls $0.07
*** TURN *** [Kc 4c 4h] [9c]
35f7fbd3: checks
3759e445: checks
Hero: checks
*** RIVER *** [Kc 4c 4h 9c] [Js]
35f7fbd3: checks
3759e445: bets $0.28
Hero: folds
35f7fbd3: folds
Uncalled bet ($0.28) returned to 3759e445
*** SHOWDOWN ***
3759e445 collected $0.54 from pot
*** SUMMARY ***
Total pot $0.56 | Rake $0.02 | Jackpot $0 | Bingo $0 | Fortune $0 | Tax $0
Board [Kc 4c 4h 9c Js]
Seat 1: 329a3fca (button) folded before Flop (didn't bet)
Seat 2: c4c1c89a (small blind) folded before Flop
Seat 3: 35f7fbd3 (big blind) folded on the River
Seat 4: 8505bab2 folded before Flop (didn't bet)
Seat 5: 3759e445 won ($0.54)
Seat 6: Hero folded on the River


Poker Hand #RC2078419221: Hold'em No Limit ($0.02/$0.05) - 2023/12/22 21:01:15
Table 'RushAndCash775543' 6-max Seat #1 is the button
Seat 1: 6c94c615 ($5.78 in chips)
Seat 2: d588ef94 ($5.31 in chips)
Seat 3: cb9a7609 ($5 in chips)
Seat 4: db5367a6 ($7.66 in chips)
Seat 5: b2b4173f ($3.17 in chips)
Seat 6: Hero ($5 in chips)
d588ef94: posts small blind $0.02
cb9a7609: posts big blind $0.05
*** HOLE CARDS ***
Dealt to 6c94c615 
Dealt to d588ef94 
Dealt to cb9a7609 
Dealt to db5367a6 
Dealt to b2b4173f 
Dealt to Hero [4d 7d]
db5367a6: raises $0.1 to $0.15
b2b4173f: folds
Hero: folds
6c94c615: folds
d588ef94: folds
cb9a7609: folds
Uncalled bet ($0.1) returned to db5367a6
*** SHOWDOWN ***
db5367a6 collected $0.12 from pot
*** SUMMARY ***
Total pot $0.12 | Rake $0 | Jackpot $0 | Bingo $0 | Fortune $0 | Tax $0
Seat 1: 6c94c615 (button) folded before Flop (didn't bet)
Seat 2: d588ef94 (small blind) folded before Flop
Seat 3: cb9a7609 (big blind) folded before Flop
Seat 4: db5367a6 collected ($0.12)
Seat 5: b2b4173f folded before Flop (didn't bet)
Seat 6: Hero folded before Flop (didn't bet)


Poker Hand #RC2078419094: Hold'em No Limit ($0.02/$0.05) - 2023/12/22 21:01:08
Table 'RushAndCash775488' 6-max Seat #1 is the button
Seat 1: 8f1c60bf ($7.49 in chips)
Seat 2: d9ac0d0f ($5.76 in chips)
Seat 3: ef402e16 ($7.86 in chips)
Seat 4: 4b6faedf ($6.73 in chips)
Seat 5: Hero ($5 in chips)
Seat 6: 5d317abf ($5.92 in chips)
d9ac0d0f: posts small blind $0.02
ef402e16: posts big blind $0.05
*** HOLE CARDS ***
Dealt to 8f1c60bf 
Dealt to d9ac0d0f 
Dealt to ef402e16 
Dealt to 4b6faedf 
Dealt to Hero [Td Ac]
Dealt to 5d317abf 
4b6faedf: raises $0.1 to $0.15
Hero: folds
5d317abf: folds
8f1c60bf: calls $0.15
d9ac0d0f: calls $0.13
ef402e16: calls $0.1
*** FLOP *** [9h Jd 5d]
d9ac0d0f: checks
ef402e16: checks
4b6faedf: bets $0.41
8f1c60bf: folds
d9ac0d0f: folds
ef402e16: folds
Uncalled bet ($0.41) returned to 4b6faedf
*** SHOWDOWN ***
4b6faedf collected $0.57 from pot
*** SUMMARY ***
Total pot $0.6 | Rake $0.03 | Jackpot $0 | Bingo $0 | Fortune $0 | Tax $0
Board [9h Jd 5d]
Seat 1: 8f1c60bf (button) folded on the Flop
Seat 2: d9ac0d0f (small blind) folded on the Flop
Seat 3: ef402e16 (big blind) folded on the Flop
Seat 4: 4b6faedf won ($0.57)
Seat 5: Hero folded before Flop (didn't bet)
Seat 6: 5d317abf folded before Flop (didn't bet)


Poker Hand #RC2078418824: Hold'em No Limit ($0.02/$0.05) - 2023/12/22 21:00:52
Table 'RushAndCash775364' 6-max Seat #1 is the button
Seat 1: 5bebfa04 ($5 in chips)
Seat 2: Hero ($5 in chips)
Seat 3: d726f002 ($4.53 in chips)
Seat 4: 816eac8 ($6.56 in chips)
Seat 5: cddb31fe ($2.49 in chips)
Seat 6: 4ab8a557 ($5 in chips)
Hero: posts small blind $0.02
d726f002: posts big blind $0.05
*** HOLE CARDS ***
Dealt to 5bebfa04 
Dealt to Hero [Kd 9c]
Dealt to d726f002 
Dealt to 816eac8 
Dealt to cddb31fe 
Dealt to 4ab8a557 
816eac8: folds
cddb31fe: folds
4ab8a557: folds
5bebfa04: raises $0.09 to $0.14
Hero: folds
d726f002: folds
Uncalled bet ($0.09) returned to 5bebfa04
*** SHOWDOWN ***
5bebfa04 collected $0.12 from pot
*** SUMMARY ***
Total pot $0.12 | Rake $0 | Jackpot $0 | Bingo $0 | Fortune $0 | Tax $0
Seat 1: 5bebfa04 (button) collected ($0.12)
Seat 2: Hero (small blind) folded before Flop
Seat 3: d726f002 (big blind) folded before Flop
Seat 4: 816eac8 folded before Flop (didn't bet)
Seat 5: cddb31fe folded before Flop (didn't bet)
Seat 6: 4ab8a557 folded before Flop (didn't bet)


Poker Hand #RC2078417846: Hold'em No Limit ($0.02/$0.05) - 2023/12/22 20:59:57
Table 'RushAndCash774945' 6-max Seat #1 is the button
Seat 1: eb19bb65 ($10.21 in chips)
Seat 2: 3e455537 ($6.66 in chips)
Seat 3: 680eb0e1 ($9.64 in chips)
Seat 4: 54daf47b ($10.2 in chips)
Seat 5: Hero ($5.02 in chips)
Seat 6: 3e2e2010 ($5 in chips)
3e455537: posts small blind $0.02
680eb0e1: posts big blind $0.05
*** HOLE CARDS ***
Dealt to eb19bb65 
Dealt to 3e455537 
Dealt to 680eb0e1 
Dealt to 54daf47b 
Dealt to Hero [7h 6h]
Dealt to 3e2e2010 
54daf47b: folds
Hero: raises $0.05 to $0.1
3e2e2010: folds
eb19bb65: folds
3e455537: calls $0.08
680eb0e1: folds
*** FLOP *** [8s 4c 9c]
3e455537: checks
Hero: checks
*** TURN *** [8s 4c 9c] [Jd]
3e455537: checks
Hero: checks
*** RIVER *** [8s 4c 9c Jd] [6c]
3e455537: checks
Hero: checks
3e455537: shows [Ah 8d] (Pair of Eights)
Hero: shows [7h 6h] (Pair of Sixes)
*** SHOWDOWN ***
3e455537 collected $0.24 from pot
*** SUMMARY ***
Total pot $0.25 | Rake $0.01 | Jackpot $0 | Bingo $0 | Fortune $0 | Tax $0
Board [8s 4c 9c Jd 6c]
Seat 1: eb19bb65 (button) folded before Flop (didn't bet)
Seat 2: 3e455537 (small blind) showed [Ah 8d] and won ($0.24) with Pair of Eights
Seat 3: 680eb0e1 (big blind) folded before Flop
Seat 4: 54daf47b folded before Flop (didn't bet)
Seat 5: Hero showed [7h 6h] and lost with Pair of Sixes
Seat 6: 3e2e2010 folded before Flop (didn't bet)


Poker Hand #RC2078417690: Hold'em No Limit ($0.02/$0.05) - 2023/12/22 20:59:47
Table 'RushAndCash774873' 6-max Seat #1 is the button
Seat 1: 2ed46053 ($6.73 in chips)
Seat 2: 5b035bcb ($5.17 in chips)
Seat 3: Hero ($5 in chips)
Seat 4: aa6d4c49 ($17.97 in chips)
Seat 5: 8818ba78 ($7.47 in chips)
Seat 6: 809e45f6 ($4.84 in chips)
5b035bcb: posts small blind $0.02
Hero: posts big blind $0.05
*** HOLE CARDS ***
Dealt to 2ed46053 
Dealt to 5b035bcb 
Dealt to Hero [9h Jd]
Dealt to aa6d4c49 
Dealt to 8818ba78 
Dealt to 809e45f6 
aa6d4c49: folds
8818ba78: folds
809e45f6: folds
2ed46053: folds
5b035bcb: folds
Uncalled bet ($0.03) returned to Hero
*** SHOWDOWN ***
Hero collected $0.04 from pot
*** SUMMARY ***
Total pot $0.04 | Rake $0 | Jackpot $0 | Bingo $0 | Fortune $0 | Tax $0
Seat 1: 2ed46053 (button) folded before Flop (didn't bet)
Seat 2: 5b035bcb (small blind) folded before Flop
Seat 3: Hero (big blind) collected ($0.04)
Seat 4: aa6d4c49 folded before Flop (didn't bet)
Seat 5: 8818ba78 folded before Flop (didn't bet)
Seat 6: 809e45f6 folded before Flop (didn't bet)


Poker Hand #RC2078417607: Hold'em No Limit ($0.02/$0.05) - 2023/12/22 20:59:42
Table 'RushAndCash774836' 6-max Seat #1 is the button
Seat 1: Hero ($5 in chips)
Seat 2: 83f47841 ($3.96 in chips)
Seat 3: 5a299033 ($5.07 in chips)
Seat 4: ffed537c ($3.01 in chips)
Seat 5: 3169aec8 ($5.08 in chips)
Seat 6: a58677de ($2.83 in chips)
83f47841: posts small blind $0.02
5a299033: posts big blind $0.05
*** HOLE CARDS ***
Dealt to Hero [3c 7s]
Dealt to 83f47841 
Dealt to 5a299033 
Dealt to ffed537c 
Dealt to 3169aec8 
Dealt to a58677de 
ffed537c: folds
3169aec8: folds
a58677de: folds
Hero: folds
83f47841: folds
Uncalled bet ($0.03) returned to 5a299033
*** SHOWDOWN ***
5a299033 collected $0.04 from pot
*** SUMMARY ***
Total pot $0.04 | Rake $0 | Jackpot $0 | Bingo $0 | Fortune $0 | Tax $0
Seat 1: Hero (button) folded before Flop (didn't bet)
Seat 2: 83f47841 (small blind) folded before Flop
Seat 3: 5a299033 (big blind) collected ($0.04)
Seat 4: ffed537c folded before Flop (didn't bet)
Seat 5: 3169aec8 folded before Flop (didn't bet)
Seat 6: a58677de folded before Flop (didn't bet)


Poker Hand #RC2078417436: Hold'em No Limit ($0.02/$0.05) - 2023/12/22 20:59:32
Table 'RushAndCash774756' 6-max Seat #1 is the button
Seat 1: 8e0f056d ($7.61 in chips)
Seat 2: c08cf99d ($11.6 in chips)
Seat 3: 2e44f78e ($18.17 in chips)
Seat 4: 4b5380b0 ($60.31 in chips)
Seat 5: 5a299033 ($5.07 in chips)
Seat 6: Hero ($5 in chips)
c08cf99d: posts small blind $0.02
2e44f78e: posts big blind $0.05
*** HOLE CARDS ***
Dealt to 8e0f056d 
Dealt to c08cf99d 
Dealt to 2e44f78e 
Dealt to 4b5380b0 
Dealt to 5a299033 
Dealt to Hero [6s Ad]
4b5380b0: folds
5a299033: folds
Hero: folds
8e0f056d: folds
c08cf99d: folds
Uncalled bet ($0.03) returned to 2e44f78e
*** SHOWDOWN ***
2e44f78e collected $0.04 from pot
*** SUMMARY ***
Total pot $0.04 | Rake $0 | Jackpot $0 | Bingo $0 | Fortune $0 | Tax $0
Seat 1: 8e0f056d (button) folded before Flop (didn't bet)
Seat 2: c08cf99d (small blind) folded before Flop
Seat 3: 2e44f78e (big blind) collected ($0.04)
Seat 4: 4b5380b0 folded before Flop (didn't bet)
Seat 5: 5a299033 folded before Flop (didn't bet)
Seat 6: Hero folded before Flop (didn't bet)


Poker Hand #RC2078417367: Hold'em No Limit ($0.02/$0.05) - 2023/12/22 20:59:28
Table 'RushAndCash774723' 6-max Seat #1 is the button
Seat 1: c3adc948 ($6.09 in chips)
Seat 2: f9c8784e ($7.44 in chips)
Seat 3: b57e5c64 ($5.56 in chips)
Seat 4: Hero ($5 in chips)
Seat 5: ad963d07 ($4.21 in chips)
Seat 6: 5e4c4d4e ($2.63 in chips)
f9c8784e: posts small blind $0.02
b57e5c64: posts big blind $0.05
*** HOLE CARDS ***
Dealt to c3adc948 
Dealt to f9c8784e 
Dealt to b57e5c64 
Dealt to Hero [Ah 4c]
Dealt to ad963d07 
Dealt to 5e4c4d4e 
Hero: folds
ad963d07: folds
5e4c4d4e: folds
c3adc948: folds
f9c8784e: folds
Uncalled bet ($0.03) returned to b57e5c64
*** SHOWDOWN ***
b57e5c64 collected $0.04 from pot
*** SUMMARY ***
Total pot $0.04 | Rake $0 | Jackpot $0 | Bingo $0 | Fortune $0 | Tax $0
Seat 1: c3adc948 (button) folded before Flop (didn't bet)
Seat 2: f9c8784e (small blind) folded before Flop
Seat 3: b57e5c64 (big blind) collected ($0.04)
Seat 4: Hero folded before Flop (didn't bet)
Seat 5: ad963d07 folded before Flop (didn't bet)
Seat 6: 5e4c4d4e folded before Flop (didn't bet)


Poker Hand #RC2078417279: Hold'em No Limit ($0.02/$0.05) - 2023/12/22 20:59:23
Table 'RushAndCash774679' 6-max Seat #1 is the button
Seat 1: 7810e6bd ($4.21 in chips)
Seat 2: f1ad1c02 ($1.22 in chips)
Seat 3: 294b7dd8 ($9.61 in chips)
Seat 4: 404f9683 ($5.9 in chips)
Seat 5: Hero ($5 in chips)
Seat 6: d1a1b256 ($6.98 in chips)
f1ad1c02: posts small blind $0.02
294b7dd8: posts big blind $0.05
*** HOLE CARDS ***
Dealt to 7810e6bd 
Dealt to f1ad1c02 
Dealt to 294b7dd8 
Dealt to 404f9683 
Dealt to Hero [Jc 6d]
Dealt to d1a1b256 
404f9683: folds
Hero: folds
d1a1b256: raises $0.05 to $0.1
7810e6bd: calls $0.1
f1ad1c02: folds
294b7dd8: calls $0.05
*** FLOP *** [4c Js 7c]
294b7dd8: checks
d1a1b256: checks
7810e6bd: bets $0.11
294b7dd8: folds
d1a1b256: folds
Uncalled bet ($0.11) returned to 7810e6bd
*** SHOWDOWN ***
7810e6bd collected $0.31 from pot
*** SUMMARY ***
Total pot $0.32 | Rake $0.01 | Jackpot $0 | Bingo $0 | Fortune $0 | Tax $0
Board [4c Js 7c]
Seat 1: 7810e6bd (button) won ($0.31)
Seat 2: f1ad1c02 (small blind) folded before Flop
Seat 3: 294b7dd8 (big blind) folded on the Flop
Seat 4: 404f9683 folded before Flop (didn't bet)
Seat 5: Hero folded before Flop (didn't bet)
Seat 6: d1a1b256 folded on the Flop


Poker Hand #RC2078417071: Hold'em No Limit ($0.02/$0.05) - 2023/12/22 20:59:11
Table 'RushAndCash774583' 6-max Seat #1 is the button
Seat 1: 5aa55d39 ($5 in chips)
Seat 2: 911fbb72 ($4.93 in chips)
Seat 3: Hero ($5 in chips)
Seat 4: 1259a422 ($5.4 in chips)
Seat 5: a1dfe2ad ($5 in chips)
Seat 6: ff769430 ($6.23 in chips)
911fbb72: posts small blind $0.02
Hero: posts big blind $0.05
*** HOLE CARDS ***
Dealt to 5aa55d39 
Dealt to 911fbb72 
Dealt to Hero [5d 8s]
Dealt to 1259a422 
Dealt to a1dfe2ad 
Dealt to ff769430 
1259a422: raises $0.08 to $0.13
a1dfe2ad: folds
ff769430: folds
5aa55d39: folds
911fbb72: folds
Hero: folds
Uncalled bet ($0.08) returned to 1259a422
*** SHOWDOWN ***
1259a422 collected $0.12 from pot
*** SUMMARY ***
Total pot $0.12 | Rake $0 | Jackpot $0 | Bingo $0 | Fortune $0 | Tax $0
Seat 1: 5aa55d39 (button) folded before Flop (didn't bet)
Seat 2: 911fbb72 (small blind) folded before Flop
Seat 3: Hero (big blind) folded before Flop
Seat 4: 1259a422 collected ($0.12)
Seat 5: a1dfe2ad folded before Flop (didn't bet)
Seat 6: ff769430 folded before Flop (didn't bet)


Poker Hand #RC2078417003: Hold'em No Limit ($0.02/$0.05) - 2023/12/22 20:59:07
Table 'RushAndCash774551' 6-max Seat #1 is the button
Seat 1: 1b19739f ($5 in chips)
Seat 2: Hero ($5 in chips)
Seat 3: ab5dffec ($5.13 in chips)
Seat 4: cb07f953 ($8.89 in chips)
Seat 5: 921e997e ($8.59 in chips)
Seat 6: 38444444 ($13.17 in chips)
Hero: posts small blind $0.02
ab5dffec: posts big blind $0.05
*** HOLE CARDS ***
Dealt to 1b19739f 
Dealt to Hero [Jc 7d]
Dealt to ab5dffec 
Dealt to cb07f953 
Dealt to 921e997e 
Dealt to 38444444 
cb07f953: raises $0.07 to $0.12
921e997e: folds
38444444: calls $0.12
1b19739f: calls $0.12
Hero: folds
ab5dffec: calls $0.07
*** FLOP *** [5h 7h Qd]
ab5dffec: checks
cb07f953: checks
38444444: bets $0.25
1b19739f: calls $0.25
ab5dffec: folds
cb07f953: folds
*** TURN *** [5h 7h Qd] [3d]
38444444: bets $0.5
1b19739f: folds
Uncalled bet ($0.5) returned to 38444444
*** SHOWDOWN ***
38444444 collected $0.95 from pot
*** SUMMARY ***
Total pot $1 | Rake $0.05 | Jackpot $0 | Bingo $0 | Fortune $0 | Tax $0
Board [5h 7h Qd 3d]
Seat 1: 1b19739f (button) folded on the Turn
Seat 2: Hero (small blind) folded before Flop
Seat 3: ab5dffec (big blind) folded on the Flop
Seat 4: cb07f953 folded on the Flop
Seat 5: 921e997e folded before Flop (didn't bet)
Seat 6: 38444444 won ($0.95)


Poker Hand #RC2078416934: Hold'em No Limit ($0.02/$0.05) - 2023/12/22 20:59:03
Table 'RushAndCash774520' 6-max Seat #1 is the button
Seat 1: Hero ($5 in chips)
Seat 2: 59c7f4b1 ($9.22 in chips)
Seat 3: b75ac6ee ($5.02 in chips)
Seat 4: 38444444 ($13.17 in chips)
Seat 5: 5703e2fa ($13.76 in chips)
Seat 6: f942fd52 ($5.79 in chips)
59c7f4b1: posts small blind $0.02
b75ac6ee: posts big blind $0.05
*** HOLE CARDS ***
Dealt to Hero [3h 5c]
Dealt to 59c7f4b1 
Dealt to b75ac6ee 
Dealt to 38444444 
Dealt to 5703e2fa 
Dealt to f942fd52 
38444444: folds
5703e2fa: folds
f942fd52: folds
Hero: folds
59c7f4b1: raises $0.08 to $0.13
b75ac6ee: folds
Uncalled bet ($0.08) returned to 59c7f4b1
*** SHOWDOWN ***
59c7f4b1 collected $0.1 from pot
*** SUMMARY ***
Total pot $0.1 | Rake $0 | Jackpot $0 | Bingo $0 | Fortune $0 | Tax $0
Seat 1: Hero (button) folded before Flop (didn't bet)
Seat 2: 59c7f4b1 (small blind) collected ($0.1)
Seat 3: b75ac6ee (big blind) folded before Flop
Seat 4: 38444444 folded before Flop (didn't bet)
Seat 5: 5703e2fa folded before Flop (didn't bet)
Seat 6: f942fd52 folded before Flop (didn't bet)


Poker Hand #RC2078416853: Hold'em No Limit ($0.02/$0.05) - 2023/12/22 20:58:58
Table 'RushAndCash774481' 6-max Seat #1 is the button
Seat 1: Hero ($5 in chips)
Seat 2: 6ffefba2 ($6.34 in chips)
Seat 3: 8eb71456 ($12.32 in chips)
Seat 4: d18647ce ($5.94 in chips)
Seat 5: 7c10f852 ($14.19 in chips)
Seat 6: 517da49 ($5.01 in chips)
6ffefba2: posts small blind $0.02
8eb71456: posts big blind $0.05
*** HOLE CARDS ***
Dealt to Hero [2c Jd]
Dealt to 6ffefba2 
Dealt to 8eb71456 
Dealt to d18647ce 
Dealt to 7c10f852 
Dealt to 517da49 
d18647ce: folds
7c10f852: folds
517da49: raises $0.07 to $0.12
Hero: folds
6ffefba2: folds
8eb71456: calls $0.07
*** FLOP *** [Tc 7d 3s]
8eb71456: checks
517da49: bets $0.2
8eb71456: folds
Uncalled bet ($0.2) returned to 517da49
*** SHOWDOWN ***
517da49 collected $0.25 from pot
*** SUMMARY ***
Total pot $0.26 | Rake $0.01 | Jackpot $0 | Bingo $0 | Fortune $0 | Tax $0
Board [Tc 7d 3s]
Seat 1: Hero (button) folded before Flop (didn't bet)
Seat 2: 6ffefba2 (small blind) folded before Flop
Seat 3: 8eb71456 (big blind) folded on the Flop
Seat 4: d18647ce folded before Flop (didn't bet)
Seat 5: 7c10f852 folded before Flop (didn't bet)
Seat 6: 517da49 won ($0.25)


Poker Hand #RC2078416761: Hold'em No Limit ($0.02/$0.05) - 2023/12/22 20:58:53
Table 'RushAndCash774440' 6-max Seat #1 is the button
Seat 1: b8534e0 ($11.79 in chips)
Seat 2: Hero ($5 in chips)
Seat 3: 4aadc4e8 ($3.6 in chips)
Seat 4: 4ab8a557 ($5.18 in chips)
Seat 5: b2a82774 ($5.26 in chips)
Seat 6: cdb7c904 ($7.98 in chips)
Hero: posts small blind $0.02
4aadc4e8: posts big blind $0.05
*** HOLE CARDS ***
Dealt to b8534e0 
Dealt to Hero [7d Ts]
Dealt to 4aadc4e8 
Dealt to 4ab8a557 
Dealt to b2a82774 
Dealt to cdb7c904 
4ab8a557: folds
b2a82774: folds
cdb7c904: folds
b8534e0: raises $0.1 to $0.15
Hero: folds
4aadc4e8: folds
Uncalled bet ($0.1) returned to b8534e0
*** SHOWDOWN ***
b8534e0 collected $0.12 from pot
*** SUMMARY ***
Total pot $0.12 | Rake $0 | Jackpot $0 | Bingo $0 | Fortune $0 | Tax $0
Seat 1: b8534e0 (button) collected ($0.12)
Seat 2: Hero (small blind) folded before Flop
Seat 3: 4aadc4e8 (big blind) folded before Flop
Seat 4: 4ab8a557 folded before Flop (didn't bet)
Seat 5: b2a82774 folded before Flop (didn't bet)
Seat 6: cdb7c904 folded before Flop (didn't bet)


Poker Hand #RC2078416644: Hold'em No Limit ($0.02/$0.05) - 2023/12/22 20:58:46
Table 'RushAndCash774384' 6-max Seat #1 is the button
Seat 1: 8f87a7f3 ($5.45 in chips)
Seat 2: 573490f9 ($4.15 in chips)
Seat 3: 6b8a648f ($5 in chips)
Seat 4: 7c10f852 ($14.19 in chips)
Seat 5: 58e3e360 ($7.89 in chips)
Seat 6: Hero ($5 in chips)
573490f9: posts small blind $0.02
6b8a648f: posts big blind $0.05
*** HOLE CARDS ***
Dealt to 8f87a7f3 
Dealt to 573490f9 
Dealt to 6b8a648f 
Dealt to 7c10f852 
Dealt to 58e3e360 
Dealt to Hero [5s 8h]
7c10f852: folds
58e3e360: folds
Hero: folds
8f87a7f3: folds
573490f9: raises $0.1 to $0.15
6b8a648f: folds
Uncalled bet ($0.1) returned to 573490f9
*** SHOWDOWN ***
573490f9 collected $0.1 from pot
*** SUMMARY ***
Total pot $0.1 | Rake $0 | Jackpot $0 | Bingo $0 | Fortune $0 | Tax $0
Seat 1: 8f87a7f3 (button) folded before Flop (didn't bet)
Seat 2: 573490f9 (small blind) collected ($0.1)
Seat 3: 6b8a648f (big blind) folded before Flop
Seat 4: 7c10f852 folded before Flop (didn't bet)
Seat 5: 58e3e360 folded before Flop (didn't bet)
Seat 6: Hero folded before Flop (didn't bet)


Poker Hand #RC2078416544: Hold'em No Limit ($0.02/$0.05) - 2023/12/22 20:58:40
Table 'RushAndCash774335' 6-max Seat #1 is the button
Seat 1: f95c708 ($5 in chips)
Seat 2: 365a060c ($5.02 in chips)
Seat 3: 9b2d2337 ($6.69 in chips)
Seat 4: Hero ($5 in chips)
Seat 5: a4441de9 ($5.07 in chips)
Seat 6: 4eb466f4 ($12.42 in chips)
365a060c: posts small blind $0.02
9b2d2337: posts big blind $0.05
*** HOLE CARDS ***
Dealt to f95c708 
Dealt to 365a060c 
Dealt to 9b2d2337 
Dealt to Hero [Qc Jd]
Dealt to a4441de9 
Dealt to 4eb466f4 
Hero: folds
a4441de9: raises $0.1 to $0.15
4eb466f4: folds
f95c708: folds
365a060c: folds
9b2d2337: raises $0.37 to $0.52
a4441de9: raises $0.8 to $1.32
9b2d2337: raises $5.37 to $6.69 and is all-in
a4441de9: calls $3.75 and is all-in
Uncalled bet ($1.62) returned to 9b2d2337
9b2d2337: shows [Kh Ks]
a4441de9: shows [As Ah]
*** FLOP *** [7s Js 2c]
*** TURN *** [7s Js 2c] [3d]
*** RIVER *** [7s Js 2c 3d] [3h]
*** SHOWDOWN ***
a4441de9 collected $9.94 from pot
*** SUMMARY ***
Total pot $10.16 | Rake $0.15 | Jackpot $0.07 | Bingo $0 | Fortune $0 | Tax $0
Board [7s Js 2c 3d 3h]
Seat 1: f95c708 (button) folded before Flop (didn't bet)
Seat 2: 365a060c (small blind) folded before Flop
Seat 3: 9b2d2337 (big blind) showed [Kh Ks] and lost with Pair of Kings and Pair of Treys
Seat 4: Hero folded before Flop (didn't bet)
Seat 5: a4441de9 showed [As Ah] and won ($9.94) with Pair of Aces and Pair of Treys
Seat 6: 4eb466f4 folded before Flop (didn't bet)


Poker Hand #RC2078416292: Hold'em No Limit ($0.02/$0.05) - 2023/12/22 20:58:26
Table 'RushAndCash774224' 6-max Seat #1 is the button
Seat 1: 1fc1f571 ($13.6 in chips)
Seat 2: 7cf162f5 ($6.67 in chips)
Seat 3: Hero ($5 in chips)
Seat 4: 8bde3280 ($11.7 in chips)
Seat 5: c6dd581a ($9.67 in chips)
Seat 6: 998574b7 ($5 in chips)
7cf162f5: posts small blind $0.02
Hero: posts big blind $0.05
*** HOLE CARDS ***
Dealt to 1fc1f571 
Dealt to 7cf162f5 
Dealt to Hero [Jd 9c]
Dealt to 8bde3280 
Dealt to c6dd581a 
Dealt to 998574b7 
8bde3280: folds
c6dd581a: folds
998574b7: folds
1fc1f571: raises $0.05 to $0.1
7cf162f5: folds
Hero: folds
Uncalled bet ($0.05) returned to 1fc1f571
*** SHOWDOWN ***
1fc1f571 collected $0.12 from pot
*** SUMMARY ***
Total pot $0.12 | Rake $0 | Jackpot $0 | Bingo $0 | Fortune $0 | Tax $0
Seat 1: 1fc1f571 (button) collected ($0.12)
Seat 2: 7cf162f5 (small blind) folded before Flop
Seat 3: Hero (big blind) folded before Flop
Seat 4: 8bde3280 folded before Flop (didn't bet)
Seat 5: c6dd581a folded before Flop (didn't bet)
Seat 6: 998574b7 folded before Flop (didn't bet)


Poker Hand #RC2078416201: Hold'em No Limit ($0.02/$0.05) - 2023/12/22 20:58:21
Table 'RushAndCash774186' 6-max Seat #1 is the button
Seat 1: 50cbc258 ($6.47 in chips)
Seat 2: ef402e16 ($6.46 in chips)
Seat 3: 5c16c35c ($11.7 in chips)
Seat 4: Hero ($5 in chips)
Seat 5: 32d77abe ($6.77 in chips)
Seat 6: f942fd52 ($5.79 in chips)
ef402e16: posts small blind $0.02
5c16c35c: posts big blind $0.05
*** HOLE CARDS ***
Dealt to 50cbc258 
Dealt to ef402e16 
Dealt to 5c16c35c 
Dealt to Hero [Js 5h]
Dealt to 32d77abe 
Dealt to f942fd52 
Hero: folds
32d77abe: raises $0.08 to $0.13
f942fd52: folds
50cbc258: folds
ef402e16: calls $0.11
5c16c35c: folds
*** FLOP *** [6c Qs 4h]
ef402e16: checks
32d77abe: checks
*** TURN *** [6c Qs 4h] [9h]
ef402e16: bets $0.16
32d77abe: calls $0.16
*** RIVER *** [6c Qs 4h 9h] [2d]
ef402e16: checks
32d77abe: checks
ef402e16: shows [7h 7c] (Pair of Sevens)
32d77abe: shows [9d As] (Pair of Nines)
*** SHOWDOWN ***
32d77abe collected $0.6 from pot
*** SUMMARY ***
Total pot $0.63 | Rake $0.03 | Jackpot $0 | Bingo $0 | Fortune $0 | Tax $0
Board [6c Qs 4h 9h 2d]
Seat 1: 50cbc258 (button) folded before Flop (didn't bet)
Seat 2: ef402e16 (small blind) showed [7h 7c] and lost with Pair of Sevens
Seat 3: 5c16c35c (big blind) folded before Flop
Seat 4: Hero folded before Flop (didn't bet)
Seat 5: 32d77abe showed [9d As] and won ($0.6) with Pair of Nines
Seat 6: f942fd52 folded before Flop (didn't bet)


Poker Hand #RC2078416142: Hold'em No Limit ($0.02/$0.05) - 2023/12/22 20:58:18
Table 'RushAndCash774159' 6-max Seat #1 is the button
Seat 1: 7020d421 ($15.6 in chips)
Seat 2: 17be45ec ($2.92 in chips)
Seat 3: ff6f425f ($12.28 in chips)
Seat 4: Hero ($5 in chips)
Seat 5: db5367a6 ($7.17 in chips)
Seat 6: 2ec85018 ($5.04 in chips)
17be45ec: posts small blind $0.02
ff6f425f: posts big blind $0.05
*** HOLE CARDS ***
Dealt to 7020d421 
Dealt to 17be45ec 
Dealt to ff6f425f 
Dealt to Hero [6s 8h]
Dealt to db5367a6 
Dealt to 2ec85018 
Hero: folds
db5367a6: folds
2ec85018: folds
7020d421: folds
17be45ec: folds
Uncalled bet ($0.03) returned to ff6f425f
*** SHOWDOWN ***
ff6f425f collected $0.04 from pot
*** SUMMARY ***
Total pot $0.04 | Rake $0 | Jackpot $0 | Bingo $0 | Fortune $0 | Tax $0
Seat 1: 7020d421 (button) folded before Flop (didn't bet)
Seat 2: 17be45ec (small blind) folded before Flop
Seat 3: ff6f425f (big blind) collected ($0.04)
Seat 4: Hero folded before Flop (didn't bet)
Seat 5: db5367a6 folded before Flop (didn't bet)
Seat 6: 2ec85018 folded before Flop (didn't bet)


Poker Hand #RC2078416049: Hold'em No Limit ($0.02/$0.05) - 2023/12/22 20:58:13
Table 'RushAndCash774115' 6-max Seat #1 is the button
Seat 1: cddb31fe ($2.11 in chips)
Seat 2: 7020d421 ($15.62 in chips)
Seat 3: 72f7386e ($9.41 in chips)
Seat 4: 2e26b9c1 ($7.91 in chips)
Seat 5: 985b2ecb ($4.72 in chips)
Seat 6: Hero ($5 in chips)
7020d421: posts small blind $0.02
72f7386e: posts big blind $0.05
*** HOLE CARDS ***
Dealt to cddb31fe 
Dealt to 7020d421 
Dealt to 72f7386e 
Dealt to 2e26b9c1 
Dealt to 985b2ecb 
Dealt to Hero [5h Js]
2e26b9c1: folds
985b2ecb: calls $0.05
Hero: folds
cddb31fe: folds
7020d421: folds
72f7386e: checks
*** FLOP *** [4h Ac Qh]
72f7386e: checks
985b2ecb: checks
*** TURN *** [4h Ac Qh] [Ts]
72f7386e: checks
985b2ecb: bets $0.09
72f7386e: folds
Uncalled bet ($0.09) returned to 985b2ecb
*** SHOWDOWN ***
985b2ecb collected $0.12 from pot
*** SUMMARY ***
Total pot $0.12 | Rake $0 | Jackpot $0 | Bingo $0 | Fortune $0 | Tax $0
Board [4h Ac Qh Ts]
Seat 1: cddb31fe (button) folded before Flop (didn't bet)
Seat 2: 7020d421 (small blind) folded before Flop
Seat 3: 72f7386e (big blind) folded on the Turn
Seat 4: 2e26b9c1 folded before Flop (didn't bet)
Seat 5: 985b2ecb won ($0.12)
Seat 6: Hero folded before Flop (didn't bet)


Poker Hand #RC2078415975: Hold'em No Limit ($0.02/$0.05) - 2023/12/22 20:58:09
Table 'RushAndCash774081' 6-max Seat #1 is the button
Seat 1: 85eb536b ($17.07 in chips)
Seat 2: 8014c02 ($19.3 in chips)
Seat 3: eadbd152 ($5 in chips)
Seat 4: 33d498f7 ($5 in chips)
Seat 5: d4c000bf ($5.07 in chips)
Seat 6: Hero ($5 in chips)
8014c02: posts small blind $0.02
eadbd152: posts big blind $0.05
*** HOLE CARDS ***
Dealt to 85eb536b 
Dealt to 8014c02 
Dealt to eadbd152 
Dealt to 33d498f7 
Dealt to d4c000bf 
Dealt to Hero [5c 8s]
33d498f7: folds
d4c000bf: folds
Hero: folds
85eb536b: folds
8014c02: raises $0.1 to $0.15
eadbd152: folds
Uncalled bet ($0.1) returned to 8014c02
*** SHOWDOWN ***
8014c02 collected $0.1 from pot
*** SUMMARY ***
Total pot $0.1 | Rake $0 | Jackpot $0 | Bingo $0 | Fortune $0 | Tax $0
Seat 1: 85eb536b (button) folded before Flop (didn't bet)
Seat 2: 8014c02 (small blind) collected ($0.1)
Seat 3: eadbd152 (big blind) folded before Flop
Seat 4: 33d498f7 folded before Flop (didn't bet)
Seat 5: d4c000bf folded before Flop (didn't bet)
Seat 6: Hero folded before Flop (didn't bet)


Poker Hand #RC2078415909: Hold'em No Limit ($0.02/$0.05) - 2023/12/22 20:58:05
Table 'RushAndCash774049' 6-max Seat #1 is the button
Seat 1: 5861f243 ($6.2 in chips)
Seat 2: 9af3794b ($6.21 in chips)
Seat 3: 360d3b25 ($5.37 in chips)
Seat 4: Hero ($5 in chips)
Seat 5: 8e52c782 ($6 in chips)
Seat 6: 23c96099 ($6.18 in chips)
9af3794b: posts small blind $0.02
360d3b25: posts big blind $0.05
*** HOLE CARDS ***
Dealt to 5861f243 
Dealt to 9af3794b 
Dealt to 360d3b25 
Dealt to Hero [5h 2c]
Dealt to 8e52c782 
Dealt to 23c96099 
Hero: folds
8e52c782: raises $0.06 to $0.11
23c96099: folds
5861f243: folds
9af3794b: folds
360d3b25: folds
Uncalled bet ($0.06) returned to 8e52c782
*** SHOWDOWN ***
8e52c782 collected $0.12 from pot
*** SUMMARY ***
Total pot $0.12 | Rake $0 | Jackpot $0 | Bingo $0 | Fortune $0 | Tax $0
Seat 1: 5861f243 (button) folded before Flop (didn't bet)
Seat 2: 9af3794b (small blind) folded before Flop
Seat 3: 360d3b25 (big blind) folded before Flop
Seat 4: Hero folded before Flop (didn't bet)
Seat 5: 8e52c782 collected ($0.12)
Seat 6: 23c96099 folded before Flop (didn't bet)


Poker Hand #RC2078415822: Hold'em No Limit ($0.02/$0.05) - 2023/12/22 20:57:59
Table 'RushAndCash774007' 6-max Seat #1 is the button
Seat 1: 89c6e004 ($5.82 in chips)
Seat 2: Hero ($5.02 in chips)
Seat 3: a92141ad ($4.16 in chips)
Seat 4: e57ad3f ($2.69 in chips)
Seat 5: c9b8a495 ($5.22 in chips)
Seat 6: a61e93fb ($5.61 in chips)
Hero: posts small blind $0.02
a92141ad: posts big blind $0.05
*** HOLE CARDS ***
Dealt to 89c6e004 
Dealt to Hero [3s 8s]
Dealt to a92141ad 
Dealt to e57ad3f 
Dealt to c9b8a495 
Dealt to a61e93fb 
e57ad3f: raises $0.1 to $0.15
c9b8a495: folds
a61e93fb: folds
89c6e004: folds
Hero: folds
a92141ad: folds
Uncalled bet ($0.1) returned to e57ad3f
*** SHOWDOWN ***
e57ad3f collected $0.12 from pot
*** SUMMARY ***
Total pot $0.12 | Rake $0 | Jackpot $0 | Bingo $0 | Fortune $0 | Tax $0
Seat 1: 89c6e004 (button) folded before Flop (didn't bet)
Seat 2: Hero (small blind) folded before Flop
Seat 3: a92141ad (big blind) folded before Flop
Seat 4: e57ad3f collected ($0.12)
Seat 5: c9b8a495 folded before Flop (didn't bet)
Seat 6: a61e93fb folded before Flop (didn't bet)


Poker Hand #RC2078415668: Hold'em No Limit ($0.02/$0.05) - 2023/12/22 20:57:51
Table 'RushAndCash773934' 6-max Seat #1 is the button
Seat 1: 317ccf77 ($3 in chips)
Seat 2: 5d55167a ($9.91 in chips)
Seat 3: Hero ($5.07 in chips)
Seat 4: 45392e2c ($23.38 in chips)
Seat 5: acefe839 ($16.74 in chips)
Seat 6: d21a0c3 ($9.23 in chips)
5d55167a: posts small blind $0.02
Hero: posts big blind $0.05
*** HOLE CARDS ***
Dealt to 317ccf77 
Dealt to 5d55167a 
Dealt to Hero [5d Tc]
Dealt to 45392e2c 
Dealt to acefe839 
Dealt to d21a0c3 
45392e2c: folds
acefe839: raises $0.05 to $0.1
d21a0c3: folds
317ccf77: folds
5d55167a: folds
Hero: folds
Uncalled bet ($0.05) returned to acefe839
*** SHOWDOWN ***
acefe839 collected $0.12 from pot
*** SUMMARY ***
Total pot $0.12 | Rake $0 | Jackpot $0 | Bingo $0 | Fortune $0 | Tax $0
Seat 1: 317ccf77 (button) folded before Flop (didn't bet)
Seat 2: 5d55167a (small blind) folded before Flop
Seat 3: Hero (big blind) folded before Flop
Seat 4: 45392e2c folded before Flop (didn't bet)
Seat 5: acefe839 collected ($0.12)
Seat 6: d21a0c3 folded before Flop (didn't bet)


Poker Hand #RC2078415594: Hold'em No Limit ($0.02/$0.05) - 2023/12/22 20:57:47
Table 'RushAndCash773898' 6-max Seat #1 is the button
Seat 1: Hero ($5.07 in chips)
Seat 2: c9b8a495 ($5.24 in chips)
Seat 3: afffe2f9 ($5 in chips)
Seat 4: c6dd581a ($9.72 in chips)
Seat 5: b2a82774 ($5.05 in chips)
Seat 6: b8103a2d ($8.08 in chips)
c9b8a495: posts small blind $0.02
afffe2f9: posts big blind $0.05
*** HOLE CARDS ***
Dealt to Hero [9c Kd]
Dealt to c9b8a495 
Dealt to afffe2f9 
Dealt to c6dd581a 
Dealt to b2a82774 
Dealt to b8103a2d 
c6dd581a: folds
b2a82774: folds
b8103a2d: folds
Hero: folds
c9b8a495: folds
Uncalled bet ($0.03) returned to afffe2f9
*** SHOWDOWN ***
afffe2f9 collected $0.04 from pot
*** SUMMARY ***
Total pot $0.04 | Rake $0 | Jackpot $0 | Bingo $0 | Fortune $0 | Tax $0
Seat 1: Hero (button) folded before Flop (didn't bet)
Seat 2: c9b8a495 (small blind) folded before Flop
Seat 3: afffe2f9 (big blind) collected ($0.04)
Seat 4: c6dd581a folded before Flop (didn't bet)
Seat 5: b2a82774 folded before Flop (didn't bet)
Seat 6: b8103a2d folded before Flop (didn't bet)


Poker Hand #RC2078415524: Hold'em No Limit ($0.02/$0.05) - 2023/12/22 20:57:43
Table 'RushAndCash773866' 6-max Seat #1 is the button
Seat 1: c5ea8703 ($12.2 in chips)
Seat 2: b4aaf9de ($5.77 in chips)
Seat 3: 6ddc293e ($5.32 in chips)
Seat 4: Hero ($5.07 in chips)
Seat 5: 67d4b163 ($9.2 in chips)
Seat 6: 8818ba78 ($8.29 in chips)
b4aaf9de: posts small blind $0.02
6ddc293e: posts big blind $0.05
*** HOLE CARDS ***
Dealt to c5ea8703 
Dealt to b4aaf9de 
Dealt to 6ddc293e 
Dealt to Hero [4h Ts]
Dealt to 67d4b163 
Dealt to 8818ba78 
Hero: folds
67d4b163: folds
8818ba78: folds
c5ea8703: raises $0.07 to $0.12
b4aaf9de: folds
6ddc293e: folds
Uncalled bet ($0.07) returned to c5ea8703
*** SHOWDOWN ***
c5ea8703 collected $0.12 from pot
*** SUMMARY ***
Total pot $0.12 | Rake $0 | Jackpot $0 | Bingo $0 | Fortune $0 | Tax $0
Seat 1: c5ea8703 (button) collected ($0.12)
Seat 2: b4aaf9de (small blind) folded before Flop
Seat 3: 6ddc293e (big blind) folded before Flop
Seat 4: Hero folded before Flop (didn't bet)
Seat 5: 67d4b163 folded before Flop (didn't bet)
Seat 6: 8818ba78 folded before Flop (didn't bet)


Poker Hand #RC2078415425: Hold'em No Limit ($0.02/$0.05) - 2023/12/22 20:57:38
Table 'RushAndCash773822' 6-max Seat #1 is the button
Seat 1: 872860d ($4.2 in chips)
Seat 2: fdc2d3ba ($14.93 in chips)
Seat 3: 829aa739 ($5.59 in chips)
Seat 4: 494d7c43 ($5.26 in chips)
Seat 5: 90b129bf ($9.42 in chips)
Seat 6: Hero ($5.07 in chips)
fdc2d3ba: posts small blind $0.02
829aa739: posts big blind $0.05
*** HOLE CARDS ***
Dealt to 872860d 
Dealt to fdc2d3ba 
Dealt to 829aa739 
Dealt to 494d7c43 
Dealt to 90b129bf 
Dealt to Hero [6h 8d]
494d7c43: folds
90b129bf: folds
Hero: folds
872860d: folds
fdc2d3ba: raises $0.1 to $0.15
829aa739: calls $0.1
*** FLOP *** [Td 6d 8h]
fdc2d3ba: bets $0.15
829aa739: calls $0.15
*** TURN *** [Td 6d 8h] [4h]
fdc2d3ba: checks
829aa739: bets $0.45
fdc2d3ba: calls $0.45
*** RIVER *** [Td 6d 8h 4h] [2d]
fdc2d3ba: checks
829aa739: checks
fdc2d3ba: shows [8c 7s] (Pair of Eights)
829aa739: shows [Th Qd] (Pair of Tens)
*** SHOWDOWN ***
829aa739 collected $1.36 from pot
*** SUMMARY ***
Total pot $1.5 | Rake $0.07 | Jackpot $0.07 | Bingo $0 | Fortune $0 | Tax $0
Board [Td 6d 8h 4h 2d]
Seat 1: 872860d (button) folded before Flop (didn't bet)
Seat 2: fdc2d3ba (small blind) showed [8c 7s] and lost with Pair of Eights
Seat 3: 829aa739 (big blind) showed [Th Qd] and won ($1.36) with Pair of Tens
Seat 4: 494d7c43 folded before Flop (didn't bet)
Seat 5: 90b129bf folded before Flop (didn't bet)
Seat 6: Hero folded before Flop (didn't bet)


Poker Hand #RC2078415355: Hold'em No Limit ($0.02/$0.05) - 2023/12/22 20:57:34
Table 'RushAndCash773790' 6-max Seat #1 is the button
Seat 1: 9fd86997 ($18.09 in chips)
Seat 2: cc195bc9 ($2.75 in chips)
Seat 3: 4e20b85a ($9.17 in chips)
Seat 4: d5ec8351 ($5.07 in chips)
Seat 5: fdc2d3ba ($14.93 in chips)
Seat 6: Hero ($5.07 in chips)
cc195bc9: posts small blind $0.02
4e20b85a: posts big blind $0.05
*** HOLE CARDS ***
Dealt to 9fd86997 
Dealt to cc195bc9 
Dealt to 4e20b85a 
Dealt to d5ec8351 
Dealt to fdc2d3ba 
Dealt to Hero [Kd 6h]
d5ec8351: folds
fdc2d3ba: folds
Hero: folds
9fd86997: folds
cc195bc9: folds
Uncalled bet ($0.03) returned to 4e20b85a
*** SHOWDOWN ***
4e20b85a collected $0.04 from pot
*** SUMMARY ***
Total pot $0.04 | Rake $0 | Jackpot $0 | Bingo $0 | Fortune $0 | Tax $0
Seat 1: 9fd86997 (button) folded before Flop (didn't bet)
Seat 2: cc195bc9 (small blind) folded before Flop
Seat 3: 4e20b85a (big blind) collected ($0.04)
Seat 4: d5ec8351 folded before Flop (didn't bet)
Seat 5: fdc2d3ba folded before Flop (didn't bet)
Seat 6: Hero folded before Flop (didn't bet)


Poker Hand #RC2078415151: Hold'em No Limit ($0.02/$0.05) - 2023/12/22 20:57:23
Table 'RushAndCash773696' 6-max Seat #1 is the button
Seat 1: 7810e6bd ($3.65 in chips)
Seat 2: Hero ($5.02 in chips)
Seat 3: d42ee966 ($5 in chips)
Seat 4: 69a8b613 ($6.2 in chips)
Seat 5: af0d3b6b ($5.27 in chips)
Seat 6: c295eed2 ($6.76 in chips)
Hero: posts small blind $0.02
d42ee966: posts big blind $0.05
*** HOLE CARDS ***
Dealt to 7810e6bd 
Dealt to Hero [6s Ad]
Dealt to d42ee966 
Dealt to 69a8b613 
Dealt to af0d3b6b 
Dealt to c295eed2 
69a8b613: folds
af0d3b6b: folds
c295eed2: folds
7810e6bd: folds
Hero: raises $0.1 to $0.15
d42ee966: folds
Uncalled bet ($0.1) returned to Hero
*** SHOWDOWN ***
Hero collected $0.1 from pot
*** SUMMARY ***
Total pot $0.1 | Rake $0 | Jackpot $0 | Bingo $0 | Fortune $0 | Tax $0
Seat 1: 7810e6bd (button) folded before Flop (didn't bet)
Seat 2: Hero (small blind) collected ($0.1)
Seat 3: d42ee966 (big blind) folded before Flop
Seat 4: 69a8b613 folded before Flop (didn't bet)
Seat 5: af0d3b6b folded before Flop (didn't bet)
Seat 6: c295eed2 folded before Flop (didn't bet)


Poker Hand #RC2078414976: Hold'em No Limit ($0.02/$0.05) - 2023/12/22 20:57:14
Table 'RushAndCash773621' 6-max Seat #1 is the button
Seat 1: Hero ($5.02 in chips)
Seat 2: 2e2fe835 ($5.46 in chips)
Seat 3: 680eb0e1 ($8.36 in chips)
Seat 4: d56f57b9 ($5 in chips)
Seat 5: a9abc4b1 ($7.55 in chips)
Seat 6: 365a060c ($4.71 in chips)
2e2fe835: posts small blind $0.02
680eb0e1: posts big blind $0.05
*** HOLE CARDS ***
Dealt to Hero [4s Ks]
Dealt to 2e2fe835 
Dealt to 680eb0e1 
Dealt to d56f57b9 
Dealt to a9abc4b1 
Dealt to 365a060c 
d56f57b9: raises $0.06 to $0.11
a9abc4b1: folds
365a060c: folds
Hero: folds
2e2fe835: folds
680eb0e1: raises $0.39 to $0.5
d56f57b9: calls $0.39
*** FLOP *** [Jd Kd Js]
680eb0e1: bets $0.34
d56f57b9: calls $0.34
*** TURN *** [Jd Kd Js] [2s]
680eb0e1: checks
d56f57b9: bets $0.57
680eb0e1: calls $0.57
*** RIVER *** [Jd Kd Js 2s] [6d]
680eb0e1: checks
d56f57b9: checks
680eb0e1: shows [Qd Qc] (Pair of Queens and Pair of Jacks)
d56f57b9: shows [Ac 5c] (Pair of Jacks)
*** SHOWDOWN ***
680eb0e1 collected $2.64 from pot
*** SUMMARY ***
Total pot $2.84 | Rake $0.13 | Jackpot $0.07 | Bingo $0 | Fortune $0 | Tax $0
Board [Jd Kd Js 2s 6d]
Seat 1: Hero (button) folded before Flop (didn't bet)
Seat 2: 2e2fe835 (small blind) folded before Flop
Seat 3: 680eb0e1 (big blind) showed [Qd Qc] and won ($2.64) with Pair of Queens and Pair of Jacks
Seat 4: d56f57b9 showed [Ac 5c] and lost with Pair of Jacks
Seat 5: a9abc4b1 folded before Flop (didn't bet)
Seat 6: 365a060c folded before Flop (didn't bet)


Poker Hand #RC2078414843: Hold'em No Limit ($0.02/$0.05) - 2023/12/22 20:57:06
Table 'RushAndCash773563' 6-max Seat #1 is the button
Seat 1: 4c81be2e ($9.08 in chips)
Seat 2: cff0b296 ($5.66 in chips)
Seat 3: Hero ($5 in chips)
Seat 4: 915de7e4 ($5.25 in chips)
Seat 5: b61f5bde ($8.53 in chips)
Seat 6: 81ecaac5 ($4.55 in chips)
cff0b296: posts small blind $0.02
Hero: posts big blind $0.05
*** HOLE CARDS ***
Dealt to 4c81be2e 
Dealt to cff0b296 
Dealt to Hero [9c Jd]
Dealt to 915de7e4 
Dealt to b61f5bde 
Dealt to 81ecaac5 
915de7e4: folds
b61f5bde: folds
81ecaac5: folds
4c81be2e: folds
cff0b296: folds
Uncalled bet ($0.03) returned to Hero
*** SHOWDOWN ***
Hero collected $0.04 from pot
*** SUMMARY ***
Total pot $0.04 | Rake $0 | Jackpot $0 | Bingo $0 | Fortune $0 | Tax $0
Seat 1: 4c81be2e (button) folded before Flop (didn't bet)
Seat 2: cff0b296 (small blind) folded before Flop
Seat 3: Hero (big blind) collected ($0.04)
Seat 4: 915de7e4 folded before Flop (didn't bet)
Seat 5: b61f5bde folded before Flop (didn't bet)
Seat 6: 81ecaac5 folded before Flop (didn't bet)


Poker Hand #RC2078414768: Hold'em No Limit ($0.02/$0.05) - 2023/12/22 20:57:02
Table 'RushAndCash773527' 6-max Seat #1 is the button
Seat 1: a638a3a8 ($6.61 in chips)
Seat 2: 5261fe21 ($4.04 in chips)
Seat 3: 5b2bf61b ($5 in chips)
Seat 4: Hero ($5 in chips)
Seat 5: 488f1674 ($6.54 in chips)
Seat 6: 3e82955f ($5 in chips)
5261fe21: posts small blind $0.02
5b2bf61b: posts big blind $0.05
*** HOLE CARDS ***
Dealt to a638a3a8 
Dealt to 5261fe21 
Dealt to 5b2bf61b 
Dealt to Hero [6h Jd]
Dealt to 488f1674 
Dealt to 3e82955f 
Hero: folds
488f1674: folds
3e82955f: folds
a638a3a8: folds
5261fe21: raises $0.05 to $0.1
5b2bf61b: folds
Uncalled bet ($0.05) returned to 5261fe21
*** SHOWDOWN ***
5261fe21 collected $0.1 from pot
*** SUMMARY ***
Total pot $0.1 | Rake $0 | Jackpot $0 | Bingo $0 | Fortune $0 | Tax $0
Seat 1: a638a3a8 (button) folded before Flop (didn't bet)
Seat 2: 5261fe21 (small blind) collected ($0.1)
Seat 3: 5b2bf61b (big blind) folded before Flop
Seat 4: Hero folded before Flop (didn't bet)
Seat 5: 488f1674 folded before Flop (didn't bet)
Seat 6: 3e82955f folded before Flop (didn't bet)


Poker Hand #RC2078404700: Hold'em No Limit ($0.02/$0.05) - 2023/12/22 20:56:58
Table 'RushAndCash773493' 6-max Seat #1 is the button
Seat 1: 6b17ebd5 ($5 in chips)
Seat 2: 36046ad1 ($5 in chips)
Seat 3: 919daa51 ($6.23 in chips)
Seat 4: dc7cff29 ($5.85 in chips)
Seat 5: fbeaaad2 ($10.47 in chips)
Seat 6: Hero ($5 in chips)
36046ad1: posts small blind $0.02
919daa51: posts big blind $0.05
*** HOLE CARDS ***
Dealt to 6b17ebd5 
Dealt to 36046ad1 
Dealt to 919daa51 
Dealt to dc7cff29 
Dealt to fbeaaad2 
Dealt to Hero [2d Kh]
dc7cff29: folds
fbeaaad2: folds
Hero: folds
6b17ebd5: raises $0.08 to $0.13
36046ad1: folds
919daa51: calls $0.08
*** FLOP *** [Tc 8d Jd]
919daa51: checks
6b17ebd5: bets $0.1
919daa51: calls $0.1
*** TURN *** [Tc 8d Jd] [9c]
919daa51: checks
6b17ebd5: checks
*** RIVER *** [Tc 8d Jd 9c] [6c]
919daa51: bets $0.2
6b17ebd5: folds
Uncalled bet ($0.2) returned to 919daa51
*** SHOWDOWN ***
919daa51 collected $0.46 from pot
*** SUMMARY ***
Total pot $0.48 | Rake $0.02 | Jackpot $0 | Bingo $0 | Fortune $0 | Tax $0
Board [Tc 8d Jd 9c 6c]
Seat 1: 6b17ebd5 (button) folded on the River
Seat 2: 36046ad1 (small blind) folded before Flop
Seat 3: 919daa51 (big blind) won ($0.46)
Seat 4: dc7cff29 folded before Flop (didn't bet)
Seat 5: fbeaaad2 folded before Flop (didn't bet)
Seat 6: Hero folded before Flop (didn't bet)


Poker Hand #RC2078404471: Hold'em No Limit ($0.02/$0.05) - 2023/12/22 20:56:45
Table 'RushAndCash773387' 6-max Seat #1 is the button
Seat 1: 567a37c4 ($5.03 in chips)
Seat 2: Hero ($5.02 in chips)
Seat 3: af0d3b6b ($5.27 in chips)
Seat 4: ee1f67f7 ($9.44 in chips)
Seat 5: 780930d2 ($6.62 in chips)
Seat 6: 4b0bc21a ($5 in chips)
Hero: posts small blind $0.02
af0d3b6b: posts big blind $0.05
*** HOLE CARDS ***
Dealt to 567a37c4 
Dealt to Hero [6s 7c]
Dealt to af0d3b6b 
Dealt to ee1f67f7 
Dealt to 780930d2 
Dealt to 4b0bc21a 
ee1f67f7: folds
780930d2: folds
4b0bc21a: raises $0.08 to $0.13
567a37c4: folds
Hero: folds
af0d3b6b: folds
Uncalled bet ($0.08) returned to 4b0bc21a
*** SHOWDOWN ***
4b0bc21a collected $0.12 from pot
*** SUMMARY ***
Total pot $0.12 | Rake $0 | Jackpot $0 | Bingo $0 | Fortune $0 | Tax $0
Seat 1: 567a37c4 (button) folded before Flop (didn't bet)
Seat 2: Hero (small blind) folded before Flop
Seat 3: af0d3b6b (big blind) folded before Flop
Seat 4: ee1f67f7 folded before Flop (didn't bet)
Seat 5: 780930d2 folded before Flop (didn't bet)
Seat 6: 4b0bc21a collected ($0.12)


Poker Hand #RC2078404217: Hold'em No Limit ($0.02/$0.05) - 2023/12/22 20:56:30
Table 'RushAndCash773262' 6-max Seat #1 is the button
Seat 1: 7a269055 ($6.88 in chips)
Seat 2: af92dfc8 ($4.56 in chips)
Seat 3: Hero ($5 in chips)
Seat 4: a28fdf02 ($7.47 in chips)
Seat 5: fb772588 ($5.26 in chips)
Seat 6: e8df5901 ($8.92 in chips)
af92dfc8: posts small blind $0.02
Hero: posts big blind $0.05
*** HOLE CARDS ***
Dealt to 7a269055 
Dealt to af92dfc8 
Dealt to Hero [7d 9d]
Dealt to a28fdf02 
Dealt to fb772588 
Dealt to e8df5901 
a28fdf02: folds
fb772588: folds
e8df5901: folds
7a269055: folds
af92dfc8: folds
Uncalled bet ($0.03) returned to Hero
*** SHOWDOWN ***
Hero collected $0.04 from pot
*** SUMMARY ***
Total pot $0.04 | Rake $0 | Jackpot $0 | Bingo $0 | Fortune $0 | Tax $0
Seat 1: 7a269055 (button) folded before Flop (didn't bet)
Seat 2: af92dfc8 (small blind) folded before Flop
Seat 3: Hero (big blind) collected ($0.04)
Seat 4: a28fdf02 folded before Flop (didn't bet)
Seat 5: fb772588 folded before Flop (didn't bet)
Seat 6: e8df5901 folded before Flop (didn't bet)


Poker Hand #RC2078404155: Hold'em No Limit ($0.02/$0.05) - 2023/12/22 20:56:27
Table 'RushAndCash773234' 6-max Seat #1 is the button
Seat 1: Hero ($5 in chips)
Seat 2: 96f3ff6 ($9.38 in chips)
Seat 3: f942fd52 ($5 in chips)
Seat 4: 7020d421 ($15.67 in chips)
Seat 5: edd2798e ($10.01 in chips)
Seat 6: 1f940f2d ($5 in chips)
96f3ff6: posts small blind $0.02
f942fd52: posts big blind $0.05
*** HOLE CARDS ***
Dealt to Hero [3c 7c]
Dealt to 96f3ff6 
Dealt to f942fd52 
Dealt to 7020d421 
Dealt to edd2798e 
Dealt to 1f940f2d 
7020d421: folds
edd2798e: folds
1f940f2d: folds
Hero: folds
96f3ff6: folds
Uncalled bet ($0.03) returned to f942fd52
*** SHOWDOWN ***
f942fd52 collected $0.04 from pot
*** SUMMARY ***
Total pot $0.04 | Rake $0 | Jackpot $0 | Bingo $0 | Fortune $0 | Tax $0
Seat 1: Hero (button) folded before Flop (didn't bet)
Seat 2: 96f3ff6 (small blind) folded before Flop
Seat 3: f942fd52 (big blind) collected ($0.04)
Seat 4: 7020d421 folded before Flop (didn't bet)
Seat 5: edd2798e folded before Flop (didn't bet)
Seat 6: 1f940f2d folded before Flop (didn't bet)


Poker Hand #RC2078404093: Hold'em No Limit ($0.02/$0.05) - 2023/12/22 20:56:23
Table 'RushAndCash773206' 6-max Seat #1 is the button
Seat 1: 2588276e ($3.95 in chips)
Seat 2: 1f940f2d ($5 in chips)
Seat 3: 8e0f056d ($7.41 in chips)
Seat 4: Hero ($5 in chips)
Seat 5: 8f8f33cc ($8.87 in chips)
Seat 6: 16153105 ($2.89 in chips)
1f940f2d: posts small blind $0.02
8e0f056d: posts big blind $0.05
*** HOLE CARDS ***
Dealt to 2588276e 
Dealt to 1f940f2d 
Dealt to 8e0f056d 
Dealt to Hero [7h Th]
Dealt to 8f8f33cc 
Dealt to 16153105 
Hero: folds
8f8f33cc: folds
16153105: raises $0.05 to $0.1
2588276e: folds
1f940f2d: folds
8e0f056d: calls $0.05
*** FLOP *** [4s 5h 3h]
8e0f056d: checks
16153105: bets $0.11
8e0f056d: calls $0.11
*** TURN *** [4s 5h 3h] [6s]
8e0f056d: checks
16153105: checks
*** RIVER *** [4s 5h 3h 6s] [Ks]
8e0f056d: checks
16153105: checks
8e0f056d: shows [7d 8h] (Eights-High Straight)
16153105: shows [Ah Ac] (Pair of Aces)
*** SHOWDOWN ***
8e0f056d collected $0.42 from pot
*** SUMMARY ***
Total pot $0.44 | Rake $0.02 | Jackpot $0 | Bingo $0 | Fortune $0 | Tax $0
Board [4s 5h 3h 6s Ks]
Seat 1: 2588276e (button) folded before Flop (didn't bet)
Seat 2: 1f940f2d (small blind) folded before Flop
Seat 3: 8e0f056d (big blind) showed [7d 8h] and won ($0.42) with Eights-High Straight
Seat 4: Hero folded before Flop (didn't bet)
Seat 5: 8f8f33cc folded before Flop (didn't bet)
Seat 6: 16153105 showed [Ah Ac] and lost with Pair of Aces


Poker Hand #RC2078404027: Hold'em No Limit ($0.02/$0.05) - 2023/12/22 20:56:19
Table 'RushAndCash773176' 6-max Seat #1 is the button
Seat 1: f9c6a467 ($16.38 in chips)
Seat 2: 985b2ecb ($4.74 in chips)
Seat 3: 6b8a648f ($5 in chips)
Seat 4: Hero ($5 in chips)
Seat 5: 3c8f2664 ($1.83 in chips)
Seat 6: 89c6e004 ($5.17 in chips)
985b2ecb: posts small blind $0.02
6b8a648f: posts big blind $0.05
*** HOLE CARDS ***
Dealt to f9c6a467 
Dealt to 985b2ecb 
Dealt to 6b8a648f 
Dealt to Hero [2d Kh]
Dealt to 3c8f2664 
Dealt to 89c6e004 
Hero: folds
3c8f2664: folds
89c6e004: raises $0.06 to $0.11
f9c6a467: folds
985b2ecb: folds
6b8a648f: calls $0.06
*** FLOP *** [Qs 2h As]
6b8a648f: checks
89c6e004: bets $0.12
6b8a648f: folds
Uncalled bet ($0.12) returned to 89c6e004
*** SHOWDOWN ***
89c6e004 collected $0.23 from pot
*** SUMMARY ***
Total pot $0.24 | Rake $0.01 | Jackpot $0 | Bingo $0 | Fortune $0 | Tax $0
Board [Qs 2h As]
Seat 1: f9c6a467 (button) folded before Flop (didn't bet)
Seat 2: 985b2ecb (small blind) folded before Flop
Seat 3: 6b8a648f (big blind) folded on the Flop
Seat 4: Hero folded before Flop (didn't bet)
Seat 5: 3c8f2664 folded before Flop (didn't bet)
Seat 6: 89c6e004 won ($0.23)


Poker Hand #RC2078403956: Hold'em No Limit ($0.02/$0.05) - 2023/12/22 20:56:16
Table 'RushAndCash773142' 6-max Seat #1 is the button
Seat 1: Hero ($5 in chips)
Seat 2: 3c8f2664 ($1.85 in chips)
Seat 3: 3216f2c0 ($5.46 in chips)
Seat 4: 4d5fe452 ($5 in chips)
Seat 5: a9b7f4fa ($4.88 in chips)
Seat 6: 54daf47b ($10.29 in chips)
3c8f2664: posts small blind $0.02
3216f2c0: posts big blind $0.05
*** HOLE CARDS ***
Dealt to Hero [2c 6d]
Dealt to 3c8f2664 
Dealt to 3216f2c0 
Dealt to 4d5fe452 
Dealt to a9b7f4fa 
Dealt to 54daf47b 
4d5fe452: raises $0.07 to $0.12
a9b7f4fa: folds
54daf47b: folds
Hero: folds
3c8f2664: folds
3216f2c0: folds
Uncalled bet ($0.07) returned to 4d5fe452
*** SHOWDOWN ***
4d5fe452 collected $0.12 from pot
*** SUMMARY ***
Total pot $0.12 | Rake $0 | Jackpot $0 | Bingo $0 | Fortune $0 | Tax $0
Seat 1: Hero (button) folded before Flop (didn't bet)
Seat 2: 3c8f2664 (small blind) folded before Flop
Seat 3: 3216f2c0 (big blind) folded before Flop
Seat 4: 4d5fe452 collected ($0.12)
Seat 5: a9b7f4fa folded before Flop (didn't bet)
Seat 6: 54daf47b folded before Flop (didn't bet)


Poker Hand #RC2078403888: Hold'em No Limit ($0.02/$0.05) - 2023/12/22 20:56:12
Table 'RushAndCash773111' 6-max Seat #1 is the button
Seat 1: fd07586a ($5.31 in chips)
Seat 2: c71b7029 ($10.48 in chips)
Seat 3: 857de63c ($8.7 in chips)
Seat 4: a9b7f4fa ($4.88 in chips)
Seat 5: d18647ce ($6.01 in chips)
Seat 6: Hero ($5 in chips)
c71b7029: posts small blind $0.02
857de63c: posts big blind $0.05
*** HOLE CARDS ***
Dealt to fd07586a 
Dealt to c71b7029 
Dealt to 857de63c 
Dealt to a9b7f4fa 
Dealt to d18647ce 
Dealt to Hero [4c Qd]
a9b7f4fa: folds
d18647ce: raises $0.07 to $0.12
Hero: folds
fd07586a: folds
c71b7029: folds
857de63c: folds
Uncalled bet ($0.07) returned to d18647ce
*** SHOWDOWN ***
d18647ce collected $0.12 from pot
*** SUMMARY ***
Total pot $0.12 | Rake $0 | Jackpot $0 | Bingo $0 | Fortune $0 | Tax $0
Seat 1: fd07586a (button) folded before Flop (didn't bet)
Seat 2: c71b7029 (small blind) folded before Flop
Seat 3: 857de63c (big blind) folded before Flop
Seat 4: a9b7f4fa folded before Flop (didn't bet)
Seat 5: d18647ce collected ($0.12)
Seat 6: Hero folded before Flop (didn't bet)


Poker Hand #RC2078403690: Hold'em No Limit ($0.02/$0.05) - 2023/12/22 20:56:01
Table 'RushAndCash773026' 6-max Seat #1 is the button
Seat 1: 3091c4e7 ($5.09 in chips)
Seat 2: Hero ($5.02 in chips)
Seat 3: 23378cb ($1.92 in chips)
Seat 4: 1adb19a8 ($4.53 in chips)
Seat 5: 697fb04a ($43.3 in chips)
Seat 6: abd6fe91 ($5.07 in chips)
Hero: posts small blind $0.02
23378cb: posts big blind $0.05
*** HOLE CARDS ***
Dealt to 3091c4e7 
Dealt to Hero [7c Kd]
Dealt to 23378cb 
Dealt to 1adb19a8 
Dealt to 697fb04a 
Dealt to abd6fe91 
1adb19a8: raises $0.08 to $0.13
697fb04a: folds
abd6fe91: calls $0.13
3091c4e7: folds
Hero: folds
23378cb: folds
*** FLOP *** [9c 5d 4d]
1adb19a8: bets $0.11
abd6fe91: raises $0.29 to $0.4
1adb19a8: calls $0.29
*** TURN *** [9c 5d 4d] [Jc]
1adb19a8: checks
abd6fe91: checks
*** RIVER *** [9c 5d 4d Jc] [Kh]
1adb19a8: bets $0.36
abd6fe91: folds
Uncalled bet ($0.36) returned to 1adb19a8
*** SHOWDOWN ***
1adb19a8 collected $1.08 from pot
*** SUMMARY ***
Total pot $1.13 | Rake $0.05 | Jackpot $0 | Bingo $0 | Fortune $0 | Tax $0
Board [9c 5d 4d Jc Kh]
Seat 1: 3091c4e7 (button) folded before Flop (didn't bet)
Seat 2: Hero (small blind) folded before Flop
Seat 3: 23378cb (big blind) folded before Flop
Seat 4: 1adb19a8 won ($1.08)
Seat 5: 697fb04a folded before Flop (didn't bet)
Seat 6: abd6fe91 folded on the River


Poker Hand #RC2078403563: Hold'em No Limit ($0.02/$0.05) - 2023/12/22 20:55:53
Table 'RushAndCash772967' 6-max Seat #1 is the button
Seat 1: d9dd0075 ($4.93 in chips)
Seat 2: 780442c9 ($5.02 in chips)
Seat 3: Hero ($5 in chips)
Seat 4: 36060128 ($7.53 in chips)
Seat 5: 8f80311 ($5 in chips)
Seat 6: cb07f953 ($9.12 in chips)
780442c9: posts small blind $0.02
Hero: posts big blind $0.05
*** HOLE CARDS ***
Dealt to d9dd0075 
Dealt to 780442c9 
Dealt to Hero [7c Js]
Dealt to 36060128 
Dealt to 8f80311 
Dealt to cb07f953 
36060128: folds
8f80311: folds
cb07f953: folds
d9dd0075: folds
780442c9: folds
Uncalled bet ($0.03) returned to Hero
*** SHOWDOWN ***
Hero collected $0.04 from pot
*** SUMMARY ***
Total pot $0.04 | Rake $0 | Jackpot $0 | Bingo $0 | Fortune $0 | Tax $0
Seat 1: d9dd0075 (button) folded before Flop (didn't bet)
Seat 2: 780442c9 (small blind) folded before Flop
Seat 3: Hero (big blind) collected ($0.04)
Seat 4: 36060128 folded before Flop (didn't bet)
Seat 5: 8f80311 folded before Flop (didn't bet)
Seat 6: cb07f953 folded before Flop (didn't bet)


Poker Hand #RC2078403495: Hold'em No Limit ($0.02/$0.05) - 2023/12/22 20:55:49
Table 'RushAndCash772935' 6-max Seat #1 is the button
Seat 1: d29426f7 ($2.79 in chips)
Seat 2: cb07f953 ($9.14 in chips)
Seat 3: 999944fc ($3.15 in chips)
Seat 4: Hero ($5 in chips)
Seat 5: 11676b65 ($5.49 in chips)
Seat 6: 697fb04a ($43.35 in chips)
cb07f953: posts small blind $0.02
999944fc: posts big blind $0.05
*** HOLE CARDS ***
Dealt to d29426f7 
Dealt to cb07f953 
Dealt to 999944fc 
Dealt to Hero [4c 5d]
Dealt to 11676b65 
Dealt to 697fb04a 
Hero: folds
11676b65: folds
697fb04a: folds
d29426f7: raises $0.08 to $0.13
cb07f953: folds
999944fc: folds
Uncalled bet ($0.08) returned to d29426f7
*** SHOWDOWN ***
d29426f7 collected $0.12 from pot
*** SUMMARY ***
Total pot $0.12 | Rake $0 | Jackpot $0 | Bingo $0 | Fortune $0 | Tax $0
Seat 1: d29426f7 (button) collected ($0.12)
Seat 2: cb07f953 (small blind) folded before Flop
Seat 3: 999944fc (big blind) folded before Flop
Seat 4: Hero folded before Flop (didn't bet)
Seat 5: 11676b65 folded before Flop (didn't bet)
Seat 6: 697fb04a folded before Flop (didn't bet)


Poker Hand #RC2078403438: Hold'em No Limit ($0.02/$0.05) - 2023/12/22 20:55:46
Table 'RushAndCash772906' 6-max Seat #1 is the button
Seat 1: a2f5e875 ($6.52 in chips)
Seat 2: 2ec85018 ($4.95 in chips)
Seat 3: fb13494d ($4.25 in chips)
Seat 4: 780442c9 ($5.07 in chips)
Seat 5: Hero ($5 in chips)
Seat 6: 5d55167a ($10.25 in chips)
2ec85018: posts small blind $0.02
fb13494d: posts big blind $0.05
*** HOLE CARDS ***
Dealt to a2f5e875 
Dealt to 2ec85018 
Dealt to fb13494d 
Dealt to 780442c9 
Dealt to Hero [7s Qd]
Dealt to 5d55167a 
780442c9: folds
Hero: folds
5d55167a: folds
a2f5e875: raises $0.08 to $0.13
2ec85018: folds
fb13494d: calls $0.08
*** FLOP *** [3s 7h 4c]
fb13494d: checks
a2f5e875: checks
*** TURN *** [3s 7h 4c] [6s]
fb13494d: checks
a2f5e875: checks
*** RIVER *** [3s 7h 4c 6s] [Td]
fb13494d: checks
a2f5e875: checks
fb13494d: shows [Tc Kc] (Pair of Tens)
a2f5e875: shows [Qh As] (Ace-High)
*** SHOWDOWN ***
fb13494d collected $0.27 from pot
*** SUMMARY ***
Total pot $0.28 | Rake $0.01 | Jackpot $0 | Bingo $0 | Fortune $0 | Tax $0
Board [3s 7h 4c 6s Td]
Seat 1: a2f5e875 (button) showed [Qh As] and lost with Ace-High
Seat 2: 2ec85018 (small blind) folded before Flop
Seat 3: fb13494d (big blind) showed [Tc Kc] and won ($0.27) with Pair of Tens
Seat 4: 780442c9 folded before Flop (didn't bet)
Seat 5: Hero folded before Flop (didn't bet)
Seat 6: 5d55167a folded before Flop (didn't bet)


Poker Hand #RC2078403376: Hold'em No Limit ($0.02/$0.05) - 2023/12/22 20:55:42
Table 'RushAndCash772873' 6-max Seat #1 is the button
Seat 1: 69a8b613 ($6.42 in chips)
Seat 2: 7fff3387 ($5 in chips)
Seat 3: 89ac50e8 ($14.43 in chips)
Seat 4: ee6cadf8 ($6.11 in chips)
Seat 5: Hero ($5 in chips)
Seat 6: cf6f5635 ($7.26 in chips)
7fff3387: posts small blind $0.02
89ac50e8: posts big blind $0.05
*** HOLE CARDS ***
Dealt to 69a8b613 
Dealt to 7fff3387 
Dealt to 89ac50e8 
Dealt to ee6cadf8 
Dealt to Hero [8s Qd]
Dealt to cf6f5635 
ee6cadf8: folds
Hero: folds
cf6f5635: folds
69a8b613: folds
7fff3387: folds
Uncalled bet ($0.03) returned to 89ac50e8
*** SHOWDOWN ***
89ac50e8 collected $0.04 from pot
*** SUMMARY ***
Total pot $0.04 | Rake $0 | Jackpot $0 | Bingo $0 | Fortune $0 | Tax $0
Seat 1: 69a8b613 (button) folded before Flop (didn't bet)
Seat 2: 7fff3387 (small blind) folded before Flop
Seat 3: 89ac50e8 (big blind) collected ($0.04)
Seat 4: ee6cadf8 folded before Flop (didn't bet)
Seat 5: Hero folded before Flop (didn't bet)
Seat 6: cf6f5635 folded before Flop (didn't bet)


Poker Hand #RC2078403283: Hold'em No Limit ($0.02/$0.05) - 2023/12/22 20:55:37
Table 'RushAndCash772827' 6-max Seat #1 is the button
Seat 1: 4fe2d26d ($4.82 in chips)
Seat 2: 395dbfbb ($7.03 in chips)
Seat 3: 8d09c020 ($5.57 in chips)
Seat 4: Hero ($5 in chips)
Seat 5: ff6f425f ($9.36 in chips)
Seat 6: 8070ac2f ($2.27 in chips)
395dbfbb: posts small blind $0.02
8d09c020: posts big blind $0.05
*** HOLE CARDS ***
Dealt to 4fe2d26d 
Dealt to 395dbfbb 
Dealt to 8d09c020 
Dealt to Hero [4s Qc]
Dealt to ff6f425f 
Dealt to 8070ac2f 
Hero: folds
ff6f425f: folds
8070ac2f: raises $0.05 to $0.1
4fe2d26d: raises $0.2 to $0.3
395dbfbb: folds
8d09c020: folds
8070ac2f: calls $0.2
*** FLOP *** [5h 9d 6c]
8070ac2f: checks
4fe2d26d: checks
*** TURN *** [5h 9d 6c] [5s]
8070ac2f: bets $0.34
4fe2d26d: folds
Uncalled bet ($0.34) returned to 8070ac2f
*** SHOWDOWN ***
8070ac2f collected $0.63 from pot
*** SUMMARY ***
Total pot $0.67 | Rake $0.04 | Jackpot $0 | Bingo $0 | Fortune $0 | Tax $0
Board [5h 9d 6c 5s]
Seat 1: 4fe2d26d (button) folded on the Turn
Seat 2: 395dbfbb (small blind) folded before Flop
Seat 3: 8d09c020 (big blind) folded before Flop
Seat 4: Hero folded before Flop (didn't bet)
Seat 5: ff6f425f folded before Flop (didn't bet)
Seat 6: 8070ac2f won ($0.63)


Poker Hand #RC2078402728: Hold'em No Limit ($0.02/$0.05) - 2023/12/22 20:55:07
Table 'RushAndCash772562' 6-max Seat #1 is the button
Seat 1: 3a35e9f5 ($15.26 in chips)
Seat 2: Hero ($5.09 in chips)
Seat 3: 4ab8a557 ($5.43 in chips)
Seat 4: 886872c9 ($5.02 in chips)
Seat 5: e5de031c ($5.84 in chips)
Seat 6: dce31b8a ($5.87 in chips)
Hero: posts small blind $0.02
4ab8a557: posts big blind $0.05
*** HOLE CARDS ***
Dealt to 3a35e9f5 
Dealt to Hero [As 9d]
Dealt to 4ab8a557 
Dealt to 886872c9 
Dealt to e5de031c 
Dealt to dce31b8a 
886872c9: folds
e5de031c: folds
dce31b8a: folds
3a35e9f5: raises $0.06 to $0.11
Hero: calls $0.09
4ab8a557: folds
*** FLOP *** [2c 4d Qs]
Hero: checks
3a35e9f5: bets $0.1
Hero: folds
Uncalled bet ($0.1) returned to 3a35e9f5
*** SHOWDOWN ***
3a35e9f5 collected $0.26 from pot
*** SUMMARY ***
Total pot $0.27 | Rake $0.01 | Jackpot $0 | Bingo $0 | Fortune $0 | Tax $0
Board [2c 4d Qs]
Seat 1: 3a35e9f5 (button) won ($0.26)
Seat 2: Hero (small blind) folded on the Flop
Seat 3: 4ab8a557 (big blind) folded before Flop
Seat 4: 886872c9 folded before Flop (didn't bet)
Seat 5: e5de031c folded before Flop (didn't bet)
Seat 6: dce31b8a folded before Flop (didn't bet)


Poker Hand #RC2078402507: Hold'em No Limit ($0.02/$0.05) - 2023/12/22 20:54:54
Table 'RushAndCash772460' 6-max Seat #1 is the button
Seat 1: 3160ff3c ($6.26 in chips)
Seat 2: 29b0f5be ($5.26 in chips)
Seat 3: Hero ($5.07 in chips)
Seat 4: 82e9c1ba ($12.13 in chips)
Seat 5: 59846dec ($7.98 in chips)
Seat 6: 21196b97 ($5.87 in chips)
29b0f5be: posts small blind $0.02
Hero: posts big blind $0.05
*** HOLE CARDS ***
Dealt to 3160ff3c 
Dealt to 29b0f5be 
Dealt to Hero [2s 6d]
Dealt to 82e9c1ba 
Dealt to 59846dec 
Dealt to 21196b97 
82e9c1ba: folds
59846dec: folds
21196b97: folds
3160ff3c: folds
29b0f5be: folds
Uncalled bet ($0.03) returned to Hero
*** SHOWDOWN ***
Hero collected $0.04 from pot
*** SUMMARY ***
Total pot $0.04 | Rake $0 | Jackpot $0 | Bingo $0 | Fortune $0 | Tax $0
Seat 1: 3160ff3c (button) folded before Flop (didn't bet)
Seat 2: 29b0f5be (small blind) folded before Flop
Seat 3: Hero (big blind) collected ($0.04)
Seat 4: 82e9c1ba folded before Flop (didn't bet)
Seat 5: 59846dec folded before Flop (didn't bet)
Seat 6: 21196b97 folded before Flop (didn't bet)


Poker Hand #RC2078402446: Hold'em No Limit ($0.02/$0.05) - 2023/12/22 20:54:51
Table 'RushAndCash772431' 6-max Seat #1 is the button
Seat 1: Hero ($5.07 in chips)
Seat 2: bd5f2ca8 ($4.29 in chips)
Seat 3: 49ea92ea ($6.01 in chips)
Seat 4: 50d599ea ($5 in chips)
Seat 5: acefe839 ($15.95 in chips)
Seat 6: a2fed278 ($5.23 in chips)
bd5f2ca8: posts small blind $0.02
49ea92ea: posts big blind $0.05
*** HOLE CARDS ***
Dealt to Hero [6s 3c]
Dealt to bd5f2ca8 
Dealt to 49ea92ea 
Dealt to 50d599ea 
Dealt to acefe839 
Dealt to a2fed278 
50d599ea: folds
acefe839: folds
a2fed278: folds
Hero: folds
bd5f2ca8: raises $0.05 to $0.1
49ea92ea: folds
Uncalled bet ($0.05) returned to bd5f2ca8
*** SHOWDOWN ***
bd5f2ca8 collected $0.1 from pot
*** SUMMARY ***
Total pot $0.1 | Rake $0 | Jackpot $0 | Bingo $0 | Fortune $0 | Tax $0
Seat 1: Hero (button) folded before Flop (didn't bet)
Seat 2: bd5f2ca8 (small blind) collected ($0.1)
Seat 3: 49ea92ea (big blind) folded before Flop
Seat 4: 50d599ea folded before Flop (didn't bet)
Seat 5: acefe839 folded before Flop (didn't bet)
Seat 6: a2fed278 folded before Flop (didn't bet)


Poker Hand #RC2078402380: Hold'em No Limit ($0.02/$0.05) - 2023/12/22 20:54:47
Table 'RushAndCash772401' 6-max Seat #1 is the button
Seat 1: 8505bab2 ($5 in chips)
Seat 2: 885ae6ee ($9.07 in chips)
Seat 3: b6b18568 ($5.84 in chips)
Seat 4: Hero ($5.07 in chips)
Seat 5: cadbc8d6 ($5.19 in chips)
Seat 6: 44d3a861 ($5.7 in chips)
885ae6ee: posts small blind $0.02
b6b18568: posts big blind $0.05
*** HOLE CARDS ***
Dealt to 8505bab2 
Dealt to 885ae6ee 
Dealt to b6b18568 
Dealt to Hero [7s Jd]
Dealt to cadbc8d6 
Dealt to 44d3a861 
Hero: folds
cadbc8d6: folds
44d3a861: folds
8505bab2: folds
885ae6ee: folds
Uncalled bet ($0.03) returned to b6b18568
*** SHOWDOWN ***
b6b18568 collected $0.04 from pot
*** SUMMARY ***
Total pot $0.04 | Rake $0 | Jackpot $0 | Bingo $0 | Fortune $0 | Tax $0
Seat 1: 8505bab2 (button) folded before Flop (didn't bet)
Seat 2: 885ae6ee (small blind) folded before Flop
Seat 3: b6b18568 (big blind) collected ($0.04)
Seat 4: Hero folded before Flop (didn't bet)
Seat 5: cadbc8d6 folded before Flop (didn't bet)
Seat 6: 44d3a861 folded before Flop (didn't bet)


Poker Hand #RC2078402296: Hold'em No Limit ($0.02/$0.05) - 2023/12/22 20:54:43
Table 'RushAndCash772366' 6-max Seat #1 is the button
Seat 1: a28fdf02 ($7.23 in chips)
Seat 2: 81ecaac5 ($3.54 in chips)
Seat 3: e9433577 ($6.06 in chips)
Seat 4: a0ef5108 ($3.84 in chips)
Seat 5: edce49c5 ($5.02 in chips)
Seat 6: Hero ($5.07 in chips)
81ecaac5: posts small blind $0.02
e9433577: posts big blind $0.05
*** HOLE CARDS ***
Dealt to a28fdf02 
Dealt to 81ecaac5 
Dealt to e9433577 
Dealt to a0ef5108 
Dealt to edce49c5 
Dealt to Hero [2h 6h]
a0ef5108: folds
edce49c5: folds
Hero: folds
a28fdf02: raises $0.08 to $0.13
81ecaac5: folds
e9433577: folds
Uncalled bet ($0.08) returned to a28fdf02
*** SHOWDOWN ***
a28fdf02 collected $0.12 from pot
*** SUMMARY ***
Total pot $0.12 | Rake $0 | Jackpot $0 | Bingo $0 | Fortune $0 | Tax $0
Seat 1: a28fdf02 (button) collected ($0.12)
Seat 2: 81ecaac5 (small blind) folded before Flop
Seat 3: e9433577 (big blind) folded before Flop
Seat 4: a0ef5108 folded before Flop (didn't bet)
Seat 5: edce49c5 folded before Flop (didn't bet)
Seat 6: Hero folded before Flop (didn't bet)


Poker Hand #RC2078402228: Hold'em No Limit ($0.02/$0.05) - 2023/12/22 20:54:39
Table 'RushAndCash772335' 6-max Seat #1 is the button
Seat 1: Hero ($5.07 in chips)
Seat 2: 8505bab2 ($5 in chips)
Seat 3: d17fa451 ($5 in chips)
Seat 4: 3759e445 ($4.56 in chips)
Seat 5: d32741ba ($9.85 in chips)
Seat 6: edce49c5 ($5.02 in chips)
8505bab2: posts small blind $0.02
d17fa451: posts big blind $0.05
*** HOLE CARDS ***
Dealt to Hero [8d 5c]
Dealt to 8505bab2 
Dealt to d17fa451 
Dealt to 3759e445 
Dealt to d32741ba 
Dealt to edce49c5 
3759e445: raises $0.06 to $0.11
d32741ba: folds
edce49c5: folds
Hero: folds
8505bab2: folds
d17fa451: calls $0.06
*** FLOP *** [8s 4c Td]
d17fa451: checks
3759e445: bets $0.08
d17fa451: calls $0.08
*** TURN *** [8s 4c Td] [7c]
d17fa451: checks
3759e445: checks
*** RIVER *** [8s 4c Td 7c] [6h]
d17fa451: bets $0.3
3759e445: folds
Uncalled bet ($0.3) returned to d17fa451
*** SHOWDOWN ***
d17fa451 collected $0.38 from pot
*** SUMMARY ***
Total pot $0.4 | Rake $0.02 | Jackpot $0 | Bingo $0 | Fortune $0 | Tax $0
Board [8s 4c Td 7c 6h]
Seat 1: Hero (button) folded before Flop (didn't bet)
Seat 2: 8505bab2 (small blind) folded before Flop
Seat 3: d17fa451 (big blind) won ($0.38)
Seat 4: 3759e445 folded on the River
Seat 5: d32741ba folded before Flop (didn't bet)
Seat 6: edce49c5 folded before Flop (didn't bet)


Poker Hand #RC2078402122: Hold'em No Limit ($0.02/$0.05) - 2023/12/22 20:54:34
Table 'RushAndCash772290' 6-max Seat #1 is the button
Seat 1: dddaf9db ($5.16 in chips)
Seat 2: Hero ($5.09 in chips)
Seat 3: edb6154b ($5 in chips)
Seat 4: d6126048 ($7.81 in chips)
Seat 5: d74d8525 ($5 in chips)
Seat 6: 5e8dc530 ($6.07 in chips)
Hero: posts small blind $0.02
edb6154b: posts big blind $0.05
*** HOLE CARDS ***
Dealt to dddaf9db 
Dealt to Hero [2h 3d]
Dealt to edb6154b 
Dealt to d6126048 
Dealt to d74d8525 
Dealt to 5e8dc530 
d6126048: raises $0.05 to $0.1
d74d8525: folds
5e8dc530: folds
dddaf9db: folds
Hero: folds
edb6154b: folds
Uncalled bet ($0.05) returned to d6126048
*** SHOWDOWN ***
d6126048 collected $0.12 from pot
*** SUMMARY ***
Total pot $0.12 | Rake $0 | Jackpot $0 | Bingo $0 | Fortune $0 | Tax $0
Seat 1: dddaf9db (button) folded before Flop (didn't bet)
Seat 2: Hero (small blind) folded before Flop
Seat 3: edb6154b (big blind) folded before Flop
Seat 4: d6126048 collected ($0.12)
Seat 5: d74d8525 folded before Flop (didn't bet)
Seat 6: 5e8dc530 folded before Flop (didn't bet)


Poker Hand #RC2078401982: Hold'em No Limit ($0.02/$0.05) - 2023/12/22 20:54:26
Table 'RushAndCash772226' 6-max Seat #1 is the button
Seat 1: d3432d7f ($4.57 in chips)
Seat 2: dc851cb6 ($5.71 in chips)
Seat 3: Hero ($5.07 in chips)
Seat 4: 38e42730 ($5.23 in chips)
Seat 5: 32d77abe ($6.79 in chips)
Seat 6: 38444444 ($14.85 in chips)
dc851cb6: posts small blind $0.02
Hero: posts big blind $0.05
*** HOLE CARDS ***
Dealt to d3432d7f 
Dealt to dc851cb6 
Dealt to Hero [Jh Kh]
Dealt to 38e42730 
Dealt to 32d77abe 
Dealt to 38444444 
38e42730: folds
32d77abe: folds
38444444: folds
d3432d7f: folds
dc851cb6: folds
Uncalled bet ($0.03) returned to Hero
*** SHOWDOWN ***
Hero collected $0.04 from pot
*** SUMMARY ***
Total pot $0.04 | Rake $0 | Jackpot $0 | Bingo $0 | Fortune $0 | Tax $0
Seat 1: d3432d7f (button) folded before Flop (didn't bet)
Seat 2: dc851cb6 (small blind) folded before Flop
Seat 3: Hero (big blind) collected ($0.04)
Seat 4: 38e42730 folded before Flop (didn't bet)
Seat 5: 32d77abe folded before Flop (didn't bet)
Seat 6: 38444444 folded before Flop (didn't bet)


Poker Hand #RC2078401771: Hold'em No Limit ($0.02/$0.05) - 2023/12/22 20:54:15
Table 'RushAndCash772129' 6-max Seat #1 is the button
Seat 1: 9b87805 ($8.3 in chips)
Seat 2: d18647ce ($5.47 in chips)
Seat 3: eb058b2e ($5.05 in chips)
Seat 4: Hero ($5 in chips)
Seat 5: 22426c35 ($5.33 in chips)
Seat 6: 4b236fca ($10.69 in chips)
d18647ce: posts small blind $0.02
eb058b2e: posts big blind $0.05
*** HOLE CARDS ***
Dealt to 9b87805 
Dealt to d18647ce 
Dealt to eb058b2e 
Dealt to Hero [Th Ac]
Dealt to 22426c35 
Dealt to 4b236fca 
Hero: raises $0.05 to $0.1
22426c35: folds
4b236fca: folds
9b87805: folds
d18647ce: folds
eb058b2e: folds
Uncalled bet ($0.05) returned to Hero
*** SHOWDOWN ***
Hero collected $0.12 from pot
*** SUMMARY ***
Total pot $0.12 | Rake $0 | Jackpot $0 | Bingo $0 | Fortune $0 | Tax $0
Seat 1: 9b87805 (button) folded before Flop (didn't bet)
Seat 2: d18647ce (small blind) folded before Flop
Seat 3: eb058b2e (big blind) folded before Flop
Seat 4: Hero collected ($0.12)
Seat 5: 22426c35 folded before Flop (didn't bet)
Seat 6: 4b236fca folded before Flop (didn't bet)


Poker Hand #RC2078401698: Hold'em No Limit ($0.02/$0.05) - 2023/12/22 20:54:11
Table 'RushAndCash772094' 6-max Seat #1 is the button
Seat 1: d5e25f78 ($16.18 in chips)
Seat 2: c9b8a495 ($5.24 in chips)
Seat 3: 5b2bf61b ($5 in chips)
Seat 4: 320ac28b ($6.67 in chips)
Seat 5: 6c88f65e ($3.87 in chips)
Seat 6: Hero ($5 in chips)
c9b8a495: posts small blind $0.02
5b2bf61b: posts big blind $0.05
*** HOLE CARDS ***
Dealt to d5e25f78 
Dealt to c9b8a495 
Dealt to 5b2bf61b 
Dealt to 320ac28b 
Dealt to 6c88f65e 
Dealt to Hero [2s Th]
320ac28b: folds
6c88f65e: folds
Hero: folds
d5e25f78: folds
c9b8a495: raises $0.08 to $0.13
5b2bf61b: folds
Uncalled bet ($0.08) returned to c9b8a495
*** SHOWDOWN ***
c9b8a495 collected $0.1 from pot
*** SUMMARY ***
Total pot $0.1 | Rake $0 | Jackpot $0 | Bingo $0 | Fortune $0 | Tax $0
Seat 1: d5e25f78 (button) folded before Flop (didn't bet)
Seat 2: c9b8a495 (small blind) collected ($0.1)
Seat 3: 5b2bf61b (big blind) folded before Flop
Seat 4: 320ac28b folded before Flop (didn't bet)
Seat 5: 6c88f65e folded before Flop (didn't bet)
Seat 6: Hero folded before Flop (didn't bet)


Poker Hand #RC2078401622: Hold'em No Limit ($0.02/$0.05) - 2023/12/22 20:54:07
Table 'RushAndCash772059' 6-max Seat #1 is the button
Seat 1: 7732abf7 ($19.4 in chips)
Seat 2: 10abdd7b ($5 in chips)
Seat 3: 567a37c4 ($5.25 in chips)
Seat 4: 6b17ebd5 ($5.04 in chips)
Seat 5: Hero ($5 in chips)
Seat 6: 3c028e9 ($4.82 in chips)
10abdd7b: posts small blind $0.02
567a37c4: posts big blind $0.05
*** HOLE CARDS ***
Dealt to 7732abf7 
Dealt to 10abdd7b 
Dealt to 567a37c4 
Dealt to 6b17ebd5 
Dealt to Hero [Ts 3h]
Dealt to 3c028e9 
6b17ebd5: folds
Hero: folds
3c028e9: raises $0.08 to $0.13
7732abf7: folds
10abdd7b: folds
567a37c4: folds
Uncalled bet ($0.08) returned to 3c028e9
*** SHOWDOWN ***
3c028e9 collected $0.12 from pot
*** SUMMARY ***
Total pot $0.12 | Rake $0 | Jackpot $0 | Bingo $0 | Fortune $0 | Tax $0
Seat 1: 7732abf7 (button) folded before Flop (didn't bet)
Seat 2: 10abdd7b (small blind) folded before Flop
Seat 3: 567a37c4 (big blind) folded before Flop
Seat 4: 6b17ebd5 folded before Flop (didn't bet)
Seat 5: Hero folded before Flop (didn't bet)
Seat 6: 3c028e9 collected ($0.12)


Poker Hand #RC2078401540: Hold'em No Limit ($0.02/$0.05) - 2023/12/22 20:54:03
Table 'RushAndCash772016' 6-max Seat #1 is the button
Seat 1: d456b5e8 ($5.49 in chips)
Seat 2: b61f5bde ($8.62 in chips)
Seat 3: e67ce721 ($5.78 in chips)
Seat 4: b2b4173f ($1.91 in chips)
Seat 5: Hero ($5 in chips)
Seat 6: eb058b2e ($5 in chips)
b61f5bde: posts small blind $0.02
e67ce721: posts big blind $0.05
*** HOLE CARDS ***
Dealt to d456b5e8 
Dealt to b61f5bde 
Dealt to e67ce721 
Dealt to b2b4173f 
Dealt to Hero [2h 9c]
Dealt to eb058b2e 
b2b4173f: folds
Hero: folds
eb058b2e: raises $0.08 to $0.13
d456b5e8: folds
b61f5bde: folds
e67ce721: folds
Uncalled bet ($0.08) returned to eb058b2e
*** SHOWDOWN ***
eb058b2e collected $0.12 from pot
*** SUMMARY ***
Total pot $0.12 | Rake $0 | Jackpot $0 | Bingo $0 | Fortune $0 | Tax $0
Seat 1: d456b5e8 (button) folded before Flop (didn't bet)
Seat 2: b61f5bde (small blind) folded before Flop
Seat 3: e67ce721 (big blind) folded before Flop
Seat 4: b2b4173f folded before Flop (didn't bet)
Seat 5: Hero folded before Flop (didn't bet)
Seat 6: eb058b2e collected ($0.12)


Poker Hand #RC2078400935: Hold'em No Limit ($0.02/$0.05) - 2023/12/22 20:53:29
Table 'RushAndCash771748' 6-max Seat #1 is the button
Seat 1: 34b95cee ($6.05 in chips)
Seat 2: Hero ($5.16 in chips)
Seat 3: 422b3b66 ($3.45 in chips)
Seat 4: 42b55ba4 ($5.95 in chips)
Seat 5: d18647ce ($5.2 in chips)
Seat 6: 9f9a5f9d ($7.05 in chips)
Hero: posts small blind $0.02
422b3b66: posts big blind $0.05
*** HOLE CARDS ***
Dealt to 34b95cee 
Dealt to Hero [Ks Jc]
Dealt to 422b3b66 
Dealt to 42b55ba4 
Dealt to d18647ce 
Dealt to 9f9a5f9d 
42b55ba4: folds
d18647ce: raises $0.07 to $0.12
9f9a5f9d: folds
34b95cee: folds
Hero: calls $0.1
422b3b66: folds
*** FLOP *** [Ts 4c 6h]
Hero: checks
d18647ce: bets $0.1
Hero: calls $0.1
*** TURN *** [Ts 4c 6h] [Tc]
Hero: checks
d18647ce: bets $0.33
Hero: folds
Uncalled bet ($0.33) returned to d18647ce
*** SHOWDOWN ***
d18647ce collected $0.47 from pot
*** SUMMARY ***
Total pot $0.49 | Rake $0.02 | Jackpot $0 | Bingo $0 | Fortune $0 | Tax $0
Board [Ts 4c 6h Tc]
Seat 1: 34b95cee (button) folded before Flop (didn't bet)
Seat 2: Hero (small blind) folded on the Turn
Seat 3: 422b3b66 (big blind) folded before Flop
Seat 4: 42b55ba4 folded before Flop (didn't bet)
Seat 5: d18647ce won ($0.47)
Seat 6: 9f9a5f9d folded before Flop (didn't bet)


Poker Hand #RC2078400783: Hold'em No Limit ($0.02/$0.05) - 2023/12/22 20:53:21
Table 'RushAndCash771675' 6-max Seat #1 is the button
Seat 1: a0ef5108 ($4.72 in chips)
Seat 2: 54daf47b ($10.82 in chips)
Seat 3: Hero ($5.21 in chips)
Seat 4: 7a269055 ($5.5 in chips)
Seat 5: a4441de9 ($5 in chips)
Seat 6: 9ab125dd ($9.3 in chips)
54daf47b: posts small blind $0.02
Hero: posts big blind $0.05
*** HOLE CARDS ***
Dealt to a0ef5108 
Dealt to 54daf47b 
Dealt to Hero [6c Ad]
Dealt to 7a269055 
Dealt to a4441de9 
Dealt to 9ab125dd 
7a269055: folds
a4441de9: folds
9ab125dd: folds
a0ef5108: raises $0.1 to $0.15
54daf47b: folds
Hero: folds
Uncalled bet ($0.1) returned to a0ef5108
*** SHOWDOWN ***
a0ef5108 collected $0.12 from pot
*** SUMMARY ***
Total pot $0.12 | Rake $0 | Jackpot $0 | Bingo $0 | Fortune $0 | Tax $0
Seat 1: a0ef5108 (button) collected ($0.12)
Seat 2: 54daf47b (small blind) folded before Flop
Seat 3: Hero (big blind) folded before Flop
Seat 4: 7a269055 folded before Flop (didn't bet)
Seat 5: a4441de9 folded before Flop (didn't bet)
Seat 6: 9ab125dd folded before Flop (didn't bet)


Poker Hand #RC2078400685: Hold'em No Limit ($0.02/$0.05) - 2023/12/22 20:53:16
Table 'RushAndCash771634' 6-max Seat #1 is the button
Seat 1: Hero ($5.21 in chips)
Seat 2: dc1893ec ($4.8 in chips)
Seat 3: 175b9638 ($5 in chips)
Seat 4: d3b1f4ed ($5.81 in chips)
Seat 5: c0da017f ($7.45 in chips)
Seat 6: f804ce50 ($15.11 in chips)
dc1893ec: posts small blind $0.02
175b9638: posts big blind $0.05
*** HOLE CARDS ***
Dealt to Hero [6d Ts]
Dealt to dc1893ec 
Dealt to 175b9638 
Dealt to d3b1f4ed 
Dealt to c0da017f 
Dealt to f804ce50 
d3b1f4ed: folds
c0da017f: folds
f804ce50: raises $0.05 to $0.1
Hero: folds
dc1893ec: folds
175b9638: calls $0.05
*** FLOP *** [3c 8d Ac]
175b9638: checks
f804ce50: checks
*** TURN *** [3c 8d Ac] [Ad]
175b9638: checks
f804ce50: checks
*** RIVER *** [3c 8d Ac Ad] [Jd]
175b9638: checks
f804ce50: checks
175b9638: shows [6s Js] (Pair of Aces and Pair of Jacks)
f804ce50: shows [4s 4h] (Pair of Aces and Pair of Fours)
*** SHOWDOWN ***
175b9638 collected $0.21 from pot
*** SUMMARY ***
Total pot $0.22 | Rake $0.01 | Jackpot $0 | Bingo $0 | Fortune $0 | Tax $0
Board [3c 8d Ac Ad Jd]
Seat 1: Hero (button) folded before Flop (didn't bet)
Seat 2: dc1893ec (small blind) folded before Flop
Seat 3: 175b9638 (big blind) showed [6s Js] and won ($0.21) with Pair of Aces and Pair of Jacks
Seat 4: d3b1f4ed folded before Flop (didn't bet)
Seat 5: c0da017f folded before Flop (didn't bet)
Seat 6: f804ce50 showed [4s 4h] and lost with Pair of Aces and Pair of Fours


Poker Hand #RC2078400614: Hold'em No Limit ($0.02/$0.05) - 2023/12/22 20:53:12
Table 'RushAndCash771603' 6-max Seat #1 is the button
Seat 1: 4ab8a557 ($5.77 in chips)
Seat 2: 38444444 ($15.32 in chips)
Seat 3: cb2898f4 ($5.58 in chips)
Seat 4: 220b0aae ($10.43 in chips)
Seat 5: Hero ($5.21 in chips)
Seat 6: 1db6ddb1 ($4.92 in chips)
38444444: posts small blind $0.02
cb2898f4: posts big blind $0.05
*** HOLE CARDS ***
Dealt to 4ab8a557 
Dealt to 38444444 
Dealt to cb2898f4 
Dealt to 220b0aae 
Dealt to Hero [8d 7s]
Dealt to 1db6ddb1 
220b0aae: folds
Hero: folds
1db6ddb1: folds
4ab8a557: folds
38444444: folds
Uncalled bet ($0.03) returned to cb2898f4
*** SHOWDOWN ***
cb2898f4 collected $0.04 from pot
*** SUMMARY ***
Total pot $0.04 | Rake $0 | Jackpot $0 | Bingo $0 | Fortune $0 | Tax $0
Seat 1: 4ab8a557 (button) folded before Flop (didn't bet)
Seat 2: 38444444 (small blind) folded before Flop
Seat 3: cb2898f4 (big blind) collected ($0.04)
Seat 4: 220b0aae folded before Flop (didn't bet)
Seat 5: Hero folded before Flop (didn't bet)
Seat 6: 1db6ddb1 folded before Flop (didn't bet)


Poker Hand #RC2078400544: Hold'em No Limit ($0.02/$0.05) - 2023/12/22 20:53:08
Table 'RushAndCash771572' 6-max Seat #1 is the button
Seat 1: d32741ba ($5 in chips)
Seat 2: 86aa2c94 ($5.08 in chips)
Seat 3: 74cf8c40 ($9 in chips)
Seat 4: 96f3ff6 ($10.41 in chips)
Seat 5: 38818e3e ($2.24 in chips)
Seat 6: Hero ($5.21 in chips)
86aa2c94: posts small blind $0.02
74cf8c40: posts big blind $0.05
*** HOLE CARDS ***
Dealt to d32741ba 
Dealt to 86aa2c94 
Dealt to 74cf8c40 
Dealt to 96f3ff6 
Dealt to 38818e3e 
Dealt to Hero [2d 8s]
96f3ff6: folds
38818e3e: raises $0.1 to $0.15
Hero: folds
d32741ba: folds
86aa2c94: folds
74cf8c40: calls $0.1
*** FLOP *** [5d 7s 2h]
74cf8c40: checks
38818e3e: bets $0.16
74cf8c40: calls $0.16
*** TURN *** [5d 7s 2h] [2c]
74cf8c40: checks
38818e3e: bets $0.47
74cf8c40: calls $0.47
*** RIVER *** [5d 7s 2h 2c] [Jc]
74cf8c40: bets $1.46
38818e3e: calls $1.46 and is all-in
74cf8c40: shows [8c 7c] (Pair of Sevens and Pair of Twos)
38818e3e: shows [Ks Kc] (Pair of Kings and Pair of Twos)
*** SHOWDOWN ***
38818e3e collected $4.28 from pot
*** SUMMARY ***
Total pot $4.5 | Rake $0.15 | Jackpot $0.07 | Bingo $0 | Fortune $0 | Tax $0
Board [5d 7s 2h 2c Jc]
Seat 1: d32741ba (button) folded before Flop (didn't bet)
Seat 2: 86aa2c94 (small blind) folded before Flop
Seat 3: 74cf8c40 (big blind) showed [8c 7c] and lost with Pair of Sevens and Pair of Twos
Seat 4: 96f3ff6 folded before Flop (didn't bet)
Seat 5: 38818e3e showed [Ks Kc] and won ($4.28) with Pair of Kings and Pair of Twos
Seat 6: Hero folded before Flop (didn't bet)


Poker Hand #RC2078400102: Hold'em No Limit ($0.02/$0.05) - 2023/12/22 20:52:44
Table 'RushAndCash771368' 6-max Seat #1 is the button
Seat 1: Hero ($5.03 in chips)
Seat 2: 801c157f ($16.5 in chips)
Seat 3: c87acea2 ($5.07 in chips)
Seat 4: 5fea4bbc ($7.36 in chips)
Seat 5: 409f5cad ($5.32 in chips)
Seat 6: 2e835d7a ($5.6 in chips)
801c157f: posts small blind $0.02
c87acea2: posts big blind $0.05
*** HOLE CARDS ***
Dealt to Hero [Js As]
Dealt to 801c157f 
Dealt to c87acea2 
Dealt to 5fea4bbc 
Dealt to 409f5cad 
Dealt to 2e835d7a 
5fea4bbc: folds
409f5cad: raises $0.07 to $0.12
2e835d7a: folds
Hero: raises $0.31 to $0.43
801c157f: folds
c87acea2: folds
409f5cad: folds
Uncalled bet ($0.31) returned to Hero
*** SHOWDOWN ***
Hero collected $0.3 from pot
*** SUMMARY ***
Total pot $0.31 | Rake $0.01 | Jackpot $0 | Bingo $0 | Fortune $0 | Tax $0
Seat 1: Hero (button) collected ($0.3)
Seat 2: 801c157f (small blind) folded before Flop
Seat 3: c87acea2 (big blind) folded before Flop
Seat 4: 5fea4bbc folded before Flop (didn't bet)
Seat 5: 409f5cad folded before Flop
Seat 6: 2e835d7a folded before Flop (didn't bet)


Poker Hand #RC2078400041: Hold'em No Limit ($0.02/$0.05) - 2023/12/22 20:52:40
Table 'RushAndCash771340' 6-max Seat #1 is the button
Seat 1: a7076373 ($12.84 in chips)
Seat 2: Hero ($5.05 in chips)
Seat 3: ad963d07 ($4.17 in chips)
Seat 4: 3ad251d8 ($6.66 in chips)
Seat 5: e8886428 ($32.63 in chips)
Seat 6: 36046ad1 ($5 in chips)
Hero: posts small blind $0.02
ad963d07: posts big blind $0.05
*** HOLE CARDS ***
Dealt to a7076373 
Dealt to Hero [4c 2c]
Dealt to ad963d07 
Dealt to 3ad251d8 
Dealt to e8886428 
Dealt to 36046ad1 
3ad251d8: folds
e8886428: folds
36046ad1: folds
a7076373: folds
Hero: folds
Uncalled bet ($0.03) returned to ad963d07
*** SHOWDOWN ***
ad963d07 collected $0.04 from pot
*** SUMMARY ***
Total pot $0.04 | Rake $0 | Jackpot $0 | Bingo $0 | Fortune $0 | Tax $0
Seat 1: a7076373 (button) folded before Flop (didn't bet)
Seat 2: Hero (small blind) folded before Flop
Seat 3: ad963d07 (big blind) collected ($0.04)
Seat 4: 3ad251d8 folded before Flop (didn't bet)
Seat 5: e8886428 folded before Flop (didn't bet)
Seat 6: 36046ad1 folded before Flop (didn't bet)


Poker Hand #RC2078399622: Hold'em No Limit ($0.02/$0.05) - 2023/12/22 20:52:17
Table 'RushAndCash771153' 6-max Seat #1 is the button
Seat 1: 23a63651 ($15.4 in chips)
Seat 2: ad963d07 ($4.22 in chips)
Seat 3: Hero ($5 in chips)
Seat 4: acefe839 ($17.02 in chips)
Seat 5: 74cf8c40 ($9.38 in chips)
Seat 6: a862948b ($10.68 in chips)
ad963d07: posts small blind $0.02
Hero: posts big blind $0.05
*** HOLE CARDS ***
Dealt to 23a63651 
Dealt to ad963d07 
Dealt to Hero [4c 2c]
Dealt to acefe839 
Dealt to 74cf8c40 
Dealt to a862948b 
acefe839: folds
74cf8c40: folds
a862948b: folds
23a63651: folds
ad963d07: calls $0.03
Hero: checks
*** FLOP *** [Td 4s Js]
ad963d07: checks
Hero: checks
*** TURN *** [Td 4s Js] [4d]
ad963d07: checks
Hero: bets $0.1
ad963d07: folds
Uncalled bet ($0.1) returned to Hero
*** SHOWDOWN ***
Hero collected $0.1 from pot
*** SUMMARY ***
Total pot $0.1 | Rake $0 | Jackpot $0 | Bingo $0 | Fortune $0 | Tax $0
Board [Td 4s Js 4d]
Seat 1: 23a63651 (button) folded before Flop (didn't bet)
Seat 2: ad963d07 (small blind) folded on the Turn
Seat 3: Hero (big blind) won ($0.1)
Seat 4: acefe839 folded before Flop (didn't bet)
Seat 5: 74cf8c40 folded before Flop (didn't bet)
Seat 6: a862948b folded before Flop (didn't bet)


Poker Hand #RC2078399546: Hold'em No Limit ($0.02/$0.05) - 2023/12/22 20:52:14
Table 'RushAndCash771121' 6-max Seat #1 is the button
Seat 1: 7727a0d4 ($2 in chips)
Seat 2: f9c6a467 ($16.36 in chips)
Seat 3: 8e29353e ($6.75 in chips)
Seat 4: Hero ($5 in chips)
Seat 5: 6b8a648f ($5.47 in chips)
Seat 6: 42e18915 ($7.04 in chips)
f9c6a467: posts small blind $0.02
8e29353e: posts big blind $0.05
*** HOLE CARDS ***
Dealt to 7727a0d4 
Dealt to f9c6a467 
Dealt to 8e29353e 
Dealt to Hero [Jc 4s]
Dealt to 6b8a648f 
Dealt to 42e18915 
Hero: folds
6b8a648f: folds
42e18915: folds
7727a0d4: calls $0.05
f9c6a467: folds
8e29353e: checks
*** FLOP *** [3c 6h Th]
8e29353e: checks
7727a0d4: checks
*** TURN *** [3c 6h Th] [5h]
8e29353e: checks
7727a0d4: checks
*** RIVER *** [3c 6h Th 5h] [6d]
8e29353e: checks
7727a0d4: checks
8e29353e: shows [2d 8c] (Pair of Sixes)
7727a0d4: shows [Qd 9d] (Pair of Sixes)
*** SHOWDOWN ***
7727a0d4 collected $0.12 from pot
*** SUMMARY ***
Total pot $0.12 | Rake $0 | Jackpot $0 | Bingo $0 | Fortune $0 | Tax $0
Board [3c 6h Th 5h 6d]
Seat 1: 7727a0d4 (button) showed [Qd 9d] and won ($0.12) with Pair of Sixes
Seat 2: f9c6a467 (small blind) folded before Flop
Seat 3: 8e29353e (big blind) showed [2d 8c] and lost with Pair of Sixes
Seat 4: Hero folded before Flop (didn't bet)
Seat 5: 6b8a648f folded before Flop (didn't bet)
Seat 6: 42e18915 folded before Flop (didn't bet)


Poker Hand #RC2078399461: Hold'em No Limit ($0.02/$0.05) - 2023/12/22 20:52:09
Table 'RushAndCash771082' 6-max Seat #1 is the button
Seat 1: 7732abf7 ($19.34 in chips)
Seat 2: ce5771af ($6.71 in chips)
Seat 3: fb13494d ($4.2 in chips)
Seat 4: Hero ($5 in chips)
Seat 5: d51e5ac3 ($11.14 in chips)
Seat 6: ff6f425f ($7.2 in chips)
ce5771af: posts small blind $0.02
fb13494d: posts big blind $0.05
*** HOLE CARDS ***
Dealt to 7732abf7 
Dealt to ce5771af 
Dealt to fb13494d 
Dealt to Hero [7s 6s]
Dealt to d51e5ac3 
Dealt to ff6f425f 
Hero: folds
d51e5ac3: folds
ff6f425f: folds
7732abf7: raises $0.08 to $0.13
ce5771af: folds
fb13494d: folds
Uncalled bet ($0.08) returned to 7732abf7
*** SHOWDOWN ***
7732abf7 collected $0.12 from pot
*** SUMMARY ***
Total pot $0.12 | Rake $0 | Jackpot $0 | Bingo $0 | Fortune $0 | Tax $0
Seat 1: 7732abf7 (button) collected ($0.12)
Seat 2: ce5771af (small blind) folded before Flop
Seat 3: fb13494d (big blind) folded before Flop
Seat 4: Hero folded before Flop (didn't bet)
Seat 5: d51e5ac3 folded before Flop (didn't bet)
Seat 6: ff6f425f folded before Flop (didn't bet)


Poker Hand #RC2078399403: Hold'em No Limit ($0.02/$0.05) - 2023/12/22 20:52:05
Table 'RushAndCash771058' 6-max Seat #1 is the button
Seat 1: 2a364a29 ($8.53 in chips)
Seat 2: c0da017f ($7.44 in chips)
Seat 3: c5f82acb ($3.66 in chips)
Seat 4: Hero ($5 in chips)
Seat 5: f03725f ($11.03 in chips)
Seat 6: 6b17ebd5 ($5 in chips)
c0da017f: posts small blind $0.02
c5f82acb: posts big blind $0.05
*** HOLE CARDS ***
Dealt to 2a364a29 
Dealt to c0da017f 
Dealt to c5f82acb 
Dealt to Hero [2d 4c]
Dealt to f03725f 
Dealt to 6b17ebd5 
Hero: folds
f03725f: raises $0.08 to $0.13
6b17ebd5: folds
2a364a29: folds
c0da017f: calls $0.11
c5f82acb: folds
*** FLOP *** [4d Td 9h]
c0da017f: checks
f03725f: bets $0.14
c0da017f: folds
Uncalled bet ($0.14) returned to f03725f
*** SHOWDOWN ***
f03725f collected $0.3 from pot
*** SUMMARY ***
Total pot $0.31 | Rake $0.01 | Jackpot $0 | Bingo $0 | Fortune $0 | Tax $0
Board [4d Td 9h]
Seat 1: 2a364a29 (button) folded before Flop (didn't bet)
Seat 2: c0da017f (small blind) folded on the Flop
Seat 3: c5f82acb (big blind) folded before Flop
Seat 4: Hero folded before Flop (didn't bet)
Seat 5: f03725f won ($0.3)
Seat 6: 6b17ebd5 folded before Flop (didn't bet)


Poker Hand #RC2078399349: Hold'em No Limit ($0.02/$0.05) - 2023/12/22 20:52:02
Table 'RushAndCash771035' 6-max Seat #1 is the button
Seat 1: 1ff063e8 ($4.81 in chips)
Seat 2: 9fd86997 ($18.74 in chips)
Seat 3: af92dfc8 ($5.01 in chips)
Seat 4: b01c40bf ($7.36 in chips)
Seat 5: 3721b8cb ($6.91 in chips)
Seat 6: Hero ($5 in chips)
9fd86997: posts small blind $0.02
af92dfc8: posts big blind $0.05
*** HOLE CARDS ***
Dealt to 1ff063e8 
Dealt to 9fd86997 
Dealt to af92dfc8 
Dealt to b01c40bf 
Dealt to 3721b8cb 
Dealt to Hero [Kd 6h]
b01c40bf: raises $0.05 to $0.1
3721b8cb: calls $0.1
Hero: folds
1ff063e8: raises $0.42 to $0.52
9fd86997: folds
af92dfc8: folds
b01c40bf: raises $0.64 to $1.16
3721b8cb: folds
1ff063e8: calls $0.64
*** FLOP *** [9c Kc 8h]
b01c40bf: checks
1ff063e8: bets $3.65 and is all-in
b01c40bf: calls $3.65
1ff063e8: shows [7h 7s] (Pair of Sevens)
b01c40bf: shows [Jc Js] (Pair of Jacks)
*** TURN *** [9c Kc 8h] [Th]
*** RIVER *** [9c Kc 8h Th] [Kh]
*** SHOWDOWN ***
b01c40bf collected $9.57 from pot
*** SUMMARY ***
Total pot $9.79 | Rake $0.15 | Jackpot $0.07 | Bingo $0 | Fortune $0 | Tax $0
Board [9c Kc 8h Th Kh]
Seat 1: 1ff063e8 (button) showed [7h 7s] and lost with Pair of Kings and Pair of Sevens
Seat 2: 9fd86997 (small blind) folded before Flop
Seat 3: af92dfc8 (big blind) folded before Flop
Seat 4: b01c40bf showed [Jc Js] and won ($9.57) with Pair of Kings and Pair of Jacks
Seat 5: 3721b8cb folded before Flop
Seat 6: Hero folded before Flop (didn't bet)


Poker Hand #RC2078399287: Hold'em No Limit ($0.02/$0.05) - 2023/12/22 20:51:58
Table 'RushAndCash771008' 6-max Seat #1 is the button
Seat 1: Hero ($5 in chips)
Seat 2: 3a35e9f5 ($13.4 in chips)
Seat 3: 85f8105e ($18.87 in chips)
Seat 4: 3721b8cb ($6.91 in chips)
Seat 5: e67ce721 ($5.68 in chips)
Seat 6: ada70712 ($2.08 in chips)
3a35e9f5: posts small blind $0.02
85f8105e: posts big blind $0.05
*** HOLE CARDS ***
Dealt to Hero [Qc 7s]
Dealt to 3a35e9f5 
Dealt to 85f8105e 
Dealt to 3721b8cb 
Dealt to e67ce721 
Dealt to ada70712 
3721b8cb: folds
e67ce721: folds
ada70712: folds
Hero: folds
3a35e9f5: folds
Uncalled bet ($0.03) returned to 85f8105e
*** SHOWDOWN ***
85f8105e collected $0.04 from pot
*** SUMMARY ***
Total pot $0.04 | Rake $0 | Jackpot $0 | Bingo $0 | Fortune $0 | Tax $0
Seat 1: Hero (button) folded before Flop (didn't bet)
Seat 2: 3a35e9f5 (small blind) folded before Flop
Seat 3: 85f8105e (big blind) collected ($0.04)
Seat 4: 3721b8cb folded before Flop (didn't bet)
Seat 5: e67ce721 folded before Flop (didn't bet)
Seat 6: ada70712 folded before Flop (didn't bet)


Poker Hand #RC2078399090: Hold'em No Limit ($0.02/$0.05) - 2023/12/22 20:51:48
Table 'RushAndCash770918' 6-max Seat #1 is the button
Seat 1: 3153aed0 ($5.56 in chips)
Seat 2: Hero ($5 in chips)
Seat 3: f03c68f3 ($6.65 in chips)
Seat 4: eb058b2e ($5 in chips)
Seat 5: 3216f2c0 ($4.85 in chips)
Seat 6: 68c6c5e7 ($14 in chips)
Hero: posts small blind $0.02
f03c68f3: posts big blind $0.05
*** HOLE CARDS ***
Dealt to 3153aed0 
Dealt to Hero [Qd 5c]
Dealt to f03c68f3 
Dealt to eb058b2e 
Dealt to 3216f2c0 
Dealt to 68c6c5e7 
eb058b2e: raises $0.08 to $0.13
3216f2c0: calls $0.13
68c6c5e7: folds
3153aed0: folds
Hero: folds
f03c68f3: folds
*** FLOP *** [Jh Kh 7c]
eb058b2e: checks
3216f2c0: checks
*** TURN *** [Jh Kh 7c] [2s]
eb058b2e: bets $0.25
3216f2c0: folds
Uncalled bet ($0.25) returned to eb058b2e
*** SHOWDOWN ***
eb058b2e collected $0.32 from pot
*** SUMMARY ***
Total pot $0.33 | Rake $0.01 | Jackpot $0 | Bingo $0 | Fortune $0 | Tax $0
Board [Jh Kh 7c 2s]
Seat 1: 3153aed0 (button) folded before Flop (didn't bet)
Seat 2: Hero (small blind) folded before Flop
Seat 3: f03c68f3 (big blind) folded before Flop
Seat 4: eb058b2e won ($0.32)
Seat 5: 3216f2c0 folded on the Turn
Seat 6: 68c6c5e7 folded before Flop (didn't bet)


Poker Hand #RC2078398802: Hold'em No Limit ($0.02/$0.05) - 2023/12/22 20:51:32
Table 'RushAndCash770789' 6-max Seat #1 is the button
Seat 1: d32741ba ($5.05 in chips)
Seat 2: bf1992f1 ($1.31 in chips)
Seat 3: Hero ($5 in chips)
Seat 4: b9504139 ($8.36 in chips)
Seat 5: fe9fbc4f ($5.25 in chips)
Seat 6: ac89ef05 ($9.08 in chips)
bf1992f1: posts small blind $0.02
Hero: posts big blind $0.05
*** HOLE CARDS ***
Dealt to d32741ba 
Dealt to bf1992f1 
Dealt to Hero [Tc Qd]
Dealt to b9504139 
Dealt to fe9fbc4f 
Dealt to ac89ef05 
b9504139: raises $0.08 to $0.13
fe9fbc4f: raises $0.25 to $0.38
ac89ef05: folds
d32741ba: folds
bf1992f1: folds
Hero: folds
b9504139: folds
Uncalled bet ($0.25) returned to fe9fbc4f
*** SHOWDOWN ***
fe9fbc4f collected $0.32 from pot
*** SUMMARY ***
Total pot $0.33 | Rake $0.01 | Jackpot $0 | Bingo $0 | Fortune $0 | Tax $0
Seat 1: d32741ba (button) folded before Flop (didn't bet)
Seat 2: bf1992f1 (small blind) folded before Flop
Seat 3: Hero (big blind) folded before Flop
Seat 4: b9504139 folded before Flop
Seat 5: fe9fbc4f collected ($0.32)
Seat 6: ac89ef05 folded before Flop (didn't bet)


