Poker Hand #RC2078483662: Hold'em No Limit ($0.02/$0.05) - 2023/12/22 21:24:43
Table 'RushAndCash787140' 6-max Seat #1 is the button
Seat 1: 7157dd36 ($9.33 in chips)
Seat 2: Hero ($6.09 in chips)
Seat 3: 22818fb2 ($6.96 in chips)
Seat 4: 80af7fe3 ($5 in chips)
Seat 5: d2739eda ($4.38 in chips)
Seat 6: 220b0aae ($11.46 in chips)
Hero: posts small blind $0.02
22818fb2: posts big blind $0.05
*** HOLE CARDS ***
Dealt to 7157dd36 
Dealt to Hero [Qh Jc]
Dealt to 22818fb2 
Dealt to 80af7fe3 
Dealt to d2739eda 
Dealt to 220b0aae 
80af7fe3: folds
d2739eda: folds
220b0aae: folds
7157dd36: folds
Hero: raises $0.1 to $0.15
22818fb2: folds
Uncalled bet ($0.1) returned to Hero
*** SHOWDOWN ***
Hero collected $0.1 from pot
*** SUMMARY ***
Total pot $0.1 | Rake $0 | Jackpot $0 | Bingo $0 | Fortune $0 | Tax $0
Seat 1: 7157dd36 (button) folded before Flop (didn't bet)
Seat 2: Hero (small blind) collected ($0.1)
Seat 3: 22818fb2 (big blind) folded before Flop
Seat 4: 80af7fe3 folded before Flop (didn't bet)
Seat 5: d2739eda folded before Flop (didn't bet)
Seat 6: 220b0aae folded before Flop (didn't bet)


Poker Hand #RC2078482967: Hold'em No Limit ($0.02/$0.05) - 2023/12/22 21:24:04
Table 'RushAndCash786815' 6-max Seat #1 is the button
Seat 1: 23c96099 ($7.83 in chips)
Seat 2: e65ad772 ($14.01 in chips)
Seat 3: Hero ($8.35 in chips)
Seat 4: 22818fb2 ($5 in chips)
Seat 5: e19dee32 ($6.43 in chips)
Seat 6: 19915c5a ($4.67 in chips)
e65ad772: posts small blind $0.02
Hero: posts big blind $0.05
*** HOLE CARDS ***
Dealt to 23c96099 
Dealt to e65ad772 
Dealt to Hero [Ad 4h]
Dealt to 22818fb2 
Dealt to e19dee32 
Dealt to 19915c5a 
22818fb2: raises $0.1 to $0.15
e19dee32: folds
19915c5a: folds
23c96099: folds
e65ad772: folds
Hero: calls $0.1
*** FLOP *** [7s 4s Th]
Hero: checks
22818fb2: bets $0.22
Hero: calls $0.22
*** TURN *** [7s 4s Th] [2h]
Hero: checks
22818fb2: bets $0.51
Hero: calls $0.51
*** RIVER *** [7s 4s Th 2h] [9h]
Hero: checks
22818fb2: bets $1.38
Hero: calls $1.38
22818fb2: shows [3h Ah] (Ace High Flush)
Hero: shows [Ad 4h] (Pair of Fours)
*** SHOWDOWN ***
22818fb2 collected $4.22 from pot
*** SUMMARY ***
Total pot $4.54 | Rake $0.25 | Jackpot $0.07 | Bingo $0 | Fortune $0 | Tax $0
Board [7s 4s Th 2h 9h]
Seat 1: 23c96099 (button) folded before Flop (didn't bet)
Seat 2: e65ad772 (small blind) folded before Flop
Seat 3: Hero (big blind) showed [Ad 4h] and lost with Pair of Fours
Seat 4: 22818fb2 showed [3h Ah] and won ($4.22) with Ace High Flush
Seat 5: e19dee32 folded before Flop (didn't bet)
Seat 6: 19915c5a folded before Flop (didn't bet)


Poker Hand #RC2078482751: Hold'em No Limit ($0.02/$0.05) - 2023/12/22 21:23:52
Table 'RushAndCash786716' 6-max Seat #1 is the button
Seat 1: a95f5535 ($5.11 in chips)
Seat 2: 5712a0aa ($2.15 in chips)
Seat 3: 65358b0f ($3.95 in chips)
Seat 4: 4b60b73d ($7 in chips)
Seat 5: Hero ($8.28 in chips)
Seat 6: 801c157f ($23.11 in chips)
5712a0aa: posts small blind $0.02
65358b0f: posts big blind $0.05
*** HOLE CARDS ***
Dealt to a95f5535 
Dealt to 5712a0aa 
Dealt to 65358b0f 
Dealt to 4b60b73d 
Dealt to Hero [Td 9d]
Dealt to 801c157f 
4b60b73d: folds
Hero: raises $0.05 to $0.1
801c157f: folds
a95f5535: folds
5712a0aa: folds
65358b0f: folds
Uncalled bet ($0.05) returned to Hero
*** SHOWDOWN ***
Hero collected $0.12 from pot
*** SUMMARY ***
Total pot $0.12 | Rake $0 | Jackpot $0 | Bingo $0 | Fortune $0 | Tax $0
Seat 1: a95f5535 (button) folded before Flop (didn't bet)
Seat 2: 5712a0aa (small blind) folded before Flop
Seat 3: 65358b0f (big blind) folded before Flop
Seat 4: 4b60b73d folded before Flop (didn't bet)
Seat 5: Hero collected ($0.12)
Seat 6: 801c157f folded before Flop (didn't bet)


Poker Hand #RC2078482686: Hold'em No Limit ($0.02/$0.05) - 2023/12/22 21:23:47
Table 'RushAndCash786682' 6-max Seat #1 is the button
Seat 1: e24a2fed ($5 in chips)
Seat 2: f804ce50 ($14.45 in chips)
Seat 3: 8802c225 ($2.85 in chips)
Seat 4: Hero ($8.28 in chips)
Seat 5: 197fb583 ($5.26 in chips)
Seat 6: 4fedcb8f ($6.71 in chips)
f804ce50: posts small blind $0.02
8802c225: posts big blind $0.05
*** HOLE CARDS ***
Dealt to e24a2fed 
Dealt to f804ce50 
Dealt to 8802c225 
Dealt to Hero [Kh 6h]
Dealt to 197fb583 
Dealt to 4fedcb8f 
Hero: folds
197fb583: folds
4fedcb8f: folds
e24a2fed: folds
f804ce50: folds
Uncalled bet ($0.03) returned to 8802c225
*** SHOWDOWN ***
8802c225 collected $0.04 from pot
*** SUMMARY ***
Total pot $0.04 | Rake $0 | Jackpot $0 | Bingo $0 | Fortune $0 | Tax $0
Seat 1: e24a2fed (button) folded before Flop (didn't bet)
Seat 2: f804ce50 (small blind) folded before Flop
Seat 3: 8802c225 (big blind) collected ($0.04)
Seat 4: Hero folded before Flop (didn't bet)
Seat 5: 197fb583 folded before Flop (didn't bet)
Seat 6: 4fedcb8f folded before Flop (didn't bet)


Poker Hand #RC2078482625: Hold'em No Limit ($0.02/$0.05) - 2023/12/22 21:23:44
Table 'RushAndCash786652' 6-max Seat #1 is the button
Seat 1: 93570c4 ($4.77 in chips)
Seat 2: e527ebf4 ($5 in chips)
Seat 3: 58864a6e ($19.8 in chips)
Seat 4: Hero ($8.28 in chips)
Seat 5: f7d66c7 ($3.16 in chips)
Seat 6: 7d137087 ($6.7 in chips)
e527ebf4: posts small blind $0.02
58864a6e: posts big blind $0.05
*** HOLE CARDS ***
Dealt to 93570c4 
Dealt to e527ebf4 
Dealt to 58864a6e 
Dealt to Hero [6h Qc]
Dealt to f7d66c7 
Dealt to 7d137087 
Hero: folds
f7d66c7: folds
7d137087: folds
93570c4: folds
e527ebf4: raises $0.1 to $0.15
58864a6e: calls $0.1
*** FLOP *** [3c 8s Ah]
e527ebf4: checks
58864a6e: bets $0.1
e527ebf4: calls $0.1
*** TURN *** [3c 8s Ah] [Qh]
e527ebf4: checks
58864a6e: checks
*** RIVER *** [3c 8s Ah Qh] [Ts]
e527ebf4: bets $0.3
58864a6e: folds
Uncalled bet ($0.3) returned to e527ebf4
*** SHOWDOWN ***
e527ebf4 collected $0.48 from pot
*** SUMMARY ***
Total pot $0.5 | Rake $0.02 | Jackpot $0 | Bingo $0 | Fortune $0 | Tax $0
Board [3c 8s Ah Qh Ts]
Seat 1: 93570c4 (button) folded before Flop (didn't bet)
Seat 2: e527ebf4 (small blind) won ($0.48)
Seat 3: 58864a6e (big blind) folded on the River
Seat 4: Hero folded before Flop (didn't bet)
Seat 5: f7d66c7 folded before Flop (didn't bet)
Seat 6: 7d137087 folded before Flop (didn't bet)


Poker Hand #RC2078481960: Hold'em No Limit ($0.02/$0.05) - 2023/12/22 21:23:05
Table 'RushAndCash786350' 6-max Seat #1 is the button
Seat 1: 8f81efe5 ($2.6 in chips)
Seat 2: 933d69ee ($7.99 in chips)
Seat 3: ce3dc143 ($4.02 in chips)
Seat 4: Hero ($8.38 in chips)
Seat 5: 525db62f ($8.26 in chips)
Seat 6: 697fb04a ($46.8 in chips)
933d69ee: posts small blind $0.02
ce3dc143: posts big blind $0.05
*** HOLE CARDS ***
Dealt to 8f81efe5 
Dealt to 933d69ee 
Dealt to ce3dc143 
Dealt to Hero [4d 4c]
Dealt to 525db62f 
Dealt to 697fb04a 
Hero: raises $0.05 to $0.1
525db62f: folds
697fb04a: folds
8f81efe5: folds
933d69ee: calls $0.08
ce3dc143: calls $0.05
*** FLOP *** [3s Jc Ks]
933d69ee: checks
ce3dc143: checks
Hero: checks
*** TURN *** [3s Jc Ks] [Qc]
933d69ee: checks
ce3dc143: bets $0.18
Hero: folds
933d69ee: calls $0.18
*** RIVER *** [3s Jc Ks Qc] [9s]
933d69ee: checks
ce3dc143: bets $0.4
933d69ee: folds
Uncalled bet ($0.4) returned to ce3dc143
ce3dc143: shows [Ad] (Ace-High)
*** SHOWDOWN ***
ce3dc143 collected $0.62 from pot
*** SUMMARY ***
Total pot $0.66 | Rake $0.04 | Jackpot $0 | Bingo $0 | Fortune $0 | Tax $0
Board [3s Jc Ks Qc 9s]
Seat 1: 8f81efe5 (button) folded before Flop (didn't bet)
Seat 2: 933d69ee (small blind) folded on the River
Seat 3: ce3dc143 (big blind) showed [Ad] and won ($0.62)
Seat 4: Hero folded on the Turn
Seat 5: 525db62f folded before Flop (didn't bet)
Seat 6: 697fb04a folded before Flop (didn't bet)


Poker Hand #RC2078481887: Hold'em No Limit ($0.02/$0.05) - 2023/12/22 21:23:01
Table 'RushAndCash786314' 6-max Seat #1 is the button
Seat 1: dee599cb ($5.41 in chips)
Seat 2: 2f0c7239 ($5.77 in chips)
Seat 3: 23800602 ($5.16 in chips)
Seat 4: ce3dc143 ($4.02 in chips)
Seat 5: Hero ($8.38 in chips)
Seat 6: f938f1e ($5 in chips)
2f0c7239: posts small blind $0.02
23800602: posts big blind $0.05
*** HOLE CARDS ***
Dealt to dee599cb 
Dealt to 2f0c7239 
Dealt to 23800602 
Dealt to ce3dc143 
Dealt to Hero [5s 8c]
Dealt to f938f1e 
ce3dc143: folds
Hero: folds
f938f1e: folds
dee599cb: folds
2f0c7239: raises $0.1 to $0.15
23800602: folds
Uncalled bet ($0.1) returned to 2f0c7239
*** SHOWDOWN ***
2f0c7239 collected $0.1 from pot
*** SUMMARY ***
Total pot $0.1 | Rake $0 | Jackpot $0 | Bingo $0 | Fortune $0 | Tax $0
Seat 1: dee599cb (button) folded before Flop (didn't bet)
Seat 2: 2f0c7239 (small blind) collected ($0.1)
Seat 3: 23800602 (big blind) folded before Flop
Seat 4: ce3dc143 folded before Flop (didn't bet)
Seat 5: Hero folded before Flop (didn't bet)
Seat 6: f938f1e folded before Flop (didn't bet)


Poker Hand #RC2078481696: Hold'em No Limit ($0.02/$0.05) - 2023/12/22 21:22:49
Table 'RushAndCash786221' 6-max Seat #1 is the button
Seat 1: a95f5535 ($5.04 in chips)
Seat 2: 7f067c94 ($41.71 in chips)
Seat 3: 618f8ec9 ($6.61 in chips)
Seat 4: b9aa0c94 ($12.15 in chips)
Seat 5: Hero ($8.31 in chips)
Seat 6: 3c41b7f8 ($5 in chips)
7f067c94: posts small blind $0.02
618f8ec9: posts big blind $0.05
*** HOLE CARDS ***
Dealt to a95f5535 
Dealt to 7f067c94 
Dealt to 618f8ec9 
Dealt to b9aa0c94 
Dealt to Hero [Ah Ks]
Dealt to 3c41b7f8 
b9aa0c94: folds
Hero: raises $0.05 to $0.1
3c41b7f8: folds
a95f5535: folds
7f067c94: folds
618f8ec9: folds
Uncalled bet ($0.05) returned to Hero
*** SHOWDOWN ***
Hero collected $0.12 from pot
*** SUMMARY ***
Total pot $0.12 | Rake $0 | Jackpot $0 | Bingo $0 | Fortune $0 | Tax $0
Seat 1: a95f5535 (button) folded before Flop (didn't bet)
Seat 2: 7f067c94 (small blind) folded before Flop
Seat 3: 618f8ec9 (big blind) folded before Flop
Seat 4: b9aa0c94 folded before Flop (didn't bet)
Seat 5: Hero collected ($0.12)
Seat 6: 3c41b7f8 folded before Flop (didn't bet)


Poker Hand #RC2078481486: Hold'em No Limit ($0.02/$0.05) - 2023/12/22 21:22:37
Table 'RushAndCash786122' 6-max Seat #1 is the button
Seat 1: 2f160a64 ($5.21 in chips)
Seat 2: 8f81efe5 ($2.35 in chips)
Seat 3: Hero ($8.36 in chips)
Seat 4: 3056048f ($5.24 in chips)
Seat 5: d2e52b8d ($18.3 in chips)
Seat 6: 93570c4 ($4.99 in chips)
8f81efe5: posts small blind $0.02
Hero: posts big blind $0.05
*** HOLE CARDS ***
Dealt to 2f160a64 
Dealt to 8f81efe5 
Dealt to Hero [Td 3d]
Dealt to 3056048f 
Dealt to d2e52b8d 
Dealt to 93570c4 
3056048f: folds
d2e52b8d: folds
93570c4: folds
2f160a64: raises $0.07 to $0.12
8f81efe5: calls $0.1
Hero: folds
*** FLOP *** [Jh Js 5c]
8f81efe5: checks
2f160a64: bets $0.1
8f81efe5: calls $0.1
*** TURN *** [Jh Js 5c] [Ah]
8f81efe5: checks
2f160a64: checks
*** RIVER *** [Jh Js 5c Ah] [6c]
8f81efe5: bets $0.49
2f160a64: folds
Uncalled bet ($0.49) returned to 8f81efe5
*** SHOWDOWN ***
8f81efe5 collected $0.47 from pot
*** SUMMARY ***
Total pot $0.49 | Rake $0.02 | Jackpot $0 | Bingo $0 | Fortune $0 | Tax $0
Board [Jh Js 5c Ah 6c]
Seat 1: 2f160a64 (button) folded on the River
Seat 2: 8f81efe5 (small blind) won ($0.47)
Seat 3: Hero (big blind) folded before Flop
Seat 4: 3056048f folded before Flop (didn't bet)
Seat 5: d2e52b8d folded before Flop (didn't bet)
Seat 6: 93570c4 folded before Flop (didn't bet)


Poker Hand #RC2078481425: Hold'em No Limit ($0.02/$0.05) - 2023/12/22 21:22:33
Table 'RushAndCash786094' 6-max Seat #1 is the button
Seat 1: Hero ($8.36 in chips)
Seat 2: eb03c338 ($4.96 in chips)
Seat 3: bc118b95 ($5.85 in chips)
Seat 4: 7732abf7 ($23.22 in chips)
Seat 5: a2edfbd1 ($2 in chips)
Seat 6: 6e872e9c ($19.56 in chips)
eb03c338: posts small blind $0.02
bc118b95: posts big blind $0.05
*** HOLE CARDS ***
Dealt to Hero [Ad 6h]
Dealt to eb03c338 
Dealt to bc118b95 
Dealt to 7732abf7 
Dealt to a2edfbd1 
Dealt to 6e872e9c 
7732abf7: folds
a2edfbd1: folds
6e872e9c: folds
Hero: folds
eb03c338: folds
Uncalled bet ($0.03) returned to bc118b95
*** SHOWDOWN ***
bc118b95 collected $0.04 from pot
*** SUMMARY ***
Total pot $0.04 | Rake $0 | Jackpot $0 | Bingo $0 | Fortune $0 | Tax $0
Seat 1: Hero (button) folded before Flop (didn't bet)
Seat 2: eb03c338 (small blind) folded before Flop
Seat 3: bc118b95 (big blind) collected ($0.04)
Seat 4: 7732abf7 folded before Flop (didn't bet)
Seat 5: a2edfbd1 folded before Flop (didn't bet)
Seat 6: 6e872e9c folded before Flop (didn't bet)


Poker Hand #RC2078481366: Hold'em No Limit ($0.02/$0.05) - 2023/12/22 21:22:30
Table 'RushAndCash786066' 6-max Seat #1 is the button
Seat 1: b18917a1 ($7.99 in chips)
Seat 2: 604de4fe ($5.02 in chips)
Seat 3: a2f5e875 ($6.16 in chips)
Seat 4: 92b246ad ($5.08 in chips)
Seat 5: Hero ($8.36 in chips)
Seat 6: 59da0131 ($18.41 in chips)
604de4fe: posts small blind $0.02
a2f5e875: posts big blind $0.05
*** HOLE CARDS ***
Dealt to b18917a1 
Dealt to 604de4fe 
Dealt to a2f5e875 
Dealt to 92b246ad 
Dealt to Hero [2h 4h]
Dealt to 59da0131 
92b246ad: folds
Hero: folds
59da0131: raises $0.07 to $0.12
b18917a1: folds
604de4fe: folds
a2f5e875: folds
Uncalled bet ($0.07) returned to 59da0131
*** SHOWDOWN ***
59da0131 collected $0.12 from pot
*** SUMMARY ***
Total pot $0.12 | Rake $0 | Jackpot $0 | Bingo $0 | Fortune $0 | Tax $0
Seat 1: b18917a1 (button) folded before Flop (didn't bet)
Seat 2: 604de4fe (small blind) folded before Flop
Seat 3: a2f5e875 (big blind) folded before Flop
Seat 4: 92b246ad folded before Flop (didn't bet)
Seat 5: Hero folded before Flop (didn't bet)
Seat 6: 59da0131 collected ($0.12)


Poker Hand #RC2078480873: Hold'em No Limit ($0.02/$0.05) - 2023/12/22 21:22:01
Table 'RushAndCash785817' 6-max Seat #1 is the button
Seat 1: e76155ad ($5 in chips)
Seat 2: Hero ($9.11 in chips)
Seat 3: e73b11e8 ($4.02 in chips)
Seat 4: 110b939f ($5.57 in chips)
Seat 5: 10c9f9a8 ($5 in chips)
Seat 6: ab5dffec ($7.27 in chips)
Hero: posts small blind $0.02
e73b11e8: posts big blind $0.05
*** HOLE CARDS ***
Dealt to e76155ad 
Dealt to Hero [As Ad]
Dealt to e73b11e8 
Dealt to 110b939f 
Dealt to 10c9f9a8 
Dealt to ab5dffec 
110b939f: folds
10c9f9a8: folds
ab5dffec: folds
e76155ad: folds
Hero: raises $0.1 to $0.15
e73b11e8: calls $0.1
*** FLOP *** [3c 6c Tc]
Hero: bets $0.15
e73b11e8: raises $0.45 to $0.6
Hero: calls $0.45
*** TURN *** [3c 6c Tc] [7s]
Hero: checks
e73b11e8: bets $1.13
Hero: folds
Uncalled bet ($1.13) returned to e73b11e8
*** SHOWDOWN ***
e73b11e8 collected $1.36 from pot
*** SUMMARY ***
Total pot $1.5 | Rake $0.07 | Jackpot $0.07 | Bingo $0 | Fortune $0 | Tax $0
Board [3c 6c Tc 7s]
Seat 1: e76155ad (button) folded before Flop (didn't bet)
Seat 2: Hero (small blind) folded on the Turn
Seat 3: e73b11e8 (big blind) won ($1.36)
Seat 4: 110b939f folded before Flop (didn't bet)
Seat 5: 10c9f9a8 folded before Flop (didn't bet)
Seat 6: ab5dffec folded before Flop (didn't bet)


Poker Hand #RC2078480811: Hold'em No Limit ($0.02/$0.05) - 2023/12/22 21:21:58
Table 'RushAndCash785785' 6-max Seat #1 is the button
Seat 1: 3580bebf ($14.93 in chips)
Seat 2: 2ed46053 ($8.27 in chips)
Seat 3: 3d929f9f ($8.09 in chips)
Seat 4: 3c03eb6e ($6.99 in chips)
Seat 5: Hero ($9.11 in chips)
Seat 6: a9db0c00 ($15.56 in chips)
2ed46053: posts small blind $0.02
3d929f9f: posts big blind $0.05
*** HOLE CARDS ***
Dealt to 3580bebf 
Dealt to 2ed46053 
Dealt to 3d929f9f 
Dealt to 3c03eb6e 
Dealt to Hero [9h 5d]
Dealt to a9db0c00 
3c03eb6e: folds
Hero: folds
a9db0c00: raises $0.1 to $0.15
3580bebf: calls $0.15
2ed46053: folds
3d929f9f: folds
*** FLOP *** [6d Th 4h]
a9db0c00: checks
3580bebf: checks
*** TURN *** [6d Th 4h] [6h]
a9db0c00: checks
3580bebf: bets $0.37
a9db0c00: folds
Uncalled bet ($0.37) returned to 3580bebf
*** SHOWDOWN ***
3580bebf collected $0.36 from pot
*** SUMMARY ***
Total pot $0.37 | Rake $0.01 | Jackpot $0 | Bingo $0 | Fortune $0 | Tax $0
Board [6d Th 4h 6h]
Seat 1: 3580bebf (button) won ($0.36)
Seat 2: 2ed46053 (small blind) folded before Flop
Seat 3: 3d929f9f (big blind) folded before Flop
Seat 4: 3c03eb6e folded before Flop (didn't bet)
Seat 5: Hero folded before Flop (didn't bet)
Seat 6: a9db0c00 folded on the Turn


Poker Hand #RC2078480710: Hold'em No Limit ($0.02/$0.05) - 2023/12/22 21:21:51
Table 'RushAndCash785733' 6-max Seat #1 is the button
Seat 1: ebeb62f7 ($4.94 in chips)
Seat 2: 680eb0e1 ($10.89 in chips)
Seat 3: Hero ($9.09 in chips)
Seat 4: 875f34a0 ($23.57 in chips)
Seat 5: 72f7386e ($11.69 in chips)
Seat 6: 3d929f9f ($8.09 in chips)
680eb0e1: posts small blind $0.02
Hero: posts big blind $0.05
*** HOLE CARDS ***
Dealt to ebeb62f7 
Dealt to 680eb0e1 
Dealt to Hero [8d 5d]
Dealt to 875f34a0 
Dealt to 72f7386e 
Dealt to 3d929f9f 
875f34a0: folds
72f7386e: folds
3d929f9f: folds
ebeb62f7: folds
680eb0e1: folds
Uncalled bet ($0.03) returned to Hero
*** SHOWDOWN ***
Hero collected $0.04 from pot
*** SUMMARY ***
Total pot $0.04 | Rake $0 | Jackpot $0 | Bingo $0 | Fortune $0 | Tax $0
Seat 1: ebeb62f7 (button) folded before Flop (didn't bet)
Seat 2: 680eb0e1 (small blind) folded before Flop
Seat 3: Hero (big blind) collected ($0.04)
Seat 4: 875f34a0 folded before Flop (didn't bet)
Seat 5: 72f7386e folded before Flop (didn't bet)
Seat 6: 3d929f9f folded before Flop (didn't bet)


Poker Hand #RC2078480624: Hold'em No Limit ($0.02/$0.05) - 2023/12/22 21:21:47
Table 'RushAndCash785693' 6-max Seat #1 is the button
Seat 1: Hero ($9.09 in chips)
Seat 2: 89ac50e8 ($11.47 in chips)
Seat 3: 47ecc871 ($5 in chips)
Seat 4: a615a9f6 ($13.59 in chips)
Seat 5: c0d3508b ($5.33 in chips)
Seat 6: 7d137087 ($6.37 in chips)
89ac50e8: posts small blind $0.02
47ecc871: posts big blind $0.05
*** HOLE CARDS ***
Dealt to Hero [6s 4c]
Dealt to 89ac50e8 
Dealt to 47ecc871 
Dealt to a615a9f6 
Dealt to c0d3508b 
Dealt to 7d137087 
a615a9f6: folds
c0d3508b: folds
7d137087: folds
Hero: folds
89ac50e8: folds
Uncalled bet ($0.03) returned to 47ecc871
*** SHOWDOWN ***
47ecc871 collected $0.04 from pot
*** SUMMARY ***
Total pot $0.04 | Rake $0 | Jackpot $0 | Bingo $0 | Fortune $0 | Tax $0
Seat 1: Hero (button) folded before Flop (didn't bet)
Seat 2: 89ac50e8 (small blind) folded before Flop
Seat 3: 47ecc871 (big blind) collected ($0.04)
Seat 4: a615a9f6 folded before Flop (didn't bet)
Seat 5: c0d3508b folded before Flop (didn't bet)
Seat 6: 7d137087 folded before Flop (didn't bet)


Poker Hand #RC2078480549: Hold'em No Limit ($0.02/$0.05) - 2023/12/22 21:21:42
Table 'RushAndCash785659' 6-max Seat #1 is the button
Seat 1: 6ef00a1b ($15.42 in chips)
Seat 2: 40c4a4f ($10 in chips)
Seat 3: c3c9a58d ($10.16 in chips)
Seat 4: Hero ($9.09 in chips)
Seat 5: f677406 ($5.43 in chips)
Seat 6: ce3dc143 ($4.25 in chips)
40c4a4f: posts small blind $0.02
c3c9a58d: posts big blind $0.05
*** HOLE CARDS ***
Dealt to 6ef00a1b 
Dealt to 40c4a4f 
Dealt to c3c9a58d 
Dealt to Hero [Th Ks]
Dealt to f677406 
Dealt to ce3dc143 
Hero: folds
f677406: raises $0.05 to $0.1
ce3dc143: folds
6ef00a1b: folds
40c4a4f: folds
c3c9a58d: calls $0.05
*** FLOP *** [Jh Qd As]
c3c9a58d: bets $0.05
f677406: raises $0.24 to $0.29
c3c9a58d: folds
Uncalled bet ($0.24) returned to f677406
*** SHOWDOWN ***
f677406 collected $0.31 from pot
*** SUMMARY ***
Total pot $0.32 | Rake $0.01 | Jackpot $0 | Bingo $0 | Fortune $0 | Tax $0
Board [Jh Qd As]
Seat 1: 6ef00a1b (button) folded before Flop (didn't bet)
Seat 2: 40c4a4f (small blind) folded before Flop
Seat 3: c3c9a58d (big blind) folded on the Flop
Seat 4: Hero folded before Flop (didn't bet)
Seat 5: f677406 won ($0.31)
Seat 6: ce3dc143 folded before Flop (didn't bet)


Poker Hand #RC2078480484: Hold'em No Limit ($0.02/$0.05) - 2023/12/22 21:21:38
Table 'RushAndCash785630' 6-max Seat #1 is the button
Seat 1: 64a4f489 ($6.49 in chips)
Seat 2: eac1a90f ($5.14 in chips)
Seat 3: eb03c338 ($4.99 in chips)
Seat 4: 91937678 ($6.09 in chips)
Seat 5: Hero ($9.09 in chips)
Seat 6: 7ab29bd ($5 in chips)
eac1a90f: posts small blind $0.02
eb03c338: posts big blind $0.05
*** HOLE CARDS ***
Dealt to 64a4f489 
Dealt to eac1a90f 
Dealt to eb03c338 
Dealt to 91937678 
Dealt to Hero [9c 6d]
Dealt to 7ab29bd 
91937678: folds
Hero: folds
7ab29bd: folds
64a4f489: raises $0.09 to $0.14
eac1a90f: folds
eb03c338: folds
Uncalled bet ($0.09) returned to 64a4f489
*** SHOWDOWN ***
64a4f489 collected $0.12 from pot
*** SUMMARY ***
Total pot $0.12 | Rake $0 | Jackpot $0 | Bingo $0 | Fortune $0 | Tax $0
Seat 1: 64a4f489 (button) collected ($0.12)
Seat 2: eac1a90f (small blind) folded before Flop
Seat 3: eb03c338 (big blind) folded before Flop
Seat 4: 91937678 folded before Flop (didn't bet)
Seat 5: Hero folded before Flop (didn't bet)
Seat 6: 7ab29bd folded before Flop (didn't bet)


Poker Hand #RC2078480390: Hold'em No Limit ($0.02/$0.05) - 2023/12/22 21:21:33
Table 'RushAndCash785587' 6-max Seat #1 is the button
Seat 1: 4a4c34d3 ($5.13 in chips)
Seat 2: 3721b8cb ($5.85 in chips)
Seat 3: bc7afeb2 ($5.07 in chips)
Seat 4: ad142c24 ($12.3 in chips)
Seat 5: Hero ($9.09 in chips)
Seat 6: 998574b7 ($6.29 in chips)
3721b8cb: posts small blind $0.02
bc7afeb2: posts big blind $0.05
*** HOLE CARDS ***
Dealt to 4a4c34d3 
Dealt to 3721b8cb 
Dealt to bc7afeb2 
Dealt to ad142c24 
Dealt to Hero [6d Jd]
Dealt to 998574b7 
ad142c24: folds
Hero: folds
998574b7: raises $0.1 to $0.15
4a4c34d3: calls $0.15
3721b8cb: calls $0.13
bc7afeb2: folds
*** FLOP *** [6s 3d Td]
3721b8cb: checks
998574b7: bets $0.25
4a4c34d3: raises $1 to $1.25
3721b8cb: folds
998574b7: folds
Uncalled bet ($1) returned to 4a4c34d3
*** SHOWDOWN ***
4a4c34d3 collected $0.95 from pot
*** SUMMARY ***
Total pot $1 | Rake $0.05 | Jackpot $0 | Bingo $0 | Fortune $0 | Tax $0
Board [6s 3d Td]
Seat 1: 4a4c34d3 (button) won ($0.95)
Seat 2: 3721b8cb (small blind) folded on the Flop
Seat 3: bc7afeb2 (big blind) folded before Flop
Seat 4: ad142c24 folded before Flop (didn't bet)
Seat 5: Hero folded before Flop (didn't bet)
Seat 6: 998574b7 folded on the Flop


Poker Hand #RC2078480296: Hold'em No Limit ($0.02/$0.05) - 2023/12/22 21:21:28
Table 'RushAndCash785545' 6-max Seat #1 is the button
Seat 1: c6813ed5 ($6.56 in chips)
Seat 2: Hero ($9.11 in chips)
Seat 3: e65ad772 ($12.68 in chips)
Seat 4: 851fc2ef ($5.4 in chips)
Seat 5: 40810c68 ($5 in chips)
Seat 6: 3df6f82d ($2.6 in chips)
Hero: posts small blind $0.02
e65ad772: posts big blind $0.05
*** HOLE CARDS ***
Dealt to c6813ed5 
Dealt to Hero [Ts 4d]
Dealt to e65ad772 
Dealt to 851fc2ef 
Dealt to 40810c68 
Dealt to 3df6f82d 
851fc2ef: folds
40810c68: folds
3df6f82d: folds
c6813ed5: folds
Hero: folds
Uncalled bet ($0.03) returned to e65ad772
*** SHOWDOWN ***
e65ad772 collected $0.04 from pot
*** SUMMARY ***
Total pot $0.04 | Rake $0 | Jackpot $0 | Bingo $0 | Fortune $0 | Tax $0
Seat 1: c6813ed5 (button) folded before Flop (didn't bet)
Seat 2: Hero (small blind) folded before Flop
Seat 3: e65ad772 (big blind) collected ($0.04)
Seat 4: 851fc2ef folded before Flop (didn't bet)
Seat 5: 40810c68 folded before Flop (didn't bet)
Seat 6: 3df6f82d folded before Flop (didn't bet)


Poker Hand #RC2078480082: Hold'em No Limit ($0.02/$0.05) - 2023/12/22 21:21:16
Table 'RushAndCash785447' 6-max Seat #1 is the button
Seat 1: 5d55167a ($9.29 in chips)
Seat 2: 801c157f ($23.07 in chips)
Seat 3: Hero ($9.16 in chips)
Seat 4: 3c028e9 ($7.67 in chips)
Seat 5: 44795538 ($5.32 in chips)
Seat 6: eb03c338 ($5.01 in chips)
801c157f: posts small blind $0.02
Hero: posts big blind $0.05
*** HOLE CARDS ***
Dealt to 5d55167a 
Dealt to 801c157f 
Dealt to Hero [3s 7s]
Dealt to 3c028e9 
Dealt to 44795538 
Dealt to eb03c338 
3c028e9: folds
44795538: folds
eb03c338: folds
5d55167a: folds
801c157f: raises $0.07 to $0.12
Hero: folds
Uncalled bet ($0.07) returned to 801c157f
*** SHOWDOWN ***
801c157f collected $0.1 from pot
*** SUMMARY ***
Total pot $0.1 | Rake $0 | Jackpot $0 | Bingo $0 | Fortune $0 | Tax $0
Seat 1: 5d55167a (button) folded before Flop (didn't bet)
Seat 2: 801c157f (small blind) collected ($0.1)
Seat 3: Hero (big blind) folded before Flop
Seat 4: 3c028e9 folded before Flop (didn't bet)
Seat 5: 44795538 folded before Flop (didn't bet)
Seat 6: eb03c338 folded before Flop (didn't bet)


Poker Hand #RC2078480000: Hold'em No Limit ($0.02/$0.05) - 2023/12/22 21:21:11
Table 'RushAndCash785407' 6-max Seat #1 is the button
Seat 1: dee599cb ($4.89 in chips)
Seat 2: 47ecc871 ($5.07 in chips)
Seat 3: 4c0d7324 ($10.95 in chips)
Seat 4: 84572dc4 ($2.54 in chips)
Seat 5: 4ee77832 ($5 in chips)
Seat 6: Hero ($9.16 in chips)
47ecc871: posts small blind $0.02
4c0d7324: posts big blind $0.05
*** HOLE CARDS ***
Dealt to dee599cb 
Dealt to 47ecc871 
Dealt to 4c0d7324 
Dealt to 84572dc4 
Dealt to 4ee77832 
Dealt to Hero [9d 2c]
84572dc4: raises $0.08 to $0.13
4ee77832: folds
Hero: folds
dee599cb: folds
47ecc871: folds
4c0d7324: folds
Uncalled bet ($0.08) returned to 84572dc4
*** SHOWDOWN ***
84572dc4 collected $0.12 from pot
*** SUMMARY ***
Total pot $0.12 | Rake $0 | Jackpot $0 | Bingo $0 | Fortune $0 | Tax $0
Seat 1: dee599cb (button) folded before Flop (didn't bet)
Seat 2: 47ecc871 (small blind) folded before Flop
Seat 3: 4c0d7324 (big blind) folded before Flop
Seat 4: 84572dc4 collected ($0.12)
Seat 5: 4ee77832 folded before Flop (didn't bet)
Seat 6: Hero folded before Flop (didn't bet)


Poker Hand #RC2078479913: Hold'em No Limit ($0.02/$0.05) - 2023/12/22 21:21:07
Table 'RushAndCash785366' 6-max Seat #1 is the button
Seat 1: Hero ($9.16 in chips)
Seat 2: 933d69ee ($8.24 in chips)
Seat 3: f73ad9cd ($5 in chips)
Seat 4: 72e47b5b ($2.26 in chips)
Seat 5: 587c07c3 ($5.65 in chips)
Seat 6: 8f71af3 ($2.85 in chips)
933d69ee: posts small blind $0.02
f73ad9cd: posts big blind $0.05
*** HOLE CARDS ***
Dealt to Hero [4d 2s]
Dealt to 933d69ee 
Dealt to f73ad9cd 
Dealt to 72e47b5b 
Dealt to 587c07c3 
Dealt to 8f71af3 
72e47b5b: folds
587c07c3: folds
8f71af3: raises $0.12 to $0.17
Hero: folds
933d69ee: folds
f73ad9cd: folds
Uncalled bet ($0.12) returned to 8f71af3
*** SHOWDOWN ***
8f71af3 collected $0.12 from pot
*** SUMMARY ***
Total pot $0.12 | Rake $0 | Jackpot $0 | Bingo $0 | Fortune $0 | Tax $0
Seat 1: Hero (button) folded before Flop (didn't bet)
Seat 2: 933d69ee (small blind) folded before Flop
Seat 3: f73ad9cd (big blind) folded before Flop
Seat 4: 72e47b5b folded before Flop (didn't bet)
Seat 5: 587c07c3 folded before Flop (didn't bet)
Seat 6: 8f71af3 collected ($0.12)


Poker Hand #RC2078479757: Hold'em No Limit ($0.02/$0.05) - 2023/12/22 21:20:58
Table 'RushAndCash785294' 6-max Seat #1 is the button
Seat 1: 6c7c67da ($5 in chips)
Seat 2: Hero ($9.18 in chips)
Seat 3: 6524c228 ($6.12 in chips)
Seat 4: af92dfc8 ($6.77 in chips)
Seat 5: f9c8784e ($9.81 in chips)
Seat 6: 11676b65 ($5.12 in chips)
Hero: posts small blind $0.02
6524c228: posts big blind $0.05
*** HOLE CARDS ***
Dealt to 6c7c67da 
Dealt to Hero [Td 3c]
Dealt to 6524c228 
Dealt to af92dfc8 
Dealt to f9c8784e 
Dealt to 11676b65 
af92dfc8: folds
f9c8784e: raises $0.07 to $0.12
11676b65: calls $0.12
6c7c67da: folds
Hero: folds
6524c228: raises $0.38 to $0.5
f9c8784e: calls $0.38
11676b65: calls $0.38
*** FLOP *** [3h 5s 7s]
6524c228: bets $0.05
f9c8784e: raises $0.54 to $0.59
11676b65: folds
6524c228: calls $0.54
*** TURN *** [3h 5s 7s] [6d]
6524c228: bets $1.35
f9c8784e: calls $1.35
*** RIVER *** [3h 5s 7s 6d] [6c]
6524c228: checks
f9c8784e: checks
6524c228: shows [Kd As] (Pair of Sixes)
f9c8784e: shows [9c 9h] (Pair of Nines and Pair of Sixes)
*** SHOWDOWN ***
f9c8784e collected $5.18 from pot
*** SUMMARY ***
Total pot $5.4 | Rake $0.15 | Jackpot $0.07 | Bingo $0 | Fortune $0 | Tax $0
Board [3h 5s 7s 6d 6c]
Seat 1: 6c7c67da (button) folded before Flop (didn't bet)
Seat 2: Hero (small blind) folded before Flop
Seat 3: 6524c228 (big blind) showed [Kd As] and lost with Pair of Sixes
Seat 4: af92dfc8 folded before Flop (didn't bet)
Seat 5: f9c8784e showed [9c 9h] and won ($5.18) with Pair of Nines and Pair of Sixes
Seat 6: 11676b65 folded on the Flop


Poker Hand #RC2078479647: Hold'em No Limit ($0.02/$0.05) - 2023/12/22 21:20:51
Table 'RushAndCash785243' 6-max Seat #1 is the button
Seat 1: 90a9fad4 ($44.26 in chips)
Seat 2: 2861b620 ($4.71 in chips)
Seat 3: 4b60b73d ($5.86 in chips)
Seat 4: 91937678 ($6.11 in chips)
Seat 5: 983d74a ($7.63 in chips)
Seat 6: Hero ($9.18 in chips)
2861b620: posts small blind $0.02
4b60b73d: posts big blind $0.05
*** HOLE CARDS ***
Dealt to 90a9fad4 
Dealt to 2861b620 
Dealt to 4b60b73d 
Dealt to 91937678 
Dealt to 983d74a 
Dealt to Hero [7s 3c]
91937678: folds
983d74a: folds
Hero: folds
90a9fad4: folds
2861b620: folds
Uncalled bet ($0.03) returned to 4b60b73d
*** SHOWDOWN ***
4b60b73d collected $0.04 from pot
*** SUMMARY ***
Total pot $0.04 | Rake $0 | Jackpot $0 | Bingo $0 | Fortune $0 | Tax $0
Seat 1: 90a9fad4 (button) folded before Flop (didn't bet)
Seat 2: 2861b620 (small blind) folded before Flop
Seat 3: 4b60b73d (big blind) collected ($0.04)
Seat 4: 91937678 folded before Flop (didn't bet)
Seat 5: 983d74a folded before Flop (didn't bet)
Seat 6: Hero folded before Flop (didn't bet)


Poker Hand #RC2078479539: Hold'em No Limit ($0.02/$0.05) - 2023/12/22 21:20:45
Table 'RushAndCash785192' 6-max Seat #1 is the button
Seat 1: 1259a422 ($6.1 in chips)
Seat 2: Hero ($9.2 in chips)
Seat 3: cea6060f ($5.18 in chips)
Seat 4: 68c6c5e7 ($25.24 in chips)
Seat 5: d6d8d23b ($6.69 in chips)
Seat 6: 4d8d4585 ($5.21 in chips)
Hero: posts small blind $0.02
cea6060f: posts big blind $0.05
*** HOLE CARDS ***
Dealt to 1259a422 
Dealt to Hero [Qd 6d]
Dealt to cea6060f 
Dealt to 68c6c5e7 
Dealt to d6d8d23b 
Dealt to 4d8d4585 
68c6c5e7: folds
d6d8d23b: raises $0.07 to $0.12
4d8d4585: folds
1259a422: folds
Hero: folds
cea6060f: folds
Uncalled bet ($0.07) returned to d6d8d23b
*** SHOWDOWN ***
d6d8d23b collected $0.12 from pot
*** SUMMARY ***
Total pot $0.12 | Rake $0 | Jackpot $0 | Bingo $0 | Fortune $0 | Tax $0
Seat 1: 1259a422 (button) folded before Flop (didn't bet)
Seat 2: Hero (small blind) folded before Flop
Seat 3: cea6060f (big blind) folded before Flop
Seat 4: 68c6c5e7 folded before Flop (didn't bet)
Seat 5: d6d8d23b collected ($0.12)
Seat 6: 4d8d4585 folded before Flop (didn't bet)


Poker Hand #RC2078479460: Hold'em No Limit ($0.02/$0.05) - 2023/12/22 21:20:41
Table 'RushAndCash785155' 6-max Seat #1 is the button
Seat 1: 7ab29bd ($5.01 in chips)
Seat 2: d3ab8cb0 ($5.06 in chips)
Seat 3: Hero ($9.25 in chips)
Seat 4: 3a55a6df ($9.7 in chips)
Seat 5: bc118b95 ($5.54 in chips)
Seat 6: d71ab80c ($8.35 in chips)
d3ab8cb0: posts small blind $0.02
Hero: posts big blind $0.05
*** HOLE CARDS ***
Dealt to 7ab29bd 
Dealt to d3ab8cb0 
Dealt to Hero [5c 8s]
Dealt to 3a55a6df 
Dealt to bc118b95 
Dealt to d71ab80c 
3a55a6df: raises $0.06 to $0.11
bc118b95: folds
d71ab80c: folds
7ab29bd: folds
d3ab8cb0: folds
Hero: folds
Uncalled bet ($0.06) returned to 3a55a6df
*** SHOWDOWN ***
3a55a6df collected $0.12 from pot
*** SUMMARY ***
Total pot $0.12 | Rake $0 | Jackpot $0 | Bingo $0 | Fortune $0 | Tax $0
Seat 1: 7ab29bd (button) folded before Flop (didn't bet)
Seat 2: d3ab8cb0 (small blind) folded before Flop
Seat 3: Hero (big blind) folded before Flop
Seat 4: 3a55a6df collected ($0.12)
Seat 5: bc118b95 folded before Flop (didn't bet)
Seat 6: d71ab80c folded before Flop (didn't bet)


Poker Hand #RC2078479392: Hold'em No Limit ($0.02/$0.05) - 2023/12/22 21:20:37
Table 'RushAndCash785123' 6-max Seat #1 is the button
Seat 1: Hero ($9.25 in chips)
Seat 2: 660ca309 ($5.03 in chips)
Seat 3: fba7efa6 ($9.4 in chips)
Seat 4: d51e5ac3 ($5.62 in chips)
Seat 5: 1c8d5419 ($8.38 in chips)
Seat 6: 8b0c9357 ($5 in chips)
660ca309: posts small blind $0.02
fba7efa6: posts big blind $0.05
*** HOLE CARDS ***
Dealt to Hero [3c Td]
Dealt to 660ca309 
Dealt to fba7efa6 
Dealt to d51e5ac3 
Dealt to 1c8d5419 
Dealt to 8b0c9357 
d51e5ac3: raises $0.08 to $0.13
1c8d5419: folds
8b0c9357: folds
Hero: folds
660ca309: folds
fba7efa6: calls $0.08
*** FLOP *** [9h Qh 6h]
fba7efa6: checks
d51e5ac3: bets $0.14
fba7efa6: calls $0.14
*** TURN *** [9h Qh 6h] [5c]
fba7efa6: checks
d51e5ac3: checks
*** RIVER *** [9h Qh 6h 5c] [5s]
fba7efa6: bets $0.42
d51e5ac3: folds
Uncalled bet ($0.42) returned to fba7efa6
*** SHOWDOWN ***
fba7efa6 collected $0.54 from pot
*** SUMMARY ***
Total pot $0.56 | Rake $0.02 | Jackpot $0 | Bingo $0 | Fortune $0 | Tax $0
Board [9h Qh 6h 5c 5s]
Seat 1: Hero (button) folded before Flop (didn't bet)
Seat 2: 660ca309 (small blind) folded before Flop
Seat 3: fba7efa6 (big blind) won ($0.54)
Seat 4: d51e5ac3 folded on the River
Seat 5: 1c8d5419 folded before Flop (didn't bet)
Seat 6: 8b0c9357 folded before Flop (didn't bet)


Poker Hand #RC2078479330: Hold'em No Limit ($0.02/$0.05) - 2023/12/22 21:20:33
Table 'RushAndCash785093' 6-max Seat #1 is the button
Seat 1: c7592cbf ($11.6 in chips)
Seat 2: 9f9a5f9d ($6.2 in chips)
Seat 3: c7adbd3b ($5 in chips)
Seat 4: 604de4fe ($5 in chips)
Seat 5: Hero ($9.25 in chips)
Seat 6: fb13494d ($3.12 in chips)
9f9a5f9d: posts small blind $0.02
c7adbd3b: posts big blind $0.05
*** HOLE CARDS ***
Dealt to c7592cbf 
Dealt to 9f9a5f9d 
Dealt to c7adbd3b 
Dealt to 604de4fe 
Dealt to Hero [2h 9s]
Dealt to fb13494d 
604de4fe: folds
Hero: folds
fb13494d: folds
c7592cbf: raises $0.08 to $0.13
9f9a5f9d: folds
c7adbd3b: calls $0.08
*** FLOP *** [6d 8s Js]
c7adbd3b: checks
c7592cbf: checks
*** TURN *** [6d 8s Js] [4h]
c7adbd3b: checks
c7592cbf: bets $0.19
c7adbd3b: folds
Uncalled bet ($0.19) returned to c7592cbf
*** SHOWDOWN ***
c7592cbf collected $0.27 from pot
*** SUMMARY ***
Total pot $0.28 | Rake $0.01 | Jackpot $0 | Bingo $0 | Fortune $0 | Tax $0
Board [6d 8s Js 4h]
Seat 1: c7592cbf (button) won ($0.27)
Seat 2: 9f9a5f9d (small blind) folded before Flop
Seat 3: c7adbd3b (big blind) folded on the Turn
Seat 4: 604de4fe folded before Flop (didn't bet)
Seat 5: Hero folded before Flop (didn't bet)
Seat 6: fb13494d folded before Flop (didn't bet)


Poker Hand #RC2078479271: Hold'em No Limit ($0.02/$0.05) - 2023/12/22 21:20:30
Table 'RushAndCash785064' 6-max Seat #1 is the button
Seat 1: abd6fe91 ($5.07 in chips)
Seat 2: 341cb855 ($5.13 in chips)
Seat 3: d9ac0d0f ($5.74 in chips)
Seat 4: 91937678 ($6.04 in chips)
Seat 5: Hero ($9.25 in chips)
Seat 6: 9f25c37b ($4.42 in chips)
341cb855: posts small blind $0.02
d9ac0d0f: posts big blind $0.05
*** HOLE CARDS ***
Dealt to abd6fe91 
Dealt to 341cb855 
Dealt to d9ac0d0f 
Dealt to 91937678 
Dealt to Hero [Qc 5s]
Dealt to 9f25c37b 
91937678: raises $0.1 to $0.15
Hero: folds
9f25c37b: folds
abd6fe91: folds
341cb855: folds
d9ac0d0f: folds
Uncalled bet ($0.1) returned to 91937678
*** SHOWDOWN ***
91937678 collected $0.12 from pot
*** SUMMARY ***
Total pot $0.12 | Rake $0 | Jackpot $0 | Bingo $0 | Fortune $0 | Tax $0
Seat 1: abd6fe91 (button) folded before Flop (didn't bet)
Seat 2: 341cb855 (small blind) folded before Flop
Seat 3: d9ac0d0f (big blind) folded before Flop
Seat 4: 91937678 collected ($0.12)
Seat 5: Hero folded before Flop (didn't bet)
Seat 6: 9f25c37b folded before Flop (didn't bet)


Poker Hand #RC2078479185: Hold'em No Limit ($0.02/$0.05) - 2023/12/22 21:20:24
Table 'RushAndCash785021' 6-max Seat #1 is the button
Seat 1: 9926d81a ($7.09 in chips)
Seat 2: 3d929f9f ($7.54 in chips)
Seat 3: 64a4f489 ($6.17 in chips)
Seat 4: fdc2d3ba ($14.19 in chips)
Seat 5: Hero ($9.25 in chips)
Seat 6: 1b7206b8 ($3.76 in chips)
3d929f9f: posts small blind $0.02
64a4f489: posts big blind $0.05
*** HOLE CARDS ***
Dealt to 9926d81a 
Dealt to 3d929f9f 
Dealt to 64a4f489 
Dealt to fdc2d3ba 
Dealt to Hero [3s Qs]
Dealt to 1b7206b8 
fdc2d3ba: folds
Hero: folds
1b7206b8: folds
9926d81a: folds
3d929f9f: folds
Uncalled bet ($0.03) returned to 64a4f489
*** SHOWDOWN ***
64a4f489 collected $0.04 from pot
*** SUMMARY ***
Total pot $0.04 | Rake $0 | Jackpot $0 | Bingo $0 | Fortune $0 | Tax $0
Seat 1: 9926d81a (button) folded before Flop (didn't bet)
Seat 2: 3d929f9f (small blind) folded before Flop
Seat 3: 64a4f489 (big blind) collected ($0.04)
Seat 4: fdc2d3ba folded before Flop (didn't bet)
Seat 5: Hero folded before Flop (didn't bet)
Seat 6: 1b7206b8 folded before Flop (didn't bet)


Poker Hand #RC2078479042: Hold'em No Limit ($0.02/$0.05) - 2023/12/22 21:20:16
Table 'RushAndCash784949' 6-max Seat #1 is the button
Seat 1: 84d4f92c ($5.8 in chips)
Seat 2: 960a23e5 ($4.84 in chips)
Seat 3: 395dbfbb ($5.76 in chips)
Seat 4: 412701ed ($5.96 in chips)
Seat 5: Hero ($9.25 in chips)
Seat 6: 921e997e ($7.97 in chips)
960a23e5: posts small blind $0.02
395dbfbb: posts big blind $0.05
*** HOLE CARDS ***
Dealt to 84d4f92c 
Dealt to 960a23e5 
Dealt to 395dbfbb 
Dealt to 412701ed 
Dealt to Hero [9s 7c]
Dealt to 921e997e 
412701ed: folds
Hero: folds
921e997e: folds
84d4f92c: folds
960a23e5: folds
Uncalled bet ($0.03) returned to 395dbfbb
*** SHOWDOWN ***
395dbfbb collected $0.04 from pot
*** SUMMARY ***
Total pot $0.04 | Rake $0 | Jackpot $0 | Bingo $0 | Fortune $0 | Tax $0
Seat 1: 84d4f92c (button) folded before Flop (didn't bet)
Seat 2: 960a23e5 (small blind) folded before Flop
Seat 3: 395dbfbb (big blind) collected ($0.04)
Seat 4: 412701ed folded before Flop (didn't bet)
Seat 5: Hero folded before Flop (didn't bet)
Seat 6: 921e997e folded before Flop (didn't bet)


Poker Hand #RC2078477639: Hold'em No Limit ($0.02/$0.05) - 2023/12/22 21:18:53
Table 'RushAndCash784275' 6-max Seat #1 is the button
Seat 1: 6e966ccc ($5.52 in chips)
Seat 2: 2372be7b ($6.1 in chips)
Seat 3: Hero ($9.8 in chips)
Seat 4: 44795538 ($4.93 in chips)
Seat 5: f0b0a5f9 ($8.72 in chips)
Seat 6: bc118b95 ($5.58 in chips)
2372be7b: posts small blind $0.02
Hero: posts big blind $0.05
*** HOLE CARDS ***
Dealt to 6e966ccc 
Dealt to 2372be7b 
Dealt to Hero [Jh As]
Dealt to 44795538 
Dealt to f0b0a5f9 
Dealt to bc118b95 
44795538: folds
f0b0a5f9: raises $0.08 to $0.13
bc118b95: folds
6e966ccc: folds
2372be7b: folds
Hero: calls $0.08
*** FLOP *** [4d 6h Jd]
Hero: checks
f0b0a5f9: checks
*** TURN *** [4d 6h Jd] [Th]
Hero: bets $0.14
f0b0a5f9: calls $0.14
*** RIVER *** [4d 6h Jd Th] [7h]
Hero: bets $0.28
f0b0a5f9: raises $1.12 to $1.4
Hero: folds
Uncalled bet ($1.12) returned to f0b0a5f9
*** SHOWDOWN ***
f0b0a5f9 collected $1.07 from pot
*** SUMMARY ***
Total pot $1.12 | Rake $0.05 | Jackpot $0 | Bingo $0 | Fortune $0 | Tax $0
Board [4d 6h Jd Th 7h]
Seat 1: 6e966ccc (button) folded before Flop (didn't bet)
Seat 2: 2372be7b (small blind) folded before Flop
Seat 3: Hero (big blind) folded on the River
Seat 4: 44795538 folded before Flop (didn't bet)
Seat 5: f0b0a5f9 won ($1.07)
Seat 6: bc118b95 folded before Flop (didn't bet)


Poker Hand #RC2078477560: Hold'em No Limit ($0.02/$0.05) - 2023/12/22 21:18:48
Table 'RushAndCash784234' 6-max Seat #1 is the button
Seat 1: af1e12c2 ($5.36 in chips)
Seat 2: dce31b8a ($6.23 in chips)
Seat 3: 5f886f6f ($5.3 in chips)
Seat 4: Hero ($9.8 in chips)
Seat 5: 3056048f ($5 in chips)
Seat 6: 8b0c9357 ($5.11 in chips)
dce31b8a: posts small blind $0.02
5f886f6f: posts big blind $0.05
*** HOLE CARDS ***
Dealt to af1e12c2 
Dealt to dce31b8a 
Dealt to 5f886f6f 
Dealt to Hero [6h Jh]
Dealt to 3056048f 
Dealt to 8b0c9357 
Hero: folds
3056048f: folds
8b0c9357: folds
af1e12c2: raises $0.08 to $0.13
dce31b8a: folds
5f886f6f: calls $0.08
*** FLOP *** [Jc Kh 5s]
5f886f6f: checks
af1e12c2: bets $0.14
5f886f6f: calls $0.14
*** TURN *** [Jc Kh 5s] [6s]
5f886f6f: checks
af1e12c2: bets $0.28
5f886f6f: folds
Uncalled bet ($0.28) returned to af1e12c2
*** SHOWDOWN ***
af1e12c2 collected $0.54 from pot
*** SUMMARY ***
Total pot $0.56 | Rake $0.02 | Jackpot $0 | Bingo $0 | Fortune $0 | Tax $0
Board [Jc Kh 5s 6s]
Seat 1: af1e12c2 (button) won ($0.54)
Seat 2: dce31b8a (small blind) folded before Flop
Seat 3: 5f886f6f (big blind) folded on the Turn
Seat 4: Hero folded before Flop (didn't bet)
Seat 5: 3056048f folded before Flop (didn't bet)
Seat 6: 8b0c9357 folded before Flop (didn't bet)


Poker Hand #RC2078477375: Hold'em No Limit ($0.02/$0.05) - 2023/12/22 21:18:38
Table 'RushAndCash784140' 6-max Seat #1 is the button
Seat 1: f0571dd4 ($5.25 in chips)
Seat 2: Hero ($9.75 in chips)
Seat 3: c71b7029 ($9.39 in chips)
Seat 4: f804ce50 ($14.95 in chips)
Seat 5: 8da33d79 ($14.27 in chips)
Seat 6: 2ece180e ($5.63 in chips)
Hero: posts small blind $0.02
c71b7029: posts big blind $0.05
*** HOLE CARDS ***
Dealt to f0571dd4 
Dealt to Hero [4c Jc]
Dealt to c71b7029 
Dealt to f804ce50 
Dealt to 8da33d79 
Dealt to 2ece180e 
f804ce50: folds
8da33d79: folds
2ece180e: folds
f0571dd4: folds
Hero: raises $0.1 to $0.15
c71b7029: folds
Uncalled bet ($0.1) returned to Hero
*** SHOWDOWN ***
Hero collected $0.1 from pot
*** SUMMARY ***
Total pot $0.1 | Rake $0 | Jackpot $0 | Bingo $0 | Fortune $0 | Tax $0
Seat 1: f0571dd4 (button) folded before Flop (didn't bet)
Seat 2: Hero (small blind) collected ($0.1)
Seat 3: c71b7029 (big blind) folded before Flop
Seat 4: f804ce50 folded before Flop (didn't bet)
Seat 5: 8da33d79 folded before Flop (didn't bet)
Seat 6: 2ece180e folded before Flop (didn't bet)


Poker Hand #RC2078477273: Hold'em No Limit ($0.02/$0.05) - 2023/12/22 21:18:33
Table 'RushAndCash784086' 6-max Seat #1 is the button
Seat 1: Hero ($9.75 in chips)
Seat 2: 3e2e2010 ($7.03 in chips)
Seat 3: 3d929f9f ($7.25 in chips)
Seat 4: ff6f425f ($11.66 in chips)
Seat 5: cbfe1acc ($8.39 in chips)
Seat 6: 1b93f683 ($5.6 in chips)
3e2e2010: posts small blind $0.02
3d929f9f: posts big blind $0.05
*** HOLE CARDS ***
Dealt to Hero [4d 9h]
Dealt to 3e2e2010 
Dealt to 3d929f9f 
Dealt to ff6f425f 
Dealt to cbfe1acc 
Dealt to 1b93f683 
ff6f425f: folds
cbfe1acc: folds
1b93f683: folds
Hero: folds
3e2e2010: folds
Uncalled bet ($0.03) returned to 3d929f9f
*** SHOWDOWN ***
3d929f9f collected $0.04 from pot
*** SUMMARY ***
Total pot $0.04 | Rake $0 | Jackpot $0 | Bingo $0 | Fortune $0 | Tax $0
Seat 1: Hero (button) folded before Flop (didn't bet)
Seat 2: 3e2e2010 (small blind) folded before Flop
Seat 3: 3d929f9f (big blind) collected ($0.04)
Seat 4: ff6f425f folded before Flop (didn't bet)
Seat 5: cbfe1acc folded before Flop (didn't bet)
Seat 6: 1b93f683 folded before Flop (didn't bet)


Poker Hand #RC2078476861: Hold'em No Limit ($0.02/$0.05) - 2023/12/22 21:18:08
Table 'RushAndCash783880' 6-max Seat #1 is the button
Seat 1: 1b93f683 ($5.73 in chips)
Seat 2: ce3dc143 ($4.11 in chips)
Seat 3: Hero ($9.88 in chips)
Seat 4: 787a5651 ($5.12 in chips)
Seat 5: 7d137087 ($5.21 in chips)
Seat 6: cbfe1acc ($8.13 in chips)
ce3dc143: posts small blind $0.02
Hero: posts big blind $0.05
*** HOLE CARDS ***
Dealt to 1b93f683 
Dealt to ce3dc143 
Dealt to Hero [4c 6c]
Dealt to 787a5651 
Dealt to 7d137087 
Dealt to cbfe1acc 
787a5651: folds
7d137087: folds
cbfe1acc: raises $0.08 to $0.13
1b93f683: calls $0.13
ce3dc143: folds
Hero: calls $0.08
*** FLOP *** [Ah Js 8d]
Hero: checks
cbfe1acc: bets $0.21
1b93f683: folds
Hero: folds
Uncalled bet ($0.21) returned to cbfe1acc
*** SHOWDOWN ***
cbfe1acc collected $0.39 from pot
*** SUMMARY ***
Total pot $0.41 | Rake $0.02 | Jackpot $0 | Bingo $0 | Fortune $0 | Tax $0
Board [Ah Js 8d]
Seat 1: 1b93f683 (button) folded on the Flop
Seat 2: ce3dc143 (small blind) folded before Flop
Seat 3: Hero (big blind) folded on the Flop
Seat 4: 787a5651 folded before Flop (didn't bet)
Seat 5: 7d137087 folded before Flop (didn't bet)
Seat 6: cbfe1acc won ($0.39)


Poker Hand #RC2078476674: Hold'em No Limit ($0.02/$0.05) - 2023/12/22 21:17:58
Table 'RushAndCash783790' 6-max Seat #1 is the button
Seat 1: Hero ($9.88 in chips)
Seat 2: 6e966ccc ($5.47 in chips)
Seat 3: 341cb855 ($2.25 in chips)
Seat 4: 9c04f3ae ($5.92 in chips)
Seat 5: 998574b7 ($5 in chips)
Seat 6: 91937678 ($5.74 in chips)
6e966ccc: posts small blind $0.02
341cb855: posts big blind $0.05
*** HOLE CARDS ***
Dealt to Hero [5d Js]
Dealt to 6e966ccc 
Dealt to 341cb855 
Dealt to 9c04f3ae 
Dealt to 998574b7 
Dealt to 91937678 
9c04f3ae: folds
998574b7: folds
91937678: folds
Hero: folds
6e966ccc: raises $0.08 to $0.13
341cb855: folds
Uncalled bet ($0.08) returned to 6e966ccc
*** SHOWDOWN ***
6e966ccc collected $0.1 from pot
*** SUMMARY ***
Total pot $0.1 | Rake $0 | Jackpot $0 | Bingo $0 | Fortune $0 | Tax $0
Seat 1: Hero (button) folded before Flop (didn't bet)
Seat 2: 6e966ccc (small blind) collected ($0.1)
Seat 3: 341cb855 (big blind) folded before Flop
Seat 4: 9c04f3ae folded before Flop (didn't bet)
Seat 5: 998574b7 folded before Flop (didn't bet)
Seat 6: 91937678 folded before Flop (didn't bet)


Poker Hand #RC2078476278: Hold'em No Limit ($0.02/$0.05) - 2023/12/22 21:17:35
Table 'RushAndCash783603' 6-max Seat #1 is the button
Seat 1: 175b9638 ($5.07 in chips)
Seat 2: Hero ($9.9 in chips)
Seat 3: 5d317abf ($9.24 in chips)
Seat 4: f03c68f3 ($8.47 in chips)
Seat 5: a9abc4b1 ($7.69 in chips)
Seat 6: 3160ff3c ($10.11 in chips)
Hero: posts small blind $0.02
5d317abf: posts big blind $0.05
*** HOLE CARDS ***
Dealt to 175b9638 
Dealt to Hero [5d Ts]
Dealt to 5d317abf 
Dealt to f03c68f3 
Dealt to a9abc4b1 
Dealt to 3160ff3c 
f03c68f3: folds
a9abc4b1: raises $0.05 to $0.1
3160ff3c: folds
175b9638: folds
Hero: folds
5d317abf: folds
Uncalled bet ($0.05) returned to a9abc4b1
*** SHOWDOWN ***
a9abc4b1 collected $0.12 from pot
*** SUMMARY ***
Total pot $0.12 | Rake $0 | Jackpot $0 | Bingo $0 | Fortune $0 | Tax $0
Seat 1: 175b9638 (button) folded before Flop (didn't bet)
Seat 2: Hero (small blind) folded before Flop
Seat 3: 5d317abf (big blind) folded before Flop
Seat 4: f03c68f3 folded before Flop (didn't bet)
Seat 5: a9abc4b1 collected ($0.12)
Seat 6: 3160ff3c folded before Flop (didn't bet)


Poker Hand #RC2078476210: Hold'em No Limit ($0.02/$0.05) - 2023/12/22 21:17:31
Table 'RushAndCash783570' 6-max Seat #1 is the button
Seat 1: 1a6eef5 ($4.93 in chips)
Seat 2: e1380a89 ($6.56 in chips)
Seat 3: 9674377d ($1.8 in chips)
Seat 4: Hero ($9.9 in chips)
Seat 5: bbf08286 ($4.51 in chips)
Seat 6: 68c6c5e7 ($25.06 in chips)
e1380a89: posts small blind $0.02
9674377d: posts big blind $0.05
*** HOLE CARDS ***
Dealt to 1a6eef5 
Dealt to e1380a89 
Dealt to 9674377d 
Dealt to Hero [6c 4h]
Dealt to bbf08286 
Dealt to 68c6c5e7 
Hero: folds
bbf08286: raises $0.05 to $0.1
68c6c5e7: folds
1a6eef5: folds
e1380a89: raises $0.25 to $0.35
9674377d: folds
bbf08286: calls $0.25
*** FLOP *** [Jh 3c 5s]
e1380a89: bets $0.58
bbf08286: raises $0.58 to $1.16
e1380a89: raises $5.05 to $6.21 and is all-in
bbf08286: calls $3 and is all-in
Uncalled bet ($2.05) returned to e1380a89
e1380a89: shows [Js Ks] (Pair of Jacks)
bbf08286: shows [Jc 8c] (Pair of Jacks)
*** TURN *** [Jh 3c 5s] [2c]
*** RIVER *** [Jh 3c 5s 2c] [8s]
*** SHOWDOWN ***
bbf08286 collected $8.85 from pot
*** SUMMARY ***
Total pot $9.07 | Rake $0.15 | Jackpot $0.07 | Bingo $0 | Fortune $0 | Tax $0
Board [Jh 3c 5s 2c 8s]
Seat 1: 1a6eef5 (button) folded before Flop (didn't bet)
Seat 2: e1380a89 (small blind) showed [Js Ks] and lost with Pair of Jacks
Seat 3: 9674377d (big blind) folded before Flop
Seat 4: Hero folded before Flop (didn't bet)
Seat 5: bbf08286 showed [Jc 8c] and won ($8.85) with Pair of Jacks and Pair of Eights
Seat 6: 68c6c5e7 folded before Flop (didn't bet)


Poker Hand #RC2078476146: Hold'em No Limit ($0.02/$0.05) - 2023/12/22 21:17:28
Table 'RushAndCash783537' 6-max Seat #1 is the button
Seat 1: bbf08286 ($4.51 in chips)
Seat 2: bf955ffb ($5.02 in chips)
Seat 3: 6ffefba2 ($5 in chips)
Seat 4: 7466ff6a ($19.79 in chips)
Seat 5: 2d4acc60 ($3.96 in chips)
Seat 6: Hero ($9.9 in chips)
bf955ffb: posts small blind $0.02
6ffefba2: posts big blind $0.05
*** HOLE CARDS ***
Dealt to bbf08286 
Dealt to bf955ffb 
Dealt to 6ffefba2 
Dealt to 7466ff6a 
Dealt to 2d4acc60 
Dealt to Hero [Jc 5h]
7466ff6a: folds
2d4acc60: raises $0.05 to $0.1
Hero: folds
bbf08286: folds
bf955ffb: folds
6ffefba2: folds
Uncalled bet ($0.05) returned to 2d4acc60
*** SHOWDOWN ***
2d4acc60 collected $0.12 from pot
*** SUMMARY ***
Total pot $0.12 | Rake $0 | Jackpot $0 | Bingo $0 | Fortune $0 | Tax $0
Seat 1: bbf08286 (button) folded before Flop (didn't bet)
Seat 2: bf955ffb (small blind) folded before Flop
Seat 3: 6ffefba2 (big blind) folded before Flop
Seat 4: 7466ff6a folded before Flop (didn't bet)
Seat 5: 2d4acc60 collected ($0.12)
Seat 6: Hero folded before Flop (didn't bet)


Poker Hand #RC2078476065: Hold'em No Limit ($0.02/$0.05) - 2023/12/22 21:17:23
Table 'RushAndCash783498' 6-max Seat #1 is the button
Seat 1: b18917a1 ($5.38 in chips)
Seat 2: a2ebb3c7 ($5.86 in chips)
Seat 3: 618f8ec9 ($5 in chips)
Seat 4: Hero ($9.9 in chips)
Seat 5: 5d626479 ($3.53 in chips)
Seat 6: ce5771af ($5.14 in chips)
a2ebb3c7: posts small blind $0.02
618f8ec9: posts big blind $0.05
*** HOLE CARDS ***
Dealt to b18917a1 
Dealt to a2ebb3c7 
Dealt to 618f8ec9 
Dealt to Hero [Js Th]
Dealt to 5d626479 
Dealt to ce5771af 
Hero: folds
5d626479: folds
ce5771af: folds
b18917a1: raises $0.06 to $0.11
a2ebb3c7: folds
618f8ec9: folds
Uncalled bet ($0.06) returned to b18917a1
*** SHOWDOWN ***
b18917a1 collected $0.12 from pot
*** SUMMARY ***
Total pot $0.12 | Rake $0 | Jackpot $0 | Bingo $0 | Fortune $0 | Tax $0
Seat 1: b18917a1 (button) collected ($0.12)
Seat 2: a2ebb3c7 (small blind) folded before Flop
Seat 3: 618f8ec9 (big blind) folded before Flop
Seat 4: Hero folded before Flop (didn't bet)
Seat 5: 5d626479 folded before Flop (didn't bet)
Seat 6: ce5771af folded before Flop (didn't bet)


Poker Hand #RC2078476010: Hold'em No Limit ($0.02/$0.05) - 2023/12/22 21:17:20
Table 'RushAndCash783472' 6-max Seat #1 is the button
Seat 1: 4ab8a557 ($8.69 in chips)
Seat 2: d0442df9 ($8.39 in chips)
Seat 3: 913692c3 ($6.27 in chips)
Seat 4: 5d626479 ($3.53 in chips)
Seat 5: Hero ($9.9 in chips)
Seat 6: 6ffefba2 ($5 in chips)
d0442df9: posts small blind $0.02
913692c3: posts big blind $0.05
*** HOLE CARDS ***
Dealt to 4ab8a557 
Dealt to d0442df9 
Dealt to 913692c3 
Dealt to 5d626479 
Dealt to Hero [4c 9d]
Dealt to 6ffefba2 
5d626479: folds
Hero: folds
6ffefba2: folds
4ab8a557: raises $0.06 to $0.11
d0442df9: calls $0.09
913692c3: folds
*** FLOP *** [9c Qs 5h]
d0442df9: checks
4ab8a557: bets $0.14
d0442df9: folds
Uncalled bet ($0.14) returned to 4ab8a557
*** SHOWDOWN ***
4ab8a557 collected $0.26 from pot
*** SUMMARY ***
Total pot $0.27 | Rake $0.01 | Jackpot $0 | Bingo $0 | Fortune $0 | Tax $0
Board [9c Qs 5h]
Seat 1: 4ab8a557 (button) won ($0.26)
Seat 2: d0442df9 (small blind) folded on the Flop
Seat 3: 913692c3 (big blind) folded before Flop
Seat 4: 5d626479 folded before Flop (didn't bet)
Seat 5: Hero folded before Flop (didn't bet)
Seat 6: 6ffefba2 folded before Flop (didn't bet)


Poker Hand #RC2078475923: Hold'em No Limit ($0.02/$0.05) - 2023/12/22 21:17:15
Table 'RushAndCash783428' 6-max Seat #1 is the button
Seat 1: 44795538 ($3.67 in chips)
Seat 2: c6813ed5 ($4.95 in chips)
Seat 3: 2861b620 ($4.44 in chips)
Seat 4: 38e42730 ($5.07 in chips)
Seat 5: Hero ($9.9 in chips)
Seat 6: 2c2cc68d ($12.32 in chips)
c6813ed5: posts small blind $0.02
2861b620: posts big blind $0.05
*** HOLE CARDS ***
Dealt to 44795538 
Dealt to c6813ed5 
Dealt to 2861b620 
Dealt to 38e42730 
Dealt to Hero [2c 8d]
Dealt to 2c2cc68d 
38e42730: folds
Hero: folds
2c2cc68d: folds
44795538: folds
c6813ed5: folds
Uncalled bet ($0.03) returned to 2861b620
*** SHOWDOWN ***
2861b620 collected $0.04 from pot
*** SUMMARY ***
Total pot $0.04 | Rake $0 | Jackpot $0 | Bingo $0 | Fortune $0 | Tax $0
Seat 1: 44795538 (button) folded before Flop (didn't bet)
Seat 2: c6813ed5 (small blind) folded before Flop
Seat 3: 2861b620 (big blind) collected ($0.04)
Seat 4: 38e42730 folded before Flop (didn't bet)
Seat 5: Hero folded before Flop (didn't bet)
Seat 6: 2c2cc68d folded before Flop (didn't bet)


Poker Hand #RC2078475742: Hold'em No Limit ($0.02/$0.05) - 2023/12/22 21:17:04
Table 'RushAndCash783345' 6-max Seat #1 is the button
Seat 1: Hero ($9.9 in chips)
Seat 2: 84572dc4 ($5.37 in chips)
Seat 3: 2fe29be0 ($5 in chips)
Seat 4: 6c7c67da ($5.07 in chips)
Seat 5: 7728b936 ($5 in chips)
Seat 6: c9c293e2 ($5.93 in chips)
84572dc4: posts small blind $0.02
2fe29be0: posts big blind $0.05
*** HOLE CARDS ***
Dealt to Hero [7h 5h]
Dealt to 84572dc4 
Dealt to 2fe29be0 
Dealt to 6c7c67da 
Dealt to 7728b936 
Dealt to c9c293e2 
6c7c67da: folds
7728b936: raises $0.08 to $0.13
c9c293e2: folds
Hero: folds
84572dc4: folds
2fe29be0: calls $0.08
*** FLOP *** [Qd 7d 6d]
2fe29be0: checks
7728b936: bets $0.1
2fe29be0: calls $0.1
*** TURN *** [Qd 7d 6d] [Kc]
2fe29be0: checks
7728b936: bets $0.16
2fe29be0: raises $0.16 to $0.32
7728b936: calls $0.16
*** RIVER *** [Qd 7d 6d Kc] [Qc]
2fe29be0: checks
7728b936: checks
2fe29be0: shows [Ks 7s] (Pair of Kings and Pair of Queens)
7728b936: shows [Ad Qs] (Three Queens)
*** SHOWDOWN ***
7728b936 collected $1.07 from pot
*** SUMMARY ***
Total pot $1.12 | Rake $0.05 | Jackpot $0 | Bingo $0 | Fortune $0 | Tax $0
Board [Qd 7d 6d Kc Qc]
Seat 1: Hero (button) folded before Flop (didn't bet)
Seat 2: 84572dc4 (small blind) folded before Flop
Seat 3: 2fe29be0 (big blind) showed [Ks 7s] and lost with Pair of Kings and Pair of Queens
Seat 4: 6c7c67da folded before Flop (didn't bet)
Seat 5: 7728b936 showed [Ad Qs] and won ($1.07) with Three Queens
Seat 6: c9c293e2 folded before Flop (didn't bet)


Poker Hand #RC2078475486: Hold'em No Limit ($0.02/$0.05) - 2023/12/22 21:16:49
Table 'RushAndCash783217' 6-max Seat #1 is the button
Seat 1: d0442df9 ($8.42 in chips)
Seat 2: Hero ($9.92 in chips)
Seat 3: c3c9a58d ($11.45 in chips)
Seat 4: 9d480ff ($5.48 in chips)
Seat 5: 89a27c2 ($5 in chips)
Seat 6: ab5dffec ($7.12 in chips)
Hero: posts small blind $0.02
c3c9a58d: posts big blind $0.05
*** HOLE CARDS ***
Dealt to d0442df9 
Dealt to Hero [5h 4c]
Dealt to c3c9a58d 
Dealt to 9d480ff 
Dealt to 89a27c2 
Dealt to ab5dffec 
9d480ff: folds
89a27c2: folds
ab5dffec: folds
d0442df9: raises $0.05 to $0.1
Hero: folds
c3c9a58d: folds
Uncalled bet ($0.05) returned to d0442df9
*** SHOWDOWN ***
d0442df9 collected $0.12 from pot
*** SUMMARY ***
Total pot $0.12 | Rake $0 | Jackpot $0 | Bingo $0 | Fortune $0 | Tax $0
Seat 1: d0442df9 (button) collected ($0.12)
Seat 2: Hero (small blind) folded before Flop
Seat 3: c3c9a58d (big blind) folded before Flop
Seat 4: 9d480ff folded before Flop (didn't bet)
Seat 5: 89a27c2 folded before Flop (didn't bet)
Seat 6: ab5dffec folded before Flop (didn't bet)


Poker Hand #RC2078475281: Hold'em No Limit ($0.02/$0.05) - 2023/12/22 21:16:38
Table 'RushAndCash783111' 6-max Seat #1 is the button
Seat 1: eadbd152 ($4.11 in chips)
Seat 2: cd339031 ($5 in chips)
Seat 3: Hero ($9.9 in chips)
Seat 4: 7ddba90d ($5.02 in chips)
Seat 5: 6bf9020c ($5.14 in chips)
Seat 6: 9d480ff ($5.48 in chips)
cd339031: posts small blind $0.02
Hero: posts big blind $0.05
*** HOLE CARDS ***
Dealt to eadbd152 
Dealt to cd339031 
Dealt to Hero [6s 8s]
Dealt to 7ddba90d 
Dealt to 6bf9020c 
Dealt to 9d480ff 
7ddba90d: folds
6bf9020c: folds
9d480ff: folds
eadbd152: folds
cd339031: folds
Uncalled bet ($0.03) returned to Hero
*** SHOWDOWN ***
Hero collected $0.04 from pot
*** SUMMARY ***
Total pot $0.04 | Rake $0 | Jackpot $0 | Bingo $0 | Fortune $0 | Tax $0
Seat 1: eadbd152 (button) folded before Flop (didn't bet)
Seat 2: cd339031 (small blind) folded before Flop
Seat 3: Hero (big blind) collected ($0.04)
Seat 4: 7ddba90d folded before Flop (didn't bet)
Seat 5: 6bf9020c folded before Flop (didn't bet)
Seat 6: 9d480ff folded before Flop (didn't bet)


Poker Hand #RC2078475213: Hold'em No Limit ($0.02/$0.05) - 2023/12/22 21:16:33
Table 'RushAndCash783077' 6-max Seat #1 is the button
Seat 1: a90771fe ($6.79 in chips)
Seat 2: 1f7caee2 ($4.12 in chips)
Seat 3: c54f63b8 ($5.76 in chips)
Seat 4: 4dab75d6 ($4.81 in chips)
Seat 5: 6f5406fb ($5.18 in chips)
Seat 6: Hero ($9.9 in chips)
1f7caee2: posts small blind $0.02
c54f63b8: posts big blind $0.05
*** HOLE CARDS ***
Dealt to a90771fe 
Dealt to 1f7caee2 
Dealt to c54f63b8 
Dealt to 4dab75d6 
Dealt to 6f5406fb 
Dealt to Hero [3s 9s]
4dab75d6: raises $0.05 to $0.1
6f5406fb: folds
Hero: folds
a90771fe: folds
1f7caee2: folds
c54f63b8: folds
Uncalled bet ($0.05) returned to 4dab75d6
*** SHOWDOWN ***
4dab75d6 collected $0.12 from pot
*** SUMMARY ***
Total pot $0.12 | Rake $0 | Jackpot $0 | Bingo $0 | Fortune $0 | Tax $0
Seat 1: a90771fe (button) folded before Flop (didn't bet)
Seat 2: 1f7caee2 (small blind) folded before Flop
Seat 3: c54f63b8 (big blind) folded before Flop
Seat 4: 4dab75d6 collected ($0.12)
Seat 5: 6f5406fb folded before Flop (didn't bet)
Seat 6: Hero folded before Flop (didn't bet)


Poker Hand #RC2078475120: Hold'em No Limit ($0.02/$0.05) - 2023/12/22 21:16:28
Table 'RushAndCash783031' 6-max Seat #1 is the button
Seat 1: ba34a0a7 ($2.19 in chips)
Seat 2: d03e1a8e ($7.49 in chips)
Seat 3: 3580bebf ($14.94 in chips)
Seat 4: 3a26c05c ($5 in chips)
Seat 5: 4ab8a557 ($8.76 in chips)
Seat 6: Hero ($9.9 in chips)
d03e1a8e: posts small blind $0.02
3580bebf: posts big blind $0.05
*** HOLE CARDS ***
Dealt to ba34a0a7 
Dealt to d03e1a8e 
Dealt to 3580bebf 
Dealt to 3a26c05c 
Dealt to 4ab8a557 
Dealt to Hero [2s 6s]
3a26c05c: folds
4ab8a557: folds
Hero: folds
ba34a0a7: folds
d03e1a8e: raises $0.1 to $0.15
3580bebf: folds
Uncalled bet ($0.1) returned to d03e1a8e
*** SHOWDOWN ***
d03e1a8e collected $0.1 from pot
*** SUMMARY ***
Total pot $0.1 | Rake $0 | Jackpot $0 | Bingo $0 | Fortune $0 | Tax $0
Seat 1: ba34a0a7 (button) folded before Flop (didn't bet)
Seat 2: d03e1a8e (small blind) collected ($0.1)
Seat 3: 3580bebf (big blind) folded before Flop
Seat 4: 3a26c05c folded before Flop (didn't bet)
Seat 5: 4ab8a557 folded before Flop (didn't bet)
Seat 6: Hero folded before Flop (didn't bet)


Poker Hand #RC2078475046: Hold'em No Limit ($0.02/$0.05) - 2023/12/22 21:16:23
Table 'RushAndCash782996' 6-max Seat #1 is the button
Seat 1: Hero ($9.9 in chips)
Seat 2: aeb6c819 ($10.43 in chips)
Seat 3: 6524c228 ($4.9 in chips)
Seat 4: 67d4b163 ($14.84 in chips)
Seat 5: 1f940f2d ($10.11 in chips)
Seat 6: a2f5e875 ($6.39 in chips)
aeb6c819: posts small blind $0.02
6524c228: posts big blind $0.05
*** HOLE CARDS ***
Dealt to Hero [2s 3s]
Dealt to aeb6c819 
Dealt to 6524c228 
Dealt to 67d4b163 
Dealt to 1f940f2d 
Dealt to a2f5e875 
67d4b163: folds
1f940f2d: folds
a2f5e875: raises $0.08 to $0.13
Hero: folds
aeb6c819: folds
6524c228: folds
Uncalled bet ($0.08) returned to a2f5e875
*** SHOWDOWN ***
a2f5e875 collected $0.12 from pot
*** SUMMARY ***
Total pot $0.12 | Rake $0 | Jackpot $0 | Bingo $0 | Fortune $0 | Tax $0
Seat 1: Hero (button) folded before Flop (didn't bet)
Seat 2: aeb6c819 (small blind) folded before Flop
Seat 3: 6524c228 (big blind) folded before Flop
Seat 4: 67d4b163 folded before Flop (didn't bet)
Seat 5: 1f940f2d folded before Flop (didn't bet)
Seat 6: a2f5e875 collected ($0.12)


Poker Hand #RC2078474958: Hold'em No Limit ($0.02/$0.05) - 2023/12/22 21:16:18
Table 'RushAndCash782950' 6-max Seat #1 is the button
Seat 1: 604de4fe ($5.02 in chips)
Seat 2: 81ecaac5 ($5.87 in chips)
Seat 3: a4c64da ($10.76 in chips)
Seat 4: 36174378 ($2.54 in chips)
Seat 5: c7b7c566 ($5.39 in chips)
Seat 6: Hero ($9.9 in chips)
81ecaac5: posts small blind $0.02
a4c64da: posts big blind $0.05
*** HOLE CARDS ***
Dealt to 604de4fe 
Dealt to 81ecaac5 
Dealt to a4c64da 
Dealt to 36174378 
Dealt to c7b7c566 
Dealt to Hero [3d Jh]
36174378: folds
c7b7c566: folds
Hero: folds
604de4fe: folds
81ecaac5: folds
Uncalled bet ($0.03) returned to a4c64da
*** SHOWDOWN ***
a4c64da collected $0.04 from pot
*** SUMMARY ***
Total pot $0.04 | Rake $0 | Jackpot $0 | Bingo $0 | Fortune $0 | Tax $0
Seat 1: 604de4fe (button) folded before Flop (didn't bet)
Seat 2: 81ecaac5 (small blind) folded before Flop
Seat 3: a4c64da (big blind) collected ($0.04)
Seat 4: 36174378 folded before Flop (didn't bet)
Seat 5: c7b7c566 folded before Flop (didn't bet)
Seat 6: Hero folded before Flop (didn't bet)


Poker Hand #RC2078454513: Hold'em No Limit ($0.02/$0.05) - 2023/12/22 21:15:52
Table 'RushAndCash782735' 6-max Seat #1 is the button
Seat 1: 3dbf95c1 ($8.48 in chips)
Seat 2: 93990934 ($11.62 in chips)
Seat 3: Hero ($9.78 in chips)
Seat 4: 580b42af ($5.16 in chips)
Seat 5: a4c64da ($10.87 in chips)
Seat 6: bada497e ($5 in chips)
93990934: posts small blind $0.02
Hero: posts big blind $0.05
*** HOLE CARDS ***
Dealt to 3dbf95c1 
Dealt to 93990934 
Dealt to Hero [Ah As]
Dealt to 580b42af 
Dealt to a4c64da 
Dealt to bada497e 
580b42af: folds
a4c64da: raises $0.06 to $0.11
bada497e: folds
3dbf95c1: folds
93990934: folds
Hero: raises $0.34 to $0.45
a4c64da: folds
Uncalled bet ($0.34) returned to Hero
*** SHOWDOWN ***
Hero collected $0.23 from pot
*** SUMMARY ***
Total pot $0.24 | Rake $0.01 | Jackpot $0 | Bingo $0 | Fortune $0 | Tax $0
Seat 1: 3dbf95c1 (button) folded before Flop (didn't bet)
Seat 2: 93990934 (small blind) folded before Flop
Seat 3: Hero (big blind) collected ($0.23)
Seat 4: 580b42af folded before Flop (didn't bet)
Seat 5: a4c64da folded before Flop
Seat 6: bada497e folded before Flop (didn't bet)


Poker Hand #RC2078454351: Hold'em No Limit ($0.02/$0.05) - 2023/12/22 21:15:43
Table 'RushAndCash782655' 6-max Seat #1 is the button
Seat 1: 2588276e ($10.61 in chips)
Seat 2: Hero ($9.8 in chips)
Seat 3: 29b0f5be ($5.13 in chips)
Seat 4: 3a44e48f ($5.5 in chips)
Seat 5: 93b1a4e4 ($5.79 in chips)
Seat 6: 19d300cc ($6.07 in chips)
Hero: posts small blind $0.02
29b0f5be: posts big blind $0.05
*** HOLE CARDS ***
Dealt to 2588276e 
Dealt to Hero [Kh Td]
Dealt to 29b0f5be 
Dealt to 3a44e48f 
Dealt to 93b1a4e4 
Dealt to 19d300cc 
3a44e48f: folds
93b1a4e4: folds
19d300cc: folds
2588276e: raises $0.05 to $0.1
Hero: folds
29b0f5be: calls $0.05
*** FLOP *** [8d 3d 2s]
29b0f5be: checks
2588276e: checks
*** TURN *** [8d 3d 2s] [9s]
29b0f5be: bets $0.08
2588276e: folds
Uncalled bet ($0.08) returned to 29b0f5be
*** SHOWDOWN ***
29b0f5be collected $0.21 from pot
*** SUMMARY ***
Total pot $0.22 | Rake $0.01 | Jackpot $0 | Bingo $0 | Fortune $0 | Tax $0
Board [8d 3d 2s 9s]
Seat 1: 2588276e (button) folded on the Turn
Seat 2: Hero (small blind) folded before Flop
Seat 3: 29b0f5be (big blind) won ($0.21)
Seat 4: 3a44e48f folded before Flop (didn't bet)
Seat 5: 93b1a4e4 folded before Flop (didn't bet)
Seat 6: 19d300cc folded before Flop (didn't bet)


Poker Hand #RC2078454208: Hold'em No Limit ($0.02/$0.05) - 2023/12/22 21:15:34
Table 'RushAndCash782589' 6-max Seat #1 is the button
Seat 1: d6c4e270 ($2.12 in chips)
Seat 2: edb6154b ($5.43 in chips)
Seat 3: a420712c ($11.77 in chips)
Seat 4: c3adc948 ($5 in chips)
Seat 5: d935a1ba ($5 in chips)
Seat 6: Hero ($9.8 in chips)
edb6154b: posts small blind $0.02
a420712c: posts big blind $0.05
*** HOLE CARDS ***
Dealt to d6c4e270 
Dealt to edb6154b 
Dealt to a420712c 
Dealt to c3adc948 
Dealt to d935a1ba 
Dealt to Hero [Qc 3d]
c3adc948: folds
d935a1ba: folds
Hero: folds
d6c4e270: raises $0.08 to $0.13
edb6154b: folds
a420712c: folds
Uncalled bet ($0.08) returned to d6c4e270
*** SHOWDOWN ***
d6c4e270 collected $0.12 from pot
*** SUMMARY ***
Total pot $0.12 | Rake $0 | Jackpot $0 | Bingo $0 | Fortune $0 | Tax $0
Seat 1: d6c4e270 (button) collected ($0.12)
Seat 2: edb6154b (small blind) folded before Flop
Seat 3: a420712c (big blind) folded before Flop
Seat 4: c3adc948 folded before Flop (didn't bet)
Seat 5: d935a1ba folded before Flop (didn't bet)
Seat 6: Hero folded before Flop (didn't bet)


Poker Hand #RC2078454154: Hold'em No Limit ($0.02/$0.05) - 2023/12/22 21:15:30
Table 'RushAndCash782563' 6-max Seat #1 is the button
Seat 1: d21a0c3 ($8.32 in chips)
Seat 2: f804ce50 ($15.65 in chips)
Seat 3: 821f3bc7 ($6.19 in chips)
Seat 4: 34ce5e3 ($5 in chips)
Seat 5: Hero ($9.8 in chips)
Seat 6: 3da5ed9c ($4.97 in chips)
f804ce50: posts small blind $0.02
821f3bc7: posts big blind $0.05
*** HOLE CARDS ***
Dealt to d21a0c3 
Dealt to f804ce50 
Dealt to 821f3bc7 
Dealt to 34ce5e3 
Dealt to Hero [Qs 3s]
Dealt to 3da5ed9c 
34ce5e3: folds
Hero: folds
3da5ed9c: folds
d21a0c3: raises $0.07 to $0.12
f804ce50: folds
821f3bc7: calls $0.07
*** FLOP *** [7s Ad As]
821f3bc7: checks
d21a0c3: checks
*** TURN *** [7s Ad As] [3h]
821f3bc7: bets $0.2
d21a0c3: folds
Uncalled bet ($0.2) returned to 821f3bc7
*** SHOWDOWN ***
821f3bc7 collected $0.25 from pot
*** SUMMARY ***
Total pot $0.26 | Rake $0.01 | Jackpot $0 | Bingo $0 | Fortune $0 | Tax $0
Board [7s Ad As 3h]
Seat 1: d21a0c3 (button) folded on the Turn
Seat 2: f804ce50 (small blind) folded before Flop
Seat 3: 821f3bc7 (big blind) won ($0.25)
Seat 4: 34ce5e3 folded before Flop (didn't bet)
Seat 5: Hero folded before Flop (didn't bet)
Seat 6: 3da5ed9c folded before Flop (didn't bet)


Poker Hand #RC2078454092: Hold'em No Limit ($0.02/$0.05) - 2023/12/22 21:15:27
Table 'RushAndCash782533' 6-max Seat #1 is the button
Seat 1: Hero ($9.8 in chips)
Seat 2: 63c93090 ($5.79 in chips)
Seat 3: 869465ff ($15.21 in chips)
Seat 4: 38bb8e26 ($5.68 in chips)
Seat 5: 59846dec ($2.49 in chips)
Seat 6: b7a32571 ($5.71 in chips)
63c93090: posts small blind $0.02
869465ff: posts big blind $0.05
*** HOLE CARDS ***
Dealt to Hero [7c 3h]
Dealt to 63c93090 
Dealt to 869465ff 
Dealt to 38bb8e26 
Dealt to 59846dec 
Dealt to b7a32571 
38bb8e26: raises $0.06 to $0.11
59846dec: folds
b7a32571: folds
Hero: folds
63c93090: calls $0.09
869465ff: calls $0.06
*** FLOP *** [Kd 3c 5h]
63c93090: bets $0.25
869465ff: folds
38bb8e26: folds
Uncalled bet ($0.25) returned to 63c93090
*** SHOWDOWN ***
63c93090 collected $0.32 from pot
*** SUMMARY ***
Total pot $0.33 | Rake $0.01 | Jackpot $0 | Bingo $0 | Fortune $0 | Tax $0
Board [Kd 3c 5h]
Seat 1: Hero (button) folded before Flop (didn't bet)
Seat 2: 63c93090 (small blind) won ($0.32)
Seat 3: 869465ff (big blind) folded on the Flop
Seat 4: 38bb8e26 folded on the Flop
Seat 5: 59846dec folded before Flop (didn't bet)
Seat 6: b7a32571 folded before Flop (didn't bet)


Poker Hand #RC2078453959: Hold'em No Limit ($0.02/$0.05) - 2023/12/22 21:15:19
Table 'RushAndCash782468' 6-max Seat #1 is the button
Seat 1: abd6fe91 ($5.21 in chips)
Seat 2: 7e3b11a6 ($5.02 in chips)
Seat 3: Hero ($9.78 in chips)
Seat 4: 3928912e ($5.19 in chips)
Seat 5: 872860d ($5.97 in chips)
Seat 6: 56d0ca9d ($4.35 in chips)
7e3b11a6: posts small blind $0.02
Hero: posts big blind $0.05
*** HOLE CARDS ***
Dealt to abd6fe91 
Dealt to 7e3b11a6 
Dealt to Hero [8c 6c]
Dealt to 3928912e 
Dealt to 872860d 
Dealt to 56d0ca9d 
3928912e: folds
872860d: folds
56d0ca9d: folds
abd6fe91: folds
7e3b11a6: folds
Uncalled bet ($0.03) returned to Hero
*** SHOWDOWN ***
Hero collected $0.04 from pot
*** SUMMARY ***
Total pot $0.04 | Rake $0 | Jackpot $0 | Bingo $0 | Fortune $0 | Tax $0
Seat 1: abd6fe91 (button) folded before Flop (didn't bet)
Seat 2: 7e3b11a6 (small blind) folded before Flop
Seat 3: Hero (big blind) collected ($0.04)
Seat 4: 3928912e folded before Flop (didn't bet)
Seat 5: 872860d folded before Flop (didn't bet)
Seat 6: 56d0ca9d folded before Flop (didn't bet)


Poker Hand #RC2078453790: Hold'em No Limit ($0.02/$0.05) - 2023/12/22 21:15:10
Table 'RushAndCash782388' 6-max Seat #1 is the button
Seat 1: 50cbc258 ($8.29 in chips)
Seat 2: Hero ($9.8 in chips)
Seat 3: b74b84be ($3.95 in chips)
Seat 4: c18ede1f ($5.72 in chips)
Seat 5: 1699fc0f ($5.52 in chips)
Seat 6: 7c10f852 ($24.1 in chips)
Hero: posts small blind $0.02
b74b84be: posts big blind $0.05
*** HOLE CARDS ***
Dealt to 50cbc258 
Dealt to Hero [Qs 6d]
Dealt to b74b84be 
Dealt to c18ede1f 
Dealt to 1699fc0f 
Dealt to 7c10f852 
c18ede1f: folds
1699fc0f: folds
7c10f852: folds
50cbc258: raises $0.06 to $0.11
Hero: folds
b74b84be: folds
Uncalled bet ($0.06) returned to 50cbc258
*** SHOWDOWN ***
50cbc258 collected $0.12 from pot
*** SUMMARY ***
Total pot $0.12 | Rake $0 | Jackpot $0 | Bingo $0 | Fortune $0 | Tax $0
Seat 1: 50cbc258 (button) collected ($0.12)
Seat 2: Hero (small blind) folded before Flop
Seat 3: b74b84be (big blind) folded before Flop
Seat 4: c18ede1f folded before Flop (didn't bet)
Seat 5: 1699fc0f folded before Flop (didn't bet)
Seat 6: 7c10f852 folded before Flop (didn't bet)


Poker Hand #RC2078453541: Hold'em No Limit ($0.02/$0.05) - 2023/12/22 21:14:56
Table 'RushAndCash782275' 6-max Seat #1 is the button
Seat 1: 29b0f5be ($5 in chips)
Seat 2: 3b6e2f77 ($5.35 in chips)
Seat 3: bada497e ($5 in chips)
Seat 4: Hero ($9.8 in chips)
Seat 5: c7592cbf ($11.88 in chips)
Seat 6: 4c81be2e ($9.12 in chips)
3b6e2f77: posts small blind $0.02
bada497e: posts big blind $0.05
*** HOLE CARDS ***
Dealt to 29b0f5be 
Dealt to 3b6e2f77 
Dealt to bada497e 
Dealt to Hero [3s 2s]
Dealt to c7592cbf 
Dealt to 4c81be2e 
Hero: folds
c7592cbf: folds
4c81be2e: folds
29b0f5be: raises $0.07 to $0.12
3b6e2f77: folds
bada497e: calls $0.07
*** FLOP *** [5c 4c 7s]
bada497e: checks
29b0f5be: bets $0.09
bada497e: folds
Uncalled bet ($0.09) returned to 29b0f5be
*** SHOWDOWN ***
29b0f5be collected $0.25 from pot
*** SUMMARY ***
Total pot $0.26 | Rake $0.01 | Jackpot $0 | Bingo $0 | Fortune $0 | Tax $0
Board [5c 4c 7s]
Seat 1: 29b0f5be (button) won ($0.25)
Seat 2: 3b6e2f77 (small blind) folded before Flop
Seat 3: bada497e (big blind) folded on the Flop
Seat 4: Hero folded before Flop (didn't bet)
Seat 5: c7592cbf folded before Flop (didn't bet)
Seat 6: 4c81be2e folded before Flop (didn't bet)


Poker Hand #RC2078453379: Hold'em No Limit ($0.02/$0.05) - 2023/12/22 21:14:46
Table 'RushAndCash782203' 6-max Seat #1 is the button
Seat 1: f9c6a467 ($21.93 in chips)
Seat 2: 189da7f1 ($11.29 in chips)
Seat 3: 89988cd9 ($5.22 in chips)
Seat 4: deb68c7a ($5.12 in chips)
Seat 5: Hero ($9.8 in chips)
Seat 6: 5a6bcca5 ($10.66 in chips)
189da7f1: posts small blind $0.02
89988cd9: posts big blind $0.05
*** HOLE CARDS ***
Dealt to f9c6a467 
Dealt to 189da7f1 
Dealt to 89988cd9 
Dealt to deb68c7a 
Dealt to Hero [5s Qs]
Dealt to 5a6bcca5 
deb68c7a: folds
Hero: folds
5a6bcca5: folds
f9c6a467: folds
189da7f1: calls $0.03
89988cd9: checks
*** FLOP *** [5d 7s Ah]
189da7f1: bets $0.1
89988cd9: folds
Uncalled bet ($0.1) returned to 189da7f1
*** SHOWDOWN ***
189da7f1 collected $0.1 from pot
*** SUMMARY ***
Total pot $0.1 | Rake $0 | Jackpot $0 | Bingo $0 | Fortune $0 | Tax $0
Board [5d 7s Ah]
Seat 1: f9c6a467 (button) folded before Flop (didn't bet)
Seat 2: 189da7f1 (small blind) won ($0.1)
Seat 3: 89988cd9 (big blind) folded on the Flop
Seat 4: deb68c7a folded before Flop (didn't bet)
Seat 5: Hero folded before Flop (didn't bet)
Seat 6: 5a6bcca5 folded before Flop (didn't bet)


Poker Hand #RC2078453245: Hold'em No Limit ($0.02/$0.05) - 2023/12/22 21:14:38
Table 'RushAndCash782137' 6-max Seat #1 is the button
Seat 1: a9b1bcec ($4.82 in chips)
Seat 2: Hero ($9.82 in chips)
Seat 3: 2f160a64 ($5 in chips)
Seat 4: e4d2f8b7 ($5 in chips)
Seat 5: 44231a0a ($16.49 in chips)
Seat 6: 3580bebf ($14.97 in chips)
Hero: posts small blind $0.02
2f160a64: posts big blind $0.05
*** HOLE CARDS ***
Dealt to a9b1bcec 
Dealt to Hero [6s 9c]
Dealt to 2f160a64 
Dealt to e4d2f8b7 
Dealt to 44231a0a 
Dealt to 3580bebf 
e4d2f8b7: folds
44231a0a: folds
3580bebf: raises $0.08 to $0.13
a9b1bcec: folds
Hero: folds
2f160a64: calls $0.08
*** FLOP *** [Kh 6d 5d]
2f160a64: bets $0.1
3580bebf: folds
Uncalled bet ($0.1) returned to 2f160a64
*** SHOWDOWN ***
2f160a64 collected $0.27 from pot
*** SUMMARY ***
Total pot $0.28 | Rake $0.01 | Jackpot $0 | Bingo $0 | Fortune $0 | Tax $0
Board [Kh 6d 5d]
Seat 1: a9b1bcec (button) folded before Flop (didn't bet)
Seat 2: Hero (small blind) folded before Flop
Seat 3: 2f160a64 (big blind) won ($0.27)
Seat 4: e4d2f8b7 folded before Flop (didn't bet)
Seat 5: 44231a0a folded before Flop (didn't bet)
Seat 6: 3580bebf folded on the Flop


Poker Hand #RC2078453169: Hold'em No Limit ($0.02/$0.05) - 2023/12/22 21:14:33
Table 'RushAndCash782101' 6-max Seat #1 is the button
Seat 1: 19d300cc ($5.77 in chips)
Seat 2: 9e4b1c03 ($5.11 in chips)
Seat 3: 9b2d2337 ($19.93 in chips)
Seat 4: 4b60b73d ($5.3 in chips)
Seat 5: 8f80311 ($1.5 in chips)
Seat 6: Hero ($9.82 in chips)
9e4b1c03: posts small blind $0.02
9b2d2337: posts big blind $0.05
*** HOLE CARDS ***
Dealt to 19d300cc 
Dealt to 9e4b1c03 
Dealt to 9b2d2337 
Dealt to 4b60b73d 
Dealt to 8f80311 
Dealt to Hero [2s Ad]
4b60b73d: folds
8f80311: folds
Hero: folds
19d300cc: folds
9e4b1c03: folds
Uncalled bet ($0.03) returned to 9b2d2337
*** SHOWDOWN ***
9b2d2337 collected $0.04 from pot
*** SUMMARY ***
Total pot $0.04 | Rake $0 | Jackpot $0 | Bingo $0 | Fortune $0 | Tax $0
Seat 1: 19d300cc (button) folded before Flop (didn't bet)
Seat 2: 9e4b1c03 (small blind) folded before Flop
Seat 3: 9b2d2337 (big blind) collected ($0.04)
Seat 4: 4b60b73d folded before Flop (didn't bet)
Seat 5: 8f80311 folded before Flop (didn't bet)
Seat 6: Hero folded before Flop (didn't bet)


Poker Hand #RC2078453107: Hold'em No Limit ($0.02/$0.05) - 2023/12/22 21:14:30
Table 'RushAndCash782070' 6-max Seat #1 is the button
Seat 1: e8886428 ($35.25 in chips)
Seat 2: af1e12c2 ($5 in chips)
Seat 3: 175b9638 ($6.4 in chips)
Seat 4: 9d4c1c85 ($5.85 in chips)
Seat 5: Hero ($9.82 in chips)
Seat 6: 816eac8 ($4.62 in chips)
af1e12c2: posts small blind $0.02
175b9638: posts big blind $0.05
*** HOLE CARDS ***
Dealt to e8886428 
Dealt to af1e12c2 
Dealt to 175b9638 
Dealt to 9d4c1c85 
Dealt to Hero [6c Js]
Dealt to 816eac8 
9d4c1c85: folds
Hero: folds
816eac8: folds
e8886428: raises $0.06 to $0.11
af1e12c2: raises $0.21 to $0.32
175b9638: calls $0.27
e8886428: folds
*** FLOP *** [2h Jd Td]
af1e12c2: bets $0.43
175b9638: folds
Uncalled bet ($0.43) returned to af1e12c2
*** SHOWDOWN ***
af1e12c2 collected $0.72 from pot
*** SUMMARY ***
Total pot $0.75 | Rake $0.03 | Jackpot $0 | Bingo $0 | Fortune $0 | Tax $0
Board [2h Jd Td]
Seat 1: e8886428 (button) folded before Flop
Seat 2: af1e12c2 (small blind) won ($0.72)
Seat 3: 175b9638 (big blind) folded on the Flop
Seat 4: 9d4c1c85 folded before Flop (didn't bet)
Seat 5: Hero folded before Flop (didn't bet)
Seat 6: 816eac8 folded before Flop (didn't bet)


Poker Hand #RC2078453045: Hold'em No Limit ($0.02/$0.05) - 2023/12/22 21:14:26
Table 'RushAndCash782040' 6-max Seat #1 is the button
Seat 1: c0a415e7 ($2.85 in chips)
Seat 2: bc118b95 ($5.18 in chips)
Seat 3: Hero ($9.87 in chips)
Seat 4: 5d55167a ($10.07 in chips)
Seat 5: 8ced9a44 ($5.97 in chips)
Seat 6: d0ea92a4 ($5.82 in chips)
bc118b95: posts small blind $0.02
Hero: posts big blind $0.05
*** HOLE CARDS ***
Dealt to c0a415e7 
Dealt to bc118b95 
Dealt to Hero [6h 9c]
Dealt to 5d55167a 
Dealt to 8ced9a44 
Dealt to d0ea92a4 
5d55167a: folds
8ced9a44: folds
d0ea92a4: raises $0.07 to $0.12
c0a415e7: folds
bc118b95: folds
Hero: folds
Uncalled bet ($0.07) returned to d0ea92a4
*** SHOWDOWN ***
d0ea92a4 collected $0.12 from pot
*** SUMMARY ***
Total pot $0.12 | Rake $0 | Jackpot $0 | Bingo $0 | Fortune $0 | Tax $0
Seat 1: c0a415e7 (button) folded before Flop (didn't bet)
Seat 2: bc118b95 (small blind) folded before Flop
Seat 3: Hero (big blind) folded before Flop
Seat 4: 5d55167a folded before Flop (didn't bet)
Seat 5: 8ced9a44 folded before Flop (didn't bet)
Seat 6: d0ea92a4 collected ($0.12)


Poker Hand #RC2078452988: Hold'em No Limit ($0.02/$0.05) - 2023/12/22 21:14:23
Table 'RushAndCash782015' 6-max Seat #1 is the button
Seat 1: a7286848 ($5.08 in chips)
Seat 2: 29b0f5be ($5 in chips)
Seat 3: 6e872e9c ($19.44 in chips)
Seat 4: 8ced9a44 ($5.97 in chips)
Seat 5: Hero ($9.87 in chips)
Seat 6: 2d4acc60 ($2.14 in chips)
29b0f5be: posts small blind $0.02
6e872e9c: posts big blind $0.05
*** HOLE CARDS ***
Dealt to a7286848 
Dealt to 29b0f5be 
Dealt to 6e872e9c 
Dealt to 8ced9a44 
Dealt to Hero [6c 2s]
Dealt to 2d4acc60 
8ced9a44: folds
Hero: folds
2d4acc60: folds
a7286848: folds
29b0f5be: folds
Uncalled bet ($0.03) returned to 6e872e9c
*** SHOWDOWN ***
6e872e9c collected $0.04 from pot
*** SUMMARY ***
Total pot $0.04 | Rake $0 | Jackpot $0 | Bingo $0 | Fortune $0 | Tax $0
Seat 1: a7286848 (button) folded before Flop (didn't bet)
Seat 2: 29b0f5be (small blind) folded before Flop
Seat 3: 6e872e9c (big blind) collected ($0.04)
Seat 4: 8ced9a44 folded before Flop (didn't bet)
Seat 5: Hero folded before Flop (didn't bet)
Seat 6: 2d4acc60 folded before Flop (didn't bet)


Poker Hand #RC2078452901: Hold'em No Limit ($0.02/$0.05) - 2023/12/22 21:14:18
Table 'RushAndCash781971' 6-max Seat #1 is the button
Seat 1: Hero ($9.87 in chips)
Seat 2: c0a415e7 ($2.87 in chips)
Seat 3: aed2a4dc ($5.45 in chips)
Seat 4: 40c4a4f ($10.68 in chips)
Seat 5: ee21e88c ($6.42 in chips)
Seat 6: 59846dec ($2.83 in chips)
c0a415e7: posts small blind $0.02
aed2a4dc: posts big blind $0.05
*** HOLE CARDS ***
Dealt to Hero [Td 8h]
Dealt to c0a415e7 
Dealt to aed2a4dc 
Dealt to 40c4a4f 
Dealt to ee21e88c 
Dealt to 59846dec 
40c4a4f: folds
ee21e88c: folds
59846dec: raises $0.1 to $0.15
Hero: folds
c0a415e7: folds
aed2a4dc: folds
Uncalled bet ($0.1) returned to 59846dec
*** SHOWDOWN ***
59846dec collected $0.12 from pot
*** SUMMARY ***
Total pot $0.12 | Rake $0 | Jackpot $0 | Bingo $0 | Fortune $0 | Tax $0
Seat 1: Hero (button) folded before Flop (didn't bet)
Seat 2: c0a415e7 (small blind) folded before Flop
Seat 3: aed2a4dc (big blind) folded before Flop
Seat 4: 40c4a4f folded before Flop (didn't bet)
Seat 5: ee21e88c folded before Flop (didn't bet)
Seat 6: 59846dec collected ($0.12)


Poker Hand #RC2078452597: Hold'em No Limit ($0.02/$0.05) - 2023/12/22 21:14:01
Table 'RushAndCash781823' 6-max Seat #1 is the button
Seat 1: 2880461b ($5.07 in chips)
Seat 2: aa356882 ($3.89 in chips)
Seat 3: Hero ($9.92 in chips)
Seat 4: 25f07be0 ($5.24 in chips)
Seat 5: cb9a7609 ($5.09 in chips)
Seat 6: 7f067c94 ($42.59 in chips)
aa356882: posts small blind $0.02
Hero: posts big blind $0.05
*** HOLE CARDS ***
Dealt to 2880461b 
Dealt to aa356882 
Dealt to Hero [8s 4c]
Dealt to 25f07be0 
Dealt to cb9a7609 
Dealt to 7f067c94 
25f07be0: folds
cb9a7609: folds
7f067c94: folds
2880461b: folds
aa356882: calls $0.03
Hero: checks
*** FLOP *** [5c Kh 3d]
aa356882: bets $0.06
Hero: folds
Uncalled bet ($0.06) returned to aa356882
*** SHOWDOWN ***
aa356882 collected $0.1 from pot
*** SUMMARY ***
Total pot $0.1 | Rake $0 | Jackpot $0 | Bingo $0 | Fortune $0 | Tax $0
Board [5c Kh 3d]
Seat 1: 2880461b (button) folded before Flop (didn't bet)
Seat 2: aa356882 (small blind) won ($0.1)
Seat 3: Hero (big blind) folded on the Flop
Seat 4: 25f07be0 folded before Flop (didn't bet)
Seat 5: cb9a7609 folded before Flop (didn't bet)
Seat 6: 7f067c94 folded before Flop (didn't bet)


Poker Hand #RC2078452534: Hold'em No Limit ($0.02/$0.05) - 2023/12/22 21:13:58
Table 'RushAndCash781793' 6-max Seat #1 is the button
Seat 1: Hero ($9.92 in chips)
Seat 2: ec80eef8 ($4.93 in chips)
Seat 3: 1db9c453 ($5.58 in chips)
Seat 4: 875f34a0 ($19.11 in chips)
Seat 5: d2e52b8d ($19.96 in chips)
Seat 6: b95e9d10 ($5.07 in chips)
ec80eef8: posts small blind $0.02
1db9c453: posts big blind $0.05
*** HOLE CARDS ***
Dealt to Hero [Qs 4s]
Dealt to ec80eef8 
Dealt to 1db9c453 
Dealt to 875f34a0 
Dealt to d2e52b8d 
Dealt to b95e9d10 
875f34a0: folds
d2e52b8d: folds
b95e9d10: folds
Hero: folds
ec80eef8: raises $0.1 to $0.15
1db9c453: folds
Uncalled bet ($0.1) returned to ec80eef8
*** SHOWDOWN ***
ec80eef8 collected $0.1 from pot
*** SUMMARY ***
Total pot $0.1 | Rake $0 | Jackpot $0 | Bingo $0 | Fortune $0 | Tax $0
Seat 1: Hero (button) folded before Flop (didn't bet)
Seat 2: ec80eef8 (small blind) collected ($0.1)
Seat 3: 1db9c453 (big blind) folded before Flop
Seat 4: 875f34a0 folded before Flop (didn't bet)
Seat 5: d2e52b8d folded before Flop (didn't bet)
Seat 6: b95e9d10 folded before Flop (didn't bet)


Poker Hand #RC2078451530: Hold'em No Limit ($0.02/$0.05) - 2023/12/22 21:12:59
Table 'RushAndCash781305' 6-max Seat #1 is the button
Seat 1: 7424db9 ($2.24 in chips)
Seat 2: Hero ($5.07 in chips)
Seat 3: fc6fcf04 ($6.02 in chips)
Seat 4: 64a4f489 ($5 in chips)
Seat 5: 983d74a ($7.31 in chips)
Seat 6: 469c47cc ($4.96 in chips)
Hero: posts small blind $0.02
fc6fcf04: posts big blind $0.05
*** HOLE CARDS ***
Dealt to 7424db9 
Dealt to Hero [As Kd]
Dealt to fc6fcf04 
Dealt to 64a4f489 
Dealt to 983d74a 
Dealt to 469c47cc 
64a4f489: folds
983d74a: folds
469c47cc: folds
7424db9: folds
Hero: raises $0.1 to $0.15
fc6fcf04: raises $0.3 to $0.45
Hero: calls $0.3
*** FLOP *** [Ks 3d Ah]
Hero: checks
fc6fcf04: bets $0.9
Hero: calls $0.9
*** TURN *** [Ks 3d Ah] [9s]
Hero: checks
fc6fcf04: bets $2.7
Hero: raises $1.02 to $3.72 and is all-in
fc6fcf04: calls $1.02
Hero: shows [As Kd] (Pair of Aces and Pair of Kings)
fc6fcf04: shows [5s Ts] (Ace-High)
*** RIVER *** [Ks 3d Ah 9s] [4h]
*** SHOWDOWN ***
Hero collected $9.92 from pot
*** SUMMARY ***
Total pot $10.14 | Rake $0.15 | Jackpot $0.07 | Bingo $0 | Fortune $0 | Tax $0
Board [Ks 3d Ah 9s 4h]
Seat 1: 7424db9 (button) folded before Flop (didn't bet)
Seat 2: Hero (small blind) showed [As Kd] and won ($9.92) with Pair of Aces and Pair of Kings
Seat 3: fc6fcf04 (big blind) showed [5s Ts] and lost with Ace-High
Seat 4: 64a4f489 folded before Flop (didn't bet)
Seat 5: 983d74a folded before Flop (didn't bet)
Seat 6: 469c47cc folded before Flop (didn't bet)


Poker Hand #RC2078451446: Hold'em No Limit ($0.02/$0.05) - 2023/12/22 21:12:54
Table 'RushAndCash781266' 6-max Seat #1 is the button
Seat 1: 1e3d103d ($5.56 in chips)
Seat 2: e7562cd9 ($8.54 in chips)
Seat 3: e44205f6 ($6.1 in chips)
Seat 4: 4a2f512 ($2.08 in chips)
Seat 5: 54daf47b ($9.6 in chips)
Seat 6: Hero ($5.07 in chips)
e7562cd9: posts small blind $0.02
e44205f6: posts big blind $0.05
*** HOLE CARDS ***
Dealt to 1e3d103d 
Dealt to e7562cd9 
Dealt to e44205f6 
Dealt to 4a2f512 
Dealt to 54daf47b 
Dealt to Hero [9c Ts]
4a2f512: folds
54daf47b: folds
Hero: folds
1e3d103d: folds
e7562cd9: raises $0.1 to $0.15
e44205f6: calls $0.1
*** FLOP *** [Qd 3h Qs]
e7562cd9: checks
e44205f6: bets $0.1
e7562cd9: folds
Uncalled bet ($0.1) returned to e44205f6
*** SHOWDOWN ***
e44205f6 collected $0.29 from pot
*** SUMMARY ***
Total pot $0.3 | Rake $0.01 | Jackpot $0 | Bingo $0 | Fortune $0 | Tax $0
Board [Qd 3h Qs]
Seat 1: 1e3d103d (button) folded before Flop (didn't bet)
Seat 2: e7562cd9 (small blind) folded on the Flop
Seat 3: e44205f6 (big blind) won ($0.29)
Seat 4: 4a2f512 folded before Flop (didn't bet)
Seat 5: 54daf47b folded before Flop (didn't bet)
Seat 6: Hero folded before Flop (didn't bet)


Poker Hand #RC2078451391: Hold'em No Limit ($0.02/$0.05) - 2023/12/22 21:12:51
Table 'RushAndCash781241' 6-max Seat #1 is the button
Seat 1: 53d2996c ($13.15 in chips)
Seat 2: 72f7386e ($10.67 in chips)
Seat 3: 8e52c782 ($5.93 in chips)
Seat 4: Hero ($5.07 in chips)
Seat 5: 4a2f512 ($2.08 in chips)
Seat 6: 561e5b01 ($5 in chips)
72f7386e: posts small blind $0.02
8e52c782: posts big blind $0.05
*** HOLE CARDS ***
Dealt to 53d2996c 
Dealt to 72f7386e 
Dealt to 8e52c782 
Dealt to Hero [2h 8s]
Dealt to 4a2f512 
Dealt to 561e5b01 
Hero: folds
4a2f512: folds
561e5b01: folds
53d2996c: folds
72f7386e: folds
Uncalled bet ($0.03) returned to 8e52c782
*** SHOWDOWN ***
8e52c782 collected $0.04 from pot
*** SUMMARY ***
Total pot $0.04 | Rake $0 | Jackpot $0 | Bingo $0 | Fortune $0 | Tax $0
Seat 1: 53d2996c (button) folded before Flop (didn't bet)
Seat 2: 72f7386e (small blind) folded before Flop
Seat 3: 8e52c782 (big blind) collected ($0.04)
Seat 4: Hero folded before Flop (didn't bet)
Seat 5: 4a2f512 folded before Flop (didn't bet)
Seat 6: 561e5b01 folded before Flop (didn't bet)


Poker Hand #RC2078451070: Hold'em No Limit ($0.02/$0.05) - 2023/12/22 21:12:31
Table 'RushAndCash781088' 6-max Seat #1 is the button
Seat 1: e8df5901 ($7.01 in chips)
Seat 2: ebeb62f7 ($4.96 in chips)
Seat 3: 913692c3 ($6.41 in chips)
Seat 4: Hero ($5 in chips)
Seat 5: 1adb19a8 ($5.01 in chips)
Seat 6: 23d318c4 ($5 in chips)
ebeb62f7: posts small blind $0.02
913692c3: posts big blind $0.05
*** HOLE CARDS ***
Dealt to e8df5901 
Dealt to ebeb62f7 
Dealt to 913692c3 
Dealt to Hero [7c 7s]
Dealt to 1adb19a8 
Dealt to 23d318c4 
Hero: raises $0.05 to $0.1
1adb19a8: folds
23d318c4: folds
e8df5901: folds
ebeb62f7: folds
913692c3: folds
Uncalled bet ($0.05) returned to Hero
*** SHOWDOWN ***
Hero collected $0.12 from pot
*** SUMMARY ***
Total pot $0.12 | Rake $0 | Jackpot $0 | Bingo $0 | Fortune $0 | Tax $0
Seat 1: e8df5901 (button) folded before Flop (didn't bet)
Seat 2: ebeb62f7 (small blind) folded before Flop
Seat 3: 913692c3 (big blind) folded before Flop
Seat 4: Hero collected ($0.12)
Seat 5: 1adb19a8 folded before Flop (didn't bet)
Seat 6: 23d318c4 folded before Flop (didn't bet)


Poker Hand #RC2078450601: Hold'em No Limit ($0.02/$0.05) - 2023/12/22 21:12:05
Table 'RushAndCash780878' 6-max Seat #1 is the button
Seat 1: 98471e80 ($5.77 in chips)
Seat 2: d71ab80c ($7.32 in chips)
Seat 3: Hero ($5.07 in chips)
Seat 4: 71871718 ($2.31 in chips)
Seat 5: 76ead301 ($5 in chips)
Seat 6: edb6154b ($5 in chips)
d71ab80c: posts small blind $0.02
Hero: posts big blind $0.05
*** HOLE CARDS ***
Dealt to 98471e80 
Dealt to d71ab80c 
Dealt to Hero [2c 2s]
Dealt to 71871718 
Dealt to 76ead301 
Dealt to edb6154b 
71871718: raises $0.1 to $0.15
76ead301: folds
edb6154b: folds
98471e80: folds
d71ab80c: folds
Hero: calls $0.1
*** FLOP *** [Td Jd 6h]
Hero: checks
71871718: bets $0.3
Hero: folds
Uncalled bet ($0.3) returned to 71871718
*** SHOWDOWN ***
71871718 collected $0.31 from pot
*** SUMMARY ***
Total pot $0.32 | Rake $0.01 | Jackpot $0 | Bingo $0 | Fortune $0 | Tax $0
Board [Td Jd 6h]
Seat 1: 98471e80 (button) folded before Flop (didn't bet)
Seat 2: d71ab80c (small blind) folded before Flop
Seat 3: Hero (big blind) folded on the Flop
Seat 4: 71871718 won ($0.31)
Seat 5: 76ead301 folded before Flop (didn't bet)
Seat 6: edb6154b folded before Flop (didn't bet)


Poker Hand #RC2078450386: Hold'em No Limit ($0.02/$0.05) - 2023/12/22 21:11:52
Table 'RushAndCash780777' 6-max Seat #1 is the button
Seat 1: 5692960b ($3.39 in chips)
Seat 2: ce5771af ($3.93 in chips)
Seat 3: 11a726d0 ($6.2 in chips)
Seat 4: 6bd97a49 ($12.03 in chips)
Seat 5: 803de95b ($5 in chips)
Seat 6: Hero ($5 in chips)
ce5771af: posts small blind $0.02
11a726d0: posts big blind $0.05
*** HOLE CARDS ***
Dealt to 5692960b 
Dealt to ce5771af 
Dealt to 11a726d0 
Dealt to 6bd97a49 
Dealt to 803de95b 
Dealt to Hero [Kd 4d]
6bd97a49: folds
803de95b: folds
Hero: raises $0.05 to $0.1
5692960b: folds
ce5771af: folds
11a726d0: folds
Uncalled bet ($0.05) returned to Hero
*** SHOWDOWN ***
Hero collected $0.12 from pot
*** SUMMARY ***
Total pot $0.12 | Rake $0 | Jackpot $0 | Bingo $0 | Fortune $0 | Tax $0
Seat 1: 5692960b (button) folded before Flop (didn't bet)
Seat 2: ce5771af (small blind) folded before Flop
Seat 3: 11a726d0 (big blind) folded before Flop
Seat 4: 6bd97a49 folded before Flop (didn't bet)
Seat 5: 803de95b folded before Flop (didn't bet)
Seat 6: Hero collected ($0.12)


Poker Hand #RC2078450226: Hold'em No Limit ($0.02/$0.05) - 2023/12/22 21:11:43
Table 'RushAndCash780695' 6-max Seat #1 is the button
Seat 1: adc999b ($10.37 in chips)
Seat 2: Hero ($5 in chips)
Seat 3: 2cae9604 ($6.31 in chips)
Seat 4: 983d74a ($6.45 in chips)
Seat 5: 23a63651 ($20.28 in chips)
Seat 6: 5c16c35c ($11.15 in chips)
Hero: posts small blind $0.02
2cae9604: posts big blind $0.05
*** HOLE CARDS ***
Dealt to adc999b 
Dealt to Hero [3d Qh]
Dealt to 2cae9604 
Dealt to 983d74a 
Dealt to 23a63651 
Dealt to 5c16c35c 
983d74a: folds
23a63651: folds
5c16c35c: folds
adc999b: raises $0.05 to $0.1
Hero: folds
2cae9604: calls $0.05
*** FLOP *** [6s Tc 2c]
2cae9604: bets $0.11
adc999b: folds
Uncalled bet ($0.11) returned to 2cae9604
*** SHOWDOWN ***
2cae9604 collected $0.21 from pot
*** SUMMARY ***
Total pot $0.22 | Rake $0.01 | Jackpot $0 | Bingo $0 | Fortune $0 | Tax $0
Board [6s Tc 2c]
Seat 1: adc999b (button) folded on the Flop
Seat 2: Hero (small blind) folded before Flop
Seat 3: 2cae9604 (big blind) won ($0.21)
Seat 4: 983d74a folded before Flop (didn't bet)
Seat 5: 23a63651 folded before Flop (didn't bet)
Seat 6: 5c16c35c folded before Flop (didn't bet)


Poker Hand #RC2078450165: Hold'em No Limit ($0.02/$0.05) - 2023/12/22 21:11:40
Table 'RushAndCash780666' 6-max Seat #1 is the button
Seat 1: Hero ($5 in chips)
Seat 2: 74bf44f1 ($5.95 in chips)
Seat 3: 3b613695 ($9.59 in chips)
Seat 4: 1adb19a8 ($5.13 in chips)
Seat 5: a4c64da ($11.12 in chips)
Seat 6: 21073025 ($19.86 in chips)
74bf44f1: posts small blind $0.02
3b613695: posts big blind $0.05
*** HOLE CARDS ***
Dealt to Hero [Ad 6s]
Dealt to 74bf44f1 
Dealt to 3b613695 
Dealt to 1adb19a8 
Dealt to a4c64da 
Dealt to 21073025 
1adb19a8: folds
a4c64da: folds
21073025: raises $0.06 to $0.11
Hero: folds
74bf44f1: raises $0.44 to $0.55
3b613695: folds
21073025: folds
Uncalled bet ($0.44) returned to 74bf44f1
*** SHOWDOWN ***
74bf44f1 collected $0.26 from pot
*** SUMMARY ***
Total pot $0.27 | Rake $0.01 | Jackpot $0 | Bingo $0 | Fortune $0 | Tax $0
Seat 1: Hero (button) folded before Flop (didn't bet)
Seat 2: 74bf44f1 (small blind) collected ($0.26)
Seat 3: 3b613695 (big blind) folded before Flop
Seat 4: 1adb19a8 folded before Flop (didn't bet)
Seat 5: a4c64da folded before Flop (didn't bet)
Seat 6: 21073025 folded before Flop


Poker Hand #RC2078450087: Hold'em No Limit ($0.02/$0.05) - 2023/12/22 21:11:36
Table 'RushAndCash780627' 6-max Seat #1 is the button
Seat 1: d6c4e270 ($2.98 in chips)
Seat 2: 8b0c9357 ($5.34 in chips)
Seat 3: 9aad1596 ($7.38 in chips)
Seat 4: Hero ($5 in chips)
Seat 5: 3b87467 ($7.27 in chips)
Seat 6: c54f63b8 ($5.06 in chips)
8b0c9357: posts small blind $0.02
9aad1596: posts big blind $0.05
*** HOLE CARDS ***
Dealt to d6c4e270 
Dealt to 8b0c9357 
Dealt to 9aad1596 
Dealt to Hero [Kd 7s]
Dealt to 3b87467 
Dealt to c54f63b8 
Hero: folds
3b87467: folds
c54f63b8: folds
d6c4e270: folds
8b0c9357: folds
Uncalled bet ($0.03) returned to 9aad1596
*** SHOWDOWN ***
9aad1596 collected $0.04 from pot
*** SUMMARY ***
Total pot $0.04 | Rake $0 | Jackpot $0 | Bingo $0 | Fortune $0 | Tax $0
Seat 1: d6c4e270 (button) folded before Flop (didn't bet)
Seat 2: 8b0c9357 (small blind) folded before Flop
Seat 3: 9aad1596 (big blind) collected ($0.04)
Seat 4: Hero folded before Flop (didn't bet)
Seat 5: 3b87467 folded before Flop (didn't bet)
Seat 6: c54f63b8 folded before Flop (didn't bet)


Poker Hand #RC2078450026: Hold'em No Limit ($0.02/$0.05) - 2023/12/22 21:11:32
Table 'RushAndCash780598' 6-max Seat #1 is the button
Seat 1: 6c94c615 ($5.25 in chips)
Seat 2: 94b80c38 ($1.41 in chips)
Seat 3: 8505bab2 ($5.69 in chips)
Seat 4: 494d7c43 ($5.58 in chips)
Seat 5: Hero ($5 in chips)
Seat 6: 3f112fc ($7.07 in chips)
94b80c38: posts small blind $0.02
8505bab2: posts big blind $0.05
*** HOLE CARDS ***
Dealt to 6c94c615 
Dealt to 94b80c38 
Dealt to 8505bab2 
Dealt to 494d7c43 
Dealt to Hero [6s 7s]
Dealt to 3f112fc 
494d7c43: folds
Hero: folds
3f112fc: folds
6c94c615: raises $0.08 to $0.13
94b80c38: raises $0.35 to $0.48
8505bab2: folds
6c94c615: folds
Uncalled bet ($0.35) returned to 94b80c38
*** SHOWDOWN ***
94b80c38 collected $0.3 from pot
*** SUMMARY ***
Total pot $0.31 | Rake $0.01 | Jackpot $0 | Bingo $0 | Fortune $0 | Tax $0
Seat 1: 6c94c615 (button) folded before Flop
Seat 2: 94b80c38 (small blind) collected ($0.3)
Seat 3: 8505bab2 (big blind) folded before Flop
Seat 4: 494d7c43 folded before Flop (didn't bet)
Seat 5: Hero folded before Flop (didn't bet)
Seat 6: 3f112fc folded before Flop (didn't bet)


Poker Hand #RC2078449945: Hold'em No Limit ($0.02/$0.05) - 2023/12/22 21:11:27
Table 'RushAndCash780560' 6-max Seat #1 is the button
Seat 1: 68c6c5e7 ($14.24 in chips)
Seat 2: dce31b8a ($5.93 in chips)
Seat 3: a0ef5108 ($5.54 in chips)
Seat 4: 175b9638 ($7.16 in chips)
Seat 5: e3579d61 ($5.26 in chips)
Seat 6: Hero ($5 in chips)
dce31b8a: posts small blind $0.02
a0ef5108: posts big blind $0.05
*** HOLE CARDS ***
Dealt to 68c6c5e7 
Dealt to dce31b8a 
Dealt to a0ef5108 
Dealt to 175b9638 
Dealt to e3579d61 
Dealt to Hero [5h Kc]
175b9638: folds
e3579d61: folds
Hero: folds
68c6c5e7: raises $0.05 to $0.1
dce31b8a: folds
a0ef5108: folds
Uncalled bet ($0.05) returned to 68c6c5e7
*** SHOWDOWN ***
68c6c5e7 collected $0.12 from pot
*** SUMMARY ***
Total pot $0.12 | Rake $0 | Jackpot $0 | Bingo $0 | Fortune $0 | Tax $0
Seat 1: 68c6c5e7 (button) collected ($0.12)
Seat 2: dce31b8a (small blind) folded before Flop
Seat 3: a0ef5108 (big blind) folded before Flop
Seat 4: 175b9638 folded before Flop (didn't bet)
Seat 5: e3579d61 folded before Flop (didn't bet)
Seat 6: Hero folded before Flop (didn't bet)


Poker Hand #RC2078449889: Hold'em No Limit ($0.02/$0.05) - 2023/12/22 21:11:24
Table 'RushAndCash780537' 6-max Seat #1 is the button
Seat 1: cb16bb03 ($5 in chips)
Seat 2: d6c4e270 ($3 in chips)
Seat 3: 3c028e9 ($5.71 in chips)
Seat 4: 5d55167a ($8.92 in chips)
Seat 5: Hero ($5 in chips)
Seat 6: 6e872e9c ($19.75 in chips)
d6c4e270: posts small blind $0.02
3c028e9: posts big blind $0.05
*** HOLE CARDS ***
Dealt to cb16bb03 
Dealt to d6c4e270 
Dealt to 3c028e9 
Dealt to 5d55167a 
Dealt to Hero [Qc 9h]
Dealt to 6e872e9c 
5d55167a: raises $0.05 to $0.1
Hero: folds
6e872e9c: folds
cb16bb03: raises $0.32 to $0.42
d6c4e270: folds
3c028e9: folds
5d55167a: folds
Uncalled bet ($0.32) returned to cb16bb03
*** SHOWDOWN ***
cb16bb03 collected $0.26 from pot
*** SUMMARY ***
Total pot $0.27 | Rake $0.01 | Jackpot $0 | Bingo $0 | Fortune $0 | Tax $0
Seat 1: cb16bb03 (button) collected ($0.26)
Seat 2: d6c4e270 (small blind) folded before Flop
Seat 3: 3c028e9 (big blind) folded before Flop
Seat 4: 5d55167a folded before Flop
Seat 5: Hero folded before Flop (didn't bet)
Seat 6: 6e872e9c folded before Flop (didn't bet)


Poker Hand #RC2078449803: Hold'em No Limit ($0.02/$0.05) - 2023/12/22 21:11:19
Table 'RushAndCash780495' 6-max Seat #1 is the button
Seat 1: be335909 ($5.99 in chips)
Seat 2: e734080a ($14.46 in chips)
Seat 3: 517da49 ($5 in chips)
Seat 4: fb772588 ($4.6 in chips)
Seat 5: d32741ba ($10.83 in chips)
Seat 6: Hero ($5 in chips)
e734080a: posts small blind $0.02
517da49: posts big blind $0.05
*** HOLE CARDS ***
Dealt to be335909 
Dealt to e734080a 
Dealt to 517da49 
Dealt to fb772588 
Dealt to d32741ba 
Dealt to Hero [7s 3c]
fb772588: raises $0.1 to $0.15
d32741ba: folds
Hero: folds
be335909: folds
e734080a: folds
517da49: calls $0.1
*** FLOP *** [9s 6s 8c]
517da49: checks
fb772588: bets $0.24
517da49: folds
Uncalled bet ($0.24) returned to fb772588
*** SHOWDOWN ***
fb772588 collected $0.31 from pot
*** SUMMARY ***
Total pot $0.32 | Rake $0.01 | Jackpot $0 | Bingo $0 | Fortune $0 | Tax $0
Board [9s 6s 8c]
Seat 1: be335909 (button) folded before Flop (didn't bet)
Seat 2: e734080a (small blind) folded before Flop
Seat 3: 517da49 (big blind) folded on the Flop
Seat 4: fb772588 won ($0.31)
Seat 5: d32741ba folded before Flop (didn't bet)
Seat 6: Hero folded before Flop (didn't bet)


Poker Hand #RC2078449740: Hold'em No Limit ($0.02/$0.05) - 2023/12/22 21:11:15
Table 'RushAndCash780465' 6-max Seat #1 is the button
Seat 1: 40c4a4f ($11.36 in chips)
Seat 2: Hero ($5 in chips)
Seat 3: 45392e2c ($17.45 in chips)
Seat 4: d1ed32e9 ($5.11 in chips)
Seat 5: 2d4acc60 ($2.17 in chips)
Seat 6: 271c38e0 ($5.95 in chips)
Hero: posts small blind $0.02
45392e2c: posts big blind $0.05
*** HOLE CARDS ***
Dealt to 40c4a4f 
Dealt to Hero [9s Jc]
Dealt to 45392e2c 
Dealt to d1ed32e9 
Dealt to 2d4acc60 
Dealt to 271c38e0 
d1ed32e9: folds
2d4acc60: folds
271c38e0: folds
40c4a4f: raises $0.05 to $0.1
Hero: folds
45392e2c: calls $0.05
*** FLOP *** [3s Tc Ah]
45392e2c: checks
40c4a4f: checks
*** TURN *** [3s Tc Ah] [Th]
45392e2c: checks
40c4a4f: bets $0.13
45392e2c: folds
Uncalled bet ($0.13) returned to 40c4a4f
*** SHOWDOWN ***
40c4a4f collected $0.21 from pot
*** SUMMARY ***
Total pot $0.22 | Rake $0.01 | Jackpot $0 | Bingo $0 | Fortune $0 | Tax $0
Board [3s Tc Ah Th]
Seat 1: 40c4a4f (button) won ($0.21)
Seat 2: Hero (small blind) folded before Flop
Seat 3: 45392e2c (big blind) folded on the Turn
Seat 4: d1ed32e9 folded before Flop (didn't bet)
Seat 5: 2d4acc60 folded before Flop (didn't bet)
Seat 6: 271c38e0 folded before Flop (didn't bet)


Poker Hand #RC2078449158: Hold'em No Limit ($0.02/$0.05) - 2023/12/22 21:10:39
Table 'RushAndCash780196' 6-max Seat #1 is the button
Seat 1: 409f5cad ($5.7 in chips)
Seat 2: e3579d61 ($5 in chips)
Seat 3: Hero ($5 in chips)
Seat 4: 4dab75d6 ($4.85 in chips)
Seat 5: 193ba103 ($9.59 in chips)
Seat 6: eb944e6 ($7.03 in chips)
e3579d61: posts small blind $0.02
Hero: posts big blind $0.05
*** HOLE CARDS ***
Dealt to 409f5cad 
Dealt to e3579d61 
Dealt to Hero [Ah 3d]
Dealt to 4dab75d6 
Dealt to 193ba103 
Dealt to eb944e6 
4dab75d6: folds
193ba103: raises $0.05 to $0.1
eb944e6: folds
409f5cad: folds
e3579d61: calls $0.08
Hero: calls $0.05
*** FLOP *** [3s 4s 7d]
e3579d61: checks
Hero: checks
193ba103: checks
*** TURN *** [3s 4s 7d] [7s]
e3579d61: bets $0.2
Hero: folds
193ba103: folds
Uncalled bet ($0.2) returned to e3579d61
*** SHOWDOWN ***
e3579d61 collected $0.29 from pot
*** SUMMARY ***
Total pot $0.3 | Rake $0.01 | Jackpot $0 | Bingo $0 | Fortune $0 | Tax $0
Board [3s 4s 7d 7s]
Seat 1: 409f5cad (button) folded before Flop (didn't bet)
Seat 2: e3579d61 (small blind) won ($0.29)
Seat 3: Hero (big blind) folded on the Turn
Seat 4: 4dab75d6 folded before Flop (didn't bet)
Seat 5: 193ba103 folded on the Turn
Seat 6: eb944e6 folded before Flop (didn't bet)


Poker Hand #RC2078449084: Hold'em No Limit ($0.02/$0.05) - 2023/12/22 21:10:35
Table 'RushAndCash780158' 6-max Seat #1 is the button
Seat 1: 8f80311 ($2.49 in chips)
Seat 2: 7157dd36 ($9.77 in chips)
Seat 3: 963f3a1f ($2.74 in chips)
Seat 4: Hero ($5 in chips)
Seat 5: d56f57b9 ($6.35 in chips)
Seat 6: 96eff031 ($1.7 in chips)
7157dd36: posts small blind $0.02
963f3a1f: posts big blind $0.05
*** HOLE CARDS ***
Dealt to 8f80311 
Dealt to 7157dd36 
Dealt to 963f3a1f 
Dealt to Hero [2h 8c]
Dealt to d56f57b9 
Dealt to 96eff031 
Hero: folds
d56f57b9: folds
96eff031: raises $0.08 to $0.13
8f80311: folds
7157dd36: folds
963f3a1f: folds
Uncalled bet ($0.08) returned to 96eff031
*** SHOWDOWN ***
96eff031 collected $0.12 from pot
*** SUMMARY ***
Total pot $0.12 | Rake $0 | Jackpot $0 | Bingo $0 | Fortune $0 | Tax $0
Seat 1: 8f80311 (button) folded before Flop (didn't bet)
Seat 2: 7157dd36 (small blind) folded before Flop
Seat 3: 963f3a1f (big blind) folded before Flop
Seat 4: Hero folded before Flop (didn't bet)
Seat 5: d56f57b9 folded before Flop (didn't bet)
Seat 6: 96eff031 collected ($0.12)


Poker Hand #RC2078447878: Hold'em No Limit ($0.02/$0.05) - 2023/12/22 21:09:24
Table 'RushAndCash779590' 6-max Seat #1 is the button
Seat 1: e674731e ($5.05 in chips)
Seat 2: 1edaa810 ($4.83 in chips)
Seat 3: b8d8e3a7 ($5.83 in chips)
Seat 4: Hero ($5.14 in chips)
Seat 5: 8f80311 ($2.49 in chips)
Seat 6: cd5920dd ($5.13 in chips)
1edaa810: posts small blind $0.02
b8d8e3a7: posts big blind $0.05
*** HOLE CARDS ***
Dealt to e674731e 
Dealt to 1edaa810 
Dealt to b8d8e3a7 
Dealt to Hero [Js As]
Dealt to 8f80311 
Dealt to cd5920dd 
Hero: raises $0.05 to $0.1
8f80311: folds
cd5920dd: folds
e674731e: folds
1edaa810: folds
b8d8e3a7: calls $0.05
*** FLOP *** [Ts 4s 9c]
b8d8e3a7: checks
Hero: bets $0.11
b8d8e3a7: calls $0.11
*** TURN *** [Ts 4s 9c] [8h]
b8d8e3a7: checks
Hero: bets $0.27
b8d8e3a7: calls $0.27
*** RIVER *** [Ts 4s 9c 8h] [Jd]
b8d8e3a7: bets $0.98
Hero: folds
Uncalled bet ($0.98) returned to b8d8e3a7
*** SHOWDOWN ***
b8d8e3a7 collected $0.94 from pot
*** SUMMARY ***
Total pot $0.98 | Rake $0.04 | Jackpot $0 | Bingo $0 | Fortune $0 | Tax $0
Board [Ts 4s 9c 8h Jd]
Seat 1: e674731e (button) folded before Flop (didn't bet)
Seat 2: 1edaa810 (small blind) folded before Flop
Seat 3: b8d8e3a7 (big blind) won ($0.94)
Seat 4: Hero folded on the River
Seat 5: 8f80311 folded before Flop (didn't bet)
Seat 6: cd5920dd folded before Flop (didn't bet)


Poker Hand #RC2078447615: Hold'em No Limit ($0.02/$0.05) - 2023/12/22 21:09:09
Table 'RushAndCash779468' 6-max Seat #1 is the button
Seat 1: Hero ($5.14 in chips)
Seat 2: 3c03eb6e ($7.99 in chips)
Seat 3: 711581a0 ($5.2 in chips)
Seat 4: 1e3d103d ($5.66 in chips)
Seat 5: 4dab75d6 ($4.86 in chips)
Seat 6: 38eafb19 ($5 in chips)
3c03eb6e: posts small blind $0.02
711581a0: posts big blind $0.05
*** HOLE CARDS ***
Dealt to Hero [4c 5c]
Dealt to 3c03eb6e 
Dealt to 711581a0 
Dealt to 1e3d103d 
Dealt to 4dab75d6 
Dealt to 38eafb19 
1e3d103d: folds
4dab75d6: raises $0.08 to $0.13
38eafb19: calls $0.13
Hero: folds
3c03eb6e: folds
711581a0: calls $0.08
*** FLOP *** [6c 2h Td]
711581a0: checks
4dab75d6: checks
38eafb19: checks
*** TURN *** [6c 2h Td] [5s]
711581a0: bets $0.27
4dab75d6: folds
38eafb19: folds
Uncalled bet ($0.27) returned to 711581a0
*** SHOWDOWN ***
711581a0 collected $0.39 from pot
*** SUMMARY ***
Total pot $0.41 | Rake $0.02 | Jackpot $0 | Bingo $0 | Fortune $0 | Tax $0
Board [6c 2h Td 5s]
Seat 1: Hero (button) folded before Flop (didn't bet)
Seat 2: 3c03eb6e (small blind) folded before Flop
Seat 3: 711581a0 (big blind) won ($0.39)
Seat 4: 1e3d103d folded before Flop (didn't bet)
Seat 5: 4dab75d6 folded on the Turn
Seat 6: 38eafb19 folded on the Turn


Poker Hand #RC2078447180: Hold'em No Limit ($0.02/$0.05) - 2023/12/22 21:08:44
Table 'RushAndCash779259' 6-max Seat #1 is the button
Seat 1: Hero ($5 in chips)
Seat 2: a2ebb3c7 ($5.79 in chips)
Seat 3: 3c03eb6e ($8.12 in chips)
Seat 4: 567a37c4 ($5.35 in chips)
Seat 5: 7020d421 ($16.01 in chips)
Seat 6: 1e7880dc ($12.96 in chips)
a2ebb3c7: posts small blind $0.02
3c03eb6e: posts big blind $0.05
*** HOLE CARDS ***
Dealt to Hero [Ks Js]
Dealt to a2ebb3c7 
Dealt to 3c03eb6e 
Dealt to 567a37c4 
Dealt to 7020d421 
Dealt to 1e7880dc 
567a37c4: folds
7020d421: folds
1e7880dc: folds
Hero: raises $0.08 to $0.13
a2ebb3c7: folds
3c03eb6e: calls $0.08
*** FLOP *** [Jc 2s 3s]
3c03eb6e: checks
Hero: bets $0.14
3c03eb6e: folds
Uncalled bet ($0.14) returned to Hero
*** SHOWDOWN ***
Hero collected $0.27 from pot
*** SUMMARY ***
Total pot $0.28 | Rake $0.01 | Jackpot $0 | Bingo $0 | Fortune $0 | Tax $0
Board [Jc 2s 3s]
Seat 1: Hero (button) won ($0.27)
Seat 2: a2ebb3c7 (small blind) folded before Flop
Seat 3: 3c03eb6e (big blind) folded on the Flop
Seat 4: 567a37c4 folded before Flop (didn't bet)
Seat 5: 7020d421 folded before Flop (didn't bet)
Seat 6: 1e7880dc folded before Flop (didn't bet)


Poker Hand #RC2078446991: Hold'em No Limit ($0.02/$0.05) - 2023/12/22 21:08:34
Table 'RushAndCash779163' 6-max Seat #1 is the button
Seat 1: 84bf8c0b ($5.32 in chips)
Seat 2: 6ddc293e ($1.44 in chips)
Seat 3: Hero ($5 in chips)
Seat 4: 711581a0 ($5.27 in chips)
Seat 5: ce3dc143 ($5.15 in chips)
Seat 6: 89ac50e8 ($12.57 in chips)
6ddc293e: posts small blind $0.02
Hero: posts big blind $0.05
*** HOLE CARDS ***
Dealt to 84bf8c0b 
Dealt to 6ddc293e 
Dealt to Hero [4s Ts]
Dealt to 711581a0 
Dealt to ce3dc143 
Dealt to 89ac50e8 
711581a0: folds
ce3dc143: folds
89ac50e8: folds
84bf8c0b: folds
6ddc293e: raises $0.1 to $0.15
Hero: folds
Uncalled bet ($0.1) returned to 6ddc293e
*** SHOWDOWN ***
6ddc293e collected $0.1 from pot
*** SUMMARY ***
Total pot $0.1 | Rake $0 | Jackpot $0 | Bingo $0 | Fortune $0 | Tax $0
Seat 1: 84bf8c0b (button) folded before Flop (didn't bet)
Seat 2: 6ddc293e (small blind) collected ($0.1)
Seat 3: Hero (big blind) folded before Flop
Seat 4: 711581a0 folded before Flop (didn't bet)
Seat 5: ce3dc143 folded before Flop (didn't bet)
Seat 6: 89ac50e8 folded before Flop (didn't bet)


Poker Hand #RC2078446811: Hold'em No Limit ($0.02/$0.05) - 2023/12/22 21:08:23
Table 'RushAndCash779073' 6-max Seat #1 is the button
Seat 1: 6029883b ($5 in chips)
Seat 2: Hero ($5 in chips)
Seat 3: b8d8e3a7 ($6.04 in chips)
Seat 4: 3b613695 ($9.74 in chips)
Seat 5: 857de63c ($7.95 in chips)
Seat 6: f1ad1c02 ($4.5 in chips)
Hero: posts small blind $0.02
b8d8e3a7: posts big blind $0.05
*** HOLE CARDS ***
Dealt to 6029883b 
Dealt to Hero [Jc 2c]
Dealt to b8d8e3a7 
Dealt to 3b613695 
Dealt to 857de63c 
Dealt to f1ad1c02 
3b613695: raises $0.06 to $0.11
857de63c: folds
f1ad1c02: folds
6029883b: folds
Hero: folds
b8d8e3a7: calls $0.06
*** FLOP *** [6d Qc 4d]
b8d8e3a7: checks
3b613695: bets $0.08
b8d8e3a7: calls $0.08
*** TURN *** [6d Qc 4d] [Ks]
b8d8e3a7: checks
3b613695: bets $0.3
b8d8e3a7: folds
Uncalled bet ($0.3) returned to 3b613695
*** SHOWDOWN ***
3b613695 collected $0.38 from pot
*** SUMMARY ***
Total pot $0.4 | Rake $0.02 | Jackpot $0 | Bingo $0 | Fortune $0 | Tax $0
Board [6d Qc 4d Ks]
Seat 1: 6029883b (button) folded before Flop (didn't bet)
Seat 2: Hero (small blind) folded before Flop
Seat 3: b8d8e3a7 (big blind) folded on the Turn
Seat 4: 3b613695 won ($0.38)
Seat 5: 857de63c folded before Flop (didn't bet)
Seat 6: f1ad1c02 folded before Flop (didn't bet)


Poker Hand #RC2078446732: Hold'em No Limit ($0.02/$0.05) - 2023/12/22 21:08:18
Table 'RushAndCash779035' 6-max Seat #1 is the button
Seat 1: 4985a5c9 ($5.32 in chips)
Seat 2: 3d929f9f ($6.73 in chips)
Seat 3: b4aaf9de ($6.75 in chips)
Seat 4: 525db62f ($5.38 in chips)
Seat 5: Hero ($5 in chips)
Seat 6: fcc5325d ($6.17 in chips)
3d929f9f: posts small blind $0.02
b4aaf9de: posts big blind $0.05
*** HOLE CARDS ***
Dealt to 4985a5c9 
Dealt to 3d929f9f 
Dealt to b4aaf9de 
Dealt to 525db62f 
Dealt to Hero [Qc 8c]
Dealt to fcc5325d 
525db62f: folds
Hero: folds
fcc5325d: raises $0.05 to $0.1
4985a5c9: folds
3d929f9f: folds
b4aaf9de: calls $0.05
*** FLOP *** [Ad 7c 6s]
b4aaf9de: checks
fcc5325d: bets $0.08
b4aaf9de: folds
Uncalled bet ($0.08) returned to fcc5325d
*** SHOWDOWN ***
fcc5325d collected $0.21 from pot
*** SUMMARY ***
Total pot $0.22 | Rake $0.01 | Jackpot $0 | Bingo $0 | Fortune $0 | Tax $0
Board [Ad 7c 6s]
Seat 1: 4985a5c9 (button) folded before Flop (didn't bet)
Seat 2: 3d929f9f (small blind) folded before Flop
Seat 3: b4aaf9de (big blind) folded on the Flop
Seat 4: 525db62f folded before Flop (didn't bet)
Seat 5: Hero folded before Flop (didn't bet)
Seat 6: fcc5325d won ($0.21)


Poker Hand #RC2078446660: Hold'em No Limit ($0.02/$0.05) - 2023/12/22 21:08:14
Table 'RushAndCash778998' 6-max Seat #1 is the button
Seat 1: e27d5699 ($3.34 in chips)
Seat 2: 983d74a ($6.99 in chips)
Seat 3: 6a594ce8 ($5.07 in chips)
Seat 4: Hero ($5 in chips)
Seat 5: b2b4173f ($2.79 in chips)
Seat 6: ec3623ea ($5.86 in chips)
983d74a: posts small blind $0.02
6a594ce8: posts big blind $0.05
*** HOLE CARDS ***
Dealt to e27d5699 
Dealt to 983d74a 
Dealt to 6a594ce8 
Dealt to Hero [2h 9d]
Dealt to b2b4173f 
Dealt to ec3623ea 
Hero: folds
b2b4173f: folds
ec3623ea: folds
e27d5699: folds
983d74a: raises $0.08 to $0.13
6a594ce8: folds
Uncalled bet ($0.08) returned to 983d74a
*** SHOWDOWN ***
983d74a collected $0.1 from pot
*** SUMMARY ***
Total pot $0.1 | Rake $0 | Jackpot $0 | Bingo $0 | Fortune $0 | Tax $0
Seat 1: e27d5699 (button) folded before Flop (didn't bet)
Seat 2: 983d74a (small blind) collected ($0.1)
Seat 3: 6a594ce8 (big blind) folded before Flop
Seat 4: Hero folded before Flop (didn't bet)
Seat 5: b2b4173f folded before Flop (didn't bet)
Seat 6: ec3623ea folded before Flop (didn't bet)


Poker Hand #RC2078446588: Hold'em No Limit ($0.02/$0.05) - 2023/12/22 21:08:10
Table 'RushAndCash778963' 6-max Seat #1 is the button
Seat 1: bc118b95 ($5.1 in chips)
Seat 2: f92e05a8 ($16.81 in chips)
Seat 3: ec3623ea ($5.91 in chips)
Seat 4: 49ea92ea ($8.1 in chips)
Seat 5: 360d3b25 ($5.23 in chips)
Seat 6: Hero ($5 in chips)
f92e05a8: posts small blind $0.02
ec3623ea: posts big blind $0.05
*** HOLE CARDS ***
Dealt to bc118b95 
Dealt to f92e05a8 
Dealt to ec3623ea 
Dealt to 49ea92ea 
Dealt to 360d3b25 
Dealt to Hero [Th 6s]
49ea92ea: raises $0.05 to $0.1
360d3b25: folds
Hero: folds
bc118b95: folds
f92e05a8: folds
ec3623ea: folds
Uncalled bet ($0.05) returned to 49ea92ea
*** SHOWDOWN ***
49ea92ea collected $0.12 from pot
*** SUMMARY ***
Total pot $0.12 | Rake $0 | Jackpot $0 | Bingo $0 | Fortune $0 | Tax $0
Seat 1: bc118b95 (button) folded before Flop (didn't bet)
Seat 2: f92e05a8 (small blind) folded before Flop
Seat 3: ec3623ea (big blind) folded before Flop
Seat 4: 49ea92ea collected ($0.12)
Seat 5: 360d3b25 folded before Flop (didn't bet)
Seat 6: Hero folded before Flop (didn't bet)


Poker Hand #RC2078446499: Hold'em No Limit ($0.02/$0.05) - 2023/12/22 21:08:05
Table 'RushAndCash778920' 6-max Seat #1 is the button
Seat 1: Hero ($5 in chips)
Seat 2: 2372be7b ($6.17 in chips)
Seat 3: 509e9488 ($3.39 in chips)
Seat 4: bc7afeb2 ($5.51 in chips)
Seat 5: 1edaa810 ($5.03 in chips)
Seat 6: fe4d1d98 ($5.46 in chips)
2372be7b: posts small blind $0.02
509e9488: posts big blind $0.05
*** HOLE CARDS ***
Dealt to Hero [4s Js]
Dealt to 2372be7b 
Dealt to 509e9488 
Dealt to bc7afeb2 
Dealt to 1edaa810 
Dealt to fe4d1d98 
bc7afeb2: folds
1edaa810: folds
fe4d1d98: folds
Hero: folds
2372be7b: raises $0.1 to $0.15
509e9488: calls $0.1
*** FLOP *** [Kh Ac 6c]
2372be7b: bets $0.1
509e9488: calls $0.1
*** TURN *** [Kh Ac 6c] [Th]
2372be7b: bets $0.35
509e9488: calls $0.35
*** RIVER *** [Kh Ac 6c Th] [Ts]
2372be7b: checks
509e9488: checks
2372be7b: shows [Jc 7c] (Pair of Tens)
509e9488: shows [Ah Qd] (Pair of Aces and Pair of Tens)
*** SHOWDOWN ***
509e9488 collected $1.14 from pot
*** SUMMARY ***
Total pot $1.2 | Rake $0.06 | Jackpot $0 | Bingo $0 | Fortune $0 | Tax $0
Board [Kh Ac 6c Th Ts]
Seat 1: Hero (button) folded before Flop (didn't bet)
Seat 2: 2372be7b (small blind) showed [Jc 7c] and lost with Pair of Tens
Seat 3: 509e9488 (big blind) showed [Ah Qd] and won ($1.14) with Pair of Aces and Pair of Tens
Seat 4: bc7afeb2 folded before Flop (didn't bet)
Seat 5: 1edaa810 folded before Flop (didn't bet)
Seat 6: fe4d1d98 folded before Flop (didn't bet)


Poker Hand #RC2078446396: Hold'em No Limit ($0.02/$0.05) - 2023/12/22 21:07:59
Table 'RushAndCash778867' 6-max Seat #1 is the button
Seat 1: 919daa51 ($4.91 in chips)
Seat 2: Hero ($5.01 in chips)
Seat 3: 9aad1596 ($7.22 in chips)
Seat 4: a2a9ef51 ($5.32 in chips)
Seat 5: 5d55167a ($10.09 in chips)
Seat 6: 42b297d3 ($4.89 in chips)
Hero: posts small blind $0.02
9aad1596: posts big blind $0.05
*** HOLE CARDS ***
Dealt to 919daa51 
Dealt to Hero [Qd 9s]
Dealt to 9aad1596 
Dealt to a2a9ef51 
Dealt to 5d55167a 
Dealt to 42b297d3 
a2a9ef51: folds
5d55167a: folds
42b297d3: folds
919daa51: folds
Hero: folds
Uncalled bet ($0.03) returned to 9aad1596
*** SHOWDOWN ***
9aad1596 collected $0.04 from pot
*** SUMMARY ***
Total pot $0.04 | Rake $0 | Jackpot $0 | Bingo $0 | Fortune $0 | Tax $0
Seat 1: 919daa51 (button) folded before Flop (didn't bet)
Seat 2: Hero (small blind) folded before Flop
Seat 3: 9aad1596 (big blind) collected ($0.04)
Seat 4: a2a9ef51 folded before Flop (didn't bet)
Seat 5: 5d55167a folded before Flop (didn't bet)
Seat 6: 42b297d3 folded before Flop (didn't bet)


Poker Hand #RC2078445705: Hold'em No Limit ($0.02/$0.05) - 2023/12/22 21:07:21
Table 'RushAndCash778540' 6-max Seat #1 is the button
Seat 1: d6363be2 ($8.42 in chips)
Seat 2: 5d55167a ($9.5 in chips)
Seat 3: Hero ($5.11 in chips)
Seat 4: 8eb71456 ($9.47 in chips)
Seat 5: 5d317abf ($8.84 in chips)
Seat 6: a2a9ef51 ($5.87 in chips)
5d55167a: posts small blind $0.02
Hero: posts big blind $0.05
*** HOLE CARDS ***
Dealt to d6363be2 
Dealt to 5d55167a 
Dealt to Hero [4c 5s]
Dealt to 8eb71456 
Dealt to 5d317abf 
Dealt to a2a9ef51 
8eb71456: folds
5d317abf: folds
a2a9ef51: raises $0.05 to $0.1
d6363be2: folds
5d55167a: calls $0.08
Hero: calls $0.05
*** FLOP *** [2s Ac 9d]
5d55167a: bets $0.15
Hero: folds
a2a9ef51: calls $0.15
*** TURN *** [2s Ac 9d] [7s]
5d55167a: checks
a2a9ef51: bets $0.3
5d55167a: calls $0.3
*** RIVER *** [2s Ac 9d 7s] [Tc]
5d55167a: checks
a2a9ef51: checks
5d55167a: shows [Ad Js] (Pair of Aces)
a2a9ef51: shows [As 4s] (Pair of Aces)
*** SHOWDOWN ***
5d55167a collected $1.14 from pot
*** SUMMARY ***
Total pot $1.2 | Rake $0.06 | Jackpot $0 | Bingo $0 | Fortune $0 | Tax $0
Board [2s Ac 9d 7s Tc]
Seat 1: d6363be2 (button) folded before Flop (didn't bet)
Seat 2: 5d55167a (small blind) showed [Ad Js] and won ($1.14) with Pair of Aces
Seat 3: Hero (big blind) folded on the Flop
Seat 4: 8eb71456 folded before Flop (didn't bet)
Seat 5: 5d317abf folded before Flop (didn't bet)
Seat 6: a2a9ef51 showed [As 4s] and lost with Pair of Aces


Poker Hand #RC2078445658: Hold'em No Limit ($0.02/$0.05) - 2023/12/22 21:07:17
Table 'RushAndCash778521' 6-max Seat #1 is the button
Seat 1: 2372be7b ($6.12 in chips)
Seat 2: 6ddc293e ($5.02 in chips)
Seat 3: ceb10c49 ($5 in chips)
Seat 4: d1a1b256 ($6.06 in chips)
Seat 5: Hero ($5.11 in chips)
Seat 6: fd6c2d4d ($5 in chips)
6ddc293e: posts small blind $0.02
ceb10c49: posts big blind $0.05
*** HOLE CARDS ***
Dealt to 2372be7b 
Dealt to 6ddc293e 
Dealt to ceb10c49 
Dealt to d1a1b256 
Dealt to Hero [6d 3c]
Dealt to fd6c2d4d 
d1a1b256: folds
Hero: folds
fd6c2d4d: folds
2372be7b: folds
6ddc293e: folds
Uncalled bet ($0.03) returned to ceb10c49
*** SHOWDOWN ***
ceb10c49 collected $0.04 from pot
*** SUMMARY ***
Total pot $0.04 | Rake $0 | Jackpot $0 | Bingo $0 | Fortune $0 | Tax $0
Seat 1: 2372be7b (button) folded before Flop (didn't bet)
Seat 2: 6ddc293e (small blind) folded before Flop
Seat 3: ceb10c49 (big blind) collected ($0.04)
Seat 4: d1a1b256 folded before Flop (didn't bet)
Seat 5: Hero folded before Flop (didn't bet)
Seat 6: fd6c2d4d folded before Flop (didn't bet)


Poker Hand #RC2078445580: Hold'em No Limit ($0.02/$0.05) - 2023/12/22 21:07:13
Table 'RushAndCash778486' 6-max Seat #1 is the button
Seat 1: c2881b52 ($13.59 in chips)
Seat 2: fb772588 ($5 in chips)
Seat 3: 59ef18cb ($5.48 in chips)
Seat 4: Hero ($5.11 in chips)
Seat 5: 67444c22 ($5 in chips)
Seat 6: 3a35e9f5 ($17.06 in chips)
fb772588: posts small blind $0.02
59ef18cb: posts big blind $0.05
*** HOLE CARDS ***
Dealt to c2881b52 
Dealt to fb772588 
Dealt to 59ef18cb 
Dealt to Hero [5s 4h]
Dealt to 67444c22 
Dealt to 3a35e9f5 
Hero: folds
67444c22: folds
3a35e9f5: folds
c2881b52: folds
fb772588: folds
Uncalled bet ($0.03) returned to 59ef18cb
*** SHOWDOWN ***
59ef18cb collected $0.04 from pot
*** SUMMARY ***
Total pot $0.04 | Rake $0 | Jackpot $0 | Bingo $0 | Fortune $0 | Tax $0
Seat 1: c2881b52 (button) folded before Flop (didn't bet)
Seat 2: fb772588 (small blind) folded before Flop
Seat 3: 59ef18cb (big blind) collected ($0.04)
Seat 4: Hero folded before Flop (didn't bet)
Seat 5: 67444c22 folded before Flop (didn't bet)
Seat 6: 3a35e9f5 folded before Flop (didn't bet)


Poker Hand #RC2078445148: Hold'em No Limit ($0.02/$0.05) - 2023/12/22 21:06:49
Table 'RushAndCash778283' 6-max Seat #1 is the button
Seat 1: 35a4e515 ($3.09 in chips)
Seat 2: Hero ($5.22 in chips)
Seat 3: c2ec7797 ($5.43 in chips)
Seat 4: 2075befd ($5 in chips)
Seat 5: 859547f3 ($5.59 in chips)
Seat 6: c2881b52 ($13.44 in chips)
Hero: posts small blind $0.02
c2ec7797: posts big blind $0.05
*** HOLE CARDS ***
Dealt to 35a4e515 
Dealt to Hero [Ks 4s]
Dealt to c2ec7797 
Dealt to 2075befd 
Dealt to 859547f3 
Dealt to c2881b52 
2075befd: folds
859547f3: folds
c2881b52: raises $0.06 to $0.11
35a4e515: folds
Hero: calls $0.09
c2ec7797: folds
*** FLOP *** [7h 6s Th]
Hero: checks
c2881b52: bets $0.14
Hero: folds
Uncalled bet ($0.14) returned to c2881b52
*** SHOWDOWN ***
c2881b52 collected $0.26 from pot
*** SUMMARY ***
Total pot $0.27 | Rake $0.01 | Jackpot $0 | Bingo $0 | Fortune $0 | Tax $0
Board [7h 6s Th]
Seat 1: 35a4e515 (button) folded before Flop (didn't bet)
Seat 2: Hero (small blind) folded on the Flop
Seat 3: c2ec7797 (big blind) folded before Flop
Seat 4: 2075befd folded before Flop (didn't bet)
Seat 5: 859547f3 folded before Flop (didn't bet)
Seat 6: c2881b52 won ($0.26)


Poker Hand #RC2078445027: Hold'em No Limit ($0.02/$0.05) - 2023/12/22 21:06:42
Table 'RushAndCash778219' 6-max Seat #1 is the button
Seat 1: e929859b ($3.9 in chips)
Seat 2: 9584df5 ($5.33 in chips)
Seat 3: fd6c2d4d ($5 in chips)
Seat 4: Hero ($5.22 in chips)
Seat 5: 3034205c ($5.05 in chips)
Seat 6: f804ce50 ($15.35 in chips)
9584df5: posts small blind $0.02
fd6c2d4d: posts big blind $0.05
*** HOLE CARDS ***
Dealt to e929859b 
Dealt to 9584df5 
Dealt to fd6c2d4d 
Dealt to Hero [Ac 4h]
Dealt to 3034205c 
Dealt to f804ce50 
Hero: folds
3034205c: folds
f804ce50: folds
e929859b: folds
9584df5: folds
Uncalled bet ($0.03) returned to fd6c2d4d
*** SHOWDOWN ***
fd6c2d4d collected $0.04 from pot
*** SUMMARY ***
Total pot $0.04 | Rake $0 | Jackpot $0 | Bingo $0 | Fortune $0 | Tax $0
Seat 1: e929859b (button) folded before Flop (didn't bet)
Seat 2: 9584df5 (small blind) folded before Flop
Seat 3: fd6c2d4d (big blind) collected ($0.04)
Seat 4: Hero folded before Flop (didn't bet)
Seat 5: 3034205c folded before Flop (didn't bet)
Seat 6: f804ce50 folded before Flop (didn't bet)


Poker Hand #RC2078424713: Hold'em No Limit ($0.02/$0.05) - 2023/12/22 21:06:24
Table 'RushAndCash778072' 6-max Seat #1 is the button
Seat 1: a2ebb3c7 ($5 in chips)
Seat 2: 6029883b ($5.02 in chips)
Seat 3: Hero ($5.27 in chips)
Seat 4: d1a1b256 ($6.06 in chips)
Seat 5: ec3623ea ($6.07 in chips)
Seat 6: 2471888a ($5 in chips)
6029883b: posts small blind $0.02
Hero: posts big blind $0.05
*** HOLE CARDS ***
Dealt to a2ebb3c7 
Dealt to 6029883b 
Dealt to Hero [5h Jh]
Dealt to d1a1b256 
Dealt to ec3623ea 
Dealt to 2471888a 
d1a1b256: folds
ec3623ea: folds
2471888a: folds
a2ebb3c7: raises $0.08 to $0.13
6029883b: raises $0.41 to $0.54
Hero: folds
a2ebb3c7: folds
Uncalled bet ($0.41) returned to 6029883b
*** SHOWDOWN ***
6029883b collected $0.3 from pot
*** SUMMARY ***
Total pot $0.31 | Rake $0.01 | Jackpot $0 | Bingo $0 | Fortune $0 | Tax $0
Seat 1: a2ebb3c7 (button) folded before Flop
Seat 2: 6029883b (small blind) collected ($0.3)
Seat 3: Hero (big blind) folded before Flop
Seat 4: d1a1b256 folded before Flop (didn't bet)
Seat 5: ec3623ea folded before Flop (didn't bet)
Seat 6: 2471888a folded before Flop (didn't bet)


Poker Hand #RC2078424578: Hold'em No Limit ($0.02/$0.05) - 2023/12/22 21:06:17
Table 'RushAndCash778007' 6-max Seat #1 is the button
Seat 1: Hero ($5.27 in chips)
Seat 2: e67ce721 ($5.53 in chips)
Seat 3: 1d5e7c7e ($2 in chips)
Seat 4: 3e455537 ($6.71 in chips)
Seat 5: 7d406e41 ($5.62 in chips)
Seat 6: 8b0c9357 ($5.27 in chips)
e67ce721: posts small blind $0.02
1d5e7c7e: posts big blind $0.05
*** HOLE CARDS ***
Dealt to Hero [4d Th]
Dealt to e67ce721 
Dealt to 1d5e7c7e 
Dealt to 3e455537 
Dealt to 7d406e41 
Dealt to 8b0c9357 
3e455537: folds
7d406e41: raises $0.08 to $0.13
8b0c9357: folds
Hero: folds
e67ce721: folds
1d5e7c7e: folds
Uncalled bet ($0.08) returned to 7d406e41
*** SHOWDOWN ***
7d406e41 collected $0.12 from pot
*** SUMMARY ***
Total pot $0.12 | Rake $0 | Jackpot $0 | Bingo $0 | Fortune $0 | Tax $0
Seat 1: Hero (button) folded before Flop (didn't bet)
Seat 2: e67ce721 (small blind) folded before Flop
Seat 3: 1d5e7c7e (big blind) folded before Flop
Seat 4: 3e455537 folded before Flop (didn't bet)
Seat 5: 7d406e41 collected ($0.12)
Seat 6: 8b0c9357 folded before Flop (didn't bet)


Poker Hand #RC2078424461: Hold'em No Limit ($0.02/$0.05) - 2023/12/22 21:06:10
Table 'RushAndCash777949' 6-max Seat #1 is the button
Seat 1: 2471888a ($5.05 in chips)
Seat 2: 8d4b9cb6 ($6.02 in chips)
Seat 3: 6d3488f1 ($5 in chips)
Seat 4: c7be9492 ($5 in chips)
Seat 5: f6f7aa18 ($5.56 in chips)
Seat 6: Hero ($5.27 in chips)
8d4b9cb6: posts small blind $0.02
6d3488f1: posts big blind $0.05
*** HOLE CARDS ***
Dealt to 2471888a 
Dealt to 8d4b9cb6 
Dealt to 6d3488f1 
Dealt to c7be9492 
Dealt to f6f7aa18 
Dealt to Hero [Qh 6h]
c7be9492: folds
f6f7aa18: folds
Hero: folds
2471888a: folds
8d4b9cb6: folds
Uncalled bet ($0.03) returned to 6d3488f1
*** SHOWDOWN ***
6d3488f1 collected $0.04 from pot
*** SUMMARY ***
Total pot $0.04 | Rake $0 | Jackpot $0 | Bingo $0 | Fortune $0 | Tax $0
Seat 1: 2471888a (button) folded before Flop (didn't bet)
Seat 2: 8d4b9cb6 (small blind) folded before Flop
Seat 3: 6d3488f1 (big blind) collected ($0.04)
Seat 4: c7be9492 folded before Flop (didn't bet)
Seat 5: f6f7aa18 folded before Flop (didn't bet)
Seat 6: Hero folded before Flop (didn't bet)


Poker Hand #RC2078424390: Hold'em No Limit ($0.02/$0.05) - 2023/12/22 21:06:06
Table 'RushAndCash777914' 6-max Seat #1 is the button
Seat 1: 3160ff3c ($7.31 in chips)
Seat 2: 89c6e004 ($4.89 in chips)
Seat 3: fd07586a ($5.05 in chips)
Seat 4: d2739eda ($1.59 in chips)
Seat 5: d0b2d784 ($6.57 in chips)
Seat 6: Hero ($5.27 in chips)
89c6e004: posts small blind $0.02
fd07586a: posts big blind $0.05
*** HOLE CARDS ***
Dealt to 3160ff3c 
Dealt to 89c6e004 
Dealt to fd07586a 
Dealt to d2739eda 
Dealt to d0b2d784 
Dealt to Hero [3s 6s]
d2739eda: folds
d0b2d784: folds
Hero: folds
3160ff3c: raises $0.07 to $0.12
89c6e004: calls $0.1
fd07586a: folds
*** FLOP *** [Th Jh 4h]
89c6e004: bets $0.15
3160ff3c: calls $0.15
*** TURN *** [Th Jh 4h] [3d]
89c6e004: bets $0.2
3160ff3c: calls $0.2
*** RIVER *** [Th Jh 4h 3d] [5c]
89c6e004: checks
3160ff3c: bets $0.75
89c6e004: calls $0.75
3160ff3c: shows [Ad Ac] (Pair of Aces)
89c6e004: shows [Js Qh] (Pair of Jacks)
*** SHOWDOWN ***
3160ff3c collected $2.3 from pot
*** SUMMARY ***
Total pot $2.49 | Rake $0.12 | Jackpot $0.07 | Bingo $0 | Fortune $0 | Tax $0
Board [Th Jh 4h 3d 5c]
Seat 1: 3160ff3c (button) showed [Ad Ac] and won ($2.3) with Pair of Aces
Seat 2: 89c6e004 (small blind) showed [Js Qh] and lost with Pair of Jacks
Seat 3: fd07586a (big blind) folded before Flop
Seat 4: d2739eda folded before Flop (didn't bet)
Seat 5: d0b2d784 folded before Flop (didn't bet)
Seat 6: Hero folded before Flop (didn't bet)


Poker Hand #RC2078424252: Hold'em No Limit ($0.02/$0.05) - 2023/12/22 21:05:59
Table 'RushAndCash777850' 6-max Seat #1 is the button
Seat 1: 5a6bcca5 ($5.59 in chips)
Seat 2: Hero ($5.29 in chips)
Seat 3: c54f63b8 ($5.07 in chips)
Seat 4: 6ffefba2 ($5.67 in chips)
Seat 5: 40b6751c ($5.51 in chips)
Seat 6: 9942b4df ($5.07 in chips)
Hero: posts small blind $0.02
c54f63b8: posts big blind $0.05
*** HOLE CARDS ***
Dealt to 5a6bcca5 
Dealt to Hero [4d 9h]
Dealt to c54f63b8 
Dealt to 6ffefba2 
Dealt to 40b6751c 
Dealt to 9942b4df 
6ffefba2: folds
40b6751c: folds
9942b4df: folds
5a6bcca5: folds
Hero: folds
Uncalled bet ($0.03) returned to c54f63b8
*** SHOWDOWN ***
c54f63b8 collected $0.04 from pot
*** SUMMARY ***
Total pot $0.04 | Rake $0 | Jackpot $0 | Bingo $0 | Fortune $0 | Tax $0
Seat 1: 5a6bcca5 (button) folded before Flop (didn't bet)
Seat 2: Hero (small blind) folded before Flop
Seat 3: c54f63b8 (big blind) collected ($0.04)
Seat 4: 6ffefba2 folded before Flop (didn't bet)
Seat 5: 40b6751c folded before Flop (didn't bet)
Seat 6: 9942b4df folded before Flop (didn't bet)


Poker Hand #RC2078424120: Hold'em No Limit ($0.02/$0.05) - 2023/12/22 21:05:51
Table 'RushAndCash777791' 6-max Seat #1 is the button
Seat 1: 12953fac ($6.18 in chips)
Seat 2: ca4d7d81 ($7.2 in chips)
Seat 3: Hero ($5.27 in chips)
Seat 4: c7451cf4 ($8.44 in chips)
Seat 5: 1c9c1649 ($5.11 in chips)
Seat 6: c54f63b8 ($5.07 in chips)
ca4d7d81: posts small blind $0.02
Hero: posts big blind $0.05
*** HOLE CARDS ***
Dealt to 12953fac 
Dealt to ca4d7d81 
Dealt to Hero [2d Kh]
Dealt to c7451cf4 
Dealt to 1c9c1649 
Dealt to c54f63b8 
c7451cf4: folds
1c9c1649: folds
c54f63b8: folds
12953fac: folds
ca4d7d81: folds
Uncalled bet ($0.03) returned to Hero
*** SHOWDOWN ***
Hero collected $0.04 from pot
*** SUMMARY ***
Total pot $0.04 | Rake $0 | Jackpot $0 | Bingo $0 | Fortune $0 | Tax $0
Seat 1: 12953fac (button) folded before Flop (didn't bet)
Seat 2: ca4d7d81 (small blind) folded before Flop
Seat 3: Hero (big blind) collected ($0.04)
Seat 4: c7451cf4 folded before Flop (didn't bet)
Seat 5: 1c9c1649 folded before Flop (didn't bet)
Seat 6: c54f63b8 folded before Flop (didn't bet)


Poker Hand #RC2078423541: Hold'em No Limit ($0.02/$0.05) - 2023/12/22 21:05:19
Table 'RushAndCash777529' 6-max Seat #1 is the button
Seat 1: Hero ($5 in chips)
Seat 2: e7dae1d3 ($5.28 in chips)
Seat 3: e3589ec ($2.53 in chips)
Seat 4: e6f6623d ($6.02 in chips)
Seat 5: 7c950e30 ($10.33 in chips)
Seat 6: c2881b52 ($13.51 in chips)
e7dae1d3: posts small blind $0.02
e3589ec: posts big blind $0.05
*** HOLE CARDS ***
Dealt to Hero [Ad Ac]
Dealt to e7dae1d3 
Dealt to e3589ec 
Dealt to e6f6623d 
Dealt to 7c950e30 
Dealt to c2881b52 
e6f6623d: folds
7c950e30: folds
c2881b52: folds
Hero: raises $0.08 to $0.13
e7dae1d3: folds
e3589ec: calls $0.08
*** FLOP *** [7s Qh 9c]
e3589ec: checks
Hero: bets $0.14
e3589ec: calls $0.14
*** TURN *** [7s Qh 9c] [2d]
e3589ec: checks
Hero: checks
*** RIVER *** [7s Qh 9c 2d] [Ks]
e3589ec: checks
Hero: bets $0.29
e3589ec: folds
Uncalled bet ($0.29) returned to Hero
*** SHOWDOWN ***
Hero collected $0.54 from pot
*** SUMMARY ***
Total pot $0.56 | Rake $0.02 | Jackpot $0 | Bingo $0 | Fortune $0 | Tax $0
Board [7s Qh 9c 2d Ks]
Seat 1: Hero (button) won ($0.54)
Seat 2: e7dae1d3 (small blind) folded before Flop
Seat 3: e3589ec (big blind) folded on the River
Seat 4: e6f6623d folded before Flop (didn't bet)
Seat 5: 7c950e30 folded before Flop (didn't bet)
Seat 6: c2881b52 folded before Flop (didn't bet)


Poker Hand #RC2078422632: Hold'em No Limit ($0.02/$0.05) - 2023/12/22 21:04:27
Table 'RushAndCash777123' 6-max Seat #1 is the button
Seat 1: d71ab80c ($7.07 in chips)
Seat 2: 5c57b9e ($5 in chips)
Seat 3: 680eb0e1 ($9.55 in chips)
Seat 4: 1d1c20e8 ($4.66 in chips)
Seat 5: Hero ($5 in chips)
Seat 6: 271c38e0 ($5.91 in chips)
5c57b9e: posts small blind $0.02
680eb0e1: posts big blind $0.05
*** HOLE CARDS ***
Dealt to d71ab80c 
Dealt to 5c57b9e 
Dealt to 680eb0e1 
Dealt to 1d1c20e8 
Dealt to Hero [Jd Qd]
Dealt to 271c38e0 
1d1c20e8: raises $0.06 to $0.11
Hero: calls $0.11
271c38e0: folds
d71ab80c: folds
5c57b9e: folds
680eb0e1: raises $0.49 to $0.6
1d1c20e8: calls $0.49
Hero: folds
*** FLOP *** [9h 3d 2d]
680eb0e1: bets $0.44
1d1c20e8: raises $3.62 to $4.06 and is all-in
680eb0e1: calls $3.62
1d1c20e8: shows [Ad 6d] (Ace-High)
680eb0e1: shows [Js Jh] (Pair of Jacks)
*** TURN *** [9h 3d 2d] [4d]
*** RIVER *** [9h 3d 2d 4d] [Qc]
*** SHOWDOWN ***
1d1c20e8 collected $9.23 from pot
*** SUMMARY ***
Total pot $9.45 | Rake $0.15 | Jackpot $0.07 | Bingo $0 | Fortune $0 | Tax $0
Board [9h 3d 2d 4d Qc]
Seat 1: d71ab80c (button) folded before Flop (didn't bet)
Seat 2: 5c57b9e (small blind) folded before Flop
Seat 3: 680eb0e1 (big blind) showed [Js Jh] and lost with Pair of Jacks
Seat 4: 1d1c20e8 showed [Ad 6d] and won ($9.23) with Ace High Flush
Seat 5: Hero folded before Flop
Seat 6: 271c38e0 folded before Flop (didn't bet)


Poker Hand #RC2078422573: Hold'em No Limit ($0.02/$0.05) - 2023/12/22 21:04:24
Table 'RushAndCash777096' 6-max Seat #1 is the button
Seat 1: 3c0cf28c ($5 in chips)
Seat 2: d74d8525 ($5 in chips)
Seat 3: 3b613695 ($8.47 in chips)
Seat 4: 23a63651 ($20.33 in chips)
Seat 5: 49ea92ea ($8.21 in chips)
Seat 6: Hero ($5 in chips)
d74d8525: posts small blind $0.02
3b613695: posts big blind $0.05
*** HOLE CARDS ***
Dealt to 3c0cf28c 
Dealt to d74d8525 
Dealt to 3b613695 
Dealt to 23a63651 
Dealt to 49ea92ea 
Dealt to Hero [7s 6d]
23a63651: raises $0.05 to $0.1
49ea92ea: folds
Hero: folds
3c0cf28c: folds
d74d8525: folds
3b613695: calls $0.05
*** FLOP *** [2s Ts Th]
3b613695: bets $0.08
23a63651: folds
Uncalled bet ($0.08) returned to 3b613695
*** SHOWDOWN ***
3b613695 collected $0.21 from pot
*** SUMMARY ***
Total pot $0.22 | Rake $0.01 | Jackpot $0 | Bingo $0 | Fortune $0 | Tax $0
Board [2s Ts Th]
Seat 1: 3c0cf28c (button) folded before Flop (didn't bet)
Seat 2: d74d8525 (small blind) folded before Flop
Seat 3: 3b613695 (big blind) won ($0.21)
Seat 4: 23a63651 folded on the Flop
Seat 5: 49ea92ea folded before Flop (didn't bet)
Seat 6: Hero folded before Flop (didn't bet)


Poker Hand #RC2078422496: Hold'em No Limit ($0.02/$0.05) - 2023/12/22 21:04:20
Table 'RushAndCash777062' 6-max Seat #1 is the button
Seat 1: Hero ($5 in chips)
Seat 2: 494d7c43 ($5 in chips)
Seat 3: ac89ef05 ($8.59 in chips)
Seat 4: 2ec85018 ($4.16 in chips)
Seat 5: a61e93fb ($5.56 in chips)
Seat 6: 373d8880 ($5.07 in chips)
494d7c43: posts small blind $0.02
ac89ef05: posts big blind $0.05
*** HOLE CARDS ***
Dealt to Hero [Th Ks]
Dealt to 494d7c43 
Dealt to ac89ef05 
Dealt to 2ec85018 
Dealt to a61e93fb 
Dealt to 373d8880 
2ec85018: folds
a61e93fb: raises $0.07 to $0.12
373d8880: folds
Hero: folds
494d7c43: folds
ac89ef05: raises $0.43 to $0.55
a61e93fb: raises $0.63 to $1.18
ac89ef05: calls $0.63
*** FLOP *** [Tc 2s 6h]
ac89ef05: checks
a61e93fb: checks
*** TURN *** [Tc 2s 6h] [3d]
ac89ef05: checks
a61e93fb: bets $1.19
ac89ef05: folds
Uncalled bet ($1.19) returned to a61e93fb
*** SHOWDOWN ***
a61e93fb collected $2.2 from pot
*** SUMMARY ***
Total pot $2.38 | Rake $0.11 | Jackpot $0.07 | Bingo $0 | Fortune $0 | Tax $0
Board [Tc 2s 6h 3d]
Seat 1: Hero (button) folded before Flop (didn't bet)
Seat 2: 494d7c43 (small blind) folded before Flop
Seat 3: ac89ef05 (big blind) folded on the Turn
Seat 4: 2ec85018 folded before Flop (didn't bet)
Seat 5: a61e93fb won ($2.2)
Seat 6: 373d8880 folded before Flop (didn't bet)


Poker Hand #RC2078422403: Hold'em No Limit ($0.02/$0.05) - 2023/12/22 21:04:14
Table 'RushAndCash777022' 6-max Seat #1 is the button
Seat 1: a602a3b0 ($9.41 in chips)
Seat 2: d52ccee4 ($8.86 in chips)
Seat 3: a4c64da ($7.45 in chips)
Seat 4: b427f11f ($1.84 in chips)
Seat 5: 50d599ea ($6.63 in chips)
Seat 6: Hero ($5 in chips)
d52ccee4: posts small blind $0.02
a4c64da: posts big blind $0.05
*** HOLE CARDS ***
Dealt to a602a3b0 
Dealt to d52ccee4 
Dealt to a4c64da 
Dealt to b427f11f 
Dealt to 50d599ea 
Dealt to Hero [7c Kd]
b427f11f: raises $0.05 to $0.1
50d599ea: folds
Hero: folds
a602a3b0: folds
d52ccee4: folds
a4c64da: folds
Uncalled bet ($0.05) returned to b427f11f
*** SHOWDOWN ***
b427f11f collected $0.12 from pot
*** SUMMARY ***
Total pot $0.12 | Rake $0 | Jackpot $0 | Bingo $0 | Fortune $0 | Tax $0
Seat 1: a602a3b0 (button) folded before Flop (didn't bet)
Seat 2: d52ccee4 (small blind) folded before Flop
Seat 3: a4c64da (big blind) folded before Flop
Seat 4: b427f11f collected ($0.12)
Seat 5: 50d599ea folded before Flop (didn't bet)
Seat 6: Hero folded before Flop (didn't bet)


Poker Hand #RC2078422333: Hold'em No Limit ($0.02/$0.05) - 2023/12/22 21:04:10
Table 'RushAndCash776991' 6-max Seat #1 is the button
Seat 1: c5af17e2 ($5.58 in chips)
Seat 2: f3b8bc9d ($12.53 in chips)
Seat 3: 6c115aeb ($5 in chips)
Seat 4: 4e20b85a ($9.86 in chips)
Seat 5: a638a3a8 ($7.63 in chips)
Seat 6: Hero ($5 in chips)
f3b8bc9d: posts small blind $0.02
6c115aeb: posts big blind $0.05
*** HOLE CARDS ***
Dealt to c5af17e2 
Dealt to f3b8bc9d 
Dealt to 6c115aeb 
Dealt to 4e20b85a 
Dealt to a638a3a8 
Dealt to Hero [8h 7s]
4e20b85a: folds
a638a3a8: folds
Hero: folds
c5af17e2: raises $0.1 to $0.15
f3b8bc9d: folds
6c115aeb: folds
Uncalled bet ($0.1) returned to c5af17e2
*** SHOWDOWN ***
c5af17e2 collected $0.12 from pot
*** SUMMARY ***
Total pot $0.12 | Rake $0 | Jackpot $0 | Bingo $0 | Fortune $0 | Tax $0
Seat 1: c5af17e2 (button) collected ($0.12)
Seat 2: f3b8bc9d (small blind) folded before Flop
Seat 3: 6c115aeb (big blind) folded before Flop
Seat 4: 4e20b85a folded before Flop (didn't bet)
Seat 5: a638a3a8 folded before Flop (didn't bet)
Seat 6: Hero folded before Flop (didn't bet)


Poker Hand #RC2078422135: Hold'em No Limit ($0.02/$0.05) - 2023/12/22 21:04:00
Table 'RushAndCash776901' 6-max Seat #1 is the button
Seat 1: 3b87467 ($5.36 in chips)
Seat 2: Hero ($5 in chips)
Seat 3: 8e8d144e ($6.06 in chips)
Seat 4: 3dbf95c1 ($10.05 in chips)
Seat 5: ded2e0bf ($5.07 in chips)
Seat 6: c54f63b8 ($5.37 in chips)
Hero: posts small blind $0.02
8e8d144e: posts big blind $0.05
*** HOLE CARDS ***
Dealt to 3b87467 
Dealt to Hero [7c 5h]
Dealt to 8e8d144e 
Dealt to 3dbf95c1 
Dealt to ded2e0bf 
Dealt to c54f63b8 
3dbf95c1: folds
ded2e0bf: folds
c54f63b8: folds
3b87467: raises $0.08 to $0.13
Hero: folds
8e8d144e: calls $0.08
*** FLOP *** [3c Ks 5d]
8e8d144e: checks
3b87467: bets $0.14
8e8d144e: raises $0.42 to $0.56
3b87467: calls $0.42
*** TURN *** [3c Ks 5d] [Js]
8e8d144e: checks
3b87467: bets $0.7
8e8d144e: folds
Uncalled bet ($0.7) returned to 3b87467
*** SHOWDOWN ***
3b87467 collected $1.33 from pot
*** SUMMARY ***
Total pot $1.4 | Rake $0.07 | Jackpot $0 | Bingo $0 | Fortune $0 | Tax $0
Board [3c Ks 5d Js]
Seat 1: 3b87467 (button) won ($1.33)
Seat 2: Hero (small blind) folded before Flop
Seat 3: 8e8d144e (big blind) folded on the Turn
Seat 4: 3dbf95c1 folded before Flop (didn't bet)
Seat 5: ded2e0bf folded before Flop (didn't bet)
Seat 6: c54f63b8 folded before Flop (didn't bet)


Poker Hand #RC2078421731: Hold'em No Limit ($0.02/$0.05) - 2023/12/22 21:03:38
Table 'RushAndCash776712' 6-max Seat #1 is the button
Seat 1: 93d5c821 ($5.09 in chips)
Seat 2: 58864a6e ($15.32 in chips)
Seat 3: Hero ($5 in chips)
Seat 4: 23378cb ($4.58 in chips)
Seat 5: 9fd86997 ($19.14 in chips)
Seat 6: 4d5fe452 ($5 in chips)
58864a6e: posts small blind $0.02
Hero: posts big blind $0.05
*** HOLE CARDS ***
Dealt to 93d5c821 
Dealt to 58864a6e 
Dealt to Hero [2d As]
Dealt to 23378cb 
Dealt to 9fd86997 
Dealt to 4d5fe452 
23378cb: raises $0.05 to $0.1
9fd86997: folds
4d5fe452: folds
93d5c821: folds
58864a6e: folds
Hero: calls $0.05
*** FLOP *** [7d 7s 9h]
Hero: checks
23378cb: bets $0.08
Hero: folds
Uncalled bet ($0.08) returned to 23378cb
*** SHOWDOWN ***
23378cb collected $0.21 from pot
*** SUMMARY ***
Total pot $0.22 | Rake $0.01 | Jackpot $0 | Bingo $0 | Fortune $0 | Tax $0
Board [7d 7s 9h]
Seat 1: 93d5c821 (button) folded before Flop (didn't bet)
Seat 2: 58864a6e (small blind) folded before Flop
Seat 3: Hero (big blind) folded on the Flop
Seat 4: 23378cb won ($0.21)
Seat 5: 9fd86997 folded before Flop (didn't bet)
Seat 6: 4d5fe452 folded before Flop (didn't bet)


Poker Hand #RC2078421655: Hold'em No Limit ($0.02/$0.05) - 2023/12/22 21:03:34
Table 'RushAndCash776677' 6-max Seat #1 is the button
Seat 1: 8d0bca32 ($6.83 in chips)
Seat 2: e4d2f8b7 ($6.23 in chips)
Seat 3: 84497676 ($15.14 in chips)
Seat 4: 5c57b9e ($5.07 in chips)
Seat 5: 8d15f06b ($11.61 in chips)
Seat 6: Hero ($5 in chips)
e4d2f8b7: posts small blind $0.02
84497676: posts big blind $0.05
*** HOLE CARDS ***
Dealt to 8d0bca32 
Dealt to e4d2f8b7 
Dealt to 84497676 
Dealt to 5c57b9e 
Dealt to 8d15f06b 
Dealt to Hero [8h 6s]
5c57b9e: folds
8d15f06b: folds
Hero: folds
8d0bca32: folds
e4d2f8b7: folds
Uncalled bet ($0.03) returned to 84497676
*** SHOWDOWN ***
84497676 collected $0.04 from pot
*** SUMMARY ***
Total pot $0.04 | Rake $0 | Jackpot $0 | Bingo $0 | Fortune $0 | Tax $0
Seat 1: 8d0bca32 (button) folded before Flop (didn't bet)
Seat 2: e4d2f8b7 (small blind) folded before Flop
Seat 3: 84497676 (big blind) collected ($0.04)
Seat 4: 5c57b9e folded before Flop (didn't bet)
Seat 5: 8d15f06b folded before Flop (didn't bet)
Seat 6: Hero folded before Flop (didn't bet)


Poker Hand #RC2078421584: Hold'em No Limit ($0.02/$0.05) - 2023/12/22 21:03:30
Table 'RushAndCash776644' 6-max Seat #1 is the button
Seat 1: Hero ($5 in chips)
Seat 2: b61f5bde ($8.11 in chips)
Seat 3: d3b1f4ed ($5.02 in chips)
Seat 4: adc999b ($5.18 in chips)
Seat 5: cf6f5635 ($5.57 in chips)
Seat 6: 373d8880 ($5.07 in chips)
b61f5bde: posts small blind $0.02
d3b1f4ed: posts big blind $0.05
*** HOLE CARDS ***
Dealt to Hero [2d Kc]
Dealt to b61f5bde 
Dealt to d3b1f4ed 
Dealt to adc999b 
Dealt to cf6f5635 
Dealt to 373d8880 
adc999b: folds
cf6f5635: folds
373d8880: folds
Hero: folds
b61f5bde: raises $0.1 to $0.15
d3b1f4ed: calls $0.1
*** FLOP *** [Qh 8d Th]
b61f5bde: bets $0.1
d3b1f4ed: folds
Uncalled bet ($0.1) returned to b61f5bde
*** SHOWDOWN ***
b61f5bde collected $0.29 from pot
*** SUMMARY ***
Total pot $0.3 | Rake $0.01 | Jackpot $0 | Bingo $0 | Fortune $0 | Tax $0
Board [Qh 8d Th]
Seat 1: Hero (button) folded before Flop (didn't bet)
Seat 2: b61f5bde (small blind) won ($0.29)
Seat 3: d3b1f4ed (big blind) folded on the Flop
Seat 4: adc999b folded before Flop (didn't bet)
Seat 5: cf6f5635 folded before Flop (didn't bet)
Seat 6: 373d8880 folded before Flop (didn't bet)


Poker Hand #RC2078421511: Hold'em No Limit ($0.02/$0.05) - 2023/12/22 21:03:26
Table 'RushAndCash776610' 6-max Seat #1 is the button
Seat 1: 8f80311 ($2.54 in chips)
Seat 2: b8d8e3a7 ($5.82 in chips)
Seat 3: d56f57b9 ($5.62 in chips)
Seat 4: 53d2996c ($10.92 in chips)
Seat 5: Hero ($5 in chips)
Seat 6: 561e5b01 ($5.06 in chips)
b8d8e3a7: posts small blind $0.02
d56f57b9: posts big blind $0.05
*** HOLE CARDS ***
Dealt to 8f80311 
Dealt to b8d8e3a7 
Dealt to d56f57b9 
Dealt to 53d2996c 
Dealt to Hero [Ad 2s]
Dealt to 561e5b01 
53d2996c: folds
Hero: folds
561e5b01: folds
8f80311: folds
b8d8e3a7: raises $0.05 to $0.1
d56f57b9: raises $0.25 to $0.35
b8d8e3a7: calls $0.25
*** FLOP *** [8d 9s 5c]
b8d8e3a7: checks
d56f57b9: bets $0.35
b8d8e3a7: folds
Uncalled bet ($0.35) returned to d56f57b9
*** SHOWDOWN ***
d56f57b9 collected $0.67 from pot
*** SUMMARY ***
Total pot $0.7 | Rake $0.03 | Jackpot $0 | Bingo $0 | Fortune $0 | Tax $0
Board [8d 9s 5c]
Seat 1: 8f80311 (button) folded before Flop (didn't bet)
Seat 2: b8d8e3a7 (small blind) folded on the Flop
Seat 3: d56f57b9 (big blind) won ($0.67)
Seat 4: 53d2996c folded before Flop (didn't bet)
Seat 5: Hero folded before Flop (didn't bet)
Seat 6: 561e5b01 folded before Flop (didn't bet)


Poker Hand #RC2078421117: Hold'em No Limit ($0.02/$0.05) - 2023/12/22 21:03:05
Table 'RushAndCash776425' 6-max Seat #1 is the button
Seat 1: d3b1f4ed ($5.02 in chips)
Seat 2: Hero ($5 in chips)
Seat 3: 40c4a4f ($11.27 in chips)
Seat 4: 21196b97 ($5 in chips)
Seat 5: 8818ba78 ($7.57 in chips)
Seat 6: beea6e5f ($9.01 in chips)
Hero: posts small blind $0.02
40c4a4f: posts big blind $0.05
*** HOLE CARDS ***
Dealt to d3b1f4ed 
Dealt to Hero [Ad 2c]
Dealt to 40c4a4f 
Dealt to 21196b97 
Dealt to 8818ba78 
Dealt to beea6e5f 
21196b97: folds
8818ba78: folds
beea6e5f: raises $0.08 to $0.13
d3b1f4ed: folds
Hero: folds
40c4a4f: folds
Uncalled bet ($0.08) returned to beea6e5f
*** SHOWDOWN ***
beea6e5f collected $0.12 from pot
*** SUMMARY ***
Total pot $0.12 | Rake $0 | Jackpot $0 | Bingo $0 | Fortune $0 | Tax $0
Seat 1: d3b1f4ed (button) folded before Flop (didn't bet)
Seat 2: Hero (small blind) folded before Flop
Seat 3: 40c4a4f (big blind) folded before Flop
Seat 4: 21196b97 folded before Flop (didn't bet)
Seat 5: 8818ba78 folded before Flop (didn't bet)
Seat 6: beea6e5f collected ($0.12)


Poker Hand #RC2078420298: Hold'em No Limit ($0.02/$0.05) - 2023/12/22 21:02:18
Table 'RushAndCash776059' 6-max Seat #1 is the button
Seat 1: 8f1c60bf ($7.27 in chips)
Seat 2: 85f8105e ($18.8 in chips)
Seat 3: Hero ($5 in chips)
Seat 4: 8b0c9357 ($5.04 in chips)
Seat 5: 9796250f ($4.57 in chips)
Seat 6: 1fff7a0a ($5 in chips)
85f8105e: posts small blind $0.02
Hero: posts big blind $0.05
*** HOLE CARDS ***
Dealt to 8f1c60bf 
Dealt to 85f8105e 
Dealt to Hero [Qh Jc]
Dealt to 8b0c9357 
Dealt to 9796250f 
Dealt to 1fff7a0a 
8b0c9357: folds
9796250f: folds
1fff7a0a: raises $0.08 to $0.13
8f1c60bf: folds
85f8105e: folds
Hero: calls $0.08
*** FLOP *** [3d Th As]
Hero: checks
1fff7a0a: bets $0.1
Hero: calls $0.1
*** TURN *** [3d Th As] [Td]
Hero: checks
1fff7a0a: checks
*** RIVER *** [3d Th As Td] [Js]
Hero: checks
1fff7a0a: bets $0.24
Hero: folds
Uncalled bet ($0.24) returned to 1fff7a0a
*** SHOWDOWN ***
1fff7a0a collected $0.46 from pot
*** SUMMARY ***
Total pot $0.48 | Rake $0.02 | Jackpot $0 | Bingo $0 | Fortune $0 | Tax $0
Board [3d Th As Td Js]
Seat 1: 8f1c60bf (button) folded before Flop (didn't bet)
Seat 2: 85f8105e (small blind) folded before Flop
Seat 3: Hero (big blind) folded on the River
Seat 4: 8b0c9357 folded before Flop (didn't bet)
Seat 5: 9796250f folded before Flop (didn't bet)
Seat 6: 1fff7a0a won ($0.46)


Poker Hand #RC2078420235: Hold'em No Limit ($0.02/$0.05) - 2023/12/22 21:02:14
Table 'RushAndCash776030' 6-max Seat #1 is the button
Seat 1: 93d5c821 ($5.09 in chips)
Seat 2: dc851cb6 ($7 in chips)
Seat 3: 3a35e9f5 ($16.63 in chips)
Seat 4: 3f0bf20a ($5.45 in chips)
Seat 5: 4fedcb8f ($5 in chips)
Seat 6: Hero ($5 in chips)
dc851cb6: posts small blind $0.02
3a35e9f5: posts big blind $0.05
*** HOLE CARDS ***
Dealt to 93d5c821 
Dealt to dc851cb6 
Dealt to 3a35e9f5 
Dealt to 3f0bf20a 
Dealt to 4fedcb8f 
Dealt to Hero [Kh 2h]
3f0bf20a: folds
4fedcb8f: raises $0.1 to $0.15
Hero: folds
93d5c821: raises $0.25 to $0.4
dc851cb6: folds
3a35e9f5: calls $0.35
4fedcb8f: calls $0.25
*** FLOP *** [8h Ts 2c]
3a35e9f5: checks
4fedcb8f: checks
93d5c821: checks
*** TURN *** [8h Ts 2c] [5h]
3a35e9f5: checks
4fedcb8f: bets $0.61
93d5c821: folds
3a35e9f5: calls $0.61
*** RIVER *** [8h Ts 2c 5h] [3h]
3a35e9f5: checks
4fedcb8f: checks
3a35e9f5: shows [Ks Qs] (King-High)
4fedcb8f: shows [Kc Tc] (Pair of Tens)
*** SHOWDOWN ***
4fedcb8f collected $2.26 from pot
*** SUMMARY ***
Total pot $2.44 | Rake $0.11 | Jackpot $0.07 | Bingo $0 | Fortune $0 | Tax $0
Board [8h Ts 2c 5h 3h]
Seat 1: 93d5c821 (button) folded on the Turn
Seat 2: dc851cb6 (small blind) folded before Flop
Seat 3: 3a35e9f5 (big blind) showed [Ks Qs] and lost with King-High
Seat 4: 3f0bf20a folded before Flop (didn't bet)
Seat 5: 4fedcb8f showed [Kc Tc] and won ($2.26) with Pair of Tens
Seat 6: Hero folded before Flop (didn't bet)


Poker Hand #RC2078420146: Hold'em No Limit ($0.02/$0.05) - 2023/12/22 21:02:09
Table 'RushAndCash775986' 6-max Seat #1 is the button
Seat 1: 89dad04f ($10.55 in chips)
Seat 2: 38eafb19 ($5 in chips)
Seat 3: af92dfc8 ($5.26 in chips)
Seat 4: acefe839 ($14.99 in chips)
Seat 5: bd4a4d17 ($8.42 in chips)
Seat 6: Hero ($5 in chips)
38eafb19: posts small blind $0.02
af92dfc8: posts big blind $0.05
*** HOLE CARDS ***
Dealt to 89dad04f 
Dealt to 38eafb19 
Dealt to af92dfc8 
Dealt to acefe839 
Dealt to bd4a4d17 
Dealt to Hero [5d Qh]
acefe839: folds
bd4a4d17: folds
Hero: folds
89dad04f: folds
38eafb19: folds
Uncalled bet ($0.03) returned to af92dfc8
*** SHOWDOWN ***
af92dfc8 collected $0.04 from pot
*** SUMMARY ***
Total pot $0.04 | Rake $0 | Jackpot $0 | Bingo $0 | Fortune $0 | Tax $0
Seat 1: 89dad04f (button) folded before Flop (didn't bet)
Seat 2: 38eafb19 (small blind) folded before Flop
Seat 3: af92dfc8 (big blind) collected ($0.04)
Seat 4: acefe839 folded before Flop (didn't bet)
Seat 5: bd4a4d17 folded before Flop (didn't bet)
Seat 6: Hero folded before Flop (didn't bet)


Poker Hand #RC2078420087: Hold'em No Limit ($0.02/$0.05) - 2023/12/22 21:02:06
Table 'RushAndCash775957' 6-max Seat #1 is the button
Seat 1: 17206484 ($9.92 in chips)
Seat 2: 494d7c43 ($5.09 in chips)
Seat 3: 886872c9 ($5.47 in chips)
Seat 4: ce1db906 ($4.13 in chips)
Seat 5: Hero ($5 in chips)
Seat 6: 5945e592 ($3.5 in chips)
494d7c43: posts small blind $0.02
886872c9: posts big blind $0.05
*** HOLE CARDS ***
Dealt to 17206484 
Dealt to 494d7c43 
Dealt to 886872c9 
Dealt to ce1db906 
Dealt to Hero [Ks 8d]
Dealt to 5945e592 
ce1db906: folds
Hero: folds
5945e592: raises $0.1 to $0.15
17206484: folds
494d7c43: folds
886872c9: folds
Uncalled bet ($0.1) returned to 5945e592
*** SHOWDOWN ***
5945e592 collected $0.12 from pot
*** SUMMARY ***
Total pot $0.12 | Rake $0 | Jackpot $0 | Bingo $0 | Fortune $0 | Tax $0
Seat 1: 17206484 (button) folded before Flop (didn't bet)
Seat 2: 494d7c43 (small blind) folded before Flop
Seat 3: 886872c9 (big blind) folded before Flop
Seat 4: ce1db906 folded before Flop (didn't bet)
Seat 5: Hero folded before Flop (didn't bet)
Seat 6: 5945e592 collected ($0.12)


Poker Hand #RC2078419991: Hold'em No Limit ($0.02/$0.05) - 2023/12/22 21:02:01
Table 'RushAndCash775912' 6-max Seat #1 is the button
Seat 1: 816eac8 ($6.44 in chips)
Seat 2: c2881b52 ($14.08 in chips)
Seat 3: b976716a ($16.82 in chips)
Seat 4: 780930d2 ($6.76 in chips)
Seat 5: ddbe951e ($8.12 in chips)
Seat 6: Hero ($5 in chips)
c2881b52: posts small blind $0.02
b976716a: posts big blind $0.05
*** HOLE CARDS ***
Dealt to 816eac8 
Dealt to c2881b52 
Dealt to b976716a 
Dealt to 780930d2 
Dealt to ddbe951e 
Dealt to Hero [As 4c]
780930d2: folds
ddbe951e: folds
Hero: folds
816eac8: raises $0.06 to $0.11
c2881b52: folds
b976716a: calls $0.06
*** FLOP *** [Jh 9h Qd]
b976716a: checks
816eac8: checks
*** TURN *** [Jh 9h Qd] [Ts]
b976716a: checks
816eac8: bets $0.12
b976716a: folds
Uncalled bet ($0.12) returned to 816eac8
*** SHOWDOWN ***
816eac8 collected $0.23 from pot
*** SUMMARY ***
Total pot $0.24 | Rake $0.01 | Jackpot $0 | Bingo $0 | Fortune $0 | Tax $0
Board [Jh 9h Qd Ts]
Seat 1: 816eac8 (button) won ($0.23)
Seat 2: c2881b52 (small blind) folded before Flop
Seat 3: b976716a (big blind) folded on the Turn
Seat 4: 780930d2 folded before Flop (didn't bet)
Seat 5: ddbe951e folded before Flop (didn't bet)
Seat 6: Hero folded before Flop (didn't bet)


Poker Hand #RC2078419916: Hold'em No Limit ($0.02/$0.05) - 2023/12/22 21:01:56
Table 'RushAndCash775874' 6-max Seat #1 is the button
Seat 1: 9f0aa2dc ($5.11 in chips)
Seat 2: 7c950e30 ($10.97 in chips)
Seat 3: 10ba9f2b ($1.82 in chips)
Seat 4: Hero ($5 in chips)
Seat 5: d25ad10a ($58.53 in chips)
Seat 6: cb7dce24 ($5.53 in chips)
7c950e30: posts small blind $0.02
10ba9f2b: posts big blind $0.05
*** HOLE CARDS ***
Dealt to 9f0aa2dc 
Dealt to 7c950e30 
Dealt to 10ba9f2b 
Dealt to Hero [Ks 8s]
Dealt to d25ad10a 
Dealt to cb7dce24 
Hero: folds
d25ad10a: raises $0.08 to $0.13
cb7dce24: folds
9f0aa2dc: folds
7c950e30: folds
10ba9f2b: folds
Uncalled bet ($0.08) returned to d25ad10a
*** SHOWDOWN ***
d25ad10a collected $0.12 from pot
*** SUMMARY ***
Total pot $0.12 | Rake $0 | Jackpot $0 | Bingo $0 | Fortune $0 | Tax $0
Seat 1: 9f0aa2dc (button) folded before Flop (didn't bet)
Seat 2: 7c950e30 (small blind) folded before Flop
Seat 3: 10ba9f2b (big blind) folded before Flop
Seat 4: Hero folded before Flop (didn't bet)
Seat 5: d25ad10a collected ($0.12)
Seat 6: cb7dce24 folded before Flop (didn't bet)


Poker Hand #RC2078419069: Hold'em No Limit ($0.02/$0.05) - 2023/12/22 21:01:06
Table 'RushAndCash775475' 6-max Seat #1 is the button
Seat 1: 2ec85018 ($4.83 in chips)
Seat 2: 5aa55d39 ($7.09 in chips)
Seat 3: Hero ($5 in chips)
Seat 4: 53d2996c ($5 in chips)
Seat 5: b8e0eed ($5.77 in chips)
Seat 6: 7c10f852 ($22.25 in chips)
5aa55d39: posts small blind $0.02
Hero: posts big blind $0.05
*** HOLE CARDS ***
Dealt to 2ec85018 
Dealt to 5aa55d39 
Dealt to Hero [Tc Ad]
Dealt to 53d2996c 
Dealt to b8e0eed 
Dealt to 7c10f852 
53d2996c: folds
b8e0eed: raises $0.05 to $0.1
7c10f852: folds
2ec85018: folds
5aa55d39: folds
Hero: calls $0.05
*** FLOP *** [5c Kh 9h]
Hero: checks
b8e0eed: bets $0.08
Hero: calls $0.08
*** TURN *** [5c Kh 9h] [3c]
Hero: checks
b8e0eed: bets $0.48
Hero: folds
Uncalled bet ($0.48) returned to b8e0eed
*** SHOWDOWN ***
b8e0eed collected $0.37 from pot
*** SUMMARY ***
Total pot $0.38 | Rake $0.01 | Jackpot $0 | Bingo $0 | Fortune $0 | Tax $0
Board [5c Kh 9h 3c]
Seat 1: 2ec85018 (button) folded before Flop (didn't bet)
Seat 2: 5aa55d39 (small blind) folded before Flop
Seat 3: Hero (big blind) folded on the Turn
Seat 4: 53d2996c folded before Flop (didn't bet)
Seat 5: b8e0eed won ($0.37)
Seat 6: 7c10f852 folded before Flop (didn't bet)


Poker Hand #RC2078418856: Hold'em No Limit ($0.02/$0.05) - 2023/12/22 21:00:54
Table 'RushAndCash775378' 6-max Seat #1 is the button
Seat 1: 3b97cce8 ($9.19 in chips)
Seat 2: Hero ($5 in chips)
Seat 3: 1205c2ed ($5.07 in chips)
Seat 4: b61f5bde ($5 in chips)
Seat 5: 2ec85018 ($4.83 in chips)
Seat 6: d456b5e8 ($5.8 in chips)
Hero: posts small blind $0.02
1205c2ed: posts big blind $0.05
*** HOLE CARDS ***
Dealt to 3b97cce8 
Dealt to Hero [2c Qs]
Dealt to 1205c2ed 
Dealt to b61f5bde 
Dealt to 2ec85018 
Dealt to d456b5e8 
b61f5bde: folds
2ec85018: folds
d456b5e8: raises $0.07 to $0.12
3b97cce8: folds
Hero: folds
1205c2ed: calls $0.07
*** FLOP *** [Kd Ah 4s]
1205c2ed: checks
d456b5e8: checks
*** TURN *** [Kd Ah 4s] [5h]
1205c2ed: bets $0.16
d456b5e8: calls $0.16
*** RIVER *** [Kd Ah 4s 5h] [5c]
1205c2ed: bets $1.3
d456b5e8: folds
Uncalled bet ($1.3) returned to 1205c2ed
*** SHOWDOWN ***
1205c2ed collected $0.56 from pot
*** SUMMARY ***
Total pot $0.58 | Rake $0.02 | Jackpot $0 | Bingo $0 | Fortune $0 | Tax $0
Board [Kd Ah 4s 5h 5c]
Seat 1: 3b97cce8 (button) folded before Flop (didn't bet)
Seat 2: Hero (small blind) folded before Flop
Seat 3: 1205c2ed (big blind) won ($0.56)
Seat 4: b61f5bde folded before Flop (didn't bet)
Seat 5: 2ec85018 folded before Flop (didn't bet)
Seat 6: d456b5e8 folded on the River


Poker Hand #RC2078418592: Hold'em No Limit ($0.02/$0.05) - 2023/12/22 21:00:38
Table 'RushAndCash775262' 6-max Seat #1 is the button
Seat 1: Hero ($5 in chips)
Seat 2: 67d4b163 ($8.37 in chips)
Seat 3: 5da5ce8d ($18.78 in chips)
Seat 4: 317ccf77 ($2.48 in chips)
Seat 5: b00070f4 ($6.43 in chips)
Seat 6: 2588276e ($4.93 in chips)
67d4b163: posts small blind $0.02
5da5ce8d: posts big blind $0.05
*** HOLE CARDS ***
Dealt to Hero [Qd Jd]
Dealt to 67d4b163 
Dealt to 5da5ce8d 
Dealt to 317ccf77 
Dealt to b00070f4 
Dealt to 2588276e 
317ccf77: raises $0.08 to $0.13
b00070f4: folds
2588276e: raises $0.43 to $0.56
Hero: folds
67d4b163: folds
5da5ce8d: folds
317ccf77: folds
Uncalled bet ($0.43) returned to 2588276e
*** SHOWDOWN ***
2588276e collected $0.32 from pot
*** SUMMARY ***
Total pot $0.33 | Rake $0.01 | Jackpot $0 | Bingo $0 | Fortune $0 | Tax $0
Seat 1: Hero (button) folded before Flop (didn't bet)
Seat 2: 67d4b163 (small blind) folded before Flop
Seat 3: 5da5ce8d (big blind) folded before Flop
Seat 4: 317ccf77 folded before Flop
Seat 5: b00070f4 folded before Flop (didn't bet)
Seat 6: 2588276e collected ($0.32)


Poker Hand #RC2078418531: Hold'em No Limit ($0.02/$0.05) - 2023/12/22 21:00:35
Table 'RushAndCash775236' 6-max Seat #1 is the button
Seat 1: Hero ($5 in chips)
Seat 2: 59da0131 ($9.57 in chips)
Seat 3: 288c7c2 ($5 in chips)
Seat 4: 5c57b9e ($5 in chips)
Seat 5: 8429395c ($5 in chips)
Seat 6: 9217a216 ($5.06 in chips)
59da0131: posts small blind $0.02
288c7c2: posts big blind $0.05
*** HOLE CARDS ***
Dealt to Hero [Ts 3s]
Dealt to 59da0131 
Dealt to 288c7c2 
Dealt to 5c57b9e 
Dealt to 8429395c 
Dealt to 9217a216 
5c57b9e: raises $0.05 to $0.1
8429395c: folds
9217a216: folds
Hero: folds
59da0131: folds
288c7c2: folds
Uncalled bet ($0.05) returned to 5c57b9e
*** SHOWDOWN ***
5c57b9e collected $0.12 from pot
*** SUMMARY ***
Total pot $0.12 | Rake $0 | Jackpot $0 | Bingo $0 | Fortune $0 | Tax $0
Seat 1: Hero (button) folded before Flop (didn't bet)
Seat 2: 59da0131 (small blind) folded before Flop
Seat 3: 288c7c2 (big blind) folded before Flop
Seat 4: 5c57b9e collected ($0.12)
Seat 5: 8429395c folded before Flop (didn't bet)
Seat 6: 9217a216 folded before Flop (didn't bet)


Poker Hand #RC2078418467: Hold'em No Limit ($0.02/$0.05) - 2023/12/22 21:00:31
Table 'RushAndCash775208' 6-max Seat #1 is the button
Seat 1: 7ddba90d ($4.93 in chips)
Seat 2: eb19bb65 ($10.09 in chips)
Seat 3: f1ad1c02 ($1.07 in chips)
Seat 4: 175b9638 ($5 in chips)
Seat 5: Hero ($5 in chips)
Seat 6: 9217a216 ($5.06 in chips)
eb19bb65: posts small blind $0.02
f1ad1c02: posts big blind $0.05
*** HOLE CARDS ***
Dealt to 7ddba90d 
Dealt to eb19bb65 
Dealt to f1ad1c02 
Dealt to 175b9638 
Dealt to Hero [Ad 4s]
Dealt to 9217a216 
175b9638: folds
Hero: folds
9217a216: folds
7ddba90d: folds
eb19bb65: folds
Uncalled bet ($0.03) returned to f1ad1c02
*** SHOWDOWN ***
f1ad1c02 collected $0.04 from pot
*** SUMMARY ***
Total pot $0.04 | Rake $0 | Jackpot $0 | Bingo $0 | Fortune $0 | Tax $0
Seat 1: 7ddba90d (button) folded before Flop (didn't bet)
Seat 2: eb19bb65 (small blind) folded before Flop
Seat 3: f1ad1c02 (big blind) collected ($0.04)
Seat 4: 175b9638 folded before Flop (didn't bet)
Seat 5: Hero folded before Flop (didn't bet)
Seat 6: 9217a216 folded before Flop (didn't bet)


Poker Hand #RC2078418377: Hold'em No Limit ($0.02/$0.05) - 2023/12/22 21:00:27
Table 'RushAndCash775170' 6-max Seat #1 is the button
Seat 1: 1205c2ed ($5 in chips)
Seat 2: f3b8bc9d ($13.51 in chips)
Seat 3: 680eb0e1 ($9.57 in chips)
Seat 4: Hero ($5 in chips)
Seat 5: d51e5ac3 ($11.3 in chips)
Seat 6: b9aa0c94 ($4.94 in chips)
f3b8bc9d: posts small blind $0.02
680eb0e1: posts big blind $0.05
*** HOLE CARDS ***
Dealt to 1205c2ed 
Dealt to f3b8bc9d 
Dealt to 680eb0e1 
Dealt to Hero [2h 6d]
Dealt to d51e5ac3 
Dealt to b9aa0c94 
Hero: folds
d51e5ac3: folds
b9aa0c94: folds
1205c2ed: folds
f3b8bc9d: raises $0.1 to $0.15
680eb0e1: calls $0.1
*** FLOP *** [3c 8h Kc]
f3b8bc9d: bets $0.15
680eb0e1: folds
Uncalled bet ($0.15) returned to f3b8bc9d
*** SHOWDOWN ***
f3b8bc9d collected $0.29 from pot
*** SUMMARY ***
Total pot $0.3 | Rake $0.01 | Jackpot $0 | Bingo $0 | Fortune $0 | Tax $0
Board [3c 8h Kc]
Seat 1: 1205c2ed (button) folded before Flop (didn't bet)
Seat 2: f3b8bc9d (small blind) won ($0.29)
Seat 3: 680eb0e1 (big blind) folded on the Flop
Seat 4: Hero folded before Flop (didn't bet)
Seat 5: d51e5ac3 folded before Flop (didn't bet)
Seat 6: b9aa0c94 folded before Flop (didn't bet)


Poker Hand #RC2078418285: Hold'em No Limit ($0.02/$0.05) - 2023/12/22 21:00:22
Table 'RushAndCash775130' 6-max Seat #1 is the button
Seat 1: c4c1c89a ($5.15 in chips)
Seat 2: 5d317abf ($7.36 in chips)
Seat 3: Hero ($5.05 in chips)
Seat 4: 8d0bca32 ($5.76 in chips)
Seat 5: 1cfe329a ($6.22 in chips)
Seat 6: 5b2bf61b ($5.44 in chips)
5d317abf: posts small blind $0.02
Hero: posts big blind $0.05
*** HOLE CARDS ***
Dealt to c4c1c89a 
Dealt to 5d317abf 
Dealt to Hero [Jh 9s]
Dealt to 8d0bca32 
Dealt to 1cfe329a 
Dealt to 5b2bf61b 
8d0bca32: folds
1cfe329a: folds
5b2bf61b: folds
c4c1c89a: raises $0.1 to $0.15
5d317abf: folds
Hero: folds
Uncalled bet ($0.1) returned to c4c1c89a
*** SHOWDOWN ***
c4c1c89a collected $0.12 from pot
*** SUMMARY ***
Total pot $0.12 | Rake $0 | Jackpot $0 | Bingo $0 | Fortune $0 | Tax $0
Seat 1: c4c1c89a (button) collected ($0.12)
Seat 2: 5d317abf (small blind) folded before Flop
Seat 3: Hero (big blind) folded before Flop
Seat 4: 8d0bca32 folded before Flop (didn't bet)
Seat 5: 1cfe329a folded before Flop (didn't bet)
Seat 6: 5b2bf61b folded before Flop (didn't bet)


Poker Hand #RC2078418160: Hold'em No Limit ($0.02/$0.05) - 2023/12/22 21:00:14
Table 'RushAndCash775080' 6-max Seat #1 is the button
Seat 1: eb19bb65 ($10.16 in chips)
Seat 2: Hero ($5.07 in chips)
Seat 3: 4c660603 ($5.05 in chips)
Seat 4: 2a364a29 ($7.76 in chips)
Seat 5: 72c24b08 ($5.51 in chips)
Seat 6: c08cf99d ($11.07 in chips)
Hero: posts small blind $0.02
4c660603: posts big blind $0.05
*** HOLE CARDS ***
Dealt to eb19bb65 
Dealt to Hero [Kd 6d]
Dealt to 4c660603 
Dealt to 2a364a29 
Dealt to 72c24b08 
Dealt to c08cf99d 
2a364a29: raises $0.05 to $0.1
72c24b08: folds
c08cf99d: folds
eb19bb65: folds
Hero: folds
4c660603: folds
Uncalled bet ($0.05) returned to 2a364a29
*** SHOWDOWN ***
2a364a29 collected $0.12 from pot
*** SUMMARY ***
Total pot $0.12 | Rake $0 | Jackpot $0 | Bingo $0 | Fortune $0 | Tax $0
Seat 1: eb19bb65 (button) folded before Flop (didn't bet)
Seat 2: Hero (small blind) folded before Flop
Seat 3: 4c660603 (big blind) folded before Flop
Seat 4: 2a364a29 collected ($0.12)
Seat 5: 72c24b08 folded before Flop (didn't bet)
Seat 6: c08cf99d folded before Flop (didn't bet)


Poker Hand #RC2078418069: Hold'em No Limit ($0.02/$0.05) - 2023/12/22 21:00:09
Table 'RushAndCash775043' 6-max Seat #1 is the button
Seat 1: 68c6c5e7 ($12 in chips)
Seat 2: 4b5380b0 ($60.38 in chips)
Seat 3: 8d09c020 ($6.62 in chips)
Seat 4: 3928912e ($5 in chips)
Seat 5: 8e29353e ($5.73 in chips)
Seat 6: Hero ($5.07 in chips)
4b5380b0: posts small blind $0.02
8d09c020: posts big blind $0.05
*** HOLE CARDS ***
Dealt to 68c6c5e7 
Dealt to 4b5380b0 
Dealt to 8d09c020 
Dealt to 3928912e 
Dealt to 8e29353e 
Dealt to Hero [3d Th]
3928912e: folds
8e29353e: folds
Hero: folds
68c6c5e7: raises $0.05 to $0.1
4b5380b0: folds
8d09c020: folds
Uncalled bet ($0.05) returned to 68c6c5e7
*** SHOWDOWN ***
68c6c5e7 collected $0.12 from pot
*** SUMMARY ***
Total pot $0.12 | Rake $0 | Jackpot $0 | Bingo $0 | Fortune $0 | Tax $0
Seat 1: 68c6c5e7 (button) collected ($0.12)
Seat 2: 4b5380b0 (small blind) folded before Flop
Seat 3: 8d09c020 (big blind) folded before Flop
Seat 4: 3928912e folded before Flop (didn't bet)
Seat 5: 8e29353e folded before Flop (didn't bet)
Seat 6: Hero folded before Flop (didn't bet)


Poker Hand #RC2078417762: Hold'em No Limit ($0.02/$0.05) - 2023/12/22 20:59:52
Table 'RushAndCash774906' 6-max Seat #1 is the button
Seat 1: 857de63c ($8.87 in chips)
Seat 2: 5945e592 ($2.76 in chips)
Seat 3: 921e997e ($8.49 in chips)
Seat 4: Hero ($5 in chips)
Seat 5: 4d43d419 ($5 in chips)
Seat 6: cdd2600a ($3.97 in chips)
5945e592: posts small blind $0.02
921e997e: posts big blind $0.05
*** HOLE CARDS ***
Dealt to 857de63c 
Dealt to 5945e592 
Dealt to 921e997e 
Dealt to Hero [Ks Ts]
Dealt to 4d43d419 
Dealt to cdd2600a 
Hero: raises $0.05 to $0.1
4d43d419: folds
cdd2600a: folds
857de63c: folds
5945e592: folds
921e997e: folds
Uncalled bet ($0.05) returned to Hero
*** SHOWDOWN ***
Hero collected $0.12 from pot
*** SUMMARY ***
Total pot $0.12 | Rake $0 | Jackpot $0 | Bingo $0 | Fortune $0 | Tax $0
Seat 1: 857de63c (button) folded before Flop (didn't bet)
Seat 2: 5945e592 (small blind) folded before Flop
Seat 3: 921e997e (big blind) folded before Flop
Seat 4: Hero collected ($0.12)
Seat 5: 4d43d419 folded before Flop (didn't bet)
Seat 6: cdd2600a folded before Flop (didn't bet)


Poker Hand #RC2078417672: Hold'em No Limit ($0.02/$0.05) - 2023/12/22 20:59:46
Table 'RushAndCash774866' 6-max Seat #1 is the button
Seat 1: Hero ($5 in chips)
Seat 2: 610bd7fc ($10.73 in chips)
Seat 3: 83f47841 ($3.94 in chips)
Seat 4: cdb7c904 ($8.12 in chips)
Seat 5: 84497676 ($14.99 in chips)
Seat 6: dab73dc2 ($5 in chips)
610bd7fc: posts small blind $0.02
83f47841: posts big blind $0.05
*** HOLE CARDS ***
Dealt to Hero [Td 6c]
Dealt to 610bd7fc 
Dealt to 83f47841 
Dealt to cdb7c904 
Dealt to 84497676 
Dealt to dab73dc2 
cdb7c904: folds
84497676: raises $0.08 to $0.13
dab73dc2: folds
Hero: folds
610bd7fc: folds
83f47841: folds
Uncalled bet ($0.08) returned to 84497676
*** SHOWDOWN ***
84497676 collected $0.12 from pot
*** SUMMARY ***
Total pot $0.12 | Rake $0 | Jackpot $0 | Bingo $0 | Fortune $0 | Tax $0
Seat 1: Hero (button) folded before Flop (didn't bet)
Seat 2: 610bd7fc (small blind) folded before Flop
Seat 3: 83f47841 (big blind) folded before Flop
Seat 4: cdb7c904 folded before Flop (didn't bet)
Seat 5: 84497676 collected ($0.12)
Seat 6: dab73dc2 folded before Flop (didn't bet)


Poker Hand #RC2078417507: Hold'em No Limit ($0.02/$0.05) - 2023/12/22 20:59:36
Table 'RushAndCash774792' 6-max Seat #1 is the button
Seat 1: 317ccf77 ($2.48 in chips)
Seat 2: d29426f7 ($5.36 in chips)
Seat 3: ceb10c49 ($5.89 in chips)
Seat 4: 7c950e30 ($10.94 in chips)
Seat 5: Hero ($5 in chips)
Seat 6: 3216f2c0 ($5.83 in chips)
d29426f7: posts small blind $0.02
ceb10c49: posts big blind $0.05
*** HOLE CARDS ***
Dealt to 317ccf77 
Dealt to d29426f7 
Dealt to ceb10c49 
Dealt to 7c950e30 
Dealt to Hero [Jc Ts]
Dealt to 3216f2c0 
7c950e30: folds
Hero: folds
3216f2c0: raises $0.07 to $0.12
317ccf77: folds
d29426f7: folds
ceb10c49: folds
Uncalled bet ($0.07) returned to 3216f2c0
*** SHOWDOWN ***
3216f2c0 collected $0.12 from pot
*** SUMMARY ***
Total pot $0.12 | Rake $0 | Jackpot $0 | Bingo $0 | Fortune $0 | Tax $0
Seat 1: 317ccf77 (button) folded before Flop (didn't bet)
Seat 2: d29426f7 (small blind) folded before Flop
Seat 3: ceb10c49 (big blind) folded before Flop
Seat 4: 7c950e30 folded before Flop (didn't bet)
Seat 5: Hero folded before Flop (didn't bet)
Seat 6: 3216f2c0 collected ($0.12)


Poker Hand #RC2078417419: Hold'em No Limit ($0.02/$0.05) - 2023/12/22 20:59:31
Table 'RushAndCash774749' 6-max Seat #1 is the button
Seat 1: 72c24b08 ($5 in chips)
Seat 2: Hero ($5 in chips)
Seat 3: 72f7386e ($9.41 in chips)
Seat 4: 8d0bca32 ($5.52 in chips)
Seat 5: 2471888a ($5.22 in chips)
Seat 6: bbf08286 ($5.59 in chips)
Hero: posts small blind $0.02
72f7386e: posts big blind $0.05
*** HOLE CARDS ***
Dealt to 72c24b08 
Dealt to Hero [7c 9d]
Dealt to 72f7386e 
Dealt to 8d0bca32 
Dealt to 2471888a 
Dealt to bbf08286 
8d0bca32: folds
2471888a: folds
bbf08286: raises $0.05 to $0.1
72c24b08: folds
Hero: folds
72f7386e: folds
Uncalled bet ($0.05) returned to bbf08286
*** SHOWDOWN ***
bbf08286 collected $0.12 from pot
*** SUMMARY ***
Total pot $0.12 | Rake $0 | Jackpot $0 | Bingo $0 | Fortune $0 | Tax $0
Seat 1: 72c24b08 (button) folded before Flop (didn't bet)
Seat 2: Hero (small blind) folded before Flop
Seat 3: 72f7386e (big blind) folded before Flop
Seat 4: 8d0bca32 folded before Flop (didn't bet)
Seat 5: 2471888a folded before Flop (didn't bet)
Seat 6: bbf08286 collected ($0.12)


Poker Hand #RC2078417254: Hold'em No Limit ($0.02/$0.05) - 2023/12/22 20:59:22
Table 'RushAndCash774667' 6-max Seat #1 is the button
Seat 1: f4ef789c ($9.35 in chips)
Seat 2: 548ecbec ($5.05 in chips)
Seat 3: Hero ($5.05 in chips)
Seat 4: 7ab29bd ($5 in chips)
Seat 5: b9504139 ($9.64 in chips)
Seat 6: 8eab241d ($6.25 in chips)
548ecbec: posts small blind $0.02
Hero: posts big blind $0.05
*** HOLE CARDS ***
Dealt to f4ef789c 
Dealt to 548ecbec 
Dealt to Hero [6s 7h]
Dealt to 7ab29bd 
Dealt to b9504139 
Dealt to 8eab241d 
7ab29bd: folds
b9504139: folds
8eab241d: folds
f4ef789c: raises $0.08 to $0.13
548ecbec: folds
Hero: folds
Uncalled bet ($0.08) returned to f4ef789c
*** SHOWDOWN ***
f4ef789c collected $0.12 from pot
*** SUMMARY ***
Total pot $0.12 | Rake $0 | Jackpot $0 | Bingo $0 | Fortune $0 | Tax $0
Seat 1: f4ef789c (button) collected ($0.12)
Seat 2: 548ecbec (small blind) folded before Flop
Seat 3: Hero (big blind) folded before Flop
Seat 4: 7ab29bd folded before Flop (didn't bet)
Seat 5: b9504139 folded before Flop (didn't bet)
Seat 6: 8eab241d folded before Flop (didn't bet)


Poker Hand #RC2078417193: Hold'em No Limit ($0.02/$0.05) - 2023/12/22 20:59:18
Table 'RushAndCash774638' 6-max Seat #1 is the button
Seat 1: ee1f67f7 ($9.57 in chips)
Seat 2: 8eb71456 ($12.2 in chips)
Seat 3: c2796cf2 ($6.71 in chips)
Seat 4: Hero ($5.05 in chips)
Seat 5: ce5771af ($8.1 in chips)
Seat 6: 59c7f4b1 ($9.27 in chips)
8eb71456: posts small blind $0.02
c2796cf2: posts big blind $0.05
*** HOLE CARDS ***
Dealt to ee1f67f7 
Dealt to 8eb71456 
Dealt to c2796cf2 
Dealt to Hero [5d Tc]
Dealt to ce5771af 
Dealt to 59c7f4b1 
Hero: folds
ce5771af: folds
59c7f4b1: folds
ee1f67f7: folds
8eb71456: folds
Uncalled bet ($0.03) returned to c2796cf2
*** SHOWDOWN ***
c2796cf2 collected $0.04 from pot
*** SUMMARY ***
Total pot $0.04 | Rake $0 | Jackpot $0 | Bingo $0 | Fortune $0 | Tax $0
Seat 1: ee1f67f7 (button) folded before Flop (didn't bet)
Seat 2: 8eb71456 (small blind) folded before Flop
Seat 3: c2796cf2 (big blind) collected ($0.04)
Seat 4: Hero folded before Flop (didn't bet)
Seat 5: ce5771af folded before Flop (didn't bet)
Seat 6: 59c7f4b1 folded before Flop (didn't bet)


Poker Hand #RC2078417120: Hold'em No Limit ($0.02/$0.05) - 2023/12/22 20:59:14
Table 'RushAndCash774606' 6-max Seat #1 is the button
Seat 1: 8818ba78 ($7.54 in chips)
Seat 2: a2fed278 ($5.12 in chips)
Seat 3: 89c6e004 ($5.94 in chips)
Seat 4: f4ef789c ($9.35 in chips)
Seat 5: Hero ($5.05 in chips)
Seat 6: 2f160a64 ($9.89 in chips)
a2fed278: posts small blind $0.02
89c6e004: posts big blind $0.05
*** HOLE CARDS ***
Dealt to 8818ba78 
Dealt to a2fed278 
Dealt to 89c6e004 
Dealt to f4ef789c 
Dealt to Hero [5d Qc]
Dealt to 2f160a64 
f4ef789c: folds
Hero: folds
2f160a64: folds
8818ba78: folds
a2fed278: raises $0.05 to $0.1
89c6e004: calls $0.05
*** FLOP *** [3c Ah 2c]
a2fed278: checks
89c6e004: bets $0.1
a2fed278: folds
Uncalled bet ($0.1) returned to 89c6e004
*** SHOWDOWN ***
89c6e004 collected $0.19 from pot
*** SUMMARY ***
Total pot $0.2 | Rake $0.01 | Jackpot $0 | Bingo $0 | Fortune $0 | Tax $0
Board [3c Ah 2c]
Seat 1: 8818ba78 (button) folded before Flop (didn't bet)
Seat 2: a2fed278 (small blind) folded on the Flop
Seat 3: 89c6e004 (big blind) won ($0.19)
Seat 4: f4ef789c folded before Flop (didn't bet)
Seat 5: Hero folded before Flop (didn't bet)
Seat 6: 2f160a64 folded before Flop (didn't bet)


Poker Hand #RC2078417038: Hold'em No Limit ($0.02/$0.05) - 2023/12/22 20:59:09
Table 'RushAndCash774568' 6-max Seat #1 is the button
Seat 1: 8e45cdc4 ($5 in chips)
Seat 2: 9ab125dd ($9.53 in chips)
Seat 3: 998574b7 ($5.07 in chips)
Seat 4: Hero ($5.05 in chips)
Seat 5: edb6154b ($5 in chips)
Seat 6: 87a6d73f ($5.43 in chips)
9ab125dd: posts small blind $0.02
998574b7: posts big blind $0.05
*** HOLE CARDS ***
Dealt to 8e45cdc4 
Dealt to 9ab125dd 
Dealt to 998574b7 
Dealt to Hero [9s 3s]
Dealt to edb6154b 
Dealt to 87a6d73f 
Hero: folds
edb6154b: folds
87a6d73f: folds
8e45cdc4: folds
9ab125dd: folds
Uncalled bet ($0.03) returned to 998574b7
*** SHOWDOWN ***
998574b7 collected $0.04 from pot
*** SUMMARY ***
Total pot $0.04 | Rake $0 | Jackpot $0 | Bingo $0 | Fortune $0 | Tax $0
Seat 1: 8e45cdc4 (button) folded before Flop (didn't bet)
Seat 2: 9ab125dd (small blind) folded before Flop
Seat 3: 998574b7 (big blind) collected ($0.04)
Seat 4: Hero folded before Flop (didn't bet)
Seat 5: edb6154b folded before Flop (didn't bet)
Seat 6: 87a6d73f folded before Flop (didn't bet)


Poker Hand #RC2078416952: Hold'em No Limit ($0.02/$0.05) - 2023/12/22 20:59:04
Table 'RushAndCash774529' 6-max Seat #1 is the button
Seat 1: 341cb855 ($5.71 in chips)
Seat 2: Hero ($5.07 in chips)
Seat 3: e7283841 ($2.85 in chips)
Seat 4: 5d55167a ($9.74 in chips)
Seat 5: 9ab125dd ($9.53 in chips)
Seat 6: 1db6ddb1 ($4.89 in chips)
Hero: posts small blind $0.02
e7283841: posts big blind $0.05
*** HOLE CARDS ***
Dealt to 341cb855 
Dealt to Hero [2c Kc]
Dealt to e7283841 
Dealt to 5d55167a 
Dealt to 9ab125dd 
Dealt to 1db6ddb1 
5d55167a: folds
9ab125dd: folds
1db6ddb1: folds
341cb855: raises $0.08 to $0.13
Hero: folds
e7283841: folds
Uncalled bet ($0.08) returned to 341cb855
*** SHOWDOWN ***
341cb855 collected $0.12 from pot
*** SUMMARY ***
Total pot $0.12 | Rake $0 | Jackpot $0 | Bingo $0 | Fortune $0 | Tax $0
Seat 1: 341cb855 (button) collected ($0.12)
Seat 2: Hero (small blind) folded before Flop
Seat 3: e7283841 (big blind) folded before Flop
Seat 4: 5d55167a folded before Flop (didn't bet)
Seat 5: 9ab125dd folded before Flop (didn't bet)
Seat 6: 1db6ddb1 folded before Flop (didn't bet)


Poker Hand #RC2078416901: Hold'em No Limit ($0.02/$0.05) - 2023/12/22 20:59:01
Table 'RushAndCash774504' 6-max Seat #1 is the button
Seat 1: Hero ($5 in chips)
Seat 2: cc195bc9 ($2.87 in chips)
Seat 3: b18917a1 ($5.07 in chips)
Seat 4: 96f3ff6 ($9.59 in chips)
Seat 5: 50cbc258 ($6.56 in chips)
Seat 6: fb772588 ($5 in chips)
cc195bc9: posts small blind $0.02
b18917a1: posts big blind $0.05
*** HOLE CARDS ***
Dealt to Hero [2c 8h]
Dealt to cc195bc9 
Dealt to b18917a1 
Dealt to 96f3ff6 
Dealt to 50cbc258 
Dealt to fb772588 
96f3ff6: folds
50cbc258: folds
fb772588: raises $0.15 to $0.2
Hero: folds
cc195bc9: calls $0.18
b18917a1: folds
*** FLOP *** [8s 3c 8d]
cc195bc9: checks
fb772588: bets $0.34
cc195bc9: folds
Uncalled bet ($0.34) returned to fb772588
*** SHOWDOWN ***
fb772588 collected $0.43 from pot
*** SUMMARY ***
Total pot $0.45 | Rake $0.02 | Jackpot $0 | Bingo $0 | Fortune $0 | Tax $0
Board [8s 3c 8d]
Seat 1: Hero (button) folded before Flop (didn't bet)
Seat 2: cc195bc9 (small blind) folded on the Flop
Seat 3: b18917a1 (big blind) folded before Flop
Seat 4: 96f3ff6 folded before Flop (didn't bet)
Seat 5: 50cbc258 folded before Flop (didn't bet)
Seat 6: fb772588 won ($0.43)


Poker Hand #RC2078416812: Hold'em No Limit ($0.02/$0.05) - 2023/12/22 20:58:56
Table 'RushAndCash774462' 6-max Seat #1 is the button
Seat 1: 5d55167a ($9.74 in chips)
Seat 2: f266e6e1 ($4.68 in chips)
Seat 3: Hero ($5 in chips)
Seat 4: a021c094 ($5 in chips)
Seat 5: ef402e16 ($6.17 in chips)
Seat 6: c3adc948 ($6.11 in chips)
f266e6e1: posts small blind $0.02
Hero: posts big blind $0.05
*** HOLE CARDS ***
Dealt to 5d55167a 
Dealt to f266e6e1 
Dealt to Hero [3s Jc]
Dealt to a021c094 
Dealt to ef402e16 
Dealt to c3adc948 
a021c094: folds
ef402e16: folds
c3adc948: folds
5d55167a: folds
f266e6e1: folds
Uncalled bet ($0.03) returned to Hero
*** SHOWDOWN ***
Hero collected $0.04 from pot
*** SUMMARY ***
Total pot $0.04 | Rake $0 | Jackpot $0 | Bingo $0 | Fortune $0 | Tax $0
Seat 1: 5d55167a (button) folded before Flop (didn't bet)
Seat 2: f266e6e1 (small blind) folded before Flop
Seat 3: Hero (big blind) collected ($0.04)
Seat 4: a021c094 folded before Flop (didn't bet)
Seat 5: ef402e16 folded before Flop (didn't bet)
Seat 6: c3adc948 folded before Flop (didn't bet)


Poker Hand #RC2078416748: Hold'em No Limit ($0.02/$0.05) - 2023/12/22 20:58:52
Table 'RushAndCash774433' 6-max Seat #1 is the button
Seat 1: c3c9a58d ($2.31 in chips)
Seat 2: 548ecbec ($5 in chips)
Seat 3: b80e619f ($3.43 in chips)
Seat 4: 8014c02 ($19.28 in chips)
Seat 5: 20a136d7 ($5.75 in chips)
Seat 6: Hero ($5 in chips)
548ecbec: posts small blind $0.02
b80e619f: posts big blind $0.05
*** HOLE CARDS ***
Dealt to c3c9a58d 
Dealt to 548ecbec 
Dealt to b80e619f 
Dealt to 8014c02 
Dealt to 20a136d7 
Dealt to Hero [Kc 3h]
8014c02: folds
20a136d7: folds
Hero: folds
c3c9a58d: folds
548ecbec: raises $0.08 to $0.13
b80e619f: folds
Uncalled bet ($0.08) returned to 548ecbec
*** SHOWDOWN ***
548ecbec collected $0.1 from pot
*** SUMMARY ***
Total pot $0.1 | Rake $0 | Jackpot $0 | Bingo $0 | Fortune $0 | Tax $0
Seat 1: c3c9a58d (button) folded before Flop (didn't bet)
Seat 2: 548ecbec (small blind) collected ($0.1)
Seat 3: b80e619f (big blind) folded before Flop
Seat 4: 8014c02 folded before Flop (didn't bet)
Seat 5: 20a136d7 folded before Flop (didn't bet)
Seat 6: Hero folded before Flop (didn't bet)


Poker Hand #RC2078416620: Hold'em No Limit ($0.02/$0.05) - 2023/12/22 20:58:44
Table 'RushAndCash774372' 6-max Seat #1 is the button
Seat 1: 412701ed ($6.02 in chips)
Seat 2: f3b8bc9d ($6.79 in chips)
Seat 3: 8014c02 ($19.33 in chips)
Seat 4: 4eb466f4 ($12.42 in chips)
Seat 5: cb9a7609 ($5 in chips)
Seat 6: Hero ($5 in chips)
f3b8bc9d: posts small blind $0.02
8014c02: posts big blind $0.05
*** HOLE CARDS ***
Dealt to 412701ed 
Dealt to f3b8bc9d 
Dealt to 8014c02 
Dealt to 4eb466f4 
Dealt to cb9a7609 
Dealt to Hero [Kh 6h]
4eb466f4: folds
cb9a7609: folds
Hero: folds
412701ed: raises $0.05 to $0.1
f3b8bc9d: folds
8014c02: folds
Uncalled bet ($0.05) returned to 412701ed
*** SHOWDOWN ***
412701ed collected $0.12 from pot
*** SUMMARY ***
Total pot $0.12 | Rake $0 | Jackpot $0 | Bingo $0 | Fortune $0 | Tax $0
Seat 1: 412701ed (button) collected ($0.12)
Seat 2: f3b8bc9d (small blind) folded before Flop
Seat 3: 8014c02 (big blind) folded before Flop
Seat 4: 4eb466f4 folded before Flop (didn't bet)
Seat 5: cb9a7609 folded before Flop (didn't bet)
Seat 6: Hero folded before Flop (didn't bet)


Poker Hand #RC2078416512: Hold'em No Limit ($0.02/$0.05) - 2023/12/22 20:58:39
Table 'RushAndCash774319' 6-max Seat #1 is the button
Seat 1: 9a5fcc04 ($12.97 in chips)
Seat 2: 25941725 ($5.17 in chips)
Seat 3: 3153aed0 ($10.71 in chips)
Seat 4: 2075befd ($5.9 in chips)
Seat 5: a8ee5981 ($4.89 in chips)
Seat 6: Hero ($5 in chips)
25941725: posts small blind $0.02
3153aed0: posts big blind $0.05
*** HOLE CARDS ***
Dealt to 9a5fcc04 
Dealt to 25941725 
Dealt to 3153aed0 
Dealt to 2075befd 
Dealt to a8ee5981 
Dealt to Hero [Qc 7d]
2075befd: folds
a8ee5981: folds
Hero: folds
9a5fcc04: raises $0.08 to $0.13
25941725: calls $0.11
3153aed0: raises $0.43 to $0.56
9a5fcc04: raises $0.69 to $1.25
25941725: folds
3153aed0: folds
Uncalled bet ($0.69) returned to 9a5fcc04
*** SHOWDOWN ***
9a5fcc04 collected $1.19 from pot
*** SUMMARY ***
Total pot $1.25 | Rake $0.06 | Jackpot $0 | Bingo $0 | Fortune $0 | Tax $0
Seat 1: 9a5fcc04 (button) collected ($1.19)
Seat 2: 25941725 (small blind) folded before Flop
Seat 3: 3153aed0 (big blind) folded before Flop
Seat 4: 2075befd folded before Flop (didn't bet)
Seat 5: a8ee5981 folded before Flop (didn't bet)
Seat 6: Hero folded before Flop (didn't bet)


Poker Hand #RC2078415951: Hold'em No Limit ($0.02/$0.05) - 2023/12/22 20:58:08
Table 'RushAndCash774070' 6-max Seat #1 is the button
Seat 1: 4810f2d7 ($7.86 in chips)
Seat 2: 134b65d0 ($5.79 in chips)
Seat 3: Hero ($5 in chips)
Seat 4: cb07f953 ($8.96 in chips)
Seat 5: a55de19c ($35.43 in chips)
Seat 6: e9650524 ($3.15 in chips)
134b65d0: posts small blind $0.02
Hero: posts big blind $0.05
*** HOLE CARDS ***
Dealt to 4810f2d7 
Dealt to 134b65d0 
Dealt to Hero [4h 5h]
Dealt to cb07f953 
Dealt to a55de19c 
Dealt to e9650524 
cb07f953: folds
a55de19c: folds
e9650524: folds
4810f2d7: raises $0.08 to $0.13
134b65d0: folds
Hero: calls $0.08
*** FLOP *** [Ad 6h Kd]
Hero: checks
4810f2d7: bets $0.09
Hero: folds
Uncalled bet ($0.09) returned to 4810f2d7
*** SHOWDOWN ***
4810f2d7 collected $0.27 from pot
*** SUMMARY ***
Total pot $0.28 | Rake $0.01 | Jackpot $0 | Bingo $0 | Fortune $0 | Tax $0
Board [Ad 6h Kd]
Seat 1: 4810f2d7 (button) won ($0.27)
Seat 2: 134b65d0 (small blind) folded before Flop
Seat 3: Hero (big blind) folded on the Flop
Seat 4: cb07f953 folded before Flop (didn't bet)
Seat 5: a55de19c folded before Flop (didn't bet)
Seat 6: e9650524 folded before Flop (didn't bet)


Poker Hand #RC2078415867: Hold'em No Limit ($0.02/$0.05) - 2023/12/22 20:58:03
Table 'RushAndCash774030' 6-max Seat #1 is the button
Seat 1: 3216f2c0 ($5.75 in chips)
Seat 2: Hero ($5 in chips)
Seat 3: 6db845fb ($5.63 in chips)
Seat 4: 5d317abf ($6.86 in chips)
Seat 5: a90771fe ($7.08 in chips)
Seat 6: 5703e2fa ($13.85 in chips)
Hero: posts small blind $0.02
6db845fb: posts big blind $0.05
*** HOLE CARDS ***
Dealt to 3216f2c0 
Dealt to Hero [Qc 6c]
Dealt to 6db845fb 
Dealt to 5d317abf 
Dealt to a90771fe 
Dealt to 5703e2fa 
5d317abf: folds
a90771fe: folds
5703e2fa: folds
3216f2c0: raises $0.07 to $0.12
Hero: folds
6db845fb: calls $0.07
*** FLOP *** [Ah 2s 3h]
6db845fb: checks
3216f2c0: checks
*** TURN *** [Ah 2s 3h] [Qs]
6db845fb: checks
3216f2c0: checks
*** RIVER *** [Ah 2s 3h Qs] [2c]
6db845fb: bets $0.1
3216f2c0: calls $0.1
6db845fb: shows [Ts 9h] (Pair of Twos)
3216f2c0: shows [4h 4d] (Pair of Fours and Pair of Twos)
*** SHOWDOWN ***
3216f2c0 collected $0.44 from pot
*** SUMMARY ***
Total pot $0.46 | Rake $0.02 | Jackpot $0 | Bingo $0 | Fortune $0 | Tax $0
Board [Ah 2s 3h Qs 2c]
Seat 1: 3216f2c0 (button) showed [4h 4d] and won ($0.44) with Pair of Fours and Pair of Twos
Seat 2: Hero (small blind) folded before Flop
Seat 3: 6db845fb (big blind) showed [Ts 9h] and lost with Pair of Twos
Seat 4: 5d317abf folded before Flop (didn't bet)
Seat 5: a90771fe folded before Flop (didn't bet)
Seat 6: 5703e2fa folded before Flop (didn't bet)


Poker Hand #RC2078415802: Hold'em No Limit ($0.02/$0.05) - 2023/12/22 20:57:59
Table 'RushAndCash773998' 6-max Seat #1 is the button
Seat 1: 4d43d419 ($9.97 in chips)
Seat 2: d5ec8351 ($5.02 in chips)
Seat 3: ceb10c49 ($6.04 in chips)
Seat 4: 7466ff6a ($20.8 in chips)
Seat 5: Hero ($5 in chips)
Seat 6: f677406 ($5.14 in chips)
d5ec8351: posts small blind $0.02
ceb10c49: posts big blind $0.05
*** HOLE CARDS ***
Dealt to 4d43d419 
Dealt to d5ec8351 
Dealt to ceb10c49 
Dealt to 7466ff6a 
Dealt to Hero [6c 5h]
Dealt to f677406 
7466ff6a: folds
Hero: folds
f677406: folds
4d43d419: folds
d5ec8351: folds
Uncalled bet ($0.03) returned to ceb10c49
*** SHOWDOWN ***
ceb10c49 collected $0.04 from pot
*** SUMMARY ***
Total pot $0.04 | Rake $0 | Jackpot $0 | Bingo $0 | Fortune $0 | Tax $0
Seat 1: 4d43d419 (button) folded before Flop (didn't bet)
Seat 2: d5ec8351 (small blind) folded before Flop
Seat 3: ceb10c49 (big blind) collected ($0.04)
Seat 4: 7466ff6a folded before Flop (didn't bet)
Seat 5: Hero folded before Flop (didn't bet)
Seat 6: f677406 folded before Flop (didn't bet)


Poker Hand #RC2078415705: Hold'em No Limit ($0.02/$0.05) - 2023/12/22 20:57:53
Table 'RushAndCash773949' 6-max Seat #1 is the button
Seat 1: Hero ($5 in chips)
Seat 2: b8e0eed ($5.11 in chips)
Seat 3: 74cf8c40 ($3.49 in chips)
Seat 4: 134b65d0 ($5.84 in chips)
Seat 5: 294b7dd8 ($10.21 in chips)
Seat 6: 168ef649 ($5.33 in chips)
b8e0eed: posts small blind $0.02
74cf8c40: posts big blind $0.05
*** HOLE CARDS ***
Dealt to Hero [3d 9c]
Dealt to b8e0eed 
Dealt to 74cf8c40 
Dealt to 134b65d0 
Dealt to 294b7dd8 
Dealt to 168ef649 
134b65d0: folds
294b7dd8: folds
168ef649: folds
Hero: folds
b8e0eed: raises $0.1 to $0.15
74cf8c40: folds
Uncalled bet ($0.1) returned to b8e0eed
*** SHOWDOWN ***
b8e0eed collected $0.1 from pot
*** SUMMARY ***
Total pot $0.1 | Rake $0 | Jackpot $0 | Bingo $0 | Fortune $0 | Tax $0
Seat 1: Hero (button) folded before Flop (didn't bet)
Seat 2: b8e0eed (small blind) collected ($0.1)
Seat 3: 74cf8c40 (big blind) folded before Flop
Seat 4: 134b65d0 folded before Flop (didn't bet)
Seat 5: 294b7dd8 folded before Flop (didn't bet)
Seat 6: 168ef649 folded before Flop (didn't bet)


Poker Hand #RC2078415583: Hold'em No Limit ($0.02/$0.05) - 2023/12/22 20:57:47
Table 'RushAndCash773894' 6-max Seat #1 is the button
Seat 1: 8d09c020 ($6.41 in chips)
Seat 2: 49ea92ea ($5.66 in chips)
Seat 3: 1fc1f571 ($13.58 in chips)
Seat 4: e6188be4 ($5.07 in chips)
Seat 5: Hero ($5 in chips)
Seat 6: 5261fe21 ($4.02 in chips)
49ea92ea: posts small blind $0.02
1fc1f571: posts big blind $0.05
*** HOLE CARDS ***
Dealt to 8d09c020 
Dealt to 49ea92ea 
Dealt to 1fc1f571 
Dealt to e6188be4 
Dealt to Hero [Jc 8c]
Dealt to 5261fe21 
e6188be4: folds
Hero: folds
5261fe21: folds
8d09c020: folds
49ea92ea: folds
Uncalled bet ($0.03) returned to 1fc1f571
*** SHOWDOWN ***
1fc1f571 collected $0.04 from pot
*** SUMMARY ***
Total pot $0.04 | Rake $0 | Jackpot $0 | Bingo $0 | Fortune $0 | Tax $0
Seat 1: 8d09c020 (button) folded before Flop (didn't bet)
Seat 2: 49ea92ea (small blind) folded before Flop
Seat 3: 1fc1f571 (big blind) collected ($0.04)
Seat 4: e6188be4 folded before Flop (didn't bet)
Seat 5: Hero folded before Flop (didn't bet)
Seat 6: 5261fe21 folded before Flop (didn't bet)


Poker Hand #RC2078415510: Hold'em No Limit ($0.02/$0.05) - 2023/12/22 20:57:43
Table 'RushAndCash773860' 6-max Seat #1 is the button
Seat 1: Hero ($5 in chips)
Seat 2: 294b7dd8 ($10.23 in chips)
Seat 3: 8e0f056d ($7.85 in chips)
Seat 4: 50cbc258 ($6.47 in chips)
Seat 5: f9c6a467 ($16.49 in chips)
Seat 6: 2471888a ($5.73 in chips)
294b7dd8: posts small blind $0.02
8e0f056d: posts big blind $0.05
*** HOLE CARDS ***
Dealt to Hero [Th 3d]
Dealt to 294b7dd8 
Dealt to 8e0f056d 
Dealt to 50cbc258 
Dealt to f9c6a467 
Dealt to 2471888a 
50cbc258: folds
f9c6a467: folds
2471888a: folds
Hero: folds
294b7dd8: folds
Uncalled bet ($0.03) returned to 8e0f056d
*** SHOWDOWN ***
8e0f056d collected $0.04 from pot
*** SUMMARY ***
Total pot $0.04 | Rake $0 | Jackpot $0 | Bingo $0 | Fortune $0 | Tax $0
Seat 1: Hero (button) folded before Flop (didn't bet)
Seat 2: 294b7dd8 (small blind) folded before Flop
Seat 3: 8e0f056d (big blind) collected ($0.04)
Seat 4: 50cbc258 folded before Flop (didn't bet)
Seat 5: f9c6a467 folded before Flop (didn't bet)
Seat 6: 2471888a folded before Flop (didn't bet)


Poker Hand #RC2078415444: Hold'em No Limit ($0.02/$0.05) - 2023/12/22 20:57:39
Table 'RushAndCash773830' 6-max Seat #1 is the button
Seat 1: 8f87a7f3 ($5.5 in chips)
Seat 2: 98471e80 ($6.5 in chips)
Seat 3: c7be9492 ($5 in chips)
Seat 4: 7810e6bd ($3.63 in chips)
Seat 5: Hero ($5 in chips)
Seat 6: 422b3b66 ($5.02 in chips)
98471e80: posts small blind $0.02
c7be9492: posts big blind $0.05
*** HOLE CARDS ***
Dealt to 8f87a7f3 
Dealt to 98471e80 
Dealt to c7be9492 
Dealt to 7810e6bd 
Dealt to Hero [7s 6d]
Dealt to 422b3b66 
7810e6bd: calls $0.05
Hero: folds
422b3b66: folds
8f87a7f3: folds
98471e80: folds
c7be9492: checks
*** FLOP *** [Kd 5h 8h]
c7be9492: checks
7810e6bd: bets $0.09
c7be9492: calls $0.09
*** TURN *** [Kd 5h 8h] [8s]
c7be9492: checks
7810e6bd: bets $0.3
c7be9492: folds
Uncalled bet ($0.3) returned to 7810e6bd
*** SHOWDOWN ***
7810e6bd collected $0.29 from pot
*** SUMMARY ***
Total pot $0.3 | Rake $0.01 | Jackpot $0 | Bingo $0 | Fortune $0 | Tax $0
Board [Kd 5h 8h 8s]
Seat 1: 8f87a7f3 (button) folded before Flop (didn't bet)
Seat 2: 98471e80 (small blind) folded before Flop
Seat 3: c7be9492 (big blind) folded on the Turn
Seat 4: 7810e6bd won ($0.29)
Seat 5: Hero folded before Flop (didn't bet)
Seat 6: 422b3b66 folded before Flop (didn't bet)


Poker Hand #RC2078404554: Hold'em No Limit ($0.02/$0.05) - 2023/12/22 20:56:50
Table 'RushAndCash773424' 6-max Seat #1 is the button
Seat 1: 79da18b5 ($8.56 in chips)
Seat 2: Hero ($5 in chips)
Seat 3: fcd90216 ($5 in chips)
Seat 4: 17206484 ($9.47 in chips)
Seat 5: 6c88f65e ($3.95 in chips)
Seat 6: 680eb0e1 ($8.36 in chips)
Hero: posts small blind $0.02
fcd90216: posts big blind $0.05
*** HOLE CARDS ***
Dealt to 79da18b5 
Dealt to Hero [Ad Ks]
Dealt to fcd90216 
Dealt to 17206484 
Dealt to 6c88f65e 
Dealt to 680eb0e1 
17206484: folds
6c88f65e: folds
680eb0e1: folds
79da18b5: raises $0.08 to $0.13
Hero: raises $0.36 to $0.49
fcd90216: folds
79da18b5: calls $0.36
*** FLOP *** [8s 6c 5c]
Hero: bets $0.52
79da18b5: calls $0.52
*** TURN *** [8s 6c 5c] [2s]
Hero: checks
79da18b5: checks
*** RIVER *** [8s 6c 5c 2s] [Tc]
Hero: checks
79da18b5: checks
Hero: shows [Ad Ks] (Ace-High)
79da18b5: shows [Ah 8h] (Pair of Eights)
*** SHOWDOWN ***
79da18b5 collected $1.9 from pot
*** SUMMARY ***
Total pot $2.07 | Rake $0.1 | Jackpot $0.07 | Bingo $0 | Fortune $0 | Tax $0
Board [8s 6c 5c 2s Tc]
Seat 1: 79da18b5 (button) showed [Ah 8h] and won ($1.9) with Pair of Eights
Seat 2: Hero (small blind) showed [Ad Ks] and lost with Ace-High
Seat 3: fcd90216 (big blind) folded before Flop
Seat 4: 17206484 folded before Flop (didn't bet)
Seat 5: 6c88f65e folded before Flop (didn't bet)
Seat 6: 680eb0e1 folded before Flop (didn't bet)


Poker Hand #RC2078404280: Hold'em No Limit ($0.02/$0.05) - 2023/12/22 20:56:34
Table 'RushAndCash773292' 6-max Seat #1 is the button
Seat 1: 9b819678 ($2.56 in chips)
Seat 2: f3b8bc9d ($8.35 in chips)
Seat 3: Hero ($5 in chips)
Seat 4: 806c9c64 ($5.77 in chips)
Seat 5: 7020d421 ($15.67 in chips)
Seat 6: 129e05a1 ($2.39 in chips)
f3b8bc9d: posts small blind $0.02
Hero: posts big blind $0.05
*** HOLE CARDS ***
Dealt to 9b819678 
Dealt to f3b8bc9d 
Dealt to Hero [2h 9h]
Dealt to 806c9c64 
Dealt to 7020d421 
Dealt to 129e05a1 
806c9c64: folds
7020d421: folds
129e05a1: raises $0.1 to $0.15
9b819678: calls $0.15
f3b8bc9d: raises $0.75 to $0.9
Hero: folds
129e05a1: raises $1.49 to $2.39 and is all-in
9b819678: folds
f3b8bc9d: calls $1.49
129e05a1: shows [7h 7d]
f3b8bc9d: shows [Kc Tc]
*** FLOP *** [Ac 3s 7s]
*** TURN *** [Ac 3s 7s] [2s]
*** RIVER *** [Ac 3s 7s 2s] [4s]
*** SHOWDOWN ***
129e05a1 collected $4.76 from pot
*** SUMMARY ***
Total pot $4.98 | Rake $0.15 | Jackpot $0.07 | Bingo $0 | Fortune $0 | Tax $0
Board [Ac 3s 7s 2s 4s]
Seat 1: 9b819678 (button) folded before Flop
Seat 2: f3b8bc9d (small blind) showed [Kc Tc] and lost with Ace-High
Seat 3: Hero (big blind) folded before Flop
Seat 4: 806c9c64 folded before Flop (didn't bet)
Seat 5: 7020d421 folded before Flop (didn't bet)
Seat 6: 129e05a1 showed [7h 7d] and won ($4.76) with Three Sevens


Poker Hand #RC2078404219: Hold'em No Limit ($0.02/$0.05) - 2023/12/22 20:56:31
Table 'RushAndCash773263' 6-max Seat #1 is the button
Seat 1: 8ced9a44 ($7.03 in chips)
Seat 2: 52f74b76 ($5.79 in chips)
Seat 3: ada70712 ($2.17 in chips)
Seat 4: f3b8bc9d ($8.35 in chips)
Seat 5: Hero ($5 in chips)
Seat 6: 68c6c5e7 ($12.89 in chips)
52f74b76: posts small blind $0.02
ada70712: posts big blind $0.05
*** HOLE CARDS ***
Dealt to 8ced9a44 
Dealt to 52f74b76 
Dealt to ada70712 
Dealt to f3b8bc9d 
Dealt to Hero [6s Jh]
Dealt to 68c6c5e7 
f3b8bc9d: folds
Hero: folds
68c6c5e7: folds
8ced9a44: folds
52f74b76: raises $0.08 to $0.13
ada70712: folds
Uncalled bet ($0.08) returned to 52f74b76
*** SHOWDOWN ***
52f74b76 collected $0.1 from pot
*** SUMMARY ***
Total pot $0.1 | Rake $0 | Jackpot $0 | Bingo $0 | Fortune $0 | Tax $0
Seat 1: 8ced9a44 (button) folded before Flop (didn't bet)
Seat 2: 52f74b76 (small blind) collected ($0.1)
Seat 3: ada70712 (big blind) folded before Flop
Seat 4: f3b8bc9d folded before Flop (didn't bet)
Seat 5: Hero folded before Flop (didn't bet)
Seat 6: 68c6c5e7 folded before Flop (didn't bet)


Poker Hand #RC2078404140: Hold'em No Limit ($0.02/$0.05) - 2023/12/22 20:56:26
Table 'RushAndCash773227' 6-max Seat #1 is the button
Seat 1: 1db6ddb1 ($4.99 in chips)
Seat 2: e44205f6 ($8.8 in chips)
Seat 3: 373d8880 ($5.55 in chips)
Seat 4: 44d3a861 ($5.67 in chips)
Seat 5: 75daa184 ($9.41 in chips)
Seat 6: Hero ($5 in chips)
e44205f6: posts small blind $0.02
373d8880: posts big blind $0.05
*** HOLE CARDS ***
Dealt to 1db6ddb1 
Dealt to e44205f6 
Dealt to 373d8880 
Dealt to 44d3a861 
Dealt to 75daa184 
Dealt to Hero [7h 5c]
44d3a861: raises $0.06 to $0.11
75daa184: folds
Hero: folds
1db6ddb1: folds
e44205f6: folds
373d8880: folds
Uncalled bet ($0.06) returned to 44d3a861
*** SHOWDOWN ***
44d3a861 collected $0.12 from pot
*** SUMMARY ***
Total pot $0.12 | Rake $0 | Jackpot $0 | Bingo $0 | Fortune $0 | Tax $0
Seat 1: 1db6ddb1 (button) folded before Flop (didn't bet)
Seat 2: e44205f6 (small blind) folded before Flop
Seat 3: 373d8880 (big blind) folded before Flop
Seat 4: 44d3a861 collected ($0.12)
Seat 5: 75daa184 folded before Flop (didn't bet)
Seat 6: Hero folded before Flop (didn't bet)


Poker Hand #RC2078404076: Hold'em No Limit ($0.02/$0.05) - 2023/12/22 20:56:22
Table 'RushAndCash773198' 6-max Seat #1 is the button
Seat 1: e67ce721 ($5.45 in chips)
Seat 2: 1fc1f571 ($13.94 in chips)
Seat 3: 38e5e2fb ($5 in chips)
Seat 4: Hero ($5 in chips)
Seat 5: d1a1b256 ($6.7 in chips)
Seat 6: d3432d7f ($4.31 in chips)
1fc1f571: posts small blind $0.02
38e5e2fb: posts big blind $0.05
*** HOLE CARDS ***
Dealt to e67ce721 
Dealt to 1fc1f571 
Dealt to 38e5e2fb 
Dealt to Hero [4d 9d]
Dealt to d1a1b256 
Dealt to d3432d7f 
Hero: folds
d1a1b256: folds
d3432d7f: folds
e67ce721: raises $0.08 to $0.13
1fc1f571: folds
38e5e2fb: raises $0.37 to $0.5
e67ce721: calls $0.37
*** FLOP *** [6h 6d Jc]
38e5e2fb: checks
e67ce721: bets $0.48
38e5e2fb: calls $0.48
*** TURN *** [6h 6d Jc] [8c]
38e5e2fb: checks
e67ce721: checks
*** RIVER *** [6h 6d Jc 8c] [Qc]
38e5e2fb: bets $1.31
e67ce721: folds
Uncalled bet ($1.31) returned to 38e5e2fb
*** SHOWDOWN ***
38e5e2fb collected $1.82 from pot
*** SUMMARY ***
Total pot $1.98 | Rake $0.09 | Jackpot $0.07 | Bingo $0 | Fortune $0 | Tax $0
Board [6h 6d Jc 8c Qc]
Seat 1: e67ce721 (button) folded on the River
Seat 2: 1fc1f571 (small blind) folded before Flop
Seat 3: 38e5e2fb (big blind) won ($1.82)
Seat 4: Hero folded before Flop (didn't bet)
Seat 5: d1a1b256 folded before Flop (didn't bet)
Seat 6: d3432d7f folded before Flop (didn't bet)


Poker Hand #RC2078403899: Hold'em No Limit ($0.02/$0.05) - 2023/12/22 20:56:13
Table 'RushAndCash773115' 6-max Seat #1 is the button
Seat 1: 5e4c4d4e ($3.17 in chips)
Seat 2: Hero ($5 in chips)
Seat 3: dc1893ec ($4.36 in chips)
Seat 4: 9b2d2337 ($6.09 in chips)
Seat 5: 4fe2d26d ($4.52 in chips)
Seat 6: b8534e0 ($11.86 in chips)
Hero: posts small blind $0.02
dc1893ec: posts big blind $0.05
*** HOLE CARDS ***
Dealt to 5e4c4d4e 
Dealt to Hero [Qh 2s]
Dealt to dc1893ec 
Dealt to 9b2d2337 
Dealt to 4fe2d26d 
Dealt to b8534e0 
9b2d2337: raises $0.06 to $0.11
4fe2d26d: calls $0.11
b8534e0: folds
5e4c4d4e: folds
Hero: folds
dc1893ec: folds
*** FLOP *** [Ah Ac Jc]
9b2d2337: checks
4fe2d26d: checks
*** TURN *** [Ah Ac Jc] [4s]
9b2d2337: bets $0.22
4fe2d26d: folds
Uncalled bet ($0.22) returned to 9b2d2337
*** SHOWDOWN ***
9b2d2337 collected $0.28 from pot
*** SUMMARY ***
Total pot $0.29 | Rake $0.01 | Jackpot $0 | Bingo $0 | Fortune $0 | Tax $0
Board [Ah Ac Jc 4s]
Seat 1: 5e4c4d4e (button) folded before Flop (didn't bet)
Seat 2: Hero (small blind) folded before Flop
Seat 3: dc1893ec (big blind) folded before Flop
Seat 4: 9b2d2337 won ($0.28)
Seat 5: 4fe2d26d folded on the Turn
Seat 6: b8534e0 folded before Flop (didn't bet)


Poker Hand #RC2078403792: Hold'em No Limit ($0.02/$0.05) - 2023/12/22 20:56:07
Table 'RushAndCash773070' 6-max Seat #1 is the button
Seat 1: Hero ($5 in chips)
Seat 2: 24b894cb ($4.78 in chips)
Seat 3: 960a23e5 ($4.55 in chips)
Seat 4: 794cade2 ($2.23 in chips)
Seat 5: d74d8525 ($5.07 in chips)
Seat 6: f2f053b6 ($5.09 in chips)
24b894cb: posts small blind $0.02
960a23e5: posts big blind $0.05
*** HOLE CARDS ***
Dealt to Hero [2s 8h]
Dealt to 24b894cb 
Dealt to 960a23e5 
Dealt to 794cade2 
Dealt to d74d8525 
Dealt to f2f053b6 
794cade2: folds
d74d8525: folds
f2f053b6: raises $0.1 to $0.15
Hero: folds
24b894cb: folds
960a23e5: folds
Uncalled bet ($0.1) returned to f2f053b6
*** SHOWDOWN ***
f2f053b6 collected $0.12 from pot
*** SUMMARY ***
Total pot $0.12 | Rake $0 | Jackpot $0 | Bingo $0 | Fortune $0 | Tax $0
Seat 1: Hero (button) folded before Flop (didn't bet)
Seat 2: 24b894cb (small blind) folded before Flop
Seat 3: 960a23e5 (big blind) folded before Flop
Seat 4: 794cade2 folded before Flop (didn't bet)
Seat 5: d74d8525 folded before Flop (didn't bet)
Seat 6: f2f053b6 collected ($0.12)


Poker Hand #RC2078403593: Hold'em No Limit ($0.02/$0.05) - 2023/12/22 20:55:55
Table 'RushAndCash772982' 6-max Seat #1 is the button
Seat 1: e8886428 ($32.01 in chips)
Seat 2: e8df5901 ($9.04 in chips)
Seat 3: Hero ($5 in chips)
Seat 4: a2a9ef51 ($5.78 in chips)
Seat 5: d5ec8351 ($5 in chips)
Seat 6: 673162b7 ($5.35 in chips)
e8df5901: posts small blind $0.02
Hero: posts big blind $0.05
*** HOLE CARDS ***
Dealt to e8886428 
Dealt to e8df5901 
Dealt to Hero [3d 6c]
Dealt to a2a9ef51 
Dealt to d5ec8351 
Dealt to 673162b7 
a2a9ef51: folds
d5ec8351: raises $0.1 to $0.15
673162b7: calls $0.15
e8886428: folds
e8df5901: folds
Hero: folds
*** FLOP *** [5h 2s 2c]
d5ec8351: bets $0.19
673162b7: raises $0.43 to $0.62
d5ec8351: calls $0.43
*** TURN *** [5h 2s 2c] [2h]
d5ec8351: checks
673162b7: checks
*** RIVER *** [5h 2s 2c 2h] [Td]
d5ec8351: checks
673162b7: checks
d5ec8351: shows [6s 6h] (Twos Full over Sixes)
673162b7: shows [7h 7s] (Twos Full over Sevens)
*** SHOWDOWN ***
673162b7 collected $1.47 from pot
*** SUMMARY ***
Total pot $1.61 | Rake $0.07 | Jackpot $0.07 | Bingo $0 | Fortune $0 | Tax $0
Board [5h 2s 2c 2h Td]
Seat 1: e8886428 (button) folded before Flop (didn't bet)
Seat 2: e8df5901 (small blind) folded before Flop
Seat 3: Hero (big blind) folded before Flop
Seat 4: a2a9ef51 folded before Flop (didn't bet)
Seat 5: d5ec8351 showed [6s 6h] and lost with Twos Full over Sixes
Seat 6: 673162b7 showed [7h 7s] and won ($1.47) with Twos Full over Sevens


Poker Hand #RC2078403529: Hold'em No Limit ($0.02/$0.05) - 2023/12/22 20:55:51
Table 'RushAndCash772951' 6-max Seat #1 is the button
Seat 1: 23800602 ($4.71 in chips)
Seat 2: 81f9a1e6 ($14.37 in chips)
Seat 3: 711581a0 ($6.5 in chips)
Seat 4: d5ec8351 ($5 in chips)
Seat 5: Hero ($5 in chips)
Seat 6: f95c708 ($5 in chips)
81f9a1e6: posts small blind $0.02
711581a0: posts big blind $0.05
*** HOLE CARDS ***
Dealt to 23800602 
Dealt to 81f9a1e6 
Dealt to 711581a0 
Dealt to d5ec8351 
Dealt to Hero [Qc 4c]
Dealt to f95c708 
d5ec8351: folds
Hero: folds
f95c708: folds
23800602: folds
81f9a1e6: raises $0.06 to $0.11
711581a0: calls $0.06
*** FLOP *** [Ks 7d 4h]
81f9a1e6: bets $0.08
711581a0: calls $0.08
*** TURN *** [Ks 7d 4h] [Ah]
81f9a1e6: bets $0.29
711581a0: folds
Uncalled bet ($0.29) returned to 81f9a1e6
*** SHOWDOWN ***
81f9a1e6 collected $0.37 from pot
*** SUMMARY ***
Total pot $0.38 | Rake $0.01 | Jackpot $0 | Bingo $0 | Fortune $0 | Tax $0
Board [Ks 7d 4h Ah]
Seat 1: 23800602 (button) folded before Flop (didn't bet)
Seat 2: 81f9a1e6 (small blind) won ($0.37)
Seat 3: 711581a0 (big blind) folded on the Turn
Seat 4: d5ec8351 folded before Flop (didn't bet)
Seat 5: Hero folded before Flop (didn't bet)
Seat 6: f95c708 folded before Flop (didn't bet)


Poker Hand #RC2078403443: Hold'em No Limit ($0.02/$0.05) - 2023/12/22 20:55:46
Table 'RushAndCash772908' 6-max Seat #1 is the button
Seat 1: 89ac50e8 ($14.38 in chips)
Seat 2: 36626ded ($5.03 in chips)
Seat 3: 22818fb2 ($8.33 in chips)
Seat 4: b3dac847 ($8.19 in chips)
Seat 5: Hero ($5 in chips)
Seat 6: a420712c ($7.53 in chips)
36626ded: posts small blind $0.02
22818fb2: posts big blind $0.05
*** HOLE CARDS ***
Dealt to 89ac50e8 
Dealt to 36626ded 
Dealt to 22818fb2 
Dealt to b3dac847 
Dealt to Hero [5c 6s]
Dealt to a420712c 
b3dac847: raises $0.05 to $0.1
Hero: folds
a420712c: folds
89ac50e8: folds
36626ded: folds
22818fb2: raises $0.08 to $0.18
b3dac847: calls $0.08
*** FLOP *** [5h Th 9h]
22818fb2: bets $0.26
b3dac847: calls $0.26
*** TURN *** [5h Th 9h] [7h]
22818fb2: checks
b3dac847: checks
*** RIVER *** [5h Th 9h 7h] [4s]
22818fb2: bets $0.6
b3dac847: folds
Uncalled bet ($0.6) returned to 22818fb2
*** SHOWDOWN ***
22818fb2 collected $0.85 from pot
*** SUMMARY ***
Total pot $0.9 | Rake $0.05 | Jackpot $0 | Bingo $0 | Fortune $0 | Tax $0
Board [5h Th 9h 7h 4s]
Seat 1: 89ac50e8 (button) folded before Flop (didn't bet)
Seat 2: 36626ded (small blind) folded before Flop
Seat 3: 22818fb2 (big blind) won ($0.85)
Seat 4: b3dac847 folded on the River
Seat 5: Hero folded before Flop (didn't bet)
Seat 6: a420712c folded before Flop (didn't bet)


Poker Hand #RC2078403344: Hold'em No Limit ($0.02/$0.05) - 2023/12/22 20:55:40
Table 'RushAndCash772857' 6-max Seat #1 is the button
Seat 1: d0d9a2a3 ($4.73 in chips)
Seat 2: 9b87805 ($8.37 in chips)
Seat 3: b01c40bf ($11.65 in chips)
Seat 4: 7732abf7 ($20.07 in chips)
Seat 5: 17206484 ($9.66 in chips)
Seat 6: Hero ($5 in chips)
9b87805: posts small blind $0.02
b01c40bf: posts big blind $0.05
*** HOLE CARDS ***
Dealt to d0d9a2a3 
Dealt to 9b87805 
Dealt to b01c40bf 
Dealt to 7732abf7 
Dealt to 17206484 
Dealt to Hero [3c 6s]
7732abf7: folds
17206484: folds
Hero: folds
d0d9a2a3: folds
9b87805: folds
Uncalled bet ($0.03) returned to b01c40bf
*** SHOWDOWN ***
b01c40bf collected $0.04 from pot
*** SUMMARY ***
Total pot $0.04 | Rake $0 | Jackpot $0 | Bingo $0 | Fortune $0 | Tax $0
Seat 1: d0d9a2a3 (button) folded before Flop (didn't bet)
Seat 2: 9b87805 (small blind) folded before Flop
Seat 3: b01c40bf (big blind) collected ($0.04)
Seat 4: 7732abf7 folded before Flop (didn't bet)
Seat 5: 17206484 folded before Flop (didn't bet)
Seat 6: Hero folded before Flop (didn't bet)


Poker Hand #RC2078403236: Hold'em No Limit ($0.02/$0.05) - 2023/12/22 20:55:35
Table 'RushAndCash772805' 6-max Seat #1 is the button
Seat 1: Hero ($5 in chips)
Seat 2: 673162b7 ($5.42 in chips)
Seat 3: 1b93f683 ($5 in chips)
Seat 4: 610bd7fc ($10.85 in chips)
Seat 5: d03e1a8e ($7.49 in chips)
Seat 6: 2581769a ($3.69 in chips)
673162b7: posts small blind $0.02
1b93f683: posts big blind $0.05
*** HOLE CARDS ***
Dealt to Hero [Kd 8s]
Dealt to 673162b7 
Dealt to 1b93f683 
Dealt to 610bd7fc 
Dealt to d03e1a8e 
Dealt to 2581769a 
610bd7fc: raises $0.05 to $0.1
d03e1a8e: folds
2581769a: folds
Hero: folds
673162b7: folds
1b93f683: folds
Uncalled bet ($0.05) returned to 610bd7fc
*** SHOWDOWN ***
610bd7fc collected $0.12 from pot
*** SUMMARY ***
Total pot $0.12 | Rake $0 | Jackpot $0 | Bingo $0 | Fortune $0 | Tax $0
Seat 1: Hero (button) folded before Flop (didn't bet)
Seat 2: 673162b7 (small blind) folded before Flop
Seat 3: 1b93f683 (big blind) folded before Flop
Seat 4: 610bd7fc collected ($0.12)
Seat 5: d03e1a8e folded before Flop (didn't bet)
Seat 6: 2581769a folded before Flop (didn't bet)


Poker Hand #RC2078402904: Hold'em No Limit ($0.02/$0.05) - 2023/12/22 20:55:16
Table 'RushAndCash772648' 6-max Seat #1 is the button
Seat 1: b03a70ec ($5.54 in chips)
Seat 2: Hero ($5 in chips)
Seat 3: 373d8880 ($5.64 in chips)
Seat 4: 2ed46053 ($7.05 in chips)
Seat 5: c3adc948 ($5.35 in chips)
Seat 6: 193ba103 ($2.28 in chips)
Hero: posts small blind $0.02
373d8880: posts big blind $0.05
*** HOLE CARDS ***
Dealt to b03a70ec 
Dealt to Hero [5h 2s]
Dealt to 373d8880 
Dealt to 2ed46053 
Dealt to c3adc948 
Dealt to 193ba103 
2ed46053: raises $0.06 to $0.11
c3adc948: folds
193ba103: folds
b03a70ec: folds
Hero: folds
373d8880: folds
Uncalled bet ($0.06) returned to 2ed46053
*** SHOWDOWN ***
2ed46053 collected $0.12 from pot
*** SUMMARY ***
Total pot $0.12 | Rake $0 | Jackpot $0 | Bingo $0 | Fortune $0 | Tax $0
Seat 1: b03a70ec (button) folded before Flop (didn't bet)
Seat 2: Hero (small blind) folded before Flop
Seat 3: 373d8880 (big blind) folded before Flop
Seat 4: 2ed46053 collected ($0.12)
Seat 5: c3adc948 folded before Flop (didn't bet)
Seat 6: 193ba103 folded before Flop (didn't bet)


Poker Hand #RC2078401797: Hold'em No Limit ($0.02/$0.05) - 2023/12/22 20:54:17
Table 'RushAndCash772142' 6-max Seat #1 is the button
Seat 1: fe9fbc4f ($5.42 in chips)
Seat 2: 53b6f5a9 ($5.44 in chips)
Seat 3: Hero ($5 in chips)
Seat 4: 12953fac ($5.12 in chips)
Seat 5: cea6060f ($5.07 in chips)
Seat 6: d5e25f78 ($16.18 in chips)
53b6f5a9: posts small blind $0.02
Hero: posts big blind $0.05
*** HOLE CARDS ***
Dealt to fe9fbc4f 
Dealt to 53b6f5a9 
Dealt to Hero [2s As]
Dealt to 12953fac 
Dealt to cea6060f 
Dealt to d5e25f78 
12953fac: folds
cea6060f: folds
d5e25f78: raises $0.08 to $0.13
fe9fbc4f: folds
53b6f5a9: calls $0.11
Hero: calls $0.08
*** FLOP *** [8s Jc 4s]
53b6f5a9: checks
Hero: checks
d5e25f78: bets $0.26
53b6f5a9: folds
Hero: calls $0.26
*** TURN *** [8s Jc 4s] [6d]
Hero: checks
d5e25f78: bets $0.61
Hero: folds
Uncalled bet ($0.61) returned to d5e25f78
*** SHOWDOWN ***
d5e25f78 collected $0.87 from pot
*** SUMMARY ***
Total pot $0.91 | Rake $0.04 | Jackpot $0 | Bingo $0 | Fortune $0 | Tax $0
Board [8s Jc 4s 6d]
Seat 1: fe9fbc4f (button) folded before Flop (didn't bet)
Seat 2: 53b6f5a9 (small blind) folded on the Flop
Seat 3: Hero (big blind) folded on the Turn
Seat 4: 12953fac folded before Flop (didn't bet)
Seat 5: cea6060f folded before Flop (didn't bet)
Seat 6: d5e25f78 won ($0.87)


Poker Hand #RC2078401658: Hold'em No Limit ($0.02/$0.05) - 2023/12/22 20:54:09
Table 'RushAndCash772076' 6-max Seat #1 is the button
Seat 1: 4b57c53e ($10.85 in chips)
Seat 2: 9b87805 ($8.32 in chips)
Seat 3: d2f469dd ($14.33 in chips)
Seat 4: d6363be2 ($5.14 in chips)
Seat 5: 6ddc293e ($5 in chips)
Seat 6: Hero ($5 in chips)
9b87805: posts small blind $0.02
d2f469dd: posts big blind $0.05
*** HOLE CARDS ***
Dealt to 4b57c53e 
Dealt to 9b87805 
Dealt to d2f469dd 
Dealt to d6363be2 
Dealt to 6ddc293e 
Dealt to Hero [Ah Td]
d6363be2: folds
6ddc293e: raises $0.05 to $0.1
Hero: folds
4b57c53e: folds
9b87805: folds
d2f469dd: folds
Uncalled bet ($0.05) returned to 6ddc293e
*** SHOWDOWN ***
6ddc293e collected $0.12 from pot
*** SUMMARY ***
Total pot $0.12 | Rake $0 | Jackpot $0 | Bingo $0 | Fortune $0 | Tax $0
Seat 1: 4b57c53e (button) folded before Flop (didn't bet)
Seat 2: 9b87805 (small blind) folded before Flop
Seat 3: d2f469dd (big blind) folded before Flop
Seat 4: d6363be2 folded before Flop (didn't bet)
Seat 5: 6ddc293e collected ($0.12)
Seat 6: Hero folded before Flop (didn't bet)


Poker Hand #RC2078401542: Hold'em No Limit ($0.02/$0.05) - 2023/12/22 20:54:03
Table 'RushAndCash772017' 6-max Seat #1 is the button
Seat 1: d588ef94 ($5 in chips)
Seat 2: 67d4b163 ($7.66 in chips)
Seat 3: b5259737 ($15.67 in chips)
Seat 4: Hero ($5 in chips)
Seat 5: 30a2950b ($5 in chips)
Seat 6: b87456e8 ($2.55 in chips)
67d4b163: posts small blind $0.02
b5259737: posts big blind $0.05
*** HOLE CARDS ***
Dealt to d588ef94 
Dealt to 67d4b163 
Dealt to b5259737 
Dealt to Hero [Js 2h]
Dealt to 30a2950b 
Dealt to b87456e8 
Hero: folds
30a2950b: folds
b87456e8: folds
d588ef94: raises $0.05 to $0.1
67d4b163: folds
b5259737: folds
Uncalled bet ($0.05) returned to d588ef94
*** SHOWDOWN ***
d588ef94 collected $0.12 from pot
*** SUMMARY ***
Total pot $0.12 | Rake $0 | Jackpot $0 | Bingo $0 | Fortune $0 | Tax $0
Seat 1: d588ef94 (button) collected ($0.12)
Seat 2: 67d4b163 (small blind) folded before Flop
Seat 3: b5259737 (big blind) folded before Flop
Seat 4: Hero folded before Flop (didn't bet)
Seat 5: 30a2950b folded before Flop (didn't bet)
Seat 6: b87456e8 folded before Flop (didn't bet)


Poker Hand #RC2078400882: Hold'em No Limit ($0.02/$0.05) - 2023/12/22 20:53:27
Table 'RushAndCash771722' 6-max Seat #1 is the button
Seat 1: 75daa184 ($8.99 in chips)
Seat 2: 4ab8a557 ($5.72 in chips)
Seat 3: abaf267e ($5.98 in chips)
Seat 4: 2c2cc68d ($12.1 in chips)
Seat 5: 561e5b01 ($5 in chips)
Seat 6: Hero ($5 in chips)
4ab8a557: posts small blind $0.02
abaf267e: posts big blind $0.05
*** HOLE CARDS ***
Dealt to 75daa184 
Dealt to 4ab8a557 
Dealt to abaf267e 
Dealt to 2c2cc68d 
Dealt to 561e5b01 
Dealt to Hero [5s 5h]
2c2cc68d: folds
561e5b01: folds
Hero: raises $0.05 to $0.1
75daa184: folds
4ab8a557: folds
abaf267e: calls $0.05
*** FLOP *** [7h Qd 3h]
abaf267e: checks
Hero: checks
*** TURN *** [7h Qd 3h] [2d]
abaf267e: checks
Hero: checks
*** RIVER *** [7h Qd 3h 2d] [8d]
abaf267e: checks
Hero: checks
abaf267e: shows [4h 8c] (Pair of Eights)
Hero: shows [5s 5h] (Pair of Fives)
*** SHOWDOWN ***
abaf267e collected $0.21 from pot
*** SUMMARY ***
Total pot $0.22 | Rake $0.01 | Jackpot $0 | Bingo $0 | Fortune $0 | Tax $0
Board [7h Qd 3h 2d 8d]
Seat 1: 75daa184 (button) folded before Flop (didn't bet)
Seat 2: 4ab8a557 (small blind) folded before Flop
Seat 3: abaf267e (big blind) showed [4h 8c] and won ($0.21) with Pair of Eights
Seat 4: 2c2cc68d folded before Flop (didn't bet)
Seat 5: 561e5b01 folded before Flop (didn't bet)
Seat 6: Hero showed [5s 5h] and lost with Pair of Fives


Poker Hand #RC2078400822: Hold'em No Limit ($0.02/$0.05) - 2023/12/22 20:53:23
Table 'RushAndCash771693' 6-max Seat #1 is the button
Seat 1: Hero ($5 in chips)
Seat 2: a55de19c ($35.16 in chips)
Seat 3: 9e4405e1 ($3.07 in chips)
Seat 4: db5367a6 ($7.46 in chips)
Seat 5: 24567d12 ($5 in chips)
Seat 6: 40e56bda ($7.77 in chips)
a55de19c: posts small blind $0.02
9e4405e1: posts big blind $0.05
*** HOLE CARDS ***
Dealt to Hero [3d 2h]
Dealt to a55de19c 
Dealt to 9e4405e1 
Dealt to db5367a6 
Dealt to 24567d12 
Dealt to 40e56bda 
db5367a6: folds
24567d12: raises $0.1 to $0.15
40e56bda: folds
Hero: folds
a55de19c: folds
9e4405e1: calls $0.1
*** FLOP *** [2d Qh 5d]
9e4405e1: bets $0.32
24567d12: raises $0.96 to $1.28
9e4405e1: raises $1.64 to $2.92 and is all-in
24567d12: calls $1.64
9e4405e1: shows [4d Kd] (King-High)
24567d12: shows [Ah As] (Pair of Aces)
24567d12: Chooses to EV Cashout 
*** TURN *** [2d Qh 5d] [9s]
*** RIVER *** [2d Qh 5d 9s] [3h]
24567d12: Pays Cashout Risk ($2.29)
*** SHOWDOWN ***
24567d12 collected $5.94 from pot
*** SUMMARY ***
Total pot $6.16 | Rake $0.15 | Jackpot $0.07 | Bingo $0 | Fortune $0 | Tax $0
Board [2d Qh 5d 9s 3h]
Seat 1: Hero (button) folded before Flop (didn't bet)
Seat 2: a55de19c (small blind) folded before Flop
Seat 3: 9e4405e1 (big blind) showed [4d Kd] and lost with King-High
Seat 4: db5367a6 folded before Flop (didn't bet)
Seat 5: 24567d12 showed [Ah As] and won ($5.94) with Pair of Aces, Cashout Risk ($2.29)
Seat 6: 40e56bda folded before Flop (didn't bet)


Poker Hand #RC2078400677: Hold'em No Limit ($0.02/$0.05) - 2023/12/22 20:53:15
Table 'RushAndCash771631' 6-max Seat #1 is the button
Seat 1: 567a37c4 ($5.39 in chips)
Seat 2: Hero ($5 in chips)
Seat 3: ee1f67f7 ($8.8 in chips)
Seat 4: 3153aed0 ($5.53 in chips)
Seat 5: 5261fe21 ($5.04 in chips)
Seat 6: a04ab5b3 ($5.23 in chips)
Hero: posts small blind $0.02
ee1f67f7: posts big blind $0.05
*** HOLE CARDS ***
Dealt to 567a37c4 
Dealt to Hero [Kh 6h]
Dealt to ee1f67f7 
Dealt to 3153aed0 
Dealt to 5261fe21 
Dealt to a04ab5b3 
3153aed0: raises $0.05 to $0.1
5261fe21: raises $0.21 to $0.31
a04ab5b3: folds
567a37c4: folds
Hero: folds
ee1f67f7: folds
3153aed0: raises $0.66 to $0.97
5261fe21: folds
Uncalled bet ($0.66) returned to 3153aed0
*** SHOWDOWN ***
3153aed0 collected $0.66 from pot
*** SUMMARY ***
Total pot $0.69 | Rake $0.03 | Jackpot $0 | Bingo $0 | Fortune $0 | Tax $0
Seat 1: 567a37c4 (button) folded before Flop (didn't bet)
Seat 2: Hero (small blind) folded before Flop
Seat 3: ee1f67f7 (big blind) folded before Flop
Seat 4: 3153aed0 collected ($0.66)
Seat 5: 5261fe21 folded before Flop
Seat 6: a04ab5b3 folded before Flop (didn't bet)


Poker Hand #RC2078400320: Hold'em No Limit ($0.02/$0.05) - 2023/12/22 20:52:55
Table 'RushAndCash771468' 6-max Seat #1 is the button
Seat 1: 1be6b9fd ($7.08 in chips)
Seat 2: 559a8f6f ($9.59 in chips)
Seat 3: Hero ($5 in chips)
Seat 4: fcc5325d ($4.59 in chips)
Seat 5: 8f8f33cc ($8.92 in chips)
Seat 6: 735c261b ($17.12 in chips)
559a8f6f: posts small blind $0.02
Hero: posts big blind $0.05
*** HOLE CARDS ***
Dealt to 1be6b9fd 
Dealt to 559a8f6f 
Dealt to Hero [Ks 9s]
Dealt to fcc5325d 
Dealt to 8f8f33cc 
Dealt to 735c261b 
fcc5325d: folds
8f8f33cc: folds
735c261b: folds
1be6b9fd: raises $0.05 to $0.1
559a8f6f: folds
Hero: calls $0.05
*** FLOP *** [8s 3h Tc]
Hero: checks
1be6b9fd: bets $0.06
Hero: folds
Uncalled bet ($0.06) returned to 1be6b9fd
*** SHOWDOWN ***
1be6b9fd collected $0.21 from pot
*** SUMMARY ***
Total pot $0.22 | Rake $0.01 | Jackpot $0 | Bingo $0 | Fortune $0 | Tax $0
Board [8s 3h Tc]
Seat 1: 1be6b9fd (button) won ($0.21)
Seat 2: 559a8f6f (small blind) folded before Flop
Seat 3: Hero (big blind) folded on the Flop
Seat 4: fcc5325d folded before Flop (didn't bet)
Seat 5: 8f8f33cc folded before Flop (didn't bet)
Seat 6: 735c261b folded before Flop (didn't bet)


Poker Hand #RC2078400256: Hold'em No Limit ($0.02/$0.05) - 2023/12/22 20:52:52
Table 'RushAndCash771439' 6-max Seat #1 is the button
Seat 1: 49374b34 ($6.13 in chips)
Seat 2: a615a9f6 ($7.85 in chips)
Seat 3: 806c9c64 ($5.51 in chips)
Seat 4: 5945e592 ($1.94 in chips)
Seat 5: Hero ($5 in chips)
Seat 6: a2a9ef51 ($5 in chips)
a615a9f6: posts small blind $0.02
806c9c64: posts big blind $0.05
*** HOLE CARDS ***
Dealt to 49374b34 
Dealt to a615a9f6 
Dealt to 806c9c64 
Dealt to 5945e592 
Dealt to Hero [4d Ah]
Dealt to a2a9ef51 
5945e592: folds
Hero: folds
a2a9ef51: folds
49374b34: folds
a615a9f6: raises $0.05 to $0.1
806c9c64: folds
Uncalled bet ($0.05) returned to a615a9f6
*** SHOWDOWN ***
a615a9f6 collected $0.1 from pot
*** SUMMARY ***
Total pot $0.1 | Rake $0 | Jackpot $0 | Bingo $0 | Fortune $0 | Tax $0
Seat 1: 49374b34 (button) folded before Flop (didn't bet)
Seat 2: a615a9f6 (small blind) collected ($0.1)
Seat 3: 806c9c64 (big blind) folded before Flop
Seat 4: 5945e592 folded before Flop (didn't bet)
Seat 5: Hero folded before Flop (didn't bet)
Seat 6: a2a9ef51 folded before Flop (didn't bet)


Poker Hand #RC2078400190: Hold'em No Limit ($0.02/$0.05) - 2023/12/22 20:52:48
Table 'RushAndCash771409' 6-max Seat #1 is the button
Seat 1: 38bb8e26 ($7.91 in chips)
Seat 2: 58864a6e ($11.67 in chips)
Seat 3: 816eac8 ($4.93 in chips)
Seat 4: Hero ($5 in chips)
Seat 5: 5d55167a ($10.43 in chips)
Seat 6: 5e4c4d4e ($4.25 in chips)
58864a6e: posts small blind $0.02
816eac8: posts big blind $0.05
*** HOLE CARDS ***
Dealt to 38bb8e26 
Dealt to 58864a6e 
Dealt to 816eac8 
Dealt to Hero [8s 7h]
Dealt to 5d55167a 
Dealt to 5e4c4d4e 
Hero: folds
5d55167a: folds
5e4c4d4e: raises $0.05 to $0.1
38bb8e26: folds
58864a6e: folds
816eac8: raises $0.35 to $0.45
5e4c4d4e: calls $0.35
*** FLOP *** [Qs 5s Qc]
816eac8: checks
5e4c4d4e: checks
*** TURN *** [Qs 5s Qc] [4h]
816eac8: bets $0.31
5e4c4d4e: calls $0.31
*** RIVER *** [Qs 5s Qc 4h] [6s]
816eac8: bets $4.17 and is all-in
5e4c4d4e: folds
Uncalled bet ($4.17) returned to 816eac8
*** SHOWDOWN ***
816eac8 collected $1.4 from pot
*** SUMMARY ***
Total pot $1.54 | Rake $0.07 | Jackpot $0.07 | Bingo $0 | Fortune $0 | Tax $0
Board [Qs 5s Qc 4h 6s]
Seat 1: 38bb8e26 (button) folded before Flop (didn't bet)
Seat 2: 58864a6e (small blind) folded before Flop
Seat 3: 816eac8 (big blind) won ($1.4)
Seat 4: Hero folded before Flop (didn't bet)
Seat 5: 5d55167a folded before Flop (didn't bet)
Seat 6: 5e4c4d4e folded on the River


Poker Hand #RC2078400122: Hold'em No Limit ($0.02/$0.05) - 2023/12/22 20:52:45
Table 'RushAndCash771378' 6-max Seat #1 is the button
Seat 1: 23a63651 ($15.4 in chips)
Seat 2: 8d15f06b ($6.37 in chips)
Seat 3: 2c2cc68d ($12.21 in chips)
Seat 4: Hero ($5 in chips)
Seat 5: 567a37c4 ($5.25 in chips)
Seat 6: 816eac8 ($4.93 in chips)
8d15f06b: posts small blind $0.02
2c2cc68d: posts big blind $0.05
*** HOLE CARDS ***
Dealt to 23a63651 
Dealt to 8d15f06b 
Dealt to 2c2cc68d 
Dealt to Hero [Ad 5h]
Dealt to 567a37c4 
Dealt to 816eac8 
Hero: folds
567a37c4: raises $0.08 to $0.13
816eac8: folds
23a63651: folds
8d15f06b: folds
2c2cc68d: calls $0.08
*** FLOP *** [9h 2c Kc]
2c2cc68d: checks
567a37c4: bets $0.23
2c2cc68d: folds
Uncalled bet ($0.23) returned to 567a37c4
*** SHOWDOWN ***
567a37c4 collected $0.27 from pot
*** SUMMARY ***
Total pot $0.28 | Rake $0.01 | Jackpot $0 | Bingo $0 | Fortune $0 | Tax $0
Board [9h 2c Kc]
Seat 1: 23a63651 (button) folded before Flop (didn't bet)
Seat 2: 8d15f06b (small blind) folded before Flop
Seat 3: 2c2cc68d (big blind) folded on the Flop
Seat 4: Hero folded before Flop (didn't bet)
Seat 5: 567a37c4 won ($0.27)
Seat 6: 816eac8 folded before Flop (didn't bet)


Poker Hand #RC2078400062: Hold'em No Limit ($0.02/$0.05) - 2023/12/22 20:52:41
Table 'RushAndCash771349' 6-max Seat #1 is the button
Seat 1: Hero ($5 in chips)
Seat 2: 81aef653 ($7.9 in chips)
Seat 3: a1310b74 ($8.95 in chips)
Seat 4: c3b03cc8 ($9.88 in chips)
Seat 5: 5e4c4d4e ($4.25 in chips)
Seat 6: d42ee966 ($5.07 in chips)
81aef653: posts small blind $0.02
a1310b74: posts big blind $0.05
*** HOLE CARDS ***
Dealt to Hero [3c 4c]
Dealt to 81aef653 
Dealt to a1310b74 
Dealt to c3b03cc8 
Dealt to 5e4c4d4e 
Dealt to d42ee966 
c3b03cc8: folds
5e4c4d4e: folds
d42ee966: raises $0.08 to $0.13
Hero: folds
81aef653: raises $0.23 to $0.36
a1310b74: folds
d42ee966: calls $0.23
*** FLOP *** [7d 6c Ac]
81aef653: bets $0.34
d42ee966: raises $0.73 to $1.07
81aef653: folds
Uncalled bet ($0.73) returned to d42ee966
*** SHOWDOWN ***
d42ee966 collected $1.38 from pot
*** SUMMARY ***
Total pot $1.45 | Rake $0.07 | Jackpot $0 | Bingo $0 | Fortune $0 | Tax $0
Board [7d 6c Ac]
Seat 1: Hero (button) folded before Flop (didn't bet)
Seat 2: 81aef653 (small blind) folded on the Flop
Seat 3: a1310b74 (big blind) folded before Flop
Seat 4: c3b03cc8 folded before Flop (didn't bet)
Seat 5: 5e4c4d4e folded before Flop (didn't bet)
Seat 6: d42ee966 won ($1.38)


Poker Hand #RC2078399879: Hold'em No Limit ($0.02/$0.05) - 2023/12/22 20:52:31
Table 'RushAndCash771267' 6-max Seat #1 is the button
Seat 1: 5261fe21 ($5.04 in chips)
Seat 2: Hero ($5 in chips)
Seat 3: 97c53bc9 ($4.45 in chips)
Seat 4: ca7e2c6d ($5.87 in chips)
Seat 5: 3b87467 ($6.68 in chips)
Seat 6: fb772588 ($5.34 in chips)
Hero: posts small blind $0.02
97c53bc9: posts big blind $0.05
*** HOLE CARDS ***
Dealt to 5261fe21 
Dealt to Hero [7d 2s]
Dealt to 97c53bc9 
Dealt to ca7e2c6d 
Dealt to 3b87467 
Dealt to fb772588 
ca7e2c6d: folds
3b87467: folds
fb772588: folds
5261fe21: raises $0.05 to $0.1
Hero: folds
97c53bc9: folds
Uncalled bet ($0.05) returned to 5261fe21
*** SHOWDOWN ***
5261fe21 collected $0.12 from pot
*** SUMMARY ***
Total pot $0.12 | Rake $0 | Jackpot $0 | Bingo $0 | Fortune $0 | Tax $0
Seat 1: 5261fe21 (button) collected ($0.12)
Seat 2: Hero (small blind) folded before Flop
Seat 3: 97c53bc9 (big blind) folded before Flop
Seat 4: ca7e2c6d folded before Flop (didn't bet)
Seat 5: 3b87467 folded before Flop (didn't bet)
Seat 6: fb772588 folded before Flop (didn't bet)


Poker Hand #RC2078399597: Hold'em No Limit ($0.02/$0.05) - 2023/12/22 20:52:16
Table 'RushAndCash771143' 6-max Seat #1 is the button
Seat 1: d9ac0d0f ($5.19 in chips)
Seat 2: b8e0eed ($5.02 in chips)
Seat 3: Hero ($5 in chips)
Seat 4: c3ac0c83 ($4.65 in chips)
Seat 5: d3b1f4ed ($5.63 in chips)
Seat 6: b9f46049 ($4.93 in chips)
b8e0eed: posts small blind $0.02
Hero: posts big blind $0.05
*** HOLE CARDS ***
Dealt to d9ac0d0f 
Dealt to b8e0eed 
Dealt to Hero [9d 5s]
Dealt to c3ac0c83 
Dealt to d3b1f4ed 
Dealt to b9f46049 
c3ac0c83: folds
d3b1f4ed: folds
b9f46049: raises $0.08 to $0.13
d9ac0d0f: folds
b8e0eed: folds
Hero: folds
Uncalled bet ($0.08) returned to b9f46049
*** SHOWDOWN ***
b9f46049 collected $0.12 from pot
*** SUMMARY ***
Total pot $0.12 | Rake $0 | Jackpot $0 | Bingo $0 | Fortune $0 | Tax $0
Seat 1: d9ac0d0f (button) folded before Flop (didn't bet)
Seat 2: b8e0eed (small blind) folded before Flop
Seat 3: Hero (big blind) folded before Flop
Seat 4: c3ac0c83 folded before Flop (didn't bet)
Seat 5: d3b1f4ed folded before Flop (didn't bet)
Seat 6: b9f46049 collected ($0.12)


Poker Hand #RC2078399514: Hold'em No Limit ($0.02/$0.05) - 2023/12/22 20:52:12
Table 'RushAndCash771106' 6-max Seat #1 is the button
Seat 1: 32d77abe ($4.24 in chips)
Seat 2: a7392a18 ($14.48 in chips)
Seat 3: 50d599ea ($5.6 in chips)
Seat 4: ce5771af ($6.69 in chips)
Seat 5: 243211d7 ($5.42 in chips)
Seat 6: Hero ($5 in chips)
a7392a18: posts small blind $0.02
50d599ea: posts big blind $0.05
*** HOLE CARDS ***
Dealt to 32d77abe 
Dealt to a7392a18 
Dealt to 50d599ea 
Dealt to ce5771af 
Dealt to 243211d7 
Dealt to Hero [4h 8h]
ce5771af: folds
243211d7: folds
Hero: folds
32d77abe: folds
a7392a18: raises $0.1 to $0.15
50d599ea: calls $0.1
*** FLOP *** [3c Qs 5c]
a7392a18: bets $0.1
50d599ea: calls $0.1
*** TURN *** [3c Qs 5c] [8d]
a7392a18: bets $0.26
50d599ea: calls $0.26
*** RIVER *** [3c Qs 5c 8d] [Ad]
a7392a18: bets $0.77
50d599ea: calls $0.77
a7392a18: shows [3s As] (Pair of Aces and Pair of Treys)
50d599ea: shows [7h Qc] (Pair of Queens)
*** SHOWDOWN ***
a7392a18 collected $2.37 from pot
*** SUMMARY ***
Total pot $2.56 | Rake $0.12 | Jackpot $0.07 | Bingo $0 | Fortune $0 | Tax $0
Board [3c Qs 5c 8d Ad]
Seat 1: 32d77abe (button) folded before Flop (didn't bet)
Seat 2: a7392a18 (small blind) showed [3s As] and won ($2.37) with Pair of Aces and Pair of Treys
Seat 3: 50d599ea (big blind) showed [7h Qc] and lost with Pair of Queens
Seat 4: ce5771af folded before Flop (didn't bet)
Seat 5: 243211d7 folded before Flop (didn't bet)
Seat 6: Hero folded before Flop (didn't bet)


Poker Hand #RC2078399446: Hold'em No Limit ($0.02/$0.05) - 2023/12/22 20:52:08
Table 'RushAndCash771075' 6-max Seat #1 is the button
Seat 1: c87acea2 ($5.02 in chips)
Seat 2: 32d77abe ($4.26 in chips)
Seat 3: 58864a6e ($11.79 in chips)
Seat 4: 17da2929 ($7.22 in chips)
Seat 5: ceb10c49 ($8.89 in chips)
Seat 6: Hero ($5 in chips)
32d77abe: posts small blind $0.02
58864a6e: posts big blind $0.05
*** HOLE CARDS ***
Dealt to c87acea2 
Dealt to 32d77abe 
Dealt to 58864a6e 
Dealt to 17da2929 
Dealt to ceb10c49 
Dealt to Hero [8d Th]
17da2929: folds
ceb10c49: raises $0.05 to $0.1
Hero: folds
c87acea2: folds
32d77abe: folds
58864a6e: folds
Uncalled bet ($0.05) returned to ceb10c49
*** SHOWDOWN ***
ceb10c49 collected $0.12 from pot
*** SUMMARY ***
Total pot $0.12 | Rake $0 | Jackpot $0 | Bingo $0 | Fortune $0 | Tax $0
Seat 1: c87acea2 (button) folded before Flop (didn't bet)
Seat 2: 32d77abe (small blind) folded before Flop
Seat 3: 58864a6e (big blind) folded before Flop
Seat 4: 17da2929 folded before Flop (didn't bet)
Seat 5: ceb10c49 collected ($0.12)
Seat 6: Hero folded before Flop (didn't bet)


Poker Hand #RC2078399384: Hold'em No Limit ($0.02/$0.05) - 2023/12/22 20:52:04
Table 'RushAndCash771051' 6-max Seat #1 is the button
Seat 1: c2881b52 ($13.99 in chips)
Seat 2: 55e2d3e1 ($2.33 in chips)
Seat 3: d42ee966 ($5 in chips)
Seat 4: 902f08d7 ($4.27 in chips)
Seat 5: e8df5901 ($9.31 in chips)
Seat 6: Hero ($5 in chips)
55e2d3e1: posts small blind $0.02
d42ee966: posts big blind $0.05
*** HOLE CARDS ***
Dealt to c2881b52 
Dealt to 55e2d3e1 
Dealt to d42ee966 
Dealt to 902f08d7 
Dealt to e8df5901 
Dealt to Hero [4h Ks]
902f08d7: folds
e8df5901: folds
Hero: folds
c2881b52: folds
55e2d3e1: raises $0.05 to $0.1
d42ee966: calls $0.05
*** FLOP *** [Jh 2h 2c]
55e2d3e1: bets $0.07
d42ee966: calls $0.07
*** TURN *** [Jh 2h 2c] [As]
55e2d3e1: bets $0.12
d42ee966: folds
Uncalled bet ($0.12) returned to 55e2d3e1
*** SHOWDOWN ***
55e2d3e1 collected $0.32 from pot
*** SUMMARY ***
Total pot $0.34 | Rake $0.02 | Jackpot $0 | Bingo $0 | Fortune $0 | Tax $0
Board [Jh 2h 2c As]
Seat 1: c2881b52 (button) folded before Flop (didn't bet)
Seat 2: 55e2d3e1 (small blind) won ($0.32)
Seat 3: d42ee966 (big blind) folded on the Turn
Seat 4: 902f08d7 folded before Flop (didn't bet)
Seat 5: e8df5901 folded before Flop (didn't bet)
Seat 6: Hero folded before Flop (didn't bet)


Poker Hand #RC2078399328: Hold'em No Limit ($0.02/$0.05) - 2023/12/22 20:52:00
Table 'RushAndCash771026' 6-max Seat #1 is the button
Seat 1: cb2898f4 ($5.01 in chips)
Seat 2: b9f46049 ($4.95 in chips)
Seat 3: b4aaf9de ($6.41 in chips)
Seat 4: Hero ($5 in chips)
Seat 5: 711581a0 ($7.14 in chips)
Seat 6: 76e5cae3 ($5 in chips)
b9f46049: posts small blind $0.02
b4aaf9de: posts big blind $0.05
*** HOLE CARDS ***
Dealt to cb2898f4 
Dealt to b9f46049 
Dealt to b4aaf9de 
Dealt to Hero [5s 7s]
Dealt to 711581a0 
Dealt to 76e5cae3 
Hero: folds
711581a0: folds
76e5cae3: raises $0.05 to $0.1
cb2898f4: folds
b9f46049: folds
b4aaf9de: calls $0.05
*** FLOP *** [2c 5c Td]
b4aaf9de: checks
76e5cae3: checks
*** TURN *** [2c 5c Td] [2s]
b4aaf9de: bets $0.11
76e5cae3: calls $0.11
*** RIVER *** [2c 5c Td 2s] [3c]
b4aaf9de: bets $0.22
76e5cae3: folds
Uncalled bet ($0.22) returned to b4aaf9de
*** SHOWDOWN ***
b4aaf9de collected $0.42 from pot
*** SUMMARY ***
Total pot $0.44 | Rake $0.02 | Jackpot $0 | Bingo $0 | Fortune $0 | Tax $0
Board [2c 5c Td 2s 3c]
Seat 1: cb2898f4 (button) folded before Flop (didn't bet)
Seat 2: b9f46049 (small blind) folded before Flop
Seat 3: b4aaf9de (big blind) won ($0.42)
Seat 4: Hero folded before Flop (didn't bet)
Seat 5: 711581a0 folded before Flop (didn't bet)
Seat 6: 76e5cae3 folded on the River


Poker Hand #RC2078399262: Hold'em No Limit ($0.02/$0.05) - 2023/12/22 20:51:57
Table 'RushAndCash770995' 6-max Seat #1 is the button
Seat 1: Hero ($5 in chips)
Seat 2: b5756669 ($5.34 in chips)
Seat 3: 8429395c ($5 in chips)
Seat 4: 36626ded ($5.07 in chips)
Seat 5: 1ff063e8 ($4.81 in chips)
Seat 6: a7392a18 ($14.48 in chips)
b5756669: posts small blind $0.02
8429395c: posts big blind $0.05
*** HOLE CARDS ***
Dealt to Hero [7h As]
Dealt to b5756669 
Dealt to 8429395c 
Dealt to 36626ded 
Dealt to 1ff063e8 
Dealt to a7392a18 
36626ded: folds
1ff063e8: folds
a7392a18: folds
Hero: folds
b5756669: raises $0.08 to $0.13
8429395c: folds
Uncalled bet ($0.08) returned to b5756669
*** SHOWDOWN ***
b5756669 collected $0.1 from pot
*** SUMMARY ***
Total pot $0.1 | Rake $0 | Jackpot $0 | Bingo $0 | Fortune $0 | Tax $0
Seat 1: Hero (button) folded before Flop (didn't bet)
Seat 2: b5756669 (small blind) collected ($0.1)
Seat 3: 8429395c (big blind) folded before Flop
Seat 4: 36626ded folded before Flop (didn't bet)
Seat 5: 1ff063e8 folded before Flop (didn't bet)
Seat 6: a7392a18 folded before Flop (didn't bet)


Poker Hand #RC2078399122: Hold'em No Limit ($0.02/$0.05) - 2023/12/22 20:51:49
Table 'RushAndCash770932' 6-max Seat #1 is the button
Seat 1: 84497676 ($15.11 in chips)
Seat 2: Hero ($5 in chips)
Seat 3: 2e835d7a ($5.68 in chips)
Seat 4: b00070f4 ($5.63 in chips)
Seat 5: a8ee5981 ($4.91 in chips)
Seat 6: d7f451d5 ($9.69 in chips)
Hero: posts small blind $0.02
2e835d7a: posts big blind $0.05
*** HOLE CARDS ***
Dealt to 84497676 
Dealt to Hero [2s 8h]
Dealt to 2e835d7a 
Dealt to b00070f4 
Dealt to a8ee5981 
Dealt to d7f451d5 
b00070f4: folds
a8ee5981: raises $0.08 to $0.13
d7f451d5: folds
84497676: folds
Hero: folds
2e835d7a: calls $0.08
*** FLOP *** [2c Js 4c]
2e835d7a: checks
a8ee5981: checks
*** TURN *** [2c Js 4c] [7d]
2e835d7a: checks
a8ee5981: checks
*** RIVER *** [2c Js 4c 7d] [Qs]
2e835d7a: checks
a8ee5981: checks
2e835d7a: shows [3s Ks] (King-High)
a8ee5981: shows [As Kd] (Ace-High)
*** SHOWDOWN ***
a8ee5981 collected $0.27 from pot
*** SUMMARY ***
Total pot $0.28 | Rake $0.01 | Jackpot $0 | Bingo $0 | Fortune $0 | Tax $0
Board [2c Js 4c 7d Qs]
Seat 1: 84497676 (button) folded before Flop (didn't bet)
Seat 2: Hero (small blind) folded before Flop
Seat 3: 2e835d7a (big blind) showed [3s Ks] and lost with King-High
Seat 4: b00070f4 folded before Flop (didn't bet)
Seat 5: a8ee5981 showed [As Kd] and won ($0.27) with Ace-High
Seat 6: d7f451d5 folded before Flop (didn't bet)


Poker Hand #RC2078398736: Hold'em No Limit ($0.02/$0.05) - 2023/12/22 20:51:28
Table 'RushAndCash770759' 6-max Seat #1 is the button
Seat 1: 5e8dc530 ($5.21 in chips)
Seat 2: 13f0dad9 ($5.57 in chips)
Seat 3: Hero ($5 in chips)
Seat 4: 4f610685 ($4.62 in chips)
Seat 5: 3a44e48f ($5.86 in chips)
Seat 6: 93990934 ($13.72 in chips)
13f0dad9: posts small blind $0.02
Hero: posts big blind $0.05
*** HOLE CARDS ***
Dealt to 5e8dc530 
Dealt to 13f0dad9 
Dealt to Hero [8c Kd]
Dealt to 4f610685 
Dealt to 3a44e48f 
Dealt to 93990934 
4f610685: folds
3a44e48f: folds
93990934: folds
5e8dc530: raises $0.06 to $0.11
13f0dad9: folds
Hero: folds
Uncalled bet ($0.06) returned to 5e8dc530
*** SHOWDOWN ***
5e8dc530 collected $0.12 from pot
*** SUMMARY ***
Total pot $0.12 | Rake $0 | Jackpot $0 | Bingo $0 | Fortune $0 | Tax $0
Seat 1: 5e8dc530 (button) collected ($0.12)
Seat 2: 13f0dad9 (small blind) folded before Flop
Seat 3: Hero (big blind) folded before Flop
Seat 4: 4f610685 folded before Flop (didn't bet)
Seat 5: 3a44e48f folded before Flop (didn't bet)
Seat 6: 93990934 folded before Flop (didn't bet)


