Poker Hand #RC2078482709: Hold'em No Limit ($0.02/$0.05) - 2023/12/22 21:23:49
Table 'RushAndCash786693' 6-max Seat #1 is the button
Seat 1: Hero ($7.62 in chips)
Seat 2: 1f7caee2 ($2.89 in chips)
Seat 3: 3288926 ($10.1 in chips)
Seat 4: a77b7df9 ($2.01 in chips)
Seat 5: f5ffb37c ($5 in chips)
Seat 6: 3b6e2f77 ($5.02 in chips)
1f7caee2: posts small blind $0.02
3288926: posts big blind $0.05
*** HOLE CARDS ***
Dealt to Hero [Tc Kh]
Dealt to 1f7caee2 
Dealt to 3288926 
Dealt to a77b7df9 
Dealt to f5ffb37c 
Dealt to 3b6e2f77 
a77b7df9: folds
f5ffb37c: folds
3b6e2f77: folds
Hero: raises $0.08 to $0.13
1f7caee2: folds
3288926: calls $0.08
*** FLOP *** [3d 7s As]
3288926: checks
Hero: checks
*** TURN *** [3d 7s As] [8h]
3288926: checks
Hero: checks
*** RIVER *** [3d 7s As 8h] [Jc]
3288926: checks
Hero: checks
3288926: shows [4s Ks] (Ace-High)
Hero: shows [Tc Kh] (Ace-High)
*** SHOWDOWN ***
Hero collected $0.27 from pot
*** SUMMARY ***
Total pot $0.28 | Rake $0.01 | Jackpot $0 | Bingo $0 | Fortune $0 | Tax $0
Board [3d 7s As 8h Jc]
Seat 1: Hero (button) showed [Tc Kh] and won ($0.27) with Ace-High
Seat 2: 1f7caee2 (small blind) folded before Flop
Seat 3: 3288926 (big blind) showed [4s Ks] and lost with Ace-High
Seat 4: a77b7df9 folded before Flop (didn't bet)
Seat 5: f5ffb37c folded before Flop (didn't bet)
Seat 6: 3b6e2f77 folded before Flop (didn't bet)


Poker Hand #RC2078482602: Hold'em No Limit ($0.02/$0.05) - 2023/12/22 21:23:42
Table 'RushAndCash786640' 6-max Seat #1 is the button
Seat 1: 34ce5e3 ($5.07 in chips)
Seat 2: 84dda8d8 ($3.6 in chips)
Seat 3: a2ebb3c7 ($5.73 in chips)
Seat 4: 2ed46053 ($8.4 in chips)
Seat 5: Hero ($7.62 in chips)
Seat 6: 8f240b5e ($4.22 in chips)
84dda8d8: posts small blind $0.02
a2ebb3c7: posts big blind $0.05
*** HOLE CARDS ***
Dealt to 34ce5e3 
Dealt to 84dda8d8 
Dealt to a2ebb3c7 
Dealt to 2ed46053 
Dealt to Hero [7c 9c]
Dealt to 8f240b5e 
2ed46053: raises $0.06 to $0.11
Hero: folds
8f240b5e: folds
34ce5e3: folds
84dda8d8: folds
a2ebb3c7: calls $0.06
*** FLOP *** [7h Td Qd]
a2ebb3c7: checks
2ed46053: bets $0.12
a2ebb3c7: folds
Uncalled bet ($0.12) returned to 2ed46053
*** SHOWDOWN ***
2ed46053 collected $0.23 from pot
*** SUMMARY ***
Total pot $0.24 | Rake $0.01 | Jackpot $0 | Bingo $0 | Fortune $0 | Tax $0
Board [7h Td Qd]
Seat 1: 34ce5e3 (button) folded before Flop (didn't bet)
Seat 2: 84dda8d8 (small blind) folded before Flop
Seat 3: a2ebb3c7 (big blind) folded on the Flop
Seat 4: 2ed46053 won ($0.23)
Seat 5: Hero folded before Flop (didn't bet)
Seat 6: 8f240b5e folded before Flop (didn't bet)


Poker Hand #RC2078482511: Hold'em No Limit ($0.02/$0.05) - 2023/12/22 21:23:37
Table 'RushAndCash786598' 6-max Seat #1 is the button
Seat 1: Hero ($7.62 in chips)
Seat 2: 875f34a0 ($22.9 in chips)
Seat 3: 3da5ed9c ($4.09 in chips)
Seat 4: 25941725 ($4.52 in chips)
Seat 5: 29a59401 ($1.91 in chips)
Seat 6: 8da33d79 ($13.86 in chips)
875f34a0: posts small blind $0.02
3da5ed9c: posts big blind $0.05
*** HOLE CARDS ***
Dealt to Hero [6d Jd]
Dealt to 875f34a0 
Dealt to 3da5ed9c 
Dealt to 25941725 
Dealt to 29a59401 
Dealt to 8da33d79 
25941725: folds
29a59401: raises $0.1 to $0.15
8da33d79: calls $0.15
Hero: folds
875f34a0: folds
3da5ed9c: folds
*** FLOP *** [Js Qs 7h]
29a59401: checks
8da33d79: checks
*** TURN *** [Js Qs 7h] [Kc]
29a59401: checks
8da33d79: checks
*** RIVER *** [Js Qs 7h Kc] [8h]
29a59401: checks
8da33d79: checks
29a59401: shows [4c 4h] (Pair of Fours)
8da33d79: shows [5c 5s] (Pair of Fives)
*** SHOWDOWN ***
8da33d79 collected $0.36 from pot
*** SUMMARY ***
Total pot $0.37 | Rake $0.01 | Jackpot $0 | Bingo $0 | Fortune $0 | Tax $0
Board [Js Qs 7h Kc 8h]
Seat 1: Hero (button) folded before Flop (didn't bet)
Seat 2: 875f34a0 (small blind) folded before Flop
Seat 3: 3da5ed9c (big blind) folded before Flop
Seat 4: 25941725 folded before Flop (didn't bet)
Seat 5: 29a59401 showed [4c 4h] and lost with Pair of Fours
Seat 6: 8da33d79 showed [5c 5s] and won ($0.36) with Pair of Fives


Poker Hand #RC2078482274: Hold'em No Limit ($0.02/$0.05) - 2023/12/22 21:23:23
Table 'RushAndCash786490' 6-max Seat #1 is the button
Seat 1: 6c7c67da ($5.17 in chips)
Seat 2: Hero ($7.57 in chips)
Seat 3: 879060f7 ($16.36 in chips)
Seat 4: 7d137087 ($6.75 in chips)
Seat 5: 2ed46053 ($8.35 in chips)
Seat 6: 2ce216bb ($5.79 in chips)
Hero: posts small blind $0.02
879060f7: posts big blind $0.05
*** HOLE CARDS ***
Dealt to 6c7c67da 
Dealt to Hero [Jh 5s]
Dealt to 879060f7 
Dealt to 7d137087 
Dealt to 2ed46053 
Dealt to 2ce216bb 
7d137087: folds
2ed46053: folds
2ce216bb: folds
6c7c67da: folds
Hero: folds
Uncalled bet ($0.03) returned to 879060f7
*** SHOWDOWN ***
879060f7 collected $0.04 from pot
*** SUMMARY ***
Total pot $0.04 | Rake $0 | Jackpot $0 | Bingo $0 | Fortune $0 | Tax $0
Seat 1: 6c7c67da (button) folded before Flop (didn't bet)
Seat 2: Hero (small blind) folded before Flop
Seat 3: 879060f7 (big blind) collected ($0.04)
Seat 4: 7d137087 folded before Flop (didn't bet)
Seat 5: 2ed46053 folded before Flop (didn't bet)
Seat 6: 2ce216bb folded before Flop (didn't bet)


Poker Hand #RC2078482188: Hold'em No Limit ($0.02/$0.05) - 2023/12/22 21:23:18
Table 'RushAndCash786452' 6-max Seat #1 is the button
Seat 1: 294d35ce ($14.2 in chips)
Seat 2: c0d3508b ($5.3 in chips)
Seat 3: Hero ($7.62 in chips)
Seat 4: 517da49 ($12.34 in chips)
Seat 5: e00c91b4 ($5.07 in chips)
Seat 6: 89a27c2 ($4.43 in chips)
c0d3508b: posts small blind $0.02
Hero: posts big blind $0.05
*** HOLE CARDS ***
Dealt to 294d35ce 
Dealt to c0d3508b 
Dealt to Hero [9h 6d]
Dealt to 517da49 
Dealt to e00c91b4 
Dealt to 89a27c2 
517da49: folds
e00c91b4: folds
89a27c2: folds
294d35ce: folds
c0d3508b: folds
Uncalled bet ($0.03) returned to Hero
*** SHOWDOWN ***
Hero collected $0.04 from pot
*** SUMMARY ***
Total pot $0.04 | Rake $0 | Jackpot $0 | Bingo $0 | Fortune $0 | Tax $0
Seat 1: 294d35ce (button) folded before Flop (didn't bet)
Seat 2: c0d3508b (small blind) folded before Flop
Seat 3: Hero (big blind) collected ($0.04)
Seat 4: 517da49 folded before Flop (didn't bet)
Seat 5: e00c91b4 folded before Flop (didn't bet)
Seat 6: 89a27c2 folded before Flop (didn't bet)


Poker Hand #RC2078482098: Hold'em No Limit ($0.02/$0.05) - 2023/12/22 21:23:13
Table 'RushAndCash786412' 6-max Seat #1 is the button
Seat 1: a4441de9 ($5.7 in chips)
Seat 2: 6ff1e240 ($10.06 in chips)
Seat 3: d23c04d ($5 in chips)
Seat 4: Hero ($7.62 in chips)
Seat 5: f71b25e9 ($5.18 in chips)
Seat 6: 63c93090 ($7.17 in chips)
6ff1e240: posts small blind $0.02
d23c04d: posts big blind $0.05
*** HOLE CARDS ***
Dealt to a4441de9 
Dealt to 6ff1e240 
Dealt to d23c04d 
Dealt to Hero [Qd 2c]
Dealt to f71b25e9 
Dealt to 63c93090 
Hero: folds
f71b25e9: folds
63c93090: raises $0.1 to $0.15
a4441de9: folds
6ff1e240: folds
d23c04d: raises $0.45 to $0.6
63c93090: raises $1.7 to $2.3
d23c04d: raises $2.7 to $5 and is all-in
63c93090: calls $2.7
d23c04d: shows [Kh Ah]
63c93090: shows [Ks Kc]
*** FIRST FLOP *** [Js 8h 7c]
*** FIRST TURN *** [Js 8h 7c] [2h]
*** FIRST RIVER *** [Js 8h 7c 2h] [Ac]
*** SECOND FLOP *** [9h 4d 8d]
*** SECOND TURN *** [9h 4d 8d] [6s]
*** SECOND RIVER *** [9h 4d 8d 6s] [Jh]
*** FIRST SHOWDOWN ***
d23c04d collected $4.91 from pot
*** SECOND SHOWDOWN ***
63c93090 collected $4.9 from pot
*** SUMMARY ***
Total pot $10.02 | Rake $0.14 | Jackpot $0.07 | Bingo $0 | Fortune $0 | Tax $0
Hand was run two times
FIRST Board [Js 8h 7c 2h Ac]
SECOND Board [9h 4d 8d 6s Jh]
Seat 1: a4441de9 (button) folded before Flop (didn't bet)
Seat 2: 6ff1e240 (small blind) folded before Flop
Seat 3: d23c04d (big blind) showed [Kh Ah] and won ($4.91) with Pair of Aces, and lost with Ace-High
Seat 4: Hero folded before Flop (didn't bet)
Seat 5: f71b25e9 folded before Flop (didn't bet)
Seat 6: 63c93090 showed [Ks Kc] and lost with Pair of Kings, and won ($4.9) with Pair of Kings


Poker Hand #RC2078481197: Hold'em No Limit ($0.02/$0.05) - 2023/12/22 21:22:21
Table 'RushAndCash785986' 6-max Seat #1 is the button
Seat 1: 63c93090 ($6.88 in chips)
Seat 2: ec80eef8 ($7.05 in chips)
Seat 3: 3160ff3c ($12.51 in chips)
Seat 4: Hero ($7.86 in chips)
Seat 5: c71b7029 ($8.66 in chips)
Seat 6: 3a8a7513 ($5.07 in chips)
ec80eef8: posts small blind $0.02
3160ff3c: posts big blind $0.05
*** HOLE CARDS ***
Dealt to 63c93090 
Dealt to ec80eef8 
Dealt to 3160ff3c 
Dealt to Hero [Tc 9c]
Dealt to c71b7029 
Dealt to 3a8a7513 
Hero: raises $0.05 to $0.1
c71b7029: folds
3a8a7513: folds
63c93090: calls $0.1
ec80eef8: folds
3160ff3c: folds
*** FLOP *** [8c As 3s]
Hero: checks
63c93090: bets $0.14
Hero: calls $0.14
*** TURN *** [8c As 3s] [7d]
Hero: checks
63c93090: checks
*** RIVER *** [8c As 3s 7d] [8s]
Hero: checks
63c93090: checks
Hero: shows [Tc 9c] (Pair of Eights)
63c93090: shows [Td Kh] (Pair of Eights)
*** SHOWDOWN ***
63c93090 collected $0.53 from pot
*** SUMMARY ***
Total pot $0.55 | Rake $0.02 | Jackpot $0 | Bingo $0 | Fortune $0 | Tax $0
Board [8c As 3s 7d 8s]
Seat 1: 63c93090 (button) showed [Td Kh] and won ($0.53) with Pair of Eights
Seat 2: ec80eef8 (small blind) folded before Flop
Seat 3: 3160ff3c (big blind) folded before Flop
Seat 4: Hero showed [Tc 9c] and lost with Pair of Eights
Seat 5: c71b7029 folded before Flop (didn't bet)
Seat 6: 3a8a7513 folded before Flop (didn't bet)


Poker Hand #RC2078481128: Hold'em No Limit ($0.02/$0.05) - 2023/12/22 21:22:17
Table 'RushAndCash785949' 6-max Seat #1 is the button
Seat 1: Hero ($7.86 in chips)
Seat 2: 4af1c8bb ($3.2 in chips)
Seat 3: 985b2ecb ($6.02 in chips)
Seat 4: 8b79b6b5 ($5.23 in chips)
Seat 5: 83f47841 ($8.55 in chips)
Seat 6: af1e12c2 ($5.01 in chips)
4af1c8bb: posts small blind $0.02
985b2ecb: posts big blind $0.05
*** HOLE CARDS ***
Dealt to Hero [Kh 7s]
Dealt to 4af1c8bb 
Dealt to 985b2ecb 
Dealt to 8b79b6b5 
Dealt to 83f47841 
Dealt to af1e12c2 
8b79b6b5: folds
83f47841: folds
af1e12c2: raises $0.05 to $0.1
Hero: folds
4af1c8bb: folds
985b2ecb: raises $0.17 to $0.27
af1e12c2: folds
Uncalled bet ($0.17) returned to 985b2ecb
*** SHOWDOWN ***
985b2ecb collected $0.21 from pot
*** SUMMARY ***
Total pot $0.22 | Rake $0.01 | Jackpot $0 | Bingo $0 | Fortune $0 | Tax $0
Seat 1: Hero (button) folded before Flop (didn't bet)
Seat 2: 4af1c8bb (small blind) folded before Flop
Seat 3: 985b2ecb (big blind) collected ($0.21)
Seat 4: 8b79b6b5 folded before Flop (didn't bet)
Seat 5: 83f47841 folded before Flop (didn't bet)
Seat 6: af1e12c2 folded before Flop


Poker Hand #RC2078481030: Hold'em No Limit ($0.02/$0.05) - 2023/12/22 21:22:11
Table 'RushAndCash785899' 6-max Seat #1 is the button
Seat 1: 8802c225 ($3.4 in chips)
Seat 2: 90511c4f ($6.23 in chips)
Seat 3: c7592cbf ($11.67 in chips)
Seat 4: Hero ($7.86 in chips)
Seat 5: 6484c2 ($5 in chips)
Seat 6: 2823eab6 ($3.25 in chips)
90511c4f: posts small blind $0.02
c7592cbf: posts big blind $0.05
*** HOLE CARDS ***
Dealt to 8802c225 
Dealt to 90511c4f 
Dealt to c7592cbf 
Dealt to Hero [4s 5s]
Dealt to 6484c2 
Dealt to 2823eab6 
Hero: folds
6484c2: folds
2823eab6: folds
8802c225: raises $0.11 to $0.16
90511c4f: folds
c7592cbf: folds
Uncalled bet ($0.11) returned to 8802c225
*** SHOWDOWN ***
8802c225 collected $0.12 from pot
*** SUMMARY ***
Total pot $0.12 | Rake $0 | Jackpot $0 | Bingo $0 | Fortune $0 | Tax $0
Seat 1: 8802c225 (button) collected ($0.12)
Seat 2: 90511c4f (small blind) folded before Flop
Seat 3: c7592cbf (big blind) folded before Flop
Seat 4: Hero folded before Flop (didn't bet)
Seat 5: 6484c2 folded before Flop (didn't bet)
Seat 6: 2823eab6 folded before Flop (didn't bet)


Poker Hand #RC2078480422: Hold'em No Limit ($0.02/$0.05) - 2023/12/22 21:21:35
Table 'RushAndCash785601' 6-max Seat #1 is the button
Seat 1: 58864a6e ($20.12 in chips)
Seat 2: Hero ($7.72 in chips)
Seat 3: 90511c4f ($6.38 in chips)
Seat 4: 599a3d29 ($2.04 in chips)
Seat 5: f71b25e9 ($5.42 in chips)
Seat 6: 38bb8e26 ($5.5 in chips)
Hero: posts small blind $0.02
90511c4f: posts big blind $0.05
*** HOLE CARDS ***
Dealt to 58864a6e 
Dealt to Hero [3c Ah]
Dealt to 90511c4f 
Dealt to 599a3d29 
Dealt to f71b25e9 
Dealt to 38bb8e26 
599a3d29: folds
f71b25e9: folds
38bb8e26: folds
58864a6e: folds
Hero: raises $0.1 to $0.15
90511c4f: calls $0.1
*** FLOP *** [2c 4d 4h]
Hero: checks
90511c4f: checks
*** TURN *** [2c 4d 4h] [2h]
Hero: checks
90511c4f: checks
*** RIVER *** [2c 4d 4h 2h] [9s]
Hero: checks
90511c4f: checks
Hero: shows [3c Ah] (Pair of Fours and Pair of Twos)
90511c4f: shows [Kc 8c] (Pair of Fours and Pair of Twos)
*** SHOWDOWN ***
Hero collected $0.29 from pot
*** SUMMARY ***
Total pot $0.3 | Rake $0.01 | Jackpot $0 | Bingo $0 | Fortune $0 | Tax $0
Board [2c 4d 4h 2h 9s]
Seat 1: 58864a6e (button) folded before Flop (didn't bet)
Seat 2: Hero (small blind) showed [3c Ah] and won ($0.29) with Pair of Fours and Pair of Twos
Seat 3: 90511c4f (big blind) showed [Kc 8c] and lost with Pair of Fours and Pair of Twos
Seat 4: 599a3d29 folded before Flop (didn't bet)
Seat 5: f71b25e9 folded before Flop (didn't bet)
Seat 6: 38bb8e26 folded before Flop (didn't bet)


Poker Hand #RC2078480257: Hold'em No Limit ($0.02/$0.05) - 2023/12/22 21:21:25
Table 'RushAndCash785526' 6-max Seat #1 is the button
Seat 1: b1860e43 ($2.84 in chips)
Seat 2: 8014c02 ($22.51 in chips)
Seat 3: Hero ($7.77 in chips)
Seat 4: 6ff1e240 ($10.49 in chips)
Seat 5: 38eafb19 ($5 in chips)
Seat 6: c6bf1d22 ($6.43 in chips)
8014c02: posts small blind $0.02
Hero: posts big blind $0.05
*** HOLE CARDS ***
Dealt to b1860e43 
Dealt to 8014c02 
Dealt to Hero [Jc 7h]
Dealt to 6ff1e240 
Dealt to 38eafb19 
Dealt to c6bf1d22 
6ff1e240: folds
38eafb19: folds
c6bf1d22: folds
b1860e43: raises $0.1 to $0.15
8014c02: folds
Hero: folds
Uncalled bet ($0.1) returned to b1860e43
*** SHOWDOWN ***
b1860e43 collected $0.12 from pot
*** SUMMARY ***
Total pot $0.12 | Rake $0 | Jackpot $0 | Bingo $0 | Fortune $0 | Tax $0
Seat 1: b1860e43 (button) collected ($0.12)
Seat 2: 8014c02 (small blind) folded before Flop
Seat 3: Hero (big blind) folded before Flop
Seat 4: 6ff1e240 folded before Flop (didn't bet)
Seat 5: 38eafb19 folded before Flop (didn't bet)
Seat 6: c6bf1d22 folded before Flop (didn't bet)


Poker Hand #RC2078480190: Hold'em No Limit ($0.02/$0.05) - 2023/12/22 21:21:22
Table 'RushAndCash785496' 6-max Seat #1 is the button
Seat 1: Hero ($7.77 in chips)
Seat 2: b1860e43 ($2.86 in chips)
Seat 3: 1fff7a0a ($8.59 in chips)
Seat 4: b976716a ($17.15 in chips)
Seat 5: 9af3794b ($5 in chips)
Seat 6: 8a8eafe4 ($8.44 in chips)
b1860e43: posts small blind $0.02
1fff7a0a: posts big blind $0.05
*** HOLE CARDS ***
Dealt to Hero [Jd 3h]
Dealt to b1860e43 
Dealt to 1fff7a0a 
Dealt to b976716a 
Dealt to 9af3794b 
Dealt to 8a8eafe4 
b976716a: folds
9af3794b: raises $0.06 to $0.11
8a8eafe4: folds
Hero: folds
b1860e43: folds
1fff7a0a: calls $0.06
*** FLOP *** [3s 3c Kd]
1fff7a0a: checks
9af3794b: bets $0.08
1fff7a0a: calls $0.08
*** TURN *** [3s 3c Kd] [Ac]
1fff7a0a: checks
9af3794b: checks
*** RIVER *** [3s 3c Kd Ac] [Tc]
1fff7a0a: checks
9af3794b: checks
1fff7a0a: shows [2h 2d] (Pair of Treys and Pair of Twos)
9af3794b: shows [4d 4c] (Pair of Fours and Pair of Treys)
*** SHOWDOWN ***
9af3794b collected $0.38 from pot
*** SUMMARY ***
Total pot $0.4 | Rake $0.02 | Jackpot $0 | Bingo $0 | Fortune $0 | Tax $0
Board [3s 3c Kd Ac Tc]
Seat 1: Hero (button) folded before Flop (didn't bet)
Seat 2: b1860e43 (small blind) folded before Flop
Seat 3: 1fff7a0a (big blind) showed [2h 2d] and lost with Pair of Treys and Pair of Twos
Seat 4: b976716a folded before Flop (didn't bet)
Seat 5: 9af3794b showed [4d 4c] and won ($0.38) with Pair of Fours and Pair of Treys
Seat 6: 8a8eafe4 folded before Flop (didn't bet)


Poker Hand #RC2078480125: Hold'em No Limit ($0.02/$0.05) - 2023/12/22 21:21:18
Table 'RushAndCash785465' 6-max Seat #1 is the button
Seat 1: 257cb6ea ($5.05 in chips)
Seat 2: 6186df3d ($5.83 in chips)
Seat 3: b8e0eed ($5.46 in chips)
Seat 4: 8d15f06b ($11.39 in chips)
Seat 5: 5e4a0558 ($4.97 in chips)
Seat 6: Hero ($7.77 in chips)
6186df3d: posts small blind $0.02
b8e0eed: posts big blind $0.05
*** HOLE CARDS ***
Dealt to 257cb6ea 
Dealt to 6186df3d 
Dealt to b8e0eed 
Dealt to 8d15f06b 
Dealt to 5e4a0558 
Dealt to Hero [Ks 6d]
8d15f06b: folds
5e4a0558: folds
Hero: folds
257cb6ea: raises $0.06 to $0.11
6186df3d: folds
b8e0eed: raises $0.39 to $0.5
257cb6ea: folds
Uncalled bet ($0.39) returned to b8e0eed
*** SHOWDOWN ***
b8e0eed collected $0.23 from pot
*** SUMMARY ***
Total pot $0.24 | Rake $0.01 | Jackpot $0 | Bingo $0 | Fortune $0 | Tax $0
Seat 1: 257cb6ea (button) folded before Flop
Seat 2: 6186df3d (small blind) folded before Flop
Seat 3: b8e0eed (big blind) collected ($0.23)
Seat 4: 8d15f06b folded before Flop (didn't bet)
Seat 5: 5e4a0558 folded before Flop (didn't bet)
Seat 6: Hero folded before Flop (didn't bet)


Poker Hand #RC2078480037: Hold'em No Limit ($0.02/$0.05) - 2023/12/22 21:21:13
Table 'RushAndCash785424' 6-max Seat #1 is the button
Seat 1: ec033a10 ($5.19 in chips)
Seat 2: 4e20b85a ($7.12 in chips)
Seat 3: d56f57b9 ($10.65 in chips)
Seat 4: Hero ($7.77 in chips)
Seat 5: b61f5bde ($10.22 in chips)
Seat 6: 6ef00a1b ($15.21 in chips)
4e20b85a: posts small blind $0.02
d56f57b9: posts big blind $0.05
*** HOLE CARDS ***
Dealt to ec033a10 
Dealt to 4e20b85a 
Dealt to d56f57b9 
Dealt to Hero [6c 7d]
Dealt to b61f5bde 
Dealt to 6ef00a1b 
Hero: folds
b61f5bde: folds
6ef00a1b: folds
ec033a10: raises $0.05 to $0.1
4e20b85a: folds
d56f57b9: raises $0.33 to $0.43
ec033a10: raises $0.88 to $1.31
d56f57b9: folds
Uncalled bet ($0.88) returned to ec033a10
*** SHOWDOWN ***
ec033a10 collected $0.84 from pot
*** SUMMARY ***
Total pot $0.88 | Rake $0.04 | Jackpot $0 | Bingo $0 | Fortune $0 | Tax $0
Seat 1: ec033a10 (button) collected ($0.84)
Seat 2: 4e20b85a (small blind) folded before Flop
Seat 3: d56f57b9 (big blind) folded before Flop
Seat 4: Hero folded before Flop (didn't bet)
Seat 5: b61f5bde folded before Flop (didn't bet)
Seat 6: 6ef00a1b folded before Flop (didn't bet)


Poker Hand #RC2078479952: Hold'em No Limit ($0.02/$0.05) - 2023/12/22 21:21:09
Table 'RushAndCash785384' 6-max Seat #1 is the button
Seat 1: bdb78d67 ($5.68 in chips)
Seat 2: 4356cdb7 ($4.95 in chips)
Seat 3: 6ef00a1b ($15.26 in chips)
Seat 4: 7e84e7dc ($14.75 in chips)
Seat 5: Hero ($7.77 in chips)
Seat 6: 317ccf77 ($2.17 in chips)
4356cdb7: posts small blind $0.02
6ef00a1b: posts big blind $0.05
*** HOLE CARDS ***
Dealt to bdb78d67 
Dealt to 4356cdb7 
Dealt to 6ef00a1b 
Dealt to 7e84e7dc 
Dealt to Hero [Jc 5s]
Dealt to 317ccf77 
7e84e7dc: folds
Hero: folds
317ccf77: folds
bdb78d67: folds
4356cdb7: folds
Uncalled bet ($0.03) returned to 6ef00a1b
*** SHOWDOWN ***
6ef00a1b collected $0.04 from pot
*** SUMMARY ***
Total pot $0.04 | Rake $0 | Jackpot $0 | Bingo $0 | Fortune $0 | Tax $0
Seat 1: bdb78d67 (button) folded before Flop (didn't bet)
Seat 2: 4356cdb7 (small blind) folded before Flop
Seat 3: 6ef00a1b (big blind) collected ($0.04)
Seat 4: 7e84e7dc folded before Flop (didn't bet)
Seat 5: Hero folded before Flop (didn't bet)
Seat 6: 317ccf77 folded before Flop (didn't bet)


Poker Hand #RC2078479770: Hold'em No Limit ($0.02/$0.05) - 2023/12/22 21:20:59
Table 'RushAndCash785300' 6-max Seat #1 is the button
Seat 1: e194bfc6 ($4.25 in chips)
Seat 2: Hero ($7.79 in chips)
Seat 3: 7e84e7dc ($14.8 in chips)
Seat 4: 9dcfc86d ($3.81 in chips)
Seat 5: b1e42a90 ($5.08 in chips)
Seat 6: e5b5763b ($7.55 in chips)
Hero: posts small blind $0.02
7e84e7dc: posts big blind $0.05
*** HOLE CARDS ***
Dealt to e194bfc6 
Dealt to Hero [2d 4d]
Dealt to 7e84e7dc 
Dealt to 9dcfc86d 
Dealt to b1e42a90 
Dealt to e5b5763b 
9dcfc86d: folds
b1e42a90: folds
e5b5763b: folds
e194bfc6: raises $0.1 to $0.15
Hero: folds
7e84e7dc: folds
Uncalled bet ($0.1) returned to e194bfc6
*** SHOWDOWN ***
e194bfc6 collected $0.12 from pot
*** SUMMARY ***
Total pot $0.12 | Rake $0 | Jackpot $0 | Bingo $0 | Fortune $0 | Tax $0
Seat 1: e194bfc6 (button) collected ($0.12)
Seat 2: Hero (small blind) folded before Flop
Seat 3: 7e84e7dc (big blind) folded before Flop
Seat 4: 9dcfc86d folded before Flop (didn't bet)
Seat 5: b1e42a90 folded before Flop (didn't bet)
Seat 6: e5b5763b folded before Flop (didn't bet)


Poker Hand #RC2078479576: Hold'em No Limit ($0.02/$0.05) - 2023/12/22 21:20:47
Table 'RushAndCash785209' 6-max Seat #1 is the button
Seat 1: 395dbfbb ($5.85 in chips)
Seat 2: 6c7c67da ($5 in chips)
Seat 3: Hero ($7.84 in chips)
Seat 4: 89ac50e8 ($11.49 in chips)
Seat 5: ebeb62f7 ($5.1 in chips)
Seat 6: d6c4e270 ($3.66 in chips)
6c7c67da: posts small blind $0.02
Hero: posts big blind $0.05
*** HOLE CARDS ***
Dealt to 395dbfbb 
Dealt to 6c7c67da 
Dealt to Hero [3s 4h]
Dealt to 89ac50e8 
Dealt to ebeb62f7 
Dealt to d6c4e270 
89ac50e8: raises $0.05 to $0.1
ebeb62f7: folds
d6c4e270: folds
395dbfbb: folds
6c7c67da: folds
Hero: folds
Uncalled bet ($0.05) returned to 89ac50e8
*** SHOWDOWN ***
89ac50e8 collected $0.12 from pot
*** SUMMARY ***
Total pot $0.12 | Rake $0 | Jackpot $0 | Bingo $0 | Fortune $0 | Tax $0
Seat 1: 395dbfbb (button) folded before Flop (didn't bet)
Seat 2: 6c7c67da (small blind) folded before Flop
Seat 3: Hero (big blind) folded before Flop
Seat 4: 89ac50e8 collected ($0.12)
Seat 5: ebeb62f7 folded before Flop (didn't bet)
Seat 6: d6c4e270 folded before Flop (didn't bet)


Poker Hand #RC2078479480: Hold'em No Limit ($0.02/$0.05) - 2023/12/22 21:20:42
Table 'RushAndCash785165' 6-max Seat #1 is the button
Seat 1: dd325814 ($7.08 in chips)
Seat 2: 59ef18cb ($2.32 in chips)
Seat 3: 9926d81a ($7.16 in chips)
Seat 4: 9b0ec3a ($12.57 in chips)
Seat 5: 3a9b3c34 ($3.35 in chips)
Seat 6: Hero ($7.84 in chips)
59ef18cb: posts small blind $0.02
9926d81a: posts big blind $0.05
*** HOLE CARDS ***
Dealt to dd325814 
Dealt to 59ef18cb 
Dealt to 9926d81a 
Dealt to 9b0ec3a 
Dealt to 3a9b3c34 
Dealt to Hero [Td 9s]
9b0ec3a: folds
3a9b3c34: raises $0.07 to $0.12
Hero: folds
dd325814: folds
59ef18cb: calls $0.1
9926d81a: folds
*** FLOP *** [3s 8d As]
59ef18cb: checks
3a9b3c34: checks
*** TURN *** [3s 8d As] [Jh]
59ef18cb: bets $0.15
3a9b3c34: raises $0.3 to $0.45
59ef18cb: folds
Uncalled bet ($0.3) returned to 3a9b3c34
*** SHOWDOWN ***
3a9b3c34 collected $0.56 from pot
*** SUMMARY ***
Total pot $0.59 | Rake $0.03 | Jackpot $0 | Bingo $0 | Fortune $0 | Tax $0
Board [3s 8d As Jh]
Seat 1: dd325814 (button) folded before Flop (didn't bet)
Seat 2: 59ef18cb (small blind) folded on the Turn
Seat 3: 9926d81a (big blind) folded before Flop
Seat 4: 9b0ec3a folded before Flop (didn't bet)
Seat 5: 3a9b3c34 won ($0.56)
Seat 6: Hero folded before Flop (didn't bet)


Poker Hand #RC2078479425: Hold'em No Limit ($0.02/$0.05) - 2023/12/22 21:20:39
Table 'RushAndCash785140' 6-max Seat #1 is the button
Seat 1: 3c03eb6e ($7.1 in chips)
Seat 2: b5259737 ($12.18 in chips)
Seat 3: 93990934 ($8.53 in chips)
Seat 4: Hero ($7.84 in chips)
Seat 5: ad142c24 ($12.59 in chips)
Seat 6: cbe22a87 ($12.73 in chips)
b5259737: posts small blind $0.02
93990934: posts big blind $0.05
*** HOLE CARDS ***
Dealt to 3c03eb6e 
Dealt to b5259737 
Dealt to 93990934 
Dealt to Hero [7h 4s]
Dealt to ad142c24 
Dealt to cbe22a87 
Hero: folds
ad142c24: raises $0.06 to $0.11
cbe22a87: folds
3c03eb6e: folds
b5259737: folds
93990934: raises $0.18 to $0.29
ad142c24: calls $0.18
*** FLOP *** [3s Td 6c]
93990934: checks
ad142c24: checks
*** TURN *** [3s Td 6c] [3c]
93990934: checks
ad142c24: checks
*** RIVER *** [3s Td 6c 3c] [5s]
93990934: checks
ad142c24: checks
93990934: shows [Ac Kh] (Pair of Treys)
ad142c24: shows [Kc Qd] (Pair of Treys)
*** SHOWDOWN ***
93990934 collected $0.57 from pot
*** SUMMARY ***
Total pot $0.6 | Rake $0.03 | Jackpot $0 | Bingo $0 | Fortune $0 | Tax $0
Board [3s Td 6c 3c 5s]
Seat 1: 3c03eb6e (button) folded before Flop (didn't bet)
Seat 2: b5259737 (small blind) folded before Flop
Seat 3: 93990934 (big blind) showed [Ac Kh] and won ($0.57) with Pair of Treys
Seat 4: Hero folded before Flop (didn't bet)
Seat 5: ad142c24 showed [Kc Qd] and lost with Pair of Treys
Seat 6: cbe22a87 folded before Flop (didn't bet)


Poker Hand #RC2078479182: Hold'em No Limit ($0.02/$0.05) - 2023/12/22 21:20:24
Table 'RushAndCash785020' 6-max Seat #1 is the button
Seat 1: 42b55ba4 ($5.41 in chips)
Seat 2: 2ce216bb ($5 in chips)
Seat 3: 561e5b01 ($5.83 in chips)
Seat 4: 84d4f92c ($5.8 in chips)
Seat 5: 110b939f ($5.5 in chips)
Seat 6: Hero ($7.77 in chips)
2ce216bb: posts small blind $0.02
561e5b01: posts big blind $0.05
*** HOLE CARDS ***
Dealt to 42b55ba4 
Dealt to 2ce216bb 
Dealt to 561e5b01 
Dealt to 84d4f92c 
Dealt to 110b939f 
Dealt to Hero [3s 3c]
84d4f92c: folds
110b939f: folds
Hero: raises $0.05 to $0.1
42b55ba4: folds
2ce216bb: folds
561e5b01: folds
Uncalled bet ($0.05) returned to Hero
*** SHOWDOWN ***
Hero collected $0.12 from pot
*** SUMMARY ***
Total pot $0.12 | Rake $0 | Jackpot $0 | Bingo $0 | Fortune $0 | Tax $0
Seat 1: 42b55ba4 (button) folded before Flop (didn't bet)
Seat 2: 2ce216bb (small blind) folded before Flop
Seat 3: 561e5b01 (big blind) folded before Flop
Seat 4: 84d4f92c folded before Flop (didn't bet)
Seat 5: 110b939f folded before Flop (didn't bet)
Seat 6: Hero collected ($0.12)


Poker Hand #RC2078479092: Hold'em No Limit ($0.02/$0.05) - 2023/12/22 21:20:19
Table 'RushAndCash784974' 6-max Seat #1 is the button
Seat 1: 59a39874 ($8.76 in chips)
Seat 2: Hero ($7.79 in chips)
Seat 3: a7392a18 ($16.92 in chips)
Seat 4: 8014c02 ($22.42 in chips)
Seat 5: d6126048 ($8.13 in chips)
Seat 6: 16ecd29a ($9.47 in chips)
Hero: posts small blind $0.02
a7392a18: posts big blind $0.05
*** HOLE CARDS ***
Dealt to 59a39874 
Dealt to Hero [Td 2d]
Dealt to a7392a18 
Dealt to 8014c02 
Dealt to d6126048 
Dealt to 16ecd29a 
8014c02: folds
d6126048: folds
16ecd29a: raises $0.1 to $0.15
59a39874: folds
Hero: folds
a7392a18: folds
Uncalled bet ($0.1) returned to 16ecd29a
*** SHOWDOWN ***
16ecd29a collected $0.12 from pot
*** SUMMARY ***
Total pot $0.12 | Rake $0 | Jackpot $0 | Bingo $0 | Fortune $0 | Tax $0
Seat 1: 59a39874 (button) folded before Flop (didn't bet)
Seat 2: Hero (small blind) folded before Flop
Seat 3: a7392a18 (big blind) folded before Flop
Seat 4: 8014c02 folded before Flop (didn't bet)
Seat 5: d6126048 folded before Flop (didn't bet)
Seat 6: 16ecd29a collected ($0.12)


Poker Hand #RC2078478373: Hold'em No Limit ($0.02/$0.05) - 2023/12/22 21:19:35
Table 'RushAndCash784623' 6-max Seat #1 is the button
Seat 1: 3c8f2664 ($4.21 in chips)
Seat 2: 7157dd36 ($8.73 in chips)
Seat 3: Hero ($7.84 in chips)
Seat 4: 7466ff6a ($20.72 in chips)
Seat 5: ad963d07 ($5.1 in chips)
Seat 6: c8f603a8 ($3.45 in chips)
7157dd36: posts small blind $0.02
Hero: posts big blind $0.05
*** HOLE CARDS ***
Dealt to 3c8f2664 
Dealt to 7157dd36 
Dealt to Hero [Ad Ah]
Dealt to 7466ff6a 
Dealt to ad963d07 
Dealt to c8f603a8 
7466ff6a: raises $0.08 to $0.13
ad963d07: folds
c8f603a8: folds
3c8f2664: folds
7157dd36: folds
Hero: folds
Uncalled bet ($0.08) returned to 7466ff6a
*** SHOWDOWN ***
7466ff6a collected $0.12 from pot
*** SUMMARY ***
Total pot $0.12 | Rake $0 | Jackpot $0 | Bingo $0 | Fortune $0 | Tax $0
Seat 1: 3c8f2664 (button) folded before Flop (didn't bet)
Seat 2: 7157dd36 (small blind) folded before Flop
Seat 3: Hero (big blind) folded before Flop
Seat 4: 7466ff6a collected ($0.12)
Seat 5: ad963d07 folded before Flop (didn't bet)
Seat 6: c8f603a8 folded before Flop (didn't bet)


Poker Hand #RC2078477716: Hold'em No Limit ($0.02/$0.05) - 2023/12/22 21:18:58
Table 'RushAndCash784312' 6-max Seat #1 is the button
Seat 1: 7f179248 ($6.68 in chips)
Seat 2: a343854 ($8.03 in chips)
Seat 3: c8f603a8 ($4.23 in chips)
Seat 4: 4c0d7324 ($10.48 in chips)
Seat 5: Hero ($7.18 in chips)
Seat 6: 10c9f9a8 ($5 in chips)
a343854: posts small blind $0.02
c8f603a8: posts big blind $0.05
*** HOLE CARDS ***
Dealt to 7f179248 
Dealt to a343854 
Dealt to c8f603a8 
Dealt to 4c0d7324 
Dealt to Hero [Qs Qh]
Dealt to 10c9f9a8 
4c0d7324: folds
Hero: raises $0.05 to $0.1
10c9f9a8: folds
7f179248: folds
a343854: folds
c8f603a8: calls $0.05
*** FLOP *** [Tc Qc 5h]
c8f603a8: checks
Hero: bets $0.1
c8f603a8: calls $0.1
*** TURN *** [Tc Qc 5h] [4c]
c8f603a8: bets $0.14
Hero: calls $0.14
*** RIVER *** [Tc Qc 5h 4c] [7s]
c8f603a8: bets $0.44
Hero: calls $0.44
c8f603a8: shows [9d Jd] (Queen-High)
Hero: shows [Qs Qh] (Three Queens)
*** SHOWDOWN ***
Hero collected $1.44 from pot
*** SUMMARY ***
Total pot $1.58 | Rake $0.07 | Jackpot $0.07 | Bingo $0 | Fortune $0 | Tax $0
Board [Tc Qc 5h 4c 7s]
Seat 1: 7f179248 (button) folded before Flop (didn't bet)
Seat 2: a343854 (small blind) folded before Flop
Seat 3: c8f603a8 (big blind) showed [9d Jd] and lost with Queen-High
Seat 4: 4c0d7324 folded before Flop (didn't bet)
Seat 5: Hero showed [Qs Qh] and won ($1.44) with Three Queens
Seat 6: 10c9f9a8 folded before Flop (didn't bet)


Poker Hand #RC2078477595: Hold'em No Limit ($0.02/$0.05) - 2023/12/22 21:18:51
Table 'RushAndCash784252' 6-max Seat #1 is the button
Seat 1: Hero ($7.18 in chips)
Seat 2: 919daa51 ($3.55 in chips)
Seat 3: f4ef789c ($15.37 in chips)
Seat 4: ee21e88c ($5.68 in chips)
Seat 5: e732401c ($5.08 in chips)
Seat 6: e4d2f8b7 ($5 in chips)
919daa51: posts small blind $0.02
f4ef789c: posts big blind $0.05
*** HOLE CARDS ***
Dealt to Hero [4d 6d]
Dealt to 919daa51 
Dealt to f4ef789c 
Dealt to ee21e88c 
Dealt to e732401c 
Dealt to e4d2f8b7 
ee21e88c: raises $0.1 to $0.15
e732401c: folds
e4d2f8b7: folds
Hero: folds
919daa51: folds
f4ef789c: calls $0.1
*** FLOP *** [5s Jd 7d]
f4ef789c: checks
ee21e88c: bets $0.11
f4ef789c: calls $0.11
*** TURN *** [5s Jd 7d] [Td]
f4ef789c: checks
ee21e88c: checks
*** RIVER *** [5s Jd 7d Td] [5d]
f4ef789c: bets $0.7
ee21e88c: folds
Uncalled bet ($0.7) returned to f4ef789c
*** SHOWDOWN ***
f4ef789c collected $0.52 from pot
*** SUMMARY ***
Total pot $0.54 | Rake $0.02 | Jackpot $0 | Bingo $0 | Fortune $0 | Tax $0
Board [5s Jd 7d Td 5d]
Seat 1: Hero (button) folded before Flop (didn't bet)
Seat 2: 919daa51 (small blind) folded before Flop
Seat 3: f4ef789c (big blind) won ($0.52)
Seat 4: ee21e88c folded on the River
Seat 5: e732401c folded before Flop (didn't bet)
Seat 6: e4d2f8b7 folded before Flop (didn't bet)


Poker Hand #RC2078477464: Hold'em No Limit ($0.02/$0.05) - 2023/12/22 21:18:43
Table 'RushAndCash784186' 6-max Seat #1 is the button
Seat 1: 25941725 ($4.56 in chips)
Seat 2: 5a6bcca5 ($10.35 in chips)
Seat 3: 2ed46053 ($8.37 in chips)
Seat 4: 673162b7 ($11.89 in chips)
Seat 5: Hero ($7.18 in chips)
Seat 6: f0571dd4 ($5.25 in chips)
5a6bcca5: posts small blind $0.02
2ed46053: posts big blind $0.05
*** HOLE CARDS ***
Dealt to 25941725 
Dealt to 5a6bcca5 
Dealt to 2ed46053 
Dealt to 673162b7 
Dealt to Hero [Qd Ts]
Dealt to f0571dd4 
673162b7: folds
Hero: folds
f0571dd4: folds
25941725: raises $0.07 to $0.12
5a6bcca5: folds
2ed46053: folds
Uncalled bet ($0.07) returned to 25941725
*** SHOWDOWN ***
25941725 collected $0.12 from pot
*** SUMMARY ***
Total pot $0.12 | Rake $0 | Jackpot $0 | Bingo $0 | Fortune $0 | Tax $0
Seat 1: 25941725 (button) collected ($0.12)
Seat 2: 5a6bcca5 (small blind) folded before Flop
Seat 3: 2ed46053 (big blind) folded before Flop
Seat 4: 673162b7 folded before Flop (didn't bet)
Seat 5: Hero folded before Flop (didn't bet)
Seat 6: f0571dd4 folded before Flop (didn't bet)


Poker Hand #RC2078477359: Hold'em No Limit ($0.02/$0.05) - 2023/12/22 21:18:38
Table 'RushAndCash784132' 6-max Seat #1 is the button
Seat 1: 6ada9800 ($4.71 in chips)
Seat 2: 54daf47b ($9.34 in chips)
Seat 3: ac89ef05 ($8.68 in chips)
Seat 4: c7592cbf ($11.5 in chips)
Seat 5: Hero ($7.18 in chips)
Seat 6: a2ebb3c7 ($5.77 in chips)
54daf47b: posts small blind $0.02
ac89ef05: posts big blind $0.05
*** HOLE CARDS ***
Dealt to 6ada9800 
Dealt to 54daf47b 
Dealt to ac89ef05 
Dealt to c7592cbf 
Dealt to Hero [Ts Qc]
Dealt to a2ebb3c7 
c7592cbf: folds
Hero: folds
a2ebb3c7: folds
6ada9800: folds
54daf47b: folds
Uncalled bet ($0.03) returned to ac89ef05
*** SHOWDOWN ***
ac89ef05 collected $0.04 from pot
*** SUMMARY ***
Total pot $0.04 | Rake $0 | Jackpot $0 | Bingo $0 | Fortune $0 | Tax $0
Seat 1: 6ada9800 (button) folded before Flop (didn't bet)
Seat 2: 54daf47b (small blind) folded before Flop
Seat 3: ac89ef05 (big blind) collected ($0.04)
Seat 4: c7592cbf folded before Flop (didn't bet)
Seat 5: Hero folded before Flop (didn't bet)
Seat 6: a2ebb3c7 folded before Flop (didn't bet)


Poker Hand #RC2078476745: Hold'em No Limit ($0.02/$0.05) - 2023/12/22 21:18:01
Table 'RushAndCash783823' 6-max Seat #1 is the button
Seat 1: b61f5bde ($8.85 in chips)
Seat 2: 4fedcb8f ($7.38 in chips)
Seat 3: bdb78d67 ($6.72 in chips)
Seat 4: c7592cbf ($11.63 in chips)
Seat 5: Hero ($6.99 in chips)
Seat 6: e44205f6 ($6.39 in chips)
4fedcb8f: posts small blind $0.02
bdb78d67: posts big blind $0.05
*** HOLE CARDS ***
Dealt to b61f5bde 
Dealt to 4fedcb8f 
Dealt to bdb78d67 
Dealt to c7592cbf 
Dealt to Hero [Kc Kh]
Dealt to e44205f6 
c7592cbf: raises $0.08 to $0.13
Hero: raises $0.33 to $0.46
e44205f6: folds
b61f5bde: folds
4fedcb8f: folds
bdb78d67: folds
c7592cbf: folds
Uncalled bet ($0.33) returned to Hero
*** SHOWDOWN ***
Hero collected $0.32 from pot
*** SUMMARY ***
Total pot $0.33 | Rake $0.01 | Jackpot $0 | Bingo $0 | Fortune $0 | Tax $0
Seat 1: b61f5bde (button) folded before Flop (didn't bet)
Seat 2: 4fedcb8f (small blind) folded before Flop
Seat 3: bdb78d67 (big blind) folded before Flop
Seat 4: c7592cbf folded before Flop
Seat 5: Hero collected ($0.32)
Seat 6: e44205f6 folded before Flop (didn't bet)


Poker Hand #RC2078476232: Hold'em No Limit ($0.02/$0.05) - 2023/12/22 21:17:32
Table 'RushAndCash783580' 6-max Seat #1 is the button
Seat 1: ad963d07 ($5.71 in chips)
Seat 2: 4b46876e ($4.5 in chips)
Seat 3: Hero ($7.09 in chips)
Seat 4: 174ad468 ($5 in chips)
Seat 5: d21a0c3 ($8.33 in chips)
Seat 6: e69446ee ($6.18 in chips)
4b46876e: posts small blind $0.02
Hero: posts big blind $0.05
*** HOLE CARDS ***
Dealt to ad963d07 
Dealt to 4b46876e 
Dealt to Hero [7c Ad]
Dealt to 174ad468 
Dealt to d21a0c3 
Dealt to e69446ee 
174ad468: raises $0.05 to $0.1
d21a0c3: folds
e69446ee: folds
ad963d07: calls $0.1
4b46876e: folds
Hero: calls $0.05
*** FLOP *** [Qh 9d Ts]
Hero: checks
174ad468: bets $0.09
ad963d07: calls $0.09
Hero: folds
*** TURN *** [Qh 9d Ts] [3c]
174ad468: bets $0.25
ad963d07: calls $0.25
*** RIVER *** [Qh 9d Ts 3c] [Ks]
174ad468: bets $1.35
ad963d07: folds
Uncalled bet ($1.35) returned to 174ad468
*** SHOWDOWN ***
174ad468 collected $0.94 from pot
*** SUMMARY ***
Total pot $1 | Rake $0.06 | Jackpot $0 | Bingo $0 | Fortune $0 | Tax $0
Board [Qh 9d Ts 3c Ks]
Seat 1: ad963d07 (button) folded on the River
Seat 2: 4b46876e (small blind) folded before Flop
Seat 3: Hero (big blind) folded on the Flop
Seat 4: 174ad468 won ($0.94)
Seat 5: d21a0c3 folded before Flop (didn't bet)
Seat 6: e69446ee folded before Flop (didn't bet)


Poker Hand #RC2078476134: Hold'em No Limit ($0.02/$0.05) - 2023/12/22 21:17:27
Table 'RushAndCash783531' 6-max Seat #1 is the button
Seat 1: Hero ($7.09 in chips)
Seat 2: 4cfc823 ($5.02 in chips)
Seat 3: 71871718 ($2.55 in chips)
Seat 4: 27517d94 ($7.4 in chips)
Seat 5: db5367a6 ($10.31 in chips)
Seat 6: 23c96099 ($5.25 in chips)
4cfc823: posts small blind $0.02
71871718: posts big blind $0.05
*** HOLE CARDS ***
Dealt to Hero [8s 3h]
Dealt to 4cfc823 
Dealt to 71871718 
Dealt to 27517d94 
Dealt to db5367a6 
Dealt to 23c96099 
27517d94: folds
db5367a6: folds
23c96099: folds
Hero: folds
4cfc823: folds
Uncalled bet ($0.03) returned to 71871718
*** SHOWDOWN ***
71871718 collected $0.04 from pot
*** SUMMARY ***
Total pot $0.04 | Rake $0 | Jackpot $0 | Bingo $0 | Fortune $0 | Tax $0
Seat 1: Hero (button) folded before Flop (didn't bet)
Seat 2: 4cfc823 (small blind) folded before Flop
Seat 3: 71871718 (big blind) collected ($0.04)
Seat 4: 27517d94 folded before Flop (didn't bet)
Seat 5: db5367a6 folded before Flop (didn't bet)
Seat 6: 23c96099 folded before Flop (didn't bet)


Poker Hand #RC2078475962: Hold'em No Limit ($0.02/$0.05) - 2023/12/22 21:17:17
Table 'RushAndCash783448' 6-max Seat #1 is the button
Seat 1: 8f80311 ($1.47 in chips)
Seat 2: Hero ($7.11 in chips)
Seat 3: edce49c5 ($13.17 in chips)
Seat 4: f0571dd4 ($5.35 in chips)
Seat 5: de3b84bb ($25.07 in chips)
Seat 6: f751acea ($5.06 in chips)
Hero: posts small blind $0.02
edce49c5: posts big blind $0.05
*** HOLE CARDS ***
Dealt to 8f80311 
Dealt to Hero [Ad 3s]
Dealt to edce49c5 
Dealt to f0571dd4 
Dealt to de3b84bb 
Dealt to f751acea 
f0571dd4: folds
de3b84bb: folds
f751acea: folds
8f80311: raises $0.1 to $0.15
Hero: folds
edce49c5: folds
Uncalled bet ($0.1) returned to 8f80311
*** SHOWDOWN ***
8f80311 collected $0.12 from pot
*** SUMMARY ***
Total pot $0.12 | Rake $0 | Jackpot $0 | Bingo $0 | Fortune $0 | Tax $0
Seat 1: 8f80311 (button) collected ($0.12)
Seat 2: Hero (small blind) folded before Flop
Seat 3: edce49c5 (big blind) folded before Flop
Seat 4: f0571dd4 folded before Flop (didn't bet)
Seat 5: de3b84bb folded before Flop (didn't bet)
Seat 6: f751acea folded before Flop (didn't bet)


Poker Hand #RC2078475897: Hold'em No Limit ($0.02/$0.05) - 2023/12/22 21:17:13
Table 'RushAndCash783415' 6-max Seat #1 is the button
Seat 1: 5d317abf ($9.24 in chips)
Seat 2: 7157dd36 ($8.91 in chips)
Seat 3: bada497e ($5.07 in chips)
Seat 4: 40c4a4f ($10.53 in chips)
Seat 5: b976716a ($17.04 in chips)
Seat 6: Hero ($7.11 in chips)
7157dd36: posts small blind $0.02
bada497e: posts big blind $0.05
*** HOLE CARDS ***
Dealt to 5d317abf 
Dealt to 7157dd36 
Dealt to bada497e 
Dealt to 40c4a4f 
Dealt to b976716a 
Dealt to Hero [2s 4c]
40c4a4f: folds
b976716a: folds
Hero: folds
5d317abf: folds
7157dd36: calls $0.03
bada497e: checks
*** FLOP *** [Jh Kh 3s]
7157dd36: bets $0.05
bada497e: calls $0.05
*** TURN *** [Jh Kh 3s] [8d]
7157dd36: bets $0.1
bada497e: calls $0.1
*** RIVER *** [Jh Kh 3s 8d] [As]
7157dd36: checks
bada497e: bets $0.4
7157dd36: folds
Uncalled bet ($0.4) returned to bada497e
*** SHOWDOWN ***
bada497e collected $0.38 from pot
*** SUMMARY ***
Total pot $0.4 | Rake $0.02 | Jackpot $0 | Bingo $0 | Fortune $0 | Tax $0
Board [Jh Kh 3s 8d As]
Seat 1: 5d317abf (button) folded before Flop (didn't bet)
Seat 2: 7157dd36 (small blind) folded on the River
Seat 3: bada497e (big blind) won ($0.38)
Seat 4: 40c4a4f folded before Flop (didn't bet)
Seat 5: b976716a folded before Flop (didn't bet)
Seat 6: Hero folded before Flop (didn't bet)


Poker Hand #RC2078475760: Hold'em No Limit ($0.02/$0.05) - 2023/12/22 21:17:05
Table 'RushAndCash783352' 6-max Seat #1 is the button
Seat 1: b4439dda ($4.01 in chips)
Seat 2: 610bd7fc ($11.88 in chips)
Seat 3: 83d24812 ($5.2 in chips)
Seat 4: 74c8019d ($2.74 in chips)
Seat 5: 3056048f ($5.07 in chips)
Seat 6: Hero ($7.11 in chips)
610bd7fc: posts small blind $0.02
83d24812: posts big blind $0.05
*** HOLE CARDS ***
Dealt to b4439dda 
Dealt to 610bd7fc 
Dealt to 83d24812 
Dealt to 74c8019d 
Dealt to 3056048f 
Dealt to Hero [Ac 5d]
74c8019d: folds
3056048f: folds
Hero: folds
b4439dda: folds
610bd7fc: folds
Uncalled bet ($0.03) returned to 83d24812
*** SHOWDOWN ***
83d24812 collected $0.04 from pot
*** SUMMARY ***
Total pot $0.04 | Rake $0 | Jackpot $0 | Bingo $0 | Fortune $0 | Tax $0
Seat 1: b4439dda (button) folded before Flop (didn't bet)
Seat 2: 610bd7fc (small blind) folded before Flop
Seat 3: 83d24812 (big blind) collected ($0.04)
Seat 4: 74c8019d folded before Flop (didn't bet)
Seat 5: 3056048f folded before Flop (didn't bet)
Seat 6: Hero folded before Flop (didn't bet)


Poker Hand #RC2078475515: Hold'em No Limit ($0.02/$0.05) - 2023/12/22 21:16:51
Table 'RushAndCash783231' 6-max Seat #1 is the button
Seat 1: 7e3b11a6 ($5 in chips)
Seat 2: 3cf310b ($7.69 in chips)
Seat 3: 2ed46053 ($8.75 in chips)
Seat 4: Hero ($7.11 in chips)
Seat 5: dc7cff29 ($5.69 in chips)
Seat 6: 59ef18cb ($2.2 in chips)
3cf310b: posts small blind $0.02
2ed46053: posts big blind $0.05
*** HOLE CARDS ***
Dealt to 7e3b11a6 
Dealt to 3cf310b 
Dealt to 2ed46053 
Dealt to Hero [2h As]
Dealt to dc7cff29 
Dealt to 59ef18cb 
Hero: folds
dc7cff29: folds
59ef18cb: folds
7e3b11a6: raises $0.06 to $0.11
3cf310b: raises $0.33 to $0.44
2ed46053: folds
7e3b11a6: folds
Uncalled bet ($0.33) returned to 3cf310b
*** SHOWDOWN ***
3cf310b collected $0.26 from pot
*** SUMMARY ***
Total pot $0.27 | Rake $0.01 | Jackpot $0 | Bingo $0 | Fortune $0 | Tax $0
Seat 1: 7e3b11a6 (button) folded before Flop
Seat 2: 3cf310b (small blind) collected ($0.26)
Seat 3: 2ed46053 (big blind) folded before Flop
Seat 4: Hero folded before Flop (didn't bet)
Seat 5: dc7cff29 folded before Flop (didn't bet)
Seat 6: 59ef18cb folded before Flop (didn't bet)


Poker Hand #RC2078475444: Hold'em No Limit ($0.02/$0.05) - 2023/12/22 21:16:47
Table 'RushAndCash783194' 6-max Seat #1 is the button
Seat 1: 3c028e9 ($7.61 in chips)
Seat 2: 5b2bf61b ($5.21 in chips)
Seat 3: 42b55ba4 ($6.37 in chips)
Seat 4: Hero ($7.11 in chips)
Seat 5: d3b1f4ed ($5 in chips)
Seat 6: 6e966ccc ($5.17 in chips)
5b2bf61b: posts small blind $0.02
42b55ba4: posts big blind $0.05
*** HOLE CARDS ***
Dealt to 3c028e9 
Dealt to 5b2bf61b 
Dealt to 42b55ba4 
Dealt to Hero [Ts 5s]
Dealt to d3b1f4ed 
Dealt to 6e966ccc 
Hero: folds
d3b1f4ed: raises $0.08 to $0.13
6e966ccc: folds
3c028e9: folds
5b2bf61b: folds
42b55ba4: folds
Uncalled bet ($0.08) returned to d3b1f4ed
*** SHOWDOWN ***
d3b1f4ed collected $0.12 from pot
*** SUMMARY ***
Total pot $0.12 | Rake $0 | Jackpot $0 | Bingo $0 | Fortune $0 | Tax $0
Seat 1: 3c028e9 (button) folded before Flop (didn't bet)
Seat 2: 5b2bf61b (small blind) folded before Flop
Seat 3: 42b55ba4 (big blind) folded before Flop
Seat 4: Hero folded before Flop (didn't bet)
Seat 5: d3b1f4ed collected ($0.12)
Seat 6: 6e966ccc folded before Flop (didn't bet)


Poker Hand #RC2078475262: Hold'em No Limit ($0.02/$0.05) - 2023/12/22 21:16:36
Table 'RushAndCash783103' 6-max Seat #1 is the button
Seat 1: 3f0bf20a ($5 in chips)
Seat 2: Hero ($7.13 in chips)
Seat 3: 24503504 ($5.07 in chips)
Seat 4: 23a63651 ($16.43 in chips)
Seat 5: 294d35ce ($5.75 in chips)
Seat 6: a420712c ($12.09 in chips)
Hero: posts small blind $0.02
24503504: posts big blind $0.05
*** HOLE CARDS ***
Dealt to 3f0bf20a 
Dealt to Hero [4s Qs]
Dealt to 24503504 
Dealt to 23a63651 
Dealt to 294d35ce 
Dealt to a420712c 
23a63651: raises $0.05 to $0.1
294d35ce: calls $0.1
a420712c: folds
3f0bf20a: folds
Hero: folds
24503504: raises $0.4 to $0.5
23a63651: calls $0.4
294d35ce: folds
*** FLOP *** [5h 6h 2d]
24503504: bets $0.5
23a63651: calls $0.5
*** TURN *** [5h 6h 2d] [Tc]
24503504: checks
23a63651: bets $1.59
24503504: raises $2.48 to $4.07 and is all-in
23a63651: calls $2.48
24503504: shows [Jc Js] (Pair of Jacks)
23a63651: shows [7d 7h] (Pair of Sevens)
*** RIVER *** [5h 6h 2d Tc] [Qh]
*** SHOWDOWN ***
24503504 collected $10.04 from pot
*** SUMMARY ***
Total pot $10.26 | Rake $0.15 | Jackpot $0.07 | Bingo $0 | Fortune $0 | Tax $0
Board [5h 6h 2d Tc Qh]
Seat 1: 3f0bf20a (button) folded before Flop (didn't bet)
Seat 2: Hero (small blind) folded before Flop
Seat 3: 24503504 (big blind) showed [Jc Js] and won ($10.04) with Pair of Jacks
Seat 4: 23a63651 showed [7d 7h] and lost with Pair of Sevens
Seat 5: 294d35ce folded before Flop
Seat 6: a420712c folded before Flop (didn't bet)


Poker Hand #RC2078475064: Hold'em No Limit ($0.02/$0.05) - 2023/12/22 21:16:24
Table 'RushAndCash783004' 6-max Seat #1 is the button
Seat 1: 38e42730 ($5 in chips)
Seat 2: 2eae311 ($8.52 in chips)
Seat 3: Hero ($7.18 in chips)
Seat 4: f4ef789c ($14.83 in chips)
Seat 5: 76ead301 ($5 in chips)
Seat 6: 4ee77832 ($5.07 in chips)
2eae311: posts small blind $0.02
Hero: posts big blind $0.05
*** HOLE CARDS ***
Dealt to 38e42730 
Dealt to 2eae311 
Dealt to Hero [5s 4c]
Dealt to f4ef789c 
Dealt to 76ead301 
Dealt to 4ee77832 
f4ef789c: folds
76ead301: raises $0.08 to $0.13
4ee77832: folds
38e42730: folds
2eae311: raises $0.31 to $0.44
Hero: folds
76ead301: calls $0.31
*** FLOP *** [6s Qh Tc]
2eae311: bets $0.24
76ead301: calls $0.24
*** TURN *** [6s Qh Tc] [5c]
2eae311: checks
76ead301: bets $1.13
2eae311: folds
Uncalled bet ($1.13) returned to 76ead301
*** SHOWDOWN ***
76ead301 collected $1.34 from pot
*** SUMMARY ***
Total pot $1.41 | Rake $0.07 | Jackpot $0 | Bingo $0 | Fortune $0 | Tax $0
Board [6s Qh Tc 5c]
Seat 1: 38e42730 (button) folded before Flop (didn't bet)
Seat 2: 2eae311 (small blind) folded on the Turn
Seat 3: Hero (big blind) folded before Flop
Seat 4: f4ef789c folded before Flop (didn't bet)
Seat 5: 76ead301 won ($1.34)
Seat 6: 4ee77832 folded before Flop (didn't bet)


Poker Hand #RC2078474981: Hold'em No Limit ($0.02/$0.05) - 2023/12/22 21:16:19
Table 'RushAndCash782964' 6-max Seat #1 is the button
Seat 1: 6ff1e240 ($10.15 in chips)
Seat 2: 7d406e41 ($10.26 in chips)
Seat 3: 90b129bf ($8.77 in chips)
Seat 4: Hero ($7.18 in chips)
Seat 5: bc7afeb2 ($5 in chips)
Seat 6: 373bc096 ($5 in chips)
7d406e41: posts small blind $0.02
90b129bf: posts big blind $0.05
*** HOLE CARDS ***
Dealt to 6ff1e240 
Dealt to 7d406e41 
Dealt to 90b129bf 
Dealt to Hero [7h 5d]
Dealt to bc7afeb2 
Dealt to 373bc096 
Hero: folds
bc7afeb2: raises $0.05 to $0.1
373bc096: folds
6ff1e240: raises $0.21 to $0.31
7d406e41: folds
90b129bf: calls $0.26
bc7afeb2: calls $0.21
*** FLOP *** [6d 7c Kc]
90b129bf: checks
bc7afeb2: checks
6ff1e240: bets $0.32
90b129bf: raises $0.88 to $1.2
bc7afeb2: folds
6ff1e240: folds
Uncalled bet ($0.88) returned to 90b129bf
*** SHOWDOWN ***
90b129bf collected $1.45 from pot
*** SUMMARY ***
Total pot $1.59 | Rake $0.07 | Jackpot $0.07 | Bingo $0 | Fortune $0 | Tax $0
Board [6d 7c Kc]
Seat 1: 6ff1e240 (button) folded on the Flop
Seat 2: 7d406e41 (small blind) folded before Flop
Seat 3: 90b129bf (big blind) won ($1.45)
Seat 4: Hero folded before Flop (didn't bet)
Seat 5: bc7afeb2 folded on the Flop
Seat 6: 373bc096 folded before Flop (didn't bet)


Poker Hand #RC2078474923: Hold'em No Limit ($0.02/$0.05) - 2023/12/22 21:16:16
Table 'RushAndCash782935' 6-max Seat #1 is the button
Seat 1: Hero ($7.18 in chips)
Seat 2: 8572ffde ($1.15 in chips)
Seat 3: 517da49 ($4.69 in chips)
Seat 4: b8d8e3a7 ($5.97 in chips)
Seat 5: ad963d07 ($5 in chips)
Seat 6: 1b7b574c ($5 in chips)
8572ffde: posts small blind $0.02
517da49: posts big blind $0.05
*** HOLE CARDS ***
Dealt to Hero [3c Th]
Dealt to 8572ffde 
Dealt to 517da49 
Dealt to b8d8e3a7 
Dealt to ad963d07 
Dealt to 1b7b574c 
b8d8e3a7: folds
ad963d07: raises $0.1 to $0.15
1b7b574c: folds
Hero: folds
8572ffde: calls $0.13
517da49: folds
*** FLOP *** [3s 3h 5d]
8572ffde: checks
ad963d07: bets $0.18
8572ffde: calls $0.18
*** TURN *** [3s 3h 5d] [Qc]
8572ffde: checks
ad963d07: checks
*** RIVER *** [3s 3h 5d Qc] [4c]
8572ffde: bets $0.82 and is all-in
ad963d07: calls $0.82
8572ffde: shows [7h 6h] (Sevens-High Straight)
ad963d07: shows [Qs Qd] (Queens Full over Treys)
*** SHOWDOWN ***
ad963d07 collected $2.17 from pot
*** SUMMARY ***
Total pot $2.35 | Rake $0.11 | Jackpot $0.07 | Bingo $0 | Fortune $0 | Tax $0
Board [3s 3h 5d Qc 4c]
Seat 1: Hero (button) folded before Flop (didn't bet)
Seat 2: 8572ffde (small blind) showed [7h 6h] and lost with Sevens-High Straight
Seat 3: 517da49 (big blind) folded before Flop
Seat 4: b8d8e3a7 folded before Flop (didn't bet)
Seat 5: ad963d07 showed [Qs Qd] and won ($2.17) with Queens Full over Treys
Seat 6: 1b7b574c folded before Flop (didn't bet)


Poker Hand #RC2078474794: Hold'em No Limit ($0.02/$0.05) - 2023/12/22 21:16:08
Table 'RushAndCash782871' 6-max Seat #1 is the button
Seat 1: d56f57b9 ($9.29 in chips)
Seat 2: Hero ($7.2 in chips)
Seat 3: 803de95b ($5.55 in chips)
Seat 4: 6ef00a1b ($13.74 in chips)
Seat 5: b4aaf9de ($8.44 in chips)
Seat 6: d32741ba ($10.38 in chips)
Hero: posts small blind $0.02
803de95b: posts big blind $0.05
*** HOLE CARDS ***
Dealt to d56f57b9 
Dealt to Hero [9c 2d]
Dealt to 803de95b 
Dealt to 6ef00a1b 
Dealt to b4aaf9de 
Dealt to d32741ba 
6ef00a1b: folds
b4aaf9de: folds
d32741ba: raises $0.08 to $0.13
d56f57b9: folds
Hero: folds
803de95b: folds
Uncalled bet ($0.08) returned to d32741ba
*** SHOWDOWN ***
d32741ba collected $0.12 from pot
*** SUMMARY ***
Total pot $0.12 | Rake $0 | Jackpot $0 | Bingo $0 | Fortune $0 | Tax $0
Seat 1: d56f57b9 (button) folded before Flop (didn't bet)
Seat 2: Hero (small blind) folded before Flop
Seat 3: 803de95b (big blind) folded before Flop
Seat 4: 6ef00a1b folded before Flop (didn't bet)
Seat 5: b4aaf9de folded before Flop (didn't bet)
Seat 6: d32741ba collected ($0.12)


Poker Hand #RC2078454001: Hold'em No Limit ($0.02/$0.05) - 2023/12/22 21:15:22
Table 'RushAndCash782489' 6-max Seat #1 is the button
Seat 1: a4c64da ($10.82 in chips)
Seat 2: 960a23e5 ($5.1 in chips)
Seat 3: Hero ($7.33 in chips)
Seat 4: 6c75362e ($5.07 in chips)
Seat 5: 803de95b ($5.41 in chips)
Seat 6: 2c2cc68d ($12.71 in chips)
960a23e5: posts small blind $0.02
Hero: posts big blind $0.05
*** HOLE CARDS ***
Dealt to a4c64da 
Dealt to 960a23e5 
Dealt to Hero [Ts Kc]
Dealt to 6c75362e 
Dealt to 803de95b 
Dealt to 2c2cc68d 
6c75362e: folds
803de95b: raises $0.08 to $0.13
2c2cc68d: folds
a4c64da: folds
960a23e5: folds
Hero: calls $0.08
*** FLOP *** [6c 4d Ad]
Hero: checks
803de95b: checks
*** TURN *** [6c 4d Ad] [Ac]
Hero: checks
803de95b: checks
*** RIVER *** [6c 4d Ad Ac] [8c]
Hero: checks
803de95b: bets $0.1
Hero: folds
Uncalled bet ($0.1) returned to 803de95b
*** SHOWDOWN ***
803de95b collected $0.27 from pot
*** SUMMARY ***
Total pot $0.28 | Rake $0.01 | Jackpot $0 | Bingo $0 | Fortune $0 | Tax $0
Board [6c 4d Ad Ac 8c]
Seat 1: a4c64da (button) folded before Flop (didn't bet)
Seat 2: 960a23e5 (small blind) folded before Flop
Seat 3: Hero (big blind) folded on the River
Seat 4: 6c75362e folded before Flop (didn't bet)
Seat 5: 803de95b won ($0.27)
Seat 6: 2c2cc68d folded before Flop (didn't bet)


Poker Hand #RC2078453937: Hold'em No Limit ($0.02/$0.05) - 2023/12/22 21:15:18
Table 'RushAndCash782458' 6-max Seat #1 is the button
Seat 1: 1cfe329a ($10.82 in chips)
Seat 2: cb16bb03 ($6.29 in chips)
Seat 3: 4356cdb7 ($5.4 in chips)
Seat 4: 177da66b ($7.41 in chips)
Seat 5: Hero ($7.33 in chips)
Seat 6: a61e93fb ($8.98 in chips)
cb16bb03: posts small blind $0.02
4356cdb7: posts big blind $0.05
*** HOLE CARDS ***
Dealt to 1cfe329a 
Dealt to cb16bb03 
Dealt to 4356cdb7 
Dealt to 177da66b 
Dealt to Hero [8d 2h]
Dealt to a61e93fb 
177da66b: folds
Hero: folds
a61e93fb: raises $0.07 to $0.12
1cfe329a: folds
cb16bb03: folds
4356cdb7: calls $0.07
*** FLOP *** [9c Ts Jh]
4356cdb7: checks
a61e93fb: bets $0.18
4356cdb7: folds
Uncalled bet ($0.18) returned to a61e93fb
*** SHOWDOWN ***
a61e93fb collected $0.25 from pot
*** SUMMARY ***
Total pot $0.26 | Rake $0.01 | Jackpot $0 | Bingo $0 | Fortune $0 | Tax $0
Board [9c Ts Jh]
Seat 1: 1cfe329a (button) folded before Flop (didn't bet)
Seat 2: cb16bb03 (small blind) folded before Flop
Seat 3: 4356cdb7 (big blind) folded on the Flop
Seat 4: 177da66b folded before Flop (didn't bet)
Seat 5: Hero folded before Flop (didn't bet)
Seat 6: a61e93fb won ($0.25)


Poker Hand #RC2078453118: Hold'em No Limit ($0.02/$0.05) - 2023/12/22 21:14:31
Table 'RushAndCash782076' 6-max Seat #1 is the button
Seat 1: 4356cdb7 ($5.64 in chips)
Seat 2: 4e44d49f ($12.54 in chips)
Seat 3: 9f6ece19 ($4.38 in chips)
Seat 4: 360d3b25 ($5 in chips)
Seat 5: Hero ($7.04 in chips)
Seat 6: 84bf8c0b ($5.5 in chips)
4e44d49f: posts small blind $0.02
9f6ece19: posts big blind $0.05
*** HOLE CARDS ***
Dealt to 4356cdb7 
Dealt to 4e44d49f 
Dealt to 9f6ece19 
Dealt to 360d3b25 
Dealt to Hero [Tc Ts]
Dealt to 84bf8c0b 
360d3b25: folds
Hero: raises $0.05 to $0.1
84bf8c0b: folds
4356cdb7: calls $0.1
4e44d49f: folds
9f6ece19: folds
*** FLOP *** [3s 2d 2c]
Hero: checks
4356cdb7: bets $0.14
Hero: calls $0.14
*** TURN *** [3s 2d 2c] [Kd]
Hero: checks
4356cdb7: checks
*** RIVER *** [3s 2d 2c Kd] [Qs]
Hero: checks
4356cdb7: checks
Hero: shows [Tc Ts] (Pair of Tens and Pair of Twos)
4356cdb7: shows [6d 7d] (Pair of Twos)
*** SHOWDOWN ***
Hero collected $0.53 from pot
*** SUMMARY ***
Total pot $0.55 | Rake $0.02 | Jackpot $0 | Bingo $0 | Fortune $0 | Tax $0
Board [3s 2d 2c Kd Qs]
Seat 1: 4356cdb7 (button) showed [6d 7d] and lost with Pair of Twos
Seat 2: 4e44d49f (small blind) folded before Flop
Seat 3: 9f6ece19 (big blind) folded before Flop
Seat 4: 360d3b25 folded before Flop (didn't bet)
Seat 5: Hero showed [Tc Ts] and won ($0.53) with Pair of Tens and Pair of Twos
Seat 6: 84bf8c0b folded before Flop (didn't bet)


Poker Hand #RC2078453054: Hold'em No Limit ($0.02/$0.05) - 2023/12/22 21:14:27
Table 'RushAndCash782044' 6-max Seat #1 is the button
Seat 1: 6ff1e240 ($10.47 in chips)
Seat 2: f3b8bc9d ($10.54 in chips)
Seat 3: abd6fe91 ($5 in chips)
Seat 4: Hero ($7.04 in chips)
Seat 5: b75ac6ee ($5.15 in chips)
Seat 6: 53b6f5a9 ($4.88 in chips)
f3b8bc9d: posts small blind $0.02
abd6fe91: posts big blind $0.05
*** HOLE CARDS ***
Dealt to 6ff1e240 
Dealt to f3b8bc9d 
Dealt to abd6fe91 
Dealt to Hero [9s 2h]
Dealt to b75ac6ee 
Dealt to 53b6f5a9 
Hero: folds
b75ac6ee: folds
53b6f5a9: folds
6ff1e240: folds
f3b8bc9d: calls $0.03
abd6fe91: checks
*** FLOP *** [Ac Th Js]
f3b8bc9d: checks
abd6fe91: checks
*** TURN *** [Ac Th Js] [4s]
f3b8bc9d: bets $0.05
abd6fe91: folds
Uncalled bet ($0.05) returned to f3b8bc9d
*** SHOWDOWN ***
f3b8bc9d collected $0.1 from pot
*** SUMMARY ***
Total pot $0.1 | Rake $0 | Jackpot $0 | Bingo $0 | Fortune $0 | Tax $0
Board [Ac Th Js 4s]
Seat 1: 6ff1e240 (button) folded before Flop (didn't bet)
Seat 2: f3b8bc9d (small blind) won ($0.1)
Seat 3: abd6fe91 (big blind) folded on the Turn
Seat 4: Hero folded before Flop (didn't bet)
Seat 5: b75ac6ee folded before Flop (didn't bet)
Seat 6: 53b6f5a9 folded before Flop (didn't bet)


Poker Hand #RC2078452981: Hold'em No Limit ($0.02/$0.05) - 2023/12/22 21:14:23
Table 'RushAndCash782012' 6-max Seat #1 is the button
Seat 1: Hero ($7.04 in chips)
Seat 2: 1f940f2d ($9.65 in chips)
Seat 3: a9b1bcec ($4.89 in chips)
Seat 4: f8e2b3b6 ($4.29 in chips)
Seat 5: 4dc000f1 ($4.37 in chips)
Seat 6: 3da5ed9c ($5.14 in chips)
1f940f2d: posts small blind $0.02
a9b1bcec: posts big blind $0.05
*** HOLE CARDS ***
Dealt to Hero [Td 6h]
Dealt to 1f940f2d 
Dealt to a9b1bcec 
Dealt to f8e2b3b6 
Dealt to 4dc000f1 
Dealt to 3da5ed9c 
f8e2b3b6: folds
4dc000f1: folds
3da5ed9c: folds
Hero: folds
1f940f2d: raises $0.1 to $0.15
a9b1bcec: folds
Uncalled bet ($0.1) returned to 1f940f2d
*** SHOWDOWN ***
1f940f2d collected $0.1 from pot
*** SUMMARY ***
Total pot $0.1 | Rake $0 | Jackpot $0 | Bingo $0 | Fortune $0 | Tax $0
Seat 1: Hero (button) folded before Flop (didn't bet)
Seat 2: 1f940f2d (small blind) collected ($0.1)
Seat 3: a9b1bcec (big blind) folded before Flop
Seat 4: f8e2b3b6 folded before Flop (didn't bet)
Seat 5: 4dc000f1 folded before Flop (didn't bet)
Seat 6: 3da5ed9c folded before Flop (didn't bet)


Poker Hand #RC2078452910: Hold'em No Limit ($0.02/$0.05) - 2023/12/22 21:14:19
Table 'RushAndCash781976' 6-max Seat #1 is the button
Seat 1: 5fea4bbc ($13.18 in chips)
Seat 2: Hero ($7.06 in chips)
Seat 3: 4dab75d6 ($4.58 in chips)
Seat 4: e1380a89 ($5.38 in chips)
Seat 5: c7b7c566 ($5.43 in chips)
Seat 6: 220b0aae ($11.64 in chips)
Hero: posts small blind $0.02
4dab75d6: posts big blind $0.05
*** HOLE CARDS ***
Dealt to 5fea4bbc 
Dealt to Hero [6d Qd]
Dealt to 4dab75d6 
Dealt to e1380a89 
Dealt to c7b7c566 
Dealt to 220b0aae 
e1380a89: raises $0.1 to $0.15
c7b7c566: folds
220b0aae: folds
5fea4bbc: folds
Hero: folds
4dab75d6: folds
Uncalled bet ($0.1) returned to e1380a89
*** SHOWDOWN ***
e1380a89 collected $0.12 from pot
*** SUMMARY ***
Total pot $0.12 | Rake $0 | Jackpot $0 | Bingo $0 | Fortune $0 | Tax $0
Seat 1: 5fea4bbc (button) folded before Flop (didn't bet)
Seat 2: Hero (small blind) folded before Flop
Seat 3: 4dab75d6 (big blind) folded before Flop
Seat 4: e1380a89 collected ($0.12)
Seat 5: c7b7c566 folded before Flop (didn't bet)
Seat 6: 220b0aae folded before Flop (didn't bet)


Poker Hand #RC2078452851: Hold'em No Limit ($0.02/$0.05) - 2023/12/22 21:14:15
Table 'RushAndCash781948' 6-max Seat #1 is the button
Seat 1: 49ea92ea ($9.59 in chips)
Seat 2: 7e3b11a6 ($5 in chips)
Seat 3: cea6060f ($5.56 in chips)
Seat 4: Hero ($7.06 in chips)
Seat 5: c7b7c566 ($5.43 in chips)
Seat 6: a602a3b0 ($9.37 in chips)
7e3b11a6: posts small blind $0.02
cea6060f: posts big blind $0.05
*** HOLE CARDS ***
Dealt to 49ea92ea 
Dealt to 7e3b11a6 
Dealt to cea6060f 
Dealt to Hero [8d Ts]
Dealt to c7b7c566 
Dealt to a602a3b0 
Hero: folds
c7b7c566: folds
a602a3b0: folds
49ea92ea: folds
7e3b11a6: raises $0.1 to $0.15
cea6060f: raises $0.35 to $0.5
7e3b11a6: folds
Uncalled bet ($0.35) returned to cea6060f
*** SHOWDOWN ***
cea6060f collected $0.29 from pot
*** SUMMARY ***
Total pot $0.3 | Rake $0.01 | Jackpot $0 | Bingo $0 | Fortune $0 | Tax $0
Seat 1: 49ea92ea (button) folded before Flop (didn't bet)
Seat 2: 7e3b11a6 (small blind) folded before Flop
Seat 3: cea6060f (big blind) collected ($0.29)
Seat 4: Hero folded before Flop (didn't bet)
Seat 5: c7b7c566 folded before Flop (didn't bet)
Seat 6: a602a3b0 folded before Flop (didn't bet)


Poker Hand #RC2078452537: Hold'em No Limit ($0.02/$0.05) - 2023/12/22 21:13:58
Table 'RushAndCash781794' 6-max Seat #1 is the button
Seat 1: 89a27c2 ($4.41 in chips)
Seat 2: 8aaa95a5 ($3.96 in chips)
Seat 3: Hero ($7.04 in chips)
Seat 4: 2588276e ($10.52 in chips)
Seat 5: ebeb62f7 ($4.71 in chips)
Seat 6: be335909 ($5 in chips)
8aaa95a5: posts small blind $0.02
Hero: posts big blind $0.05
*** HOLE CARDS ***
Dealt to 89a27c2 
Dealt to 8aaa95a5 
Dealt to Hero [Ac Jh]
Dealt to 2588276e 
Dealt to ebeb62f7 
Dealt to be335909 
2588276e: folds
ebeb62f7: folds
be335909: folds
89a27c2: folds
8aaa95a5: folds
Uncalled bet ($0.03) returned to Hero
*** SHOWDOWN ***
Hero collected $0.04 from pot
*** SUMMARY ***
Total pot $0.04 | Rake $0 | Jackpot $0 | Bingo $0 | Fortune $0 | Tax $0
Seat 1: 89a27c2 (button) folded before Flop (didn't bet)
Seat 2: 8aaa95a5 (small blind) folded before Flop
Seat 3: Hero (big blind) collected ($0.04)
Seat 4: 2588276e folded before Flop (didn't bet)
Seat 5: ebeb62f7 folded before Flop (didn't bet)
Seat 6: be335909 folded before Flop (didn't bet)


Poker Hand #RC2078452456: Hold'em No Limit ($0.02/$0.05) - 2023/12/22 21:13:53
Table 'RushAndCash781757' 6-max Seat #1 is the button
Seat 1: Hero ($7.04 in chips)
Seat 2: d0442df9 ($10.34 in chips)
Seat 3: 257cb6ea ($5 in chips)
Seat 4: a7286848 ($5.15 in chips)
Seat 5: 9b2d2337 ($20.19 in chips)
Seat 6: 1fc1f571 ($13.44 in chips)
d0442df9: posts small blind $0.02
257cb6ea: posts big blind $0.05
*** HOLE CARDS ***
Dealt to Hero [Qh 2h]
Dealt to d0442df9 
Dealt to 257cb6ea 
Dealt to a7286848 
Dealt to 9b2d2337 
Dealt to 1fc1f571 
a7286848: folds
9b2d2337: folds
1fc1f571: folds
Hero: folds
d0442df9: calls $0.03
257cb6ea: checks
*** FLOP *** [9c 3d 8c]
d0442df9: checks
257cb6ea: bets $0.05
d0442df9: raises $0.1 to $0.15
257cb6ea: calls $0.1
*** TURN *** [9c 3d 8c] [7c]
d0442df9: checks
257cb6ea: checks
*** RIVER *** [9c 3d 8c 7c] [8h]
d0442df9: bets $0.3
257cb6ea: calls $0.3
d0442df9: shows [Jd 4c] (Pair of Eights)
257cb6ea: shows [Jc 8d] (Three Eights)
*** SHOWDOWN ***
257cb6ea collected $0.95 from pot
*** SUMMARY ***
Total pot $1 | Rake $0.05 | Jackpot $0 | Bingo $0 | Fortune $0 | Tax $0
Board [9c 3d 8c 7c 8h]
Seat 1: Hero (button) folded before Flop (didn't bet)
Seat 2: d0442df9 (small blind) showed [Jd 4c] and lost with Pair of Eights
Seat 3: 257cb6ea (big blind) showed [Jc 8d] and won ($0.95) with Three Eights
Seat 4: a7286848 folded before Flop (didn't bet)
Seat 5: 9b2d2337 folded before Flop (didn't bet)
Seat 6: 1fc1f571 folded before Flop (didn't bet)


Poker Hand #RC2078452398: Hold'em No Limit ($0.02/$0.05) - 2023/12/22 21:13:50
Table 'RushAndCash781729' 6-max Seat #1 is the button
Seat 1: 4e20b85a ($9.47 in chips)
Seat 2: 38eafb19 ($5.09 in chips)
Seat 3: 45bb3f0f ($5 in chips)
Seat 4: 45392e2c ($17.56 in chips)
Seat 5: Hero ($7.04 in chips)
Seat 6: 7f067c94 ($42.57 in chips)
38eafb19: posts small blind $0.02
45bb3f0f: posts big blind $0.05
*** HOLE CARDS ***
Dealt to 4e20b85a 
Dealt to 38eafb19 
Dealt to 45bb3f0f 
Dealt to 45392e2c 
Dealt to Hero [2c 4s]
Dealt to 7f067c94 
45392e2c: folds
Hero: folds
7f067c94: folds
4e20b85a: folds
38eafb19: folds
Uncalled bet ($0.03) returned to 45bb3f0f
*** SHOWDOWN ***
45bb3f0f collected $0.04 from pot
*** SUMMARY ***
Total pot $0.04 | Rake $0 | Jackpot $0 | Bingo $0 | Fortune $0 | Tax $0
Seat 1: 4e20b85a (button) folded before Flop (didn't bet)
Seat 2: 38eafb19 (small blind) folded before Flop
Seat 3: 45bb3f0f (big blind) collected ($0.04)
Seat 4: 45392e2c folded before Flop (didn't bet)
Seat 5: Hero folded before Flop (didn't bet)
Seat 6: 7f067c94 folded before Flop (didn't bet)


Poker Hand #RC2078452327: Hold'em No Limit ($0.02/$0.05) - 2023/12/22 21:13:46
Table 'RushAndCash781694' 6-max Seat #1 is the button
Seat 1: 742fb9b0 ($5.42 in chips)
Seat 2: 3f0bf20a ($5 in chips)
Seat 3: 8f240b5e ($4.34 in chips)
Seat 4: Hero ($7.04 in chips)
Seat 5: 89a27c2 ($4.41 in chips)
Seat 6: c2ec7797 ($5 in chips)
3f0bf20a: posts small blind $0.02
8f240b5e: posts big blind $0.05
*** HOLE CARDS ***
Dealt to 742fb9b0 
Dealt to 3f0bf20a 
Dealt to 8f240b5e 
Dealt to Hero [7c Ad]
Dealt to 89a27c2 
Dealt to c2ec7797 
Hero: folds
89a27c2: folds
c2ec7797: folds
742fb9b0: folds
3f0bf20a: raises $0.11 to $0.16
8f240b5e: folds
Uncalled bet ($0.11) returned to 3f0bf20a
*** SHOWDOWN ***
3f0bf20a collected $0.1 from pot
*** SUMMARY ***
Total pot $0.1 | Rake $0 | Jackpot $0 | Bingo $0 | Fortune $0 | Tax $0
Seat 1: 742fb9b0 (button) folded before Flop (didn't bet)
Seat 2: 3f0bf20a (small blind) collected ($0.1)
Seat 3: 8f240b5e (big blind) folded before Flop
Seat 4: Hero folded before Flop (didn't bet)
Seat 5: 89a27c2 folded before Flop (didn't bet)
Seat 6: c2ec7797 folded before Flop (didn't bet)


Poker Hand #RC2078452243: Hold'em No Limit ($0.02/$0.05) - 2023/12/22 21:13:41
Table 'RushAndCash781654' 6-max Seat #1 is the button
Seat 1: Hero ($7.04 in chips)
Seat 2: aeda30e3 ($5.96 in chips)
Seat 3: 95bbee71 ($5 in chips)
Seat 4: 49ea92ea ($9.35 in chips)
Seat 5: 7c950e30 ($9.5 in chips)
Seat 6: ca4d7d81 ($7.17 in chips)
aeda30e3: posts small blind $0.02
95bbee71: posts big blind $0.05
*** HOLE CARDS ***
Dealt to Hero [4c 2s]
Dealt to aeda30e3 
Dealt to 95bbee71 
Dealt to 49ea92ea 
Dealt to 7c950e30 
Dealt to ca4d7d81 
49ea92ea: folds
7c950e30: folds
ca4d7d81: folds
Hero: folds
aeda30e3: raises $0.07 to $0.12
95bbee71: calls $0.07
*** FLOP *** [3d Ts 7h]
aeda30e3: checks
95bbee71: bets $0.1
aeda30e3: folds
Uncalled bet ($0.1) returned to 95bbee71
*** SHOWDOWN ***
95bbee71 collected $0.23 from pot
*** SUMMARY ***
Total pot $0.24 | Rake $0.01 | Jackpot $0 | Bingo $0 | Fortune $0 | Tax $0
Board [3d Ts 7h]
Seat 1: Hero (button) folded before Flop (didn't bet)
Seat 2: aeda30e3 (small blind) folded on the Flop
Seat 3: 95bbee71 (big blind) won ($0.23)
Seat 4: 49ea92ea folded before Flop (didn't bet)
Seat 5: 7c950e30 folded before Flop (didn't bet)
Seat 6: ca4d7d81 folded before Flop (didn't bet)


Poker Hand #RC2078450872: Hold'em No Limit ($0.02/$0.05) - 2023/12/22 21:12:20
Table 'RushAndCash781001' 6-max Seat #1 is the button
Seat 1: c320c189 ($6.94 in chips)
Seat 2: Hero ($6.42 in chips)
Seat 3: 29a59401 ($2.94 in chips)
Seat 4: ca4d7d81 ($7.72 in chips)
Seat 5: d1ed32e9 ($5.87 in chips)
Seat 6: f4da6166 ($0.59 in chips)
Hero: posts small blind $0.02
29a59401: posts big blind $0.05
*** HOLE CARDS ***
Dealt to c320c189 
Dealt to Hero [9h 9d]
Dealt to 29a59401 
Dealt to ca4d7d81 
Dealt to d1ed32e9 
Dealt to f4da6166 
ca4d7d81: raises $0.08 to $0.13
d1ed32e9: folds
f4da6166: folds
c320c189: folds
Hero: calls $0.11
29a59401: folds
*** FLOP *** [2c 3h 9s]
Hero: checks
ca4d7d81: checks
*** TURN *** [2c 3h 9s] [Kh]
Hero: checks
ca4d7d81: bets $0.42
Hero: raises $0.62 to $1.04
ca4d7d81: folds
Uncalled bet ($0.62) returned to Hero
*** SHOWDOWN ***
Hero collected $1.1 from pot
*** SUMMARY ***
Total pot $1.15 | Rake $0.05 | Jackpot $0 | Bingo $0 | Fortune $0 | Tax $0
Board [2c 3h 9s Kh]
Seat 1: c320c189 (button) folded before Flop (didn't bet)
Seat 2: Hero (small blind) won ($1.1)
Seat 3: 29a59401 (big blind) folded before Flop
Seat 4: ca4d7d81 folded on the Turn
Seat 5: d1ed32e9 folded before Flop (didn't bet)
Seat 6: f4da6166 folded before Flop (didn't bet)


Poker Hand #RC2078450791: Hold'em No Limit ($0.02/$0.05) - 2023/12/22 21:12:15
Table 'RushAndCash780964' 6-max Seat #1 is the button
Seat 1: c54f63b8 ($5.18 in chips)
Seat 2: e4d2f8b7 ($5.11 in chips)
Seat 3: Hero ($6.47 in chips)
Seat 4: e929859b ($5 in chips)
Seat 5: f3501d52 ($5.02 in chips)
Seat 6: 6e3c9195 ($6.15 in chips)
e4d2f8b7: posts small blind $0.02
Hero: posts big blind $0.05
*** HOLE CARDS ***
Dealt to c54f63b8 
Dealt to e4d2f8b7 
Dealt to Hero [2d 7d]
Dealt to e929859b 
Dealt to f3501d52 
Dealt to 6e3c9195 
e929859b: folds
f3501d52: folds
6e3c9195: folds
c54f63b8: folds
e4d2f8b7: folds
Uncalled bet ($0.03) returned to Hero
*** SHOWDOWN ***
Hero collected $0.04 from pot
*** SUMMARY ***
Total pot $0.04 | Rake $0 | Jackpot $0 | Bingo $0 | Fortune $0 | Tax $0
Seat 1: c54f63b8 (button) folded before Flop (didn't bet)
Seat 2: e4d2f8b7 (small blind) folded before Flop
Seat 3: Hero (big blind) collected ($0.04)
Seat 4: e929859b folded before Flop (didn't bet)
Seat 5: f3501d52 folded before Flop (didn't bet)
Seat 6: 6e3c9195 folded before Flop (didn't bet)


Poker Hand #RC2078450123: Hold'em No Limit ($0.02/$0.05) - 2023/12/22 21:11:38
Table 'RushAndCash780645' 6-max Seat #1 is the button
Seat 1: e734080a ($14.44 in chips)
Seat 2: 38eafb19 ($5 in chips)
Seat 3: e4d2f8b7 ($5 in chips)
Seat 4: 59846dec ($2.19 in chips)
Seat 5: Hero ($6.57 in chips)
Seat 6: 1f9b16cf ($5.26 in chips)
38eafb19: posts small blind $0.02
e4d2f8b7: posts big blind $0.05
*** HOLE CARDS ***
Dealt to e734080a 
Dealt to 38eafb19 
Dealt to e4d2f8b7 
Dealt to 59846dec 
Dealt to Hero [9c 9h]
Dealt to 1f9b16cf 
59846dec: folds
Hero: raises $0.05 to $0.1
1f9b16cf: folds
e734080a: folds
38eafb19: folds
e4d2f8b7: raises $0.35 to $0.45
Hero: folds
Uncalled bet ($0.35) returned to e4d2f8b7
*** SHOWDOWN ***
e4d2f8b7 collected $0.21 from pot
*** SUMMARY ***
Total pot $0.22 | Rake $0.01 | Jackpot $0 | Bingo $0 | Fortune $0 | Tax $0
Seat 1: e734080a (button) folded before Flop (didn't bet)
Seat 2: 38eafb19 (small blind) folded before Flop
Seat 3: e4d2f8b7 (big blind) collected ($0.21)
Seat 4: 59846dec folded before Flop (didn't bet)
Seat 5: Hero folded before Flop
Seat 6: 1f9b16cf folded before Flop (didn't bet)


Poker Hand #RC2078450007: Hold'em No Limit ($0.02/$0.05) - 2023/12/22 21:11:31
Table 'RushAndCash780588' 6-max Seat #1 is the button
Seat 1: Hero ($6.57 in chips)
Seat 2: 6a594ce8 ($5.09 in chips)
Seat 3: 22818fb2 ($5.07 in chips)
Seat 4: a87d0af2 ($4.27 in chips)
Seat 5: d74d8525 ($6.52 in chips)
Seat 6: 8070ac2f ($3.25 in chips)
6a594ce8: posts small blind $0.02
22818fb2: posts big blind $0.05
*** HOLE CARDS ***
Dealt to Hero [Th Jd]
Dealt to 6a594ce8 
Dealt to 22818fb2 
Dealt to a87d0af2 
Dealt to d74d8525 
Dealt to 8070ac2f 
a87d0af2: raises $0.07 to $0.12
d74d8525: folds
8070ac2f: calls $0.12
Hero: folds
6a594ce8: folds
22818fb2: calls $0.07
*** FLOP *** [4c Ks 8c]
22818fb2: checks
a87d0af2: checks
8070ac2f: checks
*** TURN *** [4c Ks 8c] [8d]
22818fb2: bets $0.26
a87d0af2: folds
8070ac2f: folds
Uncalled bet ($0.26) returned to 22818fb2
*** SHOWDOWN ***
22818fb2 collected $0.36 from pot
*** SUMMARY ***
Total pot $0.38 | Rake $0.02 | Jackpot $0 | Bingo $0 | Fortune $0 | Tax $0
Board [4c Ks 8c 8d]
Seat 1: Hero (button) folded before Flop (didn't bet)
Seat 2: 6a594ce8 (small blind) folded before Flop
Seat 3: 22818fb2 (big blind) won ($0.36)
Seat 4: a87d0af2 folded on the Turn
Seat 5: d74d8525 folded before Flop (didn't bet)
Seat 6: 8070ac2f folded on the Turn


Poker Hand #RC2078449910: Hold'em No Limit ($0.02/$0.05) - 2023/12/22 21:11:25
Table 'RushAndCash780545' 6-max Seat #1 is the button
Seat 1: 9d4c1c85 ($5.81 in chips)
Seat 2: b2b4173f ($2.31 in chips)
Seat 3: f73ad9cd ($5 in chips)
Seat 4: 494d7c43 ($5.58 in chips)
Seat 5: Hero ($6.57 in chips)
Seat 6: ff5dd678 ($2.45 in chips)
b2b4173f: posts small blind $0.02
f73ad9cd: posts big blind $0.05
*** HOLE CARDS ***
Dealt to 9d4c1c85 
Dealt to b2b4173f 
Dealt to f73ad9cd 
Dealt to 494d7c43 
Dealt to Hero [Ks 4s]
Dealt to ff5dd678 
494d7c43: folds
Hero: folds
ff5dd678: raises $0.05 to $0.1
9d4c1c85: raises $0.22 to $0.32
b2b4173f: folds
f73ad9cd: folds
ff5dd678: calls $0.22
*** FLOP *** [2h 2d 6s]
ff5dd678: checks
9d4c1c85: checks
*** TURN *** [2h 2d 6s] [5c]
ff5dd678: bets $0.05
9d4c1c85: calls $0.05
*** RIVER *** [2h 2d 6s 5c] [9d]
ff5dd678: checks
9d4c1c85: checks
ff5dd678: shows [Ad Jd] (Pair of Twos)
9d4c1c85: shows [As Kh] (Pair of Twos)
*** SHOWDOWN ***
9d4c1c85 collected $0.77 from pot
*** SUMMARY ***
Total pot $0.81 | Rake $0.04 | Jackpot $0 | Bingo $0 | Fortune $0 | Tax $0
Board [2h 2d 6s 5c 9d]
Seat 1: 9d4c1c85 (button) showed [As Kh] and won ($0.77) with Pair of Twos
Seat 2: b2b4173f (small blind) folded before Flop
Seat 3: f73ad9cd (big blind) folded before Flop
Seat 4: 494d7c43 folded before Flop (didn't bet)
Seat 5: Hero folded before Flop (didn't bet)
Seat 6: ff5dd678 showed [Ad Jd] and lost with Pair of Twos


Poker Hand #RC2078449847: Hold'em No Limit ($0.02/$0.05) - 2023/12/22 21:11:21
Table 'RushAndCash780516' 6-max Seat #1 is the button
Seat 1: 809e45f6 ($6.11 in chips)
Seat 2: Hero ($6.59 in chips)
Seat 3: fc6fcf04 ($5.79 in chips)
Seat 4: ad142c24 ($12.41 in chips)
Seat 5: efaec7cf ($5.51 in chips)
Seat 6: 93990934 ($11.27 in chips)
Hero: posts small blind $0.02
fc6fcf04: posts big blind $0.05
*** HOLE CARDS ***
Dealt to 809e45f6 
Dealt to Hero [Qc 3d]
Dealt to fc6fcf04 
Dealt to ad142c24 
Dealt to efaec7cf 
Dealt to 93990934 
ad142c24: folds
efaec7cf: folds
93990934: raises $0.1 to $0.15
809e45f6: folds
Hero: folds
fc6fcf04: folds
Uncalled bet ($0.1) returned to 93990934
*** SHOWDOWN ***
93990934 collected $0.12 from pot
*** SUMMARY ***
Total pot $0.12 | Rake $0 | Jackpot $0 | Bingo $0 | Fortune $0 | Tax $0
Seat 1: 809e45f6 (button) folded before Flop (didn't bet)
Seat 2: Hero (small blind) folded before Flop
Seat 3: fc6fcf04 (big blind) folded before Flop
Seat 4: ad142c24 folded before Flop (didn't bet)
Seat 5: efaec7cf folded before Flop (didn't bet)
Seat 6: 93990934 collected ($0.12)


Poker Hand #RC2078449207: Hold'em No Limit ($0.02/$0.05) - 2023/12/22 21:10:42
Table 'RushAndCash780219' 6-max Seat #1 is the button
Seat 1: 54daf47b ($9.96 in chips)
Seat 2: 2b810e8b ($5.04 in chips)
Seat 3: Hero ($6.47 in chips)
Seat 4: f0337111 ($7.64 in chips)
Seat 5: 58864a6e ($21.01 in chips)
Seat 6: 59218957 ($13.07 in chips)
2b810e8b: posts small blind $0.02
Hero: posts big blind $0.05
*** HOLE CARDS ***
Dealt to 54daf47b 
Dealt to 2b810e8b 
Dealt to Hero [Js 3s]
Dealt to f0337111 
Dealt to 58864a6e 
Dealt to 59218957 
f0337111: folds
58864a6e: folds
59218957: folds
54daf47b: raises $0.06 to $0.11
2b810e8b: folds
Hero: calls $0.06
*** FLOP *** [Ts 2d 7c]
Hero: checks
54daf47b: checks
*** TURN *** [Ts 2d 7c] [6s]
Hero: checks
54daf47b: checks
*** RIVER *** [Ts 2d 7c 6s] [Jd]
Hero: bets $0.12
54daf47b: folds
Uncalled bet ($0.12) returned to Hero
*** SHOWDOWN ***
Hero collected $0.23 from pot
*** SUMMARY ***
Total pot $0.24 | Rake $0.01 | Jackpot $0 | Bingo $0 | Fortune $0 | Tax $0
Board [Ts 2d 7c 6s Jd]
Seat 1: 54daf47b (button) folded on the River
Seat 2: 2b810e8b (small blind) folded before Flop
Seat 3: Hero (big blind) won ($0.23)
Seat 4: f0337111 folded before Flop (didn't bet)
Seat 5: 58864a6e folded before Flop (didn't bet)
Seat 6: 59218957 folded before Flop (didn't bet)


Poker Hand #RC2078449119: Hold'em No Limit ($0.02/$0.05) - 2023/12/22 21:10:37
Table 'RushAndCash780176' 6-max Seat #1 is the button
Seat 1: e5b5763b ($6.61 in chips)
Seat 2: 86f62bb0 ($5.41 in chips)
Seat 3: 5b8f96c1 ($4.21 in chips)
Seat 4: c87acea2 ($14.78 in chips)
Seat 5: Hero ($6.47 in chips)
Seat 6: 53442c3b ($10.92 in chips)
86f62bb0: posts small blind $0.02
5b8f96c1: posts big blind $0.05
*** HOLE CARDS ***
Dealt to e5b5763b 
Dealt to 86f62bb0 
Dealt to 5b8f96c1 
Dealt to c87acea2 
Dealt to Hero [2d Tc]
Dealt to 53442c3b 
c87acea2: folds
Hero: folds
53442c3b: folds
e5b5763b: raises $0.07 to $0.12
86f62bb0: folds
5b8f96c1: folds
Uncalled bet ($0.07) returned to e5b5763b
*** SHOWDOWN ***
e5b5763b collected $0.12 from pot
*** SUMMARY ***
Total pot $0.12 | Rake $0 | Jackpot $0 | Bingo $0 | Fortune $0 | Tax $0
Seat 1: e5b5763b (button) collected ($0.12)
Seat 2: 86f62bb0 (small blind) folded before Flop
Seat 3: 5b8f96c1 (big blind) folded before Flop
Seat 4: c87acea2 folded before Flop (didn't bet)
Seat 5: Hero folded before Flop (didn't bet)
Seat 6: 53442c3b folded before Flop (didn't bet)


Poker Hand #RC2078448912: Hold'em No Limit ($0.02/$0.05) - 2023/12/22 21:10:23
Table 'RushAndCash780073' 6-max Seat #1 is the button
Seat 1: c7592cbf ($11.71 in chips)
Seat 2: Hero ($6.49 in chips)
Seat 3: d56f57b9 ($6.4 in chips)
Seat 4: 1259a422 ($5.51 in chips)
Seat 5: 53b6f5a9 ($5.69 in chips)
Seat 6: db5367a6 ($9.5 in chips)
Hero: posts small blind $0.02
d56f57b9: posts big blind $0.05
*** HOLE CARDS ***
Dealt to c7592cbf 
Dealt to Hero [Js 9c]
Dealt to d56f57b9 
Dealt to 1259a422 
Dealt to 53b6f5a9 
Dealt to db5367a6 
1259a422: folds
53b6f5a9: folds
db5367a6: raises $0.05 to $0.1
c7592cbf: folds
Hero: folds
d56f57b9: folds
Uncalled bet ($0.05) returned to db5367a6
*** SHOWDOWN ***
db5367a6 collected $0.12 from pot
*** SUMMARY ***
Total pot $0.12 | Rake $0 | Jackpot $0 | Bingo $0 | Fortune $0 | Tax $0
Seat 1: c7592cbf (button) folded before Flop (didn't bet)
Seat 2: Hero (small blind) folded before Flop
Seat 3: d56f57b9 (big blind) folded before Flop
Seat 4: 1259a422 folded before Flop (didn't bet)
Seat 5: 53b6f5a9 folded before Flop (didn't bet)
Seat 6: db5367a6 collected ($0.12)


Poker Hand #RC2078448857: Hold'em No Limit ($0.02/$0.05) - 2023/12/22 21:10:20
Table 'RushAndCash780045' 6-max Seat #1 is the button
Seat 1: 998574b7 ($5.23 in chips)
Seat 2: a187c666 ($5 in chips)
Seat 3: a90771fe ($6.59 in chips)
Seat 4: 7c10f852 ($22.12 in chips)
Seat 5: c7592cbf ($11.71 in chips)
Seat 6: Hero ($6.49 in chips)
a187c666: posts small blind $0.02
a90771fe: posts big blind $0.05
*** HOLE CARDS ***
Dealt to 998574b7 
Dealt to a187c666 
Dealt to a90771fe 
Dealt to 7c10f852 
Dealt to c7592cbf 
Dealt to Hero [2h 6d]
7c10f852: folds
c7592cbf: folds
Hero: folds
998574b7: folds
a187c666: raises $0.1 to $0.15
a90771fe: raises $0.15 to $0.3
a187c666: raises $0.75 to $1.05
a90771fe: folds
Uncalled bet ($0.75) returned to a187c666
*** SHOWDOWN ***
a187c666 collected $0.57 from pot
*** SUMMARY ***
Total pot $0.6 | Rake $0.03 | Jackpot $0 | Bingo $0 | Fortune $0 | Tax $0
Seat 1: 998574b7 (button) folded before Flop (didn't bet)
Seat 2: a187c666 (small blind) collected ($0.57)
Seat 3: a90771fe (big blind) folded before Flop
Seat 4: 7c10f852 folded before Flop (didn't bet)
Seat 5: c7592cbf folded before Flop (didn't bet)
Seat 6: Hero folded before Flop (didn't bet)


Poker Hand #RC2078448634: Hold'em No Limit ($0.02/$0.05) - 2023/12/22 21:10:07
Table 'RushAndCash779935' 6-max Seat #1 is the button
Seat 1: c81ea267 ($4.74 in chips)
Seat 2: 93b1a4e4 ($5.02 in chips)
Seat 3: 93d5c821 ($5.43 in chips)
Seat 4: Hero ($6.49 in chips)
Seat 5: 829aa739 ($6.58 in chips)
Seat 6: 6abef4c5 ($5.18 in chips)
93b1a4e4: posts small blind $0.02
93d5c821: posts big blind $0.05
*** HOLE CARDS ***
Dealt to c81ea267 
Dealt to 93b1a4e4 
Dealt to 93d5c821 
Dealt to Hero [Js 5d]
Dealt to 829aa739 
Dealt to 6abef4c5 
Hero: folds
829aa739: folds
6abef4c5: folds
c81ea267: folds
93b1a4e4: raises $0.09 to $0.14
93d5c821: folds
Uncalled bet ($0.09) returned to 93b1a4e4
*** SHOWDOWN ***
93b1a4e4 collected $0.1 from pot
*** SUMMARY ***
Total pot $0.1 | Rake $0 | Jackpot $0 | Bingo $0 | Fortune $0 | Tax $0
Seat 1: c81ea267 (button) folded before Flop (didn't bet)
Seat 2: 93b1a4e4 (small blind) collected ($0.1)
Seat 3: 93d5c821 (big blind) folded before Flop
Seat 4: Hero folded before Flop (didn't bet)
Seat 5: 829aa739 folded before Flop (didn't bet)
Seat 6: 6abef4c5 folded before Flop (didn't bet)


Poker Hand #RC2078448577: Hold'em No Limit ($0.02/$0.05) - 2023/12/22 21:10:04
Table 'RushAndCash779906' 6-max Seat #1 is the button
Seat 1: 93d5c821 ($5.43 in chips)
Seat 2: 6dd330dc ($5.9 in chips)
Seat 3: aa6d4c49 ($14.99 in chips)
Seat 4: ac89ef05 ($8.25 in chips)
Seat 5: Hero ($6.49 in chips)
Seat 6: 2471888a ($6.11 in chips)
6dd330dc: posts small blind $0.02
aa6d4c49: posts big blind $0.05
*** HOLE CARDS ***
Dealt to 93d5c821 
Dealt to 6dd330dc 
Dealt to aa6d4c49 
Dealt to ac89ef05 
Dealt to Hero [9h 3h]
Dealt to 2471888a 
ac89ef05: folds
Hero: folds
2471888a: folds
93d5c821: folds
6dd330dc: folds
Uncalled bet ($0.03) returned to aa6d4c49
*** SHOWDOWN ***
aa6d4c49 collected $0.04 from pot
*** SUMMARY ***
Total pot $0.04 | Rake $0 | Jackpot $0 | Bingo $0 | Fortune $0 | Tax $0
Seat 1: 93d5c821 (button) folded before Flop (didn't bet)
Seat 2: 6dd330dc (small blind) folded before Flop
Seat 3: aa6d4c49 (big blind) collected ($0.04)
Seat 4: ac89ef05 folded before Flop (didn't bet)
Seat 5: Hero folded before Flop (didn't bet)
Seat 6: 2471888a folded before Flop (didn't bet)


Poker Hand #RC2078448511: Hold'em No Limit ($0.02/$0.05) - 2023/12/22 21:10:00
Table 'RushAndCash779877' 6-max Seat #1 is the button
Seat 1: e67ce721 ($5.71 in chips)
Seat 2: 8f80311 ($2.44 in chips)
Seat 3: 66605bf3 ($10.95 in chips)
Seat 4: Hero ($6.49 in chips)
Seat 5: 6a594ce8 ($5 in chips)
Seat 6: 18f9cb34 ($6.23 in chips)
8f80311: posts small blind $0.02
66605bf3: posts big blind $0.05
*** HOLE CARDS ***
Dealt to e67ce721 
Dealt to 8f80311 
Dealt to 66605bf3 
Dealt to Hero [Kc 8s]
Dealt to 6a594ce8 
Dealt to 18f9cb34 
Hero: folds
6a594ce8: folds
18f9cb34: raises $0.08 to $0.13
e67ce721: folds
8f80311: folds
66605bf3: calls $0.08
*** FLOP *** [Jh Ks 7c]
66605bf3: checks
18f9cb34: checks
*** TURN *** [Jh Ks 7c] [8h]
66605bf3: checks
18f9cb34: bets $0.14
66605bf3: folds
Uncalled bet ($0.14) returned to 18f9cb34
*** SHOWDOWN ***
18f9cb34 collected $0.27 from pot
*** SUMMARY ***
Total pot $0.28 | Rake $0.01 | Jackpot $0 | Bingo $0 | Fortune $0 | Tax $0
Board [Jh Ks 7c 8h]
Seat 1: e67ce721 (button) folded before Flop (didn't bet)
Seat 2: 8f80311 (small blind) folded before Flop
Seat 3: 66605bf3 (big blind) folded on the Turn
Seat 4: Hero folded before Flop (didn't bet)
Seat 5: 6a594ce8 folded before Flop (didn't bet)
Seat 6: 18f9cb34 won ($0.27)


Poker Hand #RC2078448402: Hold'em No Limit ($0.02/$0.05) - 2023/12/22 21:09:54
Table 'RushAndCash779830' 6-max Seat #1 is the button
Seat 1: Hero ($6.49 in chips)
Seat 2: 150c6a31 ($6.15 in chips)
Seat 3: 53442c3b ($11.01 in chips)
Seat 4: 3ac73067 ($4.12 in chips)
Seat 5: 90b129bf ($8.29 in chips)
Seat 6: 3160ff3c ($5.23 in chips)
150c6a31: posts small blind $0.02
53442c3b: posts big blind $0.05
*** HOLE CARDS ***
Dealt to Hero [6h 9d]
Dealt to 150c6a31 
Dealt to 53442c3b 
Dealt to 3ac73067 
Dealt to 90b129bf 
Dealt to 3160ff3c 
3ac73067: folds
90b129bf: folds
3160ff3c: folds
Hero: folds
150c6a31: raises $0.1 to $0.15
53442c3b: folds
Uncalled bet ($0.1) returned to 150c6a31
*** SHOWDOWN ***
150c6a31 collected $0.1 from pot
*** SUMMARY ***
Total pot $0.1 | Rake $0 | Jackpot $0 | Bingo $0 | Fortune $0 | Tax $0
Seat 1: Hero (button) folded before Flop (didn't bet)
Seat 2: 150c6a31 (small blind) collected ($0.1)
Seat 3: 53442c3b (big blind) folded before Flop
Seat 4: 3ac73067 folded before Flop (didn't bet)
Seat 5: 90b129bf folded before Flop (didn't bet)
Seat 6: 3160ff3c folded before Flop (didn't bet)


Poker Hand #RC2078448243: Hold'em No Limit ($0.02/$0.05) - 2023/12/22 21:09:45
Table 'RushAndCash779754' 6-max Seat #1 is the button
Seat 1: d50b3b7c ($5.05 in chips)
Seat 2: 801c157f ($14.54 in chips)
Seat 3: Hero ($6.54 in chips)
Seat 4: 3d292096 ($10.4 in chips)
Seat 5: dc7cff29 ($6.04 in chips)
Seat 6: af92dfc8 ($5.52 in chips)
801c157f: posts small blind $0.02
Hero: posts big blind $0.05
*** HOLE CARDS ***
Dealt to d50b3b7c 
Dealt to 801c157f 
Dealt to Hero [5s Kc]
Dealt to 3d292096 
Dealt to dc7cff29 
Dealt to af92dfc8 
3d292096: folds
dc7cff29: raises $0.08 to $0.13
af92dfc8: folds
d50b3b7c: folds
801c157f: folds
Hero: folds
Uncalled bet ($0.08) returned to dc7cff29
*** SHOWDOWN ***
dc7cff29 collected $0.12 from pot
*** SUMMARY ***
Total pot $0.12 | Rake $0 | Jackpot $0 | Bingo $0 | Fortune $0 | Tax $0
Seat 1: d50b3b7c (button) folded before Flop (didn't bet)
Seat 2: 801c157f (small blind) folded before Flop
Seat 3: Hero (big blind) folded before Flop
Seat 4: 3d292096 folded before Flop (didn't bet)
Seat 5: dc7cff29 collected ($0.12)
Seat 6: af92dfc8 folded before Flop (didn't bet)


Poker Hand #RC2078448182: Hold'em No Limit ($0.02/$0.05) - 2023/12/22 21:09:41
Table 'RushAndCash779726' 6-max Seat #1 is the button
Seat 1: 93990934 ($11.08 in chips)
Seat 2: e8886428 ($36.24 in chips)
Seat 3: 53b6f5a9 ($5.81 in chips)
Seat 4: Hero ($6.54 in chips)
Seat 5: d56f57b9 ($6.74 in chips)
Seat 6: f8233bc8 ($2.57 in chips)
e8886428: posts small blind $0.02
53b6f5a9: posts big blind $0.05
*** HOLE CARDS ***
Dealt to 93990934 
Dealt to e8886428 
Dealt to 53b6f5a9 
Dealt to Hero [9d Ks]
Dealt to d56f57b9 
Dealt to f8233bc8 
Hero: folds
d56f57b9: folds
f8233bc8: raises $0.07 to $0.12
93990934: folds
e8886428: folds
53b6f5a9: folds
Uncalled bet ($0.07) returned to f8233bc8
*** SHOWDOWN ***
f8233bc8 collected $0.12 from pot
*** SUMMARY ***
Total pot $0.12 | Rake $0 | Jackpot $0 | Bingo $0 | Fortune $0 | Tax $0
Seat 1: 93990934 (button) folded before Flop (didn't bet)
Seat 2: e8886428 (small blind) folded before Flop
Seat 3: 53b6f5a9 (big blind) folded before Flop
Seat 4: Hero folded before Flop (didn't bet)
Seat 5: d56f57b9 folded before Flop (didn't bet)
Seat 6: f8233bc8 collected ($0.12)


Poker Hand #RC2078448111: Hold'em No Limit ($0.02/$0.05) - 2023/12/22 21:09:37
Table 'RushAndCash779694' 6-max Seat #1 is the button
Seat 1: 1b19739f ($6.77 in chips)
Seat 2: 3fc56396 ($5 in chips)
Seat 3: 9daba4a8 ($4.98 in chips)
Seat 4: 18f6d2d6 ($5.99 in chips)
Seat 5: Hero ($6.54 in chips)
Seat 6: 3d292096 ($10.33 in chips)
3fc56396: posts small blind $0.02
9daba4a8: posts big blind $0.05
*** HOLE CARDS ***
Dealt to 1b19739f 
Dealt to 3fc56396 
Dealt to 9daba4a8 
Dealt to 18f6d2d6 
Dealt to Hero [Ks 8s]
Dealt to 3d292096 
18f6d2d6: folds
Hero: folds
3d292096: raises $0.08 to $0.13
1b19739f: folds
3fc56396: folds
9daba4a8: folds
Uncalled bet ($0.08) returned to 3d292096
*** SHOWDOWN ***
3d292096 collected $0.12 from pot
*** SUMMARY ***
Total pot $0.12 | Rake $0 | Jackpot $0 | Bingo $0 | Fortune $0 | Tax $0
Seat 1: 1b19739f (button) folded before Flop (didn't bet)
Seat 2: 3fc56396 (small blind) folded before Flop
Seat 3: 9daba4a8 (big blind) folded before Flop
Seat 4: 18f6d2d6 folded before Flop (didn't bet)
Seat 5: Hero folded before Flop (didn't bet)
Seat 6: 3d292096 collected ($0.12)


Poker Hand #RC2078448031: Hold'em No Limit ($0.02/$0.05) - 2023/12/22 21:09:32
Table 'RushAndCash779659' 6-max Seat #1 is the button
Seat 1: 59ad445d ($3.81 in chips)
Seat 2: 501b0876 ($5.62 in chips)
Seat 3: 13f0dad9 ($7.13 in chips)
Seat 4: c9faf803 ($10.51 in chips)
Seat 5: Hero ($6.54 in chips)
Seat 6: b74b84be ($6.86 in chips)
501b0876: posts small blind $0.02
13f0dad9: posts big blind $0.05
*** HOLE CARDS ***
Dealt to 59ad445d 
Dealt to 501b0876 
Dealt to 13f0dad9 
Dealt to c9faf803 
Dealt to Hero [6s Kc]
Dealt to b74b84be 
c9faf803: folds
Hero: folds
b74b84be: raises $0.1 to $0.15
59ad445d: raises $0.31 to $0.46
501b0876: folds
13f0dad9: folds
b74b84be: calls $0.31
*** FLOP *** [6c 8s 2s]
b74b84be: checks
59ad445d: bets $0.4
b74b84be: calls $0.4
*** TURN *** [6c 8s 2s] [7s]
b74b84be: checks
59ad445d: bets $0.72
b74b84be: calls $0.72
*** RIVER *** [6c 8s 2s 7s] [3c]
b74b84be: checks
59ad445d: bets $2.23 and is all-in
b74b84be: calls $2.23
59ad445d: shows [Qs As] (Ace High Flush)
b74b84be: shows [6d 8d] (Pair of Eights and Pair of Sixes)
*** SHOWDOWN ***
59ad445d collected $7.47 from pot
*** SUMMARY ***
Total pot $7.69 | Rake $0.15 | Jackpot $0.07 | Bingo $0 | Fortune $0 | Tax $0
Board [6c 8s 2s 7s 3c]
Seat 1: 59ad445d (button) showed [Qs As] and won ($7.47) with Ace High Flush
Seat 2: 501b0876 (small blind) folded before Flop
Seat 3: 13f0dad9 (big blind) folded before Flop
Seat 4: c9faf803 folded before Flop (didn't bet)
Seat 5: Hero folded before Flop (didn't bet)
Seat 6: b74b84be showed [6d 8d] and lost with Pair of Eights and Pair of Sixes


Poker Hand #RC2078447510: Hold'em No Limit ($0.02/$0.05) - 2023/12/22 21:09:03
Table 'RushAndCash779415' 6-max Seat #1 is the button
Seat 1: aa356882 ($4.61 in chips)
Seat 2: 1ff063e8 ($8.79 in chips)
Seat 3: Hero ($6.11 in chips)
Seat 4: d6c4e270 ($2.1 in chips)
Seat 5: 86f62bb0 ($5.1 in chips)
Seat 6: 8014c02 ($21.24 in chips)
1ff063e8: posts small blind $0.02
Hero: posts big blind $0.05
*** HOLE CARDS ***
Dealt to aa356882 
Dealt to 1ff063e8 
Dealt to Hero [Ac Tc]
Dealt to d6c4e270 
Dealt to 86f62bb0 
Dealt to 8014c02 
d6c4e270: folds
86f62bb0: folds
8014c02: folds
aa356882: calls $0.05
1ff063e8: folds
Hero: checks
*** FLOP *** [6c Qc Jh]
Hero: checks
aa356882: checks
*** TURN *** [6c Qc Jh] [Kd]
Hero: bets $0.12
aa356882: calls $0.12
*** RIVER *** [6c Qc Jh Kd] [3d]
Hero: bets $0.28
aa356882: calls $0.28
Hero: shows [Ac Tc] (Aces-High Straight)
aa356882: shows [5s Kc] (Pair of Kings)
*** SHOWDOWN ***
Hero collected $0.88 from pot
*** SUMMARY ***
Total pot $0.92 | Rake $0.04 | Jackpot $0 | Bingo $0 | Fortune $0 | Tax $0
Board [6c Qc Jh Kd 3d]
Seat 1: aa356882 (button) showed [5s Kc] and lost with Pair of Kings
Seat 2: 1ff063e8 (small blind) folded before Flop
Seat 3: Hero (big blind) showed [Ac Tc] and won ($0.88) with Aces-High Straight
Seat 4: d6c4e270 folded before Flop (didn't bet)
Seat 5: 86f62bb0 folded before Flop (didn't bet)
Seat 6: 8014c02 folded before Flop (didn't bet)


Poker Hand #RC2078447428: Hold'em No Limit ($0.02/$0.05) - 2023/12/22 21:08:58
Table 'RushAndCash779375' 6-max Seat #1 is the button
Seat 1: 685dae27 ($2.81 in chips)
Seat 2: Hero ($6.13 in chips)
Seat 3: 783c5c7 ($5 in chips)
Seat 4: 998574b7 ($5.28 in chips)
Seat 5: 933d69ee ($5.09 in chips)
Seat 6: efaec7cf ($4.89 in chips)
Hero: posts small blind $0.02
783c5c7: posts big blind $0.05
*** HOLE CARDS ***
Dealt to 685dae27 
Dealt to Hero [9h 4c]
Dealt to 783c5c7 
Dealt to 998574b7 
Dealt to 933d69ee 
Dealt to efaec7cf 
998574b7: folds
933d69ee: raises $0.06 to $0.11
efaec7cf: folds
685dae27: folds
Hero: folds
783c5c7: folds
Uncalled bet ($0.06) returned to 933d69ee
*** SHOWDOWN ***
933d69ee collected $0.12 from pot
*** SUMMARY ***
Total pot $0.12 | Rake $0 | Jackpot $0 | Bingo $0 | Fortune $0 | Tax $0
Seat 1: 685dae27 (button) folded before Flop (didn't bet)
Seat 2: Hero (small blind) folded before Flop
Seat 3: 783c5c7 (big blind) folded before Flop
Seat 4: 998574b7 folded before Flop (didn't bet)
Seat 5: 933d69ee collected ($0.12)
Seat 6: efaec7cf folded before Flop (didn't bet)


Poker Hand #RC2078447351: Hold'em No Limit ($0.02/$0.05) - 2023/12/22 21:08:54
Table 'RushAndCash779340' 6-max Seat #1 is the button
Seat 1: Hero ($6.13 in chips)
Seat 2: 83d24812 ($5.49 in chips)
Seat 3: d03e1a8e ($9.52 in chips)
Seat 4: 317ccf77 ($2.83 in chips)
Seat 5: 879060f7 ($17.34 in chips)
Seat 6: 38bb8e26 ($6.32 in chips)
83d24812: posts small blind $0.02
d03e1a8e: posts big blind $0.05
*** HOLE CARDS ***
Dealt to Hero [Qh 3d]
Dealt to 83d24812 
Dealt to d03e1a8e 
Dealt to 317ccf77 
Dealt to 879060f7 
Dealt to 38bb8e26 
317ccf77: folds
879060f7: raises $0.05 to $0.1
38bb8e26: folds
Hero: folds
83d24812: raises $0.45 to $0.55
d03e1a8e: folds
879060f7: folds
Uncalled bet ($0.45) returned to 83d24812
*** SHOWDOWN ***
83d24812 collected $0.24 from pot
*** SUMMARY ***
Total pot $0.25 | Rake $0.01 | Jackpot $0 | Bingo $0 | Fortune $0 | Tax $0
Seat 1: Hero (button) folded before Flop (didn't bet)
Seat 2: 83d24812 (small blind) collected ($0.24)
Seat 3: d03e1a8e (big blind) folded before Flop
Seat 4: 317ccf77 folded before Flop (didn't bet)
Seat 5: 879060f7 folded before Flop
Seat 6: 38bb8e26 folded before Flop (didn't bet)


Poker Hand #RC2078446715: Hold'em No Limit ($0.02/$0.05) - 2023/12/22 21:08:17
Table 'RushAndCash779026' 6-max Seat #1 is the button
Seat 1: 59c7f4b1 ($8.27 in chips)
Seat 2: 879060f7 ($18.41 in chips)
Seat 3: f92e05a8 ($16.79 in chips)
Seat 4: dd5634d1 ($4.13 in chips)
Seat 5: e734080a ($14.7 in chips)
Seat 6: Hero ($5.18 in chips)
879060f7: posts small blind $0.02
f92e05a8: posts big blind $0.05
*** HOLE CARDS ***
Dealt to 59c7f4b1 
Dealt to 879060f7 
Dealt to f92e05a8 
Dealt to dd5634d1 
Dealt to e734080a 
Dealt to Hero [Jd Js]
dd5634d1: folds
e734080a: folds
Hero: raises $0.05 to $0.1
59c7f4b1: folds
879060f7: raises $0.42 to $0.52
f92e05a8: folds
Hero: calls $0.42
*** FLOP *** [Td Qd Kd]
879060f7: bets $0.55
Hero: raises $4.11 to $4.66 and is all-in
879060f7: folds
Uncalled bet ($4.11) returned to Hero
*** SHOWDOWN ***
Hero collected $2.02 from pot
*** SUMMARY ***
Total pot $2.19 | Rake $0.1 | Jackpot $0.07 | Bingo $0 | Fortune $0 | Tax $0
Board [Td Qd Kd]
Seat 1: 59c7f4b1 (button) folded before Flop (didn't bet)
Seat 2: 879060f7 (small blind) folded on the Flop
Seat 3: f92e05a8 (big blind) folded before Flop
Seat 4: dd5634d1 folded before Flop (didn't bet)
Seat 5: e734080a folded before Flop (didn't bet)
Seat 6: Hero won ($2.02)


Poker Hand #RC2078446476: Hold'em No Limit ($0.02/$0.05) - 2023/12/22 21:08:04
Table 'RushAndCash778908' 6-max Seat #1 is the button
Seat 1: 4dab75d6 ($5 in chips)
Seat 2: Hero ($5.2 in chips)
Seat 3: 1261ae28 ($5 in chips)
Seat 4: bbf08286 ($5.07 in chips)
Seat 5: 81f09a8e ($7.61 in chips)
Seat 6: d56f57b9 ($7.23 in chips)
Hero: posts small blind $0.02
1261ae28: posts big blind $0.05
*** HOLE CARDS ***
Dealt to 4dab75d6 
Dealt to Hero [Ts 7d]
Dealt to 1261ae28 
Dealt to bbf08286 
Dealt to 81f09a8e 
Dealt to d56f57b9 
bbf08286: folds
81f09a8e: raises $0.08 to $0.13
d56f57b9: folds
4dab75d6: folds
Hero: folds
1261ae28: folds
Uncalled bet ($0.08) returned to 81f09a8e
*** SHOWDOWN ***
81f09a8e collected $0.12 from pot
*** SUMMARY ***
Total pot $0.12 | Rake $0 | Jackpot $0 | Bingo $0 | Fortune $0 | Tax $0
Seat 1: 4dab75d6 (button) folded before Flop (didn't bet)
Seat 2: Hero (small blind) folded before Flop
Seat 3: 1261ae28 (big blind) folded before Flop
Seat 4: bbf08286 folded before Flop (didn't bet)
Seat 5: 81f09a8e collected ($0.12)
Seat 6: d56f57b9 folded before Flop (didn't bet)


Poker Hand #RC2078446402: Hold'em No Limit ($0.02/$0.05) - 2023/12/22 21:07:59
Table 'RushAndCash778870' 6-max Seat #1 is the button
Seat 1: Hero ($5.2 in chips)
Seat 2: cddb31fe ($4.5 in chips)
Seat 3: 869465ff ($15.25 in chips)
Seat 4: 3d929f9f ($6.8 in chips)
Seat 5: 3034205c ($5 in chips)
Seat 6: f677406 ($5.16 in chips)
cddb31fe: posts small blind $0.02
869465ff: posts big blind $0.05
*** HOLE CARDS ***
Dealt to Hero [4s 9h]
Dealt to cddb31fe 
Dealt to 869465ff 
Dealt to 3d929f9f 
Dealt to 3034205c 
Dealt to f677406 
3d929f9f: folds
3034205c: raises $0.05 to $0.1
f677406: folds
Hero: folds
cddb31fe: folds
869465ff: folds
Uncalled bet ($0.05) returned to 3034205c
*** SHOWDOWN ***
3034205c collected $0.12 from pot
*** SUMMARY ***
Total pot $0.12 | Rake $0 | Jackpot $0 | Bingo $0 | Fortune $0 | Tax $0
Seat 1: Hero (button) folded before Flop (didn't bet)
Seat 2: cddb31fe (small blind) folded before Flop
Seat 3: 869465ff (big blind) folded before Flop
Seat 4: 3d929f9f folded before Flop (didn't bet)
Seat 5: 3034205c collected ($0.12)
Seat 6: f677406 folded before Flop (didn't bet)


Poker Hand #RC2078445896: Hold'em No Limit ($0.02/$0.05) - 2023/12/22 21:07:32
Table 'RushAndCash778625' 6-max Seat #1 is the button
Seat 1: d020413c ($4.66 in chips)
Seat 2: e3579d61 ($5.79 in chips)
Seat 3: cddb31fe ($4.6 in chips)
Seat 4: Hero ($5.09 in chips)
Seat 5: 404f9683 ($5.64 in chips)
Seat 6: a9abc4b1 ($8.75 in chips)
e3579d61: posts small blind $0.02
cddb31fe: posts big blind $0.05
*** HOLE CARDS ***
Dealt to d020413c 
Dealt to e3579d61 
Dealt to cddb31fe 
Dealt to Hero [Jd Kh]
Dealt to 404f9683 
Dealt to a9abc4b1 
Hero: raises $0.05 to $0.1
404f9683: folds
a9abc4b1: folds
d020413c: folds
e3579d61: folds
cddb31fe: calls $0.05
*** FLOP *** [Ah Qc Kd]
cddb31fe: checks
Hero: checks
*** TURN *** [Ah Qc Kd] [4h]
cddb31fe: checks
Hero: checks
*** RIVER *** [Ah Qc Kd 4h] [4s]
cddb31fe: checks
Hero: checks
cddb31fe: shows [3h 8h] (Pair of Fours)
Hero: shows [Jd Kh] (Pair of Kings and Pair of Fours)
*** SHOWDOWN ***
Hero collected $0.21 from pot
*** SUMMARY ***
Total pot $0.22 | Rake $0.01 | Jackpot $0 | Bingo $0 | Fortune $0 | Tax $0
Board [Ah Qc Kd 4h 4s]
Seat 1: d020413c (button) folded before Flop (didn't bet)
Seat 2: e3579d61 (small blind) folded before Flop
Seat 3: cddb31fe (big blind) showed [3h 8h] and lost with Pair of Fours
Seat 4: Hero showed [Jd Kh] and won ($0.21) with Pair of Kings and Pair of Fours
Seat 5: 404f9683 folded before Flop (didn't bet)
Seat 6: a9abc4b1 folded before Flop (didn't bet)


Poker Hand #RC2078445632: Hold'em No Limit ($0.02/$0.05) - 2023/12/22 21:07:16
Table 'RushAndCash778509' 6-max Seat #1 is the button
Seat 1: 6ded132b ($10.94 in chips)
Seat 2: 8e29353e ($5.16 in chips)
Seat 3: Hero ($5.14 in chips)
Seat 4: 360d3b25 ($5.28 in chips)
Seat 5: c2881b52 ($13.59 in chips)
Seat 6: fb772588 ($4.98 in chips)
8e29353e: posts small blind $0.02
Hero: posts big blind $0.05
*** HOLE CARDS ***
Dealt to 6ded132b 
Dealt to 8e29353e 
Dealt to Hero [Jc Ts]
Dealt to 360d3b25 
Dealt to c2881b52 
Dealt to fb772588 
360d3b25: folds
c2881b52: folds
fb772588: folds
6ded132b: raises $0.1 to $0.15
8e29353e: folds
Hero: folds
Uncalled bet ($0.1) returned to 6ded132b
*** SHOWDOWN ***
6ded132b collected $0.12 from pot
*** SUMMARY ***
Total pot $0.12 | Rake $0 | Jackpot $0 | Bingo $0 | Fortune $0 | Tax $0
Seat 1: 6ded132b (button) collected ($0.12)
Seat 2: 8e29353e (small blind) folded before Flop
Seat 3: Hero (big blind) folded before Flop
Seat 4: 360d3b25 folded before Flop (didn't bet)
Seat 5: c2881b52 folded before Flop (didn't bet)
Seat 6: fb772588 folded before Flop (didn't bet)


Poker Hand #RC2078445569: Hold'em No Limit ($0.02/$0.05) - 2023/12/22 21:07:12
Table 'RushAndCash778481' 6-max Seat #1 is the button
Seat 1: a7286848 ($5 in chips)
Seat 2: 98471e80 ($5.43 in chips)
Seat 3: edb6154b ($5.43 in chips)
Seat 4: 27517d94 ($7.71 in chips)
Seat 5: Hero ($5.14 in chips)
Seat 6: 2b810e8b ($5 in chips)
98471e80: posts small blind $0.02
edb6154b: posts big blind $0.05
*** HOLE CARDS ***
Dealt to a7286848 
Dealt to 98471e80 
Dealt to edb6154b 
Dealt to 27517d94 
Dealt to Hero [2s 9h]
Dealt to 2b810e8b 
27517d94: folds
Hero: folds
2b810e8b: raises $0.08 to $0.13
a7286848: folds
98471e80: raises $0.37 to $0.5
edb6154b: folds
2b810e8b: folds
Uncalled bet ($0.37) returned to 98471e80
*** SHOWDOWN ***
98471e80 collected $0.3 from pot
*** SUMMARY ***
Total pot $0.31 | Rake $0.01 | Jackpot $0 | Bingo $0 | Fortune $0 | Tax $0
Seat 1: a7286848 (button) folded before Flop (didn't bet)
Seat 2: 98471e80 (small blind) collected ($0.3)
Seat 3: edb6154b (big blind) folded before Flop
Seat 4: 27517d94 folded before Flop (didn't bet)
Seat 5: Hero folded before Flop (didn't bet)
Seat 6: 2b810e8b folded before Flop


Poker Hand #RC2078445507: Hold'em No Limit ($0.02/$0.05) - 2023/12/22 21:07:09
Table 'RushAndCash778455' 6-max Seat #1 is the button
Seat 1: c71b7029 ($10.48 in chips)
Seat 2: 809e45f6 ($4.65 in chips)
Seat 3: 4810f2d7 ($6.09 in chips)
Seat 4: Hero ($5.14 in chips)
Seat 5: 6c115aeb ($5.23 in chips)
Seat 6: 2b810e8b ($5 in chips)
809e45f6: posts small blind $0.02
4810f2d7: posts big blind $0.05
*** HOLE CARDS ***
Dealt to c71b7029 
Dealt to 809e45f6 
Dealt to 4810f2d7 
Dealt to Hero [8d 3c]
Dealt to 6c115aeb 
Dealt to 2b810e8b 
Hero: folds
6c115aeb: raises $0.08 to $0.13
2b810e8b: folds
c71b7029: folds
809e45f6: folds
4810f2d7: folds
Uncalled bet ($0.08) returned to 6c115aeb
*** SHOWDOWN ***
6c115aeb collected $0.12 from pot
*** SUMMARY ***
Total pot $0.12 | Rake $0 | Jackpot $0 | Bingo $0 | Fortune $0 | Tax $0
Seat 1: c71b7029 (button) folded before Flop (didn't bet)
Seat 2: 809e45f6 (small blind) folded before Flop
Seat 3: 4810f2d7 (big blind) folded before Flop
Seat 4: Hero folded before Flop (didn't bet)
Seat 5: 6c115aeb collected ($0.12)
Seat 6: 2b810e8b folded before Flop (didn't bet)


Poker Hand #RC2078445400: Hold'em No Limit ($0.02/$0.05) - 2023/12/22 21:07:02
Table 'RushAndCash778405' 6-max Seat #1 is the button
Seat 1: 9b2d2337 ($17.38 in chips)
Seat 2: Hero ($5.16 in chips)
Seat 3: 72f7386e ($11.16 in chips)
Seat 4: 8b805e5d ($1.27 in chips)
Seat 5: 1259a422 ($5.53 in chips)
Seat 6: dd5634d1 ($4.45 in chips)
Hero: posts small blind $0.02
72f7386e: posts big blind $0.05
*** HOLE CARDS ***
Dealt to 9b2d2337 
Dealt to Hero [Kh 7s]
Dealt to 72f7386e 
Dealt to 8b805e5d 
Dealt to 1259a422 
Dealt to dd5634d1 
8b805e5d: folds
1259a422: folds
dd5634d1: calls $0.05
9b2d2337: raises $0.15 to $0.2
Hero: folds
72f7386e: folds
dd5634d1: calls $0.15
*** FLOP *** [3c 6d Qs]
dd5634d1: checks
9b2d2337: bets $0.12
dd5634d1: folds
Uncalled bet ($0.12) returned to 9b2d2337
*** SHOWDOWN ***
9b2d2337 collected $0.45 from pot
*** SUMMARY ***
Total pot $0.47 | Rake $0.02 | Jackpot $0 | Bingo $0 | Fortune $0 | Tax $0
Board [3c 6d Qs]
Seat 1: 9b2d2337 (button) won ($0.45)
Seat 2: Hero (small blind) folded before Flop
Seat 3: 72f7386e (big blind) folded before Flop
Seat 4: 8b805e5d folded before Flop (didn't bet)
Seat 5: 1259a422 folded before Flop (didn't bet)
Seat 6: dd5634d1 folded on the Flop


Poker Hand #RC2078424559: Hold'em No Limit ($0.02/$0.05) - 2023/12/22 21:06:16
Table 'RushAndCash777998' 6-max Seat #1 is the button
Seat 1: cddb31fe ($4.37 in chips)
Seat 2: 8505bab2 ($5.02 in chips)
Seat 3: d04b341b ($4.52 in chips)
Seat 4: 72f7386e ($9.54 in chips)
Seat 5: Hero ($6.86 in chips)
Seat 6: 622d6af4 ($5.1 in chips)
8505bab2: posts small blind $0.02
d04b341b: posts big blind $0.05
*** HOLE CARDS ***
Dealt to cddb31fe 
Dealt to 8505bab2 
Dealt to d04b341b 
Dealt to 72f7386e 
Dealt to Hero [Ad Qh]
Dealt to 622d6af4 
72f7386e: raises $0.07 to $0.12
Hero: raises $0.31 to $0.43
622d6af4: folds
cddb31fe: folds
8505bab2: folds
d04b341b: folds
72f7386e: calls $0.31
*** FLOP *** [8h 8c 2s]
72f7386e: checks
Hero: bets $0.31
72f7386e: calls $0.31
*** TURN *** [8h 8c 2s] [4d]
72f7386e: checks
Hero: bets $1.03
72f7386e: raises $1.05 to $2.08
Hero: folds
Uncalled bet ($1.05) returned to 72f7386e
*** SHOWDOWN ***
72f7386e collected $3.39 from pot
*** SUMMARY ***
Total pot $3.61 | Rake $0.15 | Jackpot $0.07 | Bingo $0 | Fortune $0 | Tax $0
Board [8h 8c 2s 4d]
Seat 1: cddb31fe (button) folded before Flop (didn't bet)
Seat 2: 8505bab2 (small blind) folded before Flop
Seat 3: d04b341b (big blind) folded before Flop
Seat 4: 72f7386e won ($3.39)
Seat 5: Hero folded on the Turn
Seat 6: 622d6af4 folded before Flop (didn't bet)


Poker Hand #RC2078424459: Hold'em No Limit ($0.02/$0.05) - 2023/12/22 21:06:10
Table 'RushAndCash777948' 6-max Seat #1 is the button
Seat 1: 8d15f06b ($12.09 in chips)
Seat 2: 5c1df951 ($5.55 in chips)
Seat 3: Hero ($6.91 in chips)
Seat 4: 3bfed236 ($5.23 in chips)
Seat 5: 685dae27 ($2.23 in chips)
Seat 6: ff769430 ($6.14 in chips)
5c1df951: posts small blind $0.02
Hero: posts big blind $0.05
*** HOLE CARDS ***
Dealt to 8d15f06b 
Dealt to 5c1df951 
Dealt to Hero [7c 6s]
Dealt to 3bfed236 
Dealt to 685dae27 
Dealt to ff769430 
3bfed236: folds
685dae27: folds
ff769430: folds
8d15f06b: folds
5c1df951: folds
Uncalled bet ($0.03) returned to Hero
*** SHOWDOWN ***
Hero collected $0.04 from pot
*** SUMMARY ***
Total pot $0.04 | Rake $0 | Jackpot $0 | Bingo $0 | Fortune $0 | Tax $0
Seat 1: 8d15f06b (button) folded before Flop (didn't bet)
Seat 2: 5c1df951 (small blind) folded before Flop
Seat 3: Hero (big blind) collected ($0.04)
Seat 4: 3bfed236 folded before Flop (didn't bet)
Seat 5: 685dae27 folded before Flop (didn't bet)
Seat 6: ff769430 folded before Flop (didn't bet)


Poker Hand #RC2078424360: Hold'em No Limit ($0.02/$0.05) - 2023/12/22 21:06:05
Table 'RushAndCash777899' 6-max Seat #1 is the button
Seat 1: Hero ($6.91 in chips)
Seat 2: 21196b97 ($9.63 in chips)
Seat 3: c68e2737 ($5.05 in chips)
Seat 4: 4810f2d7 ($6 in chips)
Seat 5: aeb6c819 ($11.87 in chips)
Seat 6: 16153105 ($4.8 in chips)
21196b97: posts small blind $0.02
c68e2737: posts big blind $0.05
*** HOLE CARDS ***
Dealt to Hero [5s Tc]
Dealt to 21196b97 
Dealt to c68e2737 
Dealt to 4810f2d7 
Dealt to aeb6c819 
Dealt to 16153105 
4810f2d7: folds
aeb6c819: folds
16153105: folds
Hero: folds
21196b97: raises $0.1 to $0.15
c68e2737: calls $0.1
*** FLOP *** [2c 3h 8d]
21196b97: checks
c68e2737: checks
*** TURN *** [2c 3h 8d] [8h]
21196b97: bets $0.15
c68e2737: calls $0.15
*** RIVER *** [2c 3h 8d 8h] [5c]
21196b97: checks
c68e2737: bets $0.75
21196b97: folds
Uncalled bet ($0.75) returned to c68e2737
*** SHOWDOWN ***
c68e2737 collected $0.57 from pot
*** SUMMARY ***
Total pot $0.6 | Rake $0.03 | Jackpot $0 | Bingo $0 | Fortune $0 | Tax $0
Board [2c 3h 8d 8h 5c]
Seat 1: Hero (button) folded before Flop (didn't bet)
Seat 2: 21196b97 (small blind) folded on the River
Seat 3: c68e2737 (big blind) won ($0.57)
Seat 4: 4810f2d7 folded before Flop (didn't bet)
Seat 5: aeb6c819 folded before Flop (didn't bet)
Seat 6: 16153105 folded before Flop (didn't bet)


Poker Hand #RC2078424258: Hold'em No Limit ($0.02/$0.05) - 2023/12/22 21:05:59
Table 'RushAndCash777852' 6-max Seat #1 is the button
Seat 1: a3db0062 ($8.23 in chips)
Seat 2: 5d317abf ($8.94 in chips)
Seat 3: 5ba9a692 ($5 in chips)
Seat 4: 750a6baa ($5.14 in chips)
Seat 5: edb6154b ($5.57 in chips)
Seat 6: Hero ($6.91 in chips)
5d317abf: posts small blind $0.02
5ba9a692: posts big blind $0.05
*** HOLE CARDS ***
Dealt to a3db0062 
Dealt to 5d317abf 
Dealt to 5ba9a692 
Dealt to 750a6baa 
Dealt to edb6154b 
Dealt to Hero [Td 9c]
750a6baa: folds
edb6154b: folds
Hero: folds
a3db0062: folds
5d317abf: folds
Uncalled bet ($0.03) returned to 5ba9a692
*** SHOWDOWN ***
5ba9a692 collected $0.04 from pot
*** SUMMARY ***
Total pot $0.04 | Rake $0 | Jackpot $0 | Bingo $0 | Fortune $0 | Tax $0
Seat 1: a3db0062 (button) folded before Flop (didn't bet)
Seat 2: 5d317abf (small blind) folded before Flop
Seat 3: 5ba9a692 (big blind) collected ($0.04)
Seat 4: 750a6baa folded before Flop (didn't bet)
Seat 5: edb6154b folded before Flop (didn't bet)
Seat 6: Hero folded before Flop (didn't bet)


Poker Hand #RC2078424121: Hold'em No Limit ($0.02/$0.05) - 2023/12/22 21:05:51
Table 'RushAndCash777792' 6-max Seat #1 is the button
Seat 1: e3589ec ($2.26 in chips)
Seat 2: c87acea2 ($15.43 in chips)
Seat 3: 5261fe21 ($5.21 in chips)
Seat 4: 11811683 ($5.19 in chips)
Seat 5: f9c6a467 ($16.99 in chips)
Seat 6: Hero ($6.91 in chips)
c87acea2: posts small blind $0.02
5261fe21: posts big blind $0.05
*** HOLE CARDS ***
Dealt to e3589ec 
Dealt to c87acea2 
Dealt to 5261fe21 
Dealt to 11811683 
Dealt to f9c6a467 
Dealt to Hero [Qc 7c]
11811683: folds
f9c6a467: folds
Hero: folds
e3589ec: raises $0.05 to $0.1
c87acea2: folds
5261fe21: folds
Uncalled bet ($0.05) returned to e3589ec
*** SHOWDOWN ***
e3589ec collected $0.12 from pot
*** SUMMARY ***
Total pot $0.12 | Rake $0 | Jackpot $0 | Bingo $0 | Fortune $0 | Tax $0
Seat 1: e3589ec (button) collected ($0.12)
Seat 2: c87acea2 (small blind) folded before Flop
Seat 3: 5261fe21 (big blind) folded before Flop
Seat 4: 11811683 folded before Flop (didn't bet)
Seat 5: f9c6a467 folded before Flop (didn't bet)
Seat 6: Hero folded before Flop (didn't bet)


Poker Hand #RC2078423753: Hold'em No Limit ($0.02/$0.05) - 2023/12/22 21:05:31
Table 'RushAndCash777623' 6-max Seat #1 is the button
Seat 1: 829aa739 ($6.79 in chips)
Seat 2: 4c660603 ($5.96 in chips)
Seat 3: b7c101a2 ($8.63 in chips)
Seat 4: Hero ($6.84 in chips)
Seat 5: 872860d ($5 in chips)
Seat 6: 8429395c ($5.23 in chips)
4c660603: posts small blind $0.02
b7c101a2: posts big blind $0.05
*** HOLE CARDS ***
Dealt to 829aa739 
Dealt to 4c660603 
Dealt to b7c101a2 
Dealt to Hero [8d 8h]
Dealt to 872860d 
Dealt to 8429395c 
Hero: raises $0.05 to $0.1
872860d: folds
8429395c: folds
829aa739: folds
4c660603: folds
b7c101a2: folds
Uncalled bet ($0.05) returned to Hero
*** SHOWDOWN ***
Hero collected $0.12 from pot
*** SUMMARY ***
Total pot $0.12 | Rake $0 | Jackpot $0 | Bingo $0 | Fortune $0 | Tax $0
Seat 1: 829aa739 (button) folded before Flop (didn't bet)
Seat 2: 4c660603 (small blind) folded before Flop
Seat 3: b7c101a2 (big blind) folded before Flop
Seat 4: Hero collected ($0.12)
Seat 5: 872860d folded before Flop (didn't bet)
Seat 6: 8429395c folded before Flop (didn't bet)


Poker Hand #RC2078423673: Hold'em No Limit ($0.02/$0.05) - 2023/12/22 21:05:26
Table 'RushAndCash777587' 6-max Seat #1 is the button
Seat 1: 72e2334d ($4.65 in chips)
Seat 2: 9f0aa2dc ($5.13 in chips)
Seat 3: b7a32571 ($6.52 in chips)
Seat 4: Hero ($6.84 in chips)
Seat 5: c3c9a58d ($8.63 in chips)
Seat 6: a4441de9 ($9.42 in chips)
9f0aa2dc: posts small blind $0.02
b7a32571: posts big blind $0.05
*** HOLE CARDS ***
Dealt to 72e2334d 
Dealt to 9f0aa2dc 
Dealt to b7a32571 
Dealt to Hero [Js 9c]
Dealt to c3c9a58d 
Dealt to a4441de9 
Hero: folds
c3c9a58d: folds
a4441de9: raises $0.08 to $0.13
72e2334d: folds
9f0aa2dc: folds
b7a32571: calls $0.08
*** FLOP *** [7h 7c Ts]
b7a32571: checks
a4441de9: bets $0.1
b7a32571: raises $0.24 to $0.34
a4441de9: folds
Uncalled bet ($0.24) returned to b7a32571
*** SHOWDOWN ***
b7a32571 collected $0.46 from pot
*** SUMMARY ***
Total pot $0.48 | Rake $0.02 | Jackpot $0 | Bingo $0 | Fortune $0 | Tax $0
Board [7h 7c Ts]
Seat 1: 72e2334d (button) folded before Flop (didn't bet)
Seat 2: 9f0aa2dc (small blind) folded before Flop
Seat 3: b7a32571 (big blind) won ($0.46)
Seat 4: Hero folded before Flop (didn't bet)
Seat 5: c3c9a58d folded before Flop (didn't bet)
Seat 6: a4441de9 folded on the Flop


Poker Hand #RC2078423608: Hold'em No Limit ($0.02/$0.05) - 2023/12/22 21:05:23
Table 'RushAndCash777559' 6-max Seat #1 is the button
Seat 1: Hero ($6.84 in chips)
Seat 2: b1e42a90 ($5.38 in chips)
Seat 3: 11676b65 ($4.54 in chips)
Seat 4: 18f9cb34 ($6.27 in chips)
Seat 5: 1e3d103d ($5.24 in chips)
Seat 6: d0b2d784 ($6.41 in chips)
b1e42a90: posts small blind $0.02
11676b65: posts big blind $0.05
*** HOLE CARDS ***
Dealt to Hero [3d Tc]
Dealt to b1e42a90 
Dealt to 11676b65 
Dealt to 18f9cb34 
Dealt to 1e3d103d 
Dealt to d0b2d784 
18f9cb34: folds
1e3d103d: folds
d0b2d784: folds
Hero: folds
b1e42a90: raises $0.09 to $0.14
11676b65: calls $0.09
*** FLOP *** [9c Jh Kc]
b1e42a90: checks
11676b65: bets $0.16
b1e42a90: calls $0.16
*** TURN *** [9c Jh Kc] [5d]
b1e42a90: checks
11676b65: checks
*** RIVER *** [9c Jh Kc 5d] [8h]
b1e42a90: checks
11676b65: checks
b1e42a90: shows [Kh As] (Pair of Kings)
11676b65: shows [9h 4h] (Pair of Nines)
*** SHOWDOWN ***
b1e42a90 collected $0.57 from pot
*** SUMMARY ***
Total pot $0.6 | Rake $0.03 | Jackpot $0 | Bingo $0 | Fortune $0 | Tax $0
Board [9c Jh Kc 5d 8h]
Seat 1: Hero (button) folded before Flop (didn't bet)
Seat 2: b1e42a90 (small blind) showed [Kh As] and won ($0.57) with Pair of Kings
Seat 3: 11676b65 (big blind) showed [9h 4h] and lost with Pair of Nines
Seat 4: 18f9cb34 folded before Flop (didn't bet)
Seat 5: 1e3d103d folded before Flop (didn't bet)
Seat 6: d0b2d784 folded before Flop (didn't bet)


Poker Hand #RC2078423468: Hold'em No Limit ($0.02/$0.05) - 2023/12/22 21:05:15
Table 'RushAndCash777498' 6-max Seat #1 is the button
Seat 1: 2471888a ($5 in chips)
Seat 2: c2796cf2 ($7.58 in chips)
Seat 3: Hero ($6.89 in chips)
Seat 4: 3b613695 ($8.71 in chips)
Seat 5: 2e2fe835 ($5.34 in chips)
Seat 6: 1b19739f ($5.09 in chips)
c2796cf2: posts small blind $0.02
Hero: posts big blind $0.05
*** HOLE CARDS ***
Dealt to 2471888a 
Dealt to c2796cf2 
Dealt to Hero [2s 4h]
Dealt to 3b613695 
Dealt to 2e2fe835 
Dealt to 1b19739f 
3b613695: folds
2e2fe835: folds
1b19739f: folds
2471888a: folds
c2796cf2: raises $0.09 to $0.14
Hero: folds
Uncalled bet ($0.09) returned to c2796cf2
*** SHOWDOWN ***
c2796cf2 collected $0.1 from pot
*** SUMMARY ***
Total pot $0.1 | Rake $0 | Jackpot $0 | Bingo $0 | Fortune $0 | Tax $0
Seat 1: 2471888a (button) folded before Flop (didn't bet)
Seat 2: c2796cf2 (small blind) collected ($0.1)
Seat 3: Hero (big blind) folded before Flop
Seat 4: 3b613695 folded before Flop (didn't bet)
Seat 5: 2e2fe835 folded before Flop (didn't bet)
Seat 6: 1b19739f folded before Flop (didn't bet)


Poker Hand #RC2078423129: Hold'em No Limit ($0.02/$0.05) - 2023/12/22 21:04:56
Table 'RushAndCash777348' 6-max Seat #1 is the button
Seat 1: d6c4e270 ($3.31 in chips)
Seat 2: Hero ($7 in chips)
Seat 3: 5703e2fa ($6.03 in chips)
Seat 4: 3b613695 ($8.56 in chips)
Seat 5: f2f8c789 ($19.66 in chips)
Seat 6: 94b80c38 ($3.06 in chips)
Hero: posts small blind $0.02
5703e2fa: posts big blind $0.05
*** HOLE CARDS ***
Dealt to d6c4e270 
Dealt to Hero [As Jh]
Dealt to 5703e2fa 
Dealt to 3b613695 
Dealt to f2f8c789 
Dealt to 94b80c38 
3b613695: raises $0.06 to $0.11
f2f8c789: folds
94b80c38: folds
d6c4e270: folds
Hero: calls $0.09
5703e2fa: folds
*** FLOP *** [7d 5d 5s]
Hero: checks
3b613695: bets $0.09
Hero: folds
Uncalled bet ($0.09) returned to 3b613695
*** SHOWDOWN ***
3b613695 collected $0.26 from pot
*** SUMMARY ***
Total pot $0.27 | Rake $0.01 | Jackpot $0 | Bingo $0 | Fortune $0 | Tax $0
Board [7d 5d 5s]
Seat 1: d6c4e270 (button) folded before Flop (didn't bet)
Seat 2: Hero (small blind) folded on the Flop
Seat 3: 5703e2fa (big blind) folded before Flop
Seat 4: 3b613695 won ($0.26)
Seat 5: f2f8c789 folded before Flop (didn't bet)
Seat 6: 94b80c38 folded before Flop (didn't bet)


Poker Hand #RC2078423070: Hold'em No Limit ($0.02/$0.05) - 2023/12/22 21:04:53
Table 'RushAndCash777322' 6-max Seat #1 is the button
Seat 1: 5b035bcb ($3.01 in chips)
Seat 2: 3b613695 ($8.58 in chips)
Seat 3: 5609f25 ($5 in chips)
Seat 4: Hero ($7 in chips)
Seat 5: 7f11da5e ($2.77 in chips)
Seat 6: c6bf1d22 ($8.85 in chips)
3b613695: posts small blind $0.02
5609f25: posts big blind $0.05
*** HOLE CARDS ***
Dealt to 5b035bcb 
Dealt to 3b613695 
Dealt to 5609f25 
Dealt to Hero [Ac 8s]
Dealt to 7f11da5e 
Dealt to c6bf1d22 
Hero: folds
7f11da5e: folds
c6bf1d22: raises $0.06 to $0.11
5b035bcb: calls $0.11
3b613695: folds
5609f25: folds
*** FLOP *** [2s Ah Js]
c6bf1d22: checks
5b035bcb: checks
*** TURN *** [2s Ah Js] [9c]
c6bf1d22: checks
5b035bcb: checks
*** RIVER *** [2s Ah Js 9c] [6d]
c6bf1d22: checks
5b035bcb: checks
c6bf1d22: shows [Ks Kc] (Pair of Kings)
5b035bcb: shows [Qc 9d] (Pair of Nines)
*** SHOWDOWN ***
c6bf1d22 collected $0.28 from pot
*** SUMMARY ***
Total pot $0.29 | Rake $0.01 | Jackpot $0 | Bingo $0 | Fortune $0 | Tax $0
Board [2s Ah Js 9c 6d]
Seat 1: 5b035bcb (button) showed [Qc 9d] and lost with Pair of Nines
Seat 2: 3b613695 (small blind) folded before Flop
Seat 3: 5609f25 (big blind) folded before Flop
Seat 4: Hero folded before Flop (didn't bet)
Seat 5: 7f11da5e folded before Flop (didn't bet)
Seat 6: c6bf1d22 showed [Ks Kc] and won ($0.28) with Pair of Kings


Poker Hand #RC2078422979: Hold'em No Limit ($0.02/$0.05) - 2023/12/22 21:04:47
Table 'RushAndCash777280' 6-max Seat #1 is the button
Seat 1: cf6f5635 ($5.5 in chips)
Seat 2: abd6fe91 ($5 in chips)
Seat 3: f677406 ($5.14 in chips)
Seat 4: 8d0bca32 ($6.88 in chips)
Seat 5: Hero ($7 in chips)
Seat 6: 2df55086 ($7.17 in chips)
abd6fe91: posts small blind $0.02
f677406: posts big blind $0.05
*** HOLE CARDS ***
Dealt to cf6f5635 
Dealt to abd6fe91 
Dealt to f677406 
Dealt to 8d0bca32 
Dealt to Hero [9c Qc]
Dealt to 2df55086 
8d0bca32: folds
Hero: folds
2df55086: folds
cf6f5635: folds
abd6fe91: raises $0.08 to $0.13
f677406: folds
Uncalled bet ($0.08) returned to abd6fe91
*** SHOWDOWN ***
abd6fe91 collected $0.1 from pot
*** SUMMARY ***
Total pot $0.1 | Rake $0 | Jackpot $0 | Bingo $0 | Fortune $0 | Tax $0
Seat 1: cf6f5635 (button) folded before Flop (didn't bet)
Seat 2: abd6fe91 (small blind) collected ($0.1)
Seat 3: f677406 (big blind) folded before Flop
Seat 4: 8d0bca32 folded before Flop (didn't bet)
Seat 5: Hero folded before Flop (didn't bet)
Seat 6: 2df55086 folded before Flop (didn't bet)


Poker Hand #RC2078422688: Hold'em No Limit ($0.02/$0.05) - 2023/12/22 21:04:30
Table 'RushAndCash777145' 6-max Seat #1 is the button
Seat 1: Hero ($7 in chips)
Seat 2: 67d4b163 ($13.15 in chips)
Seat 3: 22426c35 ($5.64 in chips)
Seat 4: fcc5325d ($4.83 in chips)
Seat 5: 2ec85018 ($4.16 in chips)
Seat 6: ec3623ea ($5.37 in chips)
67d4b163: posts small blind $0.02
22426c35: posts big blind $0.05
*** HOLE CARDS ***
Dealt to Hero [4h 5h]
Dealt to 67d4b163 
Dealt to 22426c35 
Dealt to fcc5325d 
Dealt to 2ec85018 
Dealt to ec3623ea 
fcc5325d: folds
2ec85018: folds
ec3623ea: folds
Hero: folds
67d4b163: folds
Uncalled bet ($0.03) returned to 22426c35
*** SHOWDOWN ***
22426c35 collected $0.04 from pot
*** SUMMARY ***
Total pot $0.04 | Rake $0 | Jackpot $0 | Bingo $0 | Fortune $0 | Tax $0
Seat 1: Hero (button) folded before Flop (didn't bet)
Seat 2: 67d4b163 (small blind) folded before Flop
Seat 3: 22426c35 (big blind) collected ($0.04)
Seat 4: fcc5325d folded before Flop (didn't bet)
Seat 5: 2ec85018 folded before Flop (didn't bet)
Seat 6: ec3623ea folded before Flop (didn't bet)


Poker Hand #RC2078422610: Hold'em No Limit ($0.02/$0.05) - 2023/12/22 21:04:26
Table 'RushAndCash777112' 6-max Seat #1 is the button
Seat 1: e57ad3f ($1.62 in chips)
Seat 2: 3c8f2664 ($3.37 in chips)
Seat 3: 50cbc258 ($6.12 in chips)
Seat 4: Hero ($7 in chips)
Seat 5: 7e84e7dc ($8.05 in chips)
Seat 6: 3d929f9f ($6.29 in chips)
3c8f2664: posts small blind $0.02
50cbc258: posts big blind $0.05
*** HOLE CARDS ***
Dealt to e57ad3f 
Dealt to 3c8f2664 
Dealt to 50cbc258 
Dealt to Hero [5h Ac]
Dealt to 7e84e7dc 
Dealt to 3d929f9f 
Hero: folds
7e84e7dc: folds
3d929f9f: folds
e57ad3f: folds
3c8f2664: raises $0.05 to $0.1
50cbc258: folds
Uncalled bet ($0.05) returned to 3c8f2664
*** SHOWDOWN ***
3c8f2664 collected $0.1 from pot
*** SUMMARY ***
Total pot $0.1 | Rake $0 | Jackpot $0 | Bingo $0 | Fortune $0 | Tax $0
Seat 1: e57ad3f (button) folded before Flop (didn't bet)
Seat 2: 3c8f2664 (small blind) collected ($0.1)
Seat 3: 50cbc258 (big blind) folded before Flop
Seat 4: Hero folded before Flop (didn't bet)
Seat 5: 7e84e7dc folded before Flop (didn't bet)
Seat 6: 3d929f9f folded before Flop (didn't bet)


Poker Hand #RC2078422387: Hold'em No Limit ($0.02/$0.05) - 2023/12/22 21:04:13
Table 'RushAndCash777014' 6-max Seat #1 is the button
Seat 1: 8a8eafe4 ($14.37 in chips)
Seat 2: Hero ($6.95 in chips)
Seat 3: 7466ff6a ($16.38 in chips)
Seat 4: 6f9a9767 ($5.98 in chips)
Seat 5: 49ea92ea ($8.26 in chips)
Seat 6: 8b805e5d ($1.13 in chips)
Hero: posts small blind $0.02
7466ff6a: posts big blind $0.05
*** HOLE CARDS ***
Dealt to 8a8eafe4 
Dealt to Hero [Js Jh]
Dealt to 7466ff6a 
Dealt to 6f9a9767 
Dealt to 49ea92ea 
Dealt to 8b805e5d 
6f9a9767: folds
49ea92ea: folds
8b805e5d: folds
8a8eafe4: folds
Hero: raises $0.1 to $0.15
7466ff6a: folds
Uncalled bet ($0.1) returned to Hero
*** SHOWDOWN ***
Hero collected $0.1 from pot
*** SUMMARY ***
Total pot $0.1 | Rake $0 | Jackpot $0 | Bingo $0 | Fortune $0 | Tax $0
Seat 1: 8a8eafe4 (button) folded before Flop (didn't bet)
Seat 2: Hero (small blind) collected ($0.1)
Seat 3: 7466ff6a (big blind) folded before Flop
Seat 4: 6f9a9767 folded before Flop (didn't bet)
Seat 5: 49ea92ea folded before Flop (didn't bet)
Seat 6: 8b805e5d folded before Flop (didn't bet)


Poker Hand #RC2078422297: Hold'em No Limit ($0.02/$0.05) - 2023/12/22 21:04:08
Table 'RushAndCash776977' 6-max Seat #1 is the button
Seat 1: a9db0c00 ($14.49 in chips)
Seat 2: f2927765 ($5.11 in chips)
Seat 3: Hero ($7 in chips)
Seat 4: 88f653a1 ($5.22 in chips)
Seat 5: b75ac6ee ($5 in chips)
Seat 6: bbf08286 ($1.81 in chips)
f2927765: posts small blind $0.02
Hero: posts big blind $0.05
*** HOLE CARDS ***
Dealt to a9db0c00 
Dealt to f2927765 
Dealt to Hero [Ah 7d]
Dealt to 88f653a1 
Dealt to b75ac6ee 
Dealt to bbf08286 
88f653a1: folds
b75ac6ee: folds
bbf08286: raises $1.76 to $1.81 and is all-in
a9db0c00: folds
f2927765: folds
Hero: folds
Uncalled bet ($1.76) returned to bbf08286
*** SHOWDOWN ***
bbf08286 collected $0.12 from pot
*** SUMMARY ***
Total pot $0.12 | Rake $0 | Jackpot $0 | Bingo $0 | Fortune $0 | Tax $0
Seat 1: a9db0c00 (button) folded before Flop (didn't bet)
Seat 2: f2927765 (small blind) folded before Flop
Seat 3: Hero (big blind) folded before Flop
Seat 4: 88f653a1 folded before Flop (didn't bet)
Seat 5: b75ac6ee folded before Flop (didn't bet)
Seat 6: bbf08286 collected ($0.12)


Poker Hand #RC2078422233: Hold'em No Limit ($0.02/$0.05) - 2023/12/22 21:04:05
Table 'RushAndCash776949' 6-max Seat #1 is the button
Seat 1: ff6f425f ($11.59 in chips)
Seat 2: 98471e80 ($6.7 in chips)
Seat 3: a4441de9 ($9.91 in chips)
Seat 4: b6036b95 ($4.97 in chips)
Seat 5: Hero ($7 in chips)
Seat 6: 49ea92ea ($8.26 in chips)
98471e80: posts small blind $0.02
a4441de9: posts big blind $0.05
*** HOLE CARDS ***
Dealt to ff6f425f 
Dealt to 98471e80 
Dealt to a4441de9 
Dealt to b6036b95 
Dealt to Hero [8h 2c]
Dealt to 49ea92ea 
b6036b95: raises $0.05 to $0.1
Hero: folds
49ea92ea: folds
ff6f425f: folds
98471e80: raises $0.3 to $0.4
a4441de9: folds
b6036b95: calls $0.3
*** FLOP *** [9h Qs 2d]
98471e80: bets $0.43
b6036b95: calls $0.43
*** TURN *** [9h Qs 2d] [5d]
98471e80: checks
b6036b95: checks
*** RIVER *** [9h Qs 2d 5d] [8d]
98471e80: checks
b6036b95: bets $4.14 and is all-in
98471e80: folds
Uncalled bet ($4.14) returned to b6036b95
*** SHOWDOWN ***
b6036b95 collected $1.56 from pot
*** SUMMARY ***
Total pot $1.71 | Rake $0.08 | Jackpot $0.07 | Bingo $0 | Fortune $0 | Tax $0
Board [9h Qs 2d 5d 8d]
Seat 1: ff6f425f (button) folded before Flop (didn't bet)
Seat 2: 98471e80 (small blind) folded on the River
Seat 3: a4441de9 (big blind) folded before Flop
Seat 4: b6036b95 won ($1.56)
Seat 5: Hero folded before Flop (didn't bet)
Seat 6: 49ea92ea folded before Flop (didn't bet)


Poker Hand #RC2078422178: Hold'em No Limit ($0.02/$0.05) - 2023/12/22 21:04:02
Table 'RushAndCash776924' 6-max Seat #1 is the button
Seat 1: 2075befd ($5.14 in chips)
Seat 2: 294b7dd8 ($6.85 in chips)
Seat 3: 11ff021b ($5.17 in chips)
Seat 4: 35a4e515 ($3.82 in chips)
Seat 5: Hero ($7 in chips)
Seat 6: 27517d94 ($7.18 in chips)
294b7dd8: posts small blind $0.02
11ff021b: posts big blind $0.05
*** HOLE CARDS ***
Dealt to 2075befd 
Dealt to 294b7dd8 
Dealt to 11ff021b 
Dealt to 35a4e515 
Dealt to Hero [8h 5c]
Dealt to 27517d94 
35a4e515: folds
Hero: folds
27517d94: folds
2075befd: folds
294b7dd8: raises $0.08 to $0.13
11ff021b: folds
Uncalled bet ($0.08) returned to 294b7dd8
*** SHOWDOWN ***
294b7dd8 collected $0.1 from pot
*** SUMMARY ***
Total pot $0.1 | Rake $0 | Jackpot $0 | Bingo $0 | Fortune $0 | Tax $0
Seat 1: 2075befd (button) folded before Flop (didn't bet)
Seat 2: 294b7dd8 (small blind) collected ($0.1)
Seat 3: 11ff021b (big blind) folded before Flop
Seat 4: 35a4e515 folded before Flop (didn't bet)
Seat 5: Hero folded before Flop (didn't bet)
Seat 6: 27517d94 folded before Flop (didn't bet)


Poker Hand #RC2078420975: Hold'em No Limit ($0.02/$0.05) - 2023/12/22 21:02:57
Table 'RushAndCash776358' 6-max Seat #1 is the button
Seat 1: b18917a1 ($5.79 in chips)
Seat 2: 921e997e ($8.28 in chips)
Seat 3: 999944fc ($2.86 in chips)
Seat 4: 5b2bf61b ($5.38 in chips)
Seat 5: 21f1ca58 ($5.35 in chips)
Seat 6: Hero ($7.1 in chips)
921e997e: posts small blind $0.02
999944fc: posts big blind $0.05
*** HOLE CARDS ***
Dealt to b18917a1 
Dealt to 921e997e 
Dealt to 999944fc 
Dealt to 5b2bf61b 
Dealt to 21f1ca58 
Dealt to Hero [2d Ad]
5b2bf61b: folds
21f1ca58: folds
Hero: raises $0.05 to $0.1
b18917a1: calls $0.1
921e997e: folds
999944fc: calls $0.05
*** FLOP *** [3s 2c Jd]
999944fc: checks
Hero: checks
b18917a1: checks
*** TURN *** [3s 2c Jd] [7c]
999944fc: checks
Hero: checks
b18917a1: bets $0.12
999944fc: calls $0.12
Hero: folds
*** RIVER *** [3s 2c Jd 7c] [Ah]
999944fc: checks
b18917a1: checks
999944fc: shows [5c As] (Pair of Aces)
b18917a1: shows [7s 5s] (Pair of Sevens)
*** SHOWDOWN ***
999944fc collected $0.54 from pot
*** SUMMARY ***
Total pot $0.56 | Rake $0.02 | Jackpot $0 | Bingo $0 | Fortune $0 | Tax $0
Board [3s 2c Jd 7c Ah]
Seat 1: b18917a1 (button) showed [7s 5s] and lost with Pair of Sevens
Seat 2: 921e997e (small blind) folded before Flop
Seat 3: 999944fc (big blind) showed [5c As] and won ($0.54) with Pair of Aces
Seat 4: 5b2bf61b folded before Flop (didn't bet)
Seat 5: 21f1ca58 folded before Flop (didn't bet)
Seat 6: Hero folded on the Turn


Poker Hand #RC2078420821: Hold'em No Limit ($0.02/$0.05) - 2023/12/22 21:02:48
Table 'RushAndCash776290' 6-max Seat #1 is the button
Seat 1: Hero ($7.1 in chips)
Seat 2: c4c1c89a ($5.2 in chips)
Seat 3: 872860d ($4.41 in chips)
Seat 4: 329a3fca ($3.1 in chips)
Seat 5: ca4d7d81 ($7.38 in chips)
Seat 6: fbeaaad2 ($9.98 in chips)
c4c1c89a: posts small blind $0.02
872860d: posts big blind $0.05
*** HOLE CARDS ***
Dealt to Hero [Qs 4d]
Dealt to c4c1c89a 
Dealt to 872860d 
Dealt to 329a3fca 
Dealt to ca4d7d81 
Dealt to fbeaaad2 
329a3fca: folds
ca4d7d81: raises $0.08 to $0.13
fbeaaad2: folds
Hero: folds
c4c1c89a: folds
872860d: folds
Uncalled bet ($0.08) returned to ca4d7d81
*** SHOWDOWN ***
ca4d7d81 collected $0.12 from pot
*** SUMMARY ***
Total pot $0.12 | Rake $0 | Jackpot $0 | Bingo $0 | Fortune $0 | Tax $0
Seat 1: Hero (button) folded before Flop (didn't bet)
Seat 2: c4c1c89a (small blind) folded before Flop
Seat 3: 872860d (big blind) folded before Flop
Seat 4: 329a3fca folded before Flop (didn't bet)
Seat 5: ca4d7d81 collected ($0.12)
Seat 6: fbeaaad2 folded before Flop (didn't bet)


Poker Hand #RC2078420738: Hold'em No Limit ($0.02/$0.05) - 2023/12/22 21:02:44
Table 'RushAndCash776256' 6-max Seat #1 is the button
Seat 1: 47bb9fc4 ($2.66 in chips)
Seat 2: Hero ($7.12 in chips)
Seat 3: 404f9683 ($6.06 in chips)
Seat 4: c54f63b8 ($5.06 in chips)
Seat 5: ee1f67f7 ($10.76 in chips)
Seat 6: a001b8d1 ($5.88 in chips)
Hero: posts small blind $0.02
404f9683: posts big blind $0.05
*** HOLE CARDS ***
Dealt to 47bb9fc4 
Dealt to Hero [5d Ks]
Dealt to 404f9683 
Dealt to c54f63b8 
Dealt to ee1f67f7 
Dealt to a001b8d1 
c54f63b8: raises $0.05 to $0.1
ee1f67f7: folds
a001b8d1: folds
47bb9fc4: folds
Hero: folds
404f9683: folds
Uncalled bet ($0.05) returned to c54f63b8
*** SHOWDOWN ***
c54f63b8 collected $0.12 from pot
*** SUMMARY ***
Total pot $0.12 | Rake $0 | Jackpot $0 | Bingo $0 | Fortune $0 | Tax $0
Seat 1: 47bb9fc4 (button) folded before Flop (didn't bet)
Seat 2: Hero (small blind) folded before Flop
Seat 3: 404f9683 (big blind) folded before Flop
Seat 4: c54f63b8 collected ($0.12)
Seat 5: ee1f67f7 folded before Flop (didn't bet)
Seat 6: a001b8d1 folded before Flop (didn't bet)


Poker Hand #RC2078420101: Hold'em No Limit ($0.02/$0.05) - 2023/12/22 21:02:07
Table 'RushAndCash775964' 6-max Seat #1 is the button
Seat 1: c54f63b8 ($5.19 in chips)
Seat 2: 404f9683 ($6.19 in chips)
Seat 3: Hero ($6.88 in chips)
Seat 4: 3dbf95c1 ($10.39 in chips)
Seat 5: 7c950e30 ($10.9 in chips)
Seat 6: 4dc000f1 ($4.8 in chips)
404f9683: posts small blind $0.02
Hero: posts big blind $0.05
*** HOLE CARDS ***
Dealt to c54f63b8 
Dealt to 404f9683 
Dealt to Hero [Qd Qc]
Dealt to 3dbf95c1 
Dealt to 7c950e30 
Dealt to 4dc000f1 
3dbf95c1: folds
7c950e30: folds
4dc000f1: folds
c54f63b8: raises $0.08 to $0.13
404f9683: calls $0.11
Hero: raises $0.39 to $0.52
c54f63b8: folds
404f9683: folds
Uncalled bet ($0.39) returned to Hero
*** SHOWDOWN ***
Hero collected $0.37 from pot
*** SUMMARY ***
Total pot $0.39 | Rake $0.02 | Jackpot $0 | Bingo $0 | Fortune $0 | Tax $0
Seat 1: c54f63b8 (button) folded before Flop
Seat 2: 404f9683 (small blind) folded before Flop
Seat 3: Hero (big blind) collected ($0.37)
Seat 4: 3dbf95c1 folded before Flop (didn't bet)
Seat 5: 7c950e30 folded before Flop (didn't bet)
Seat 6: 4dc000f1 folded before Flop (didn't bet)


Poker Hand #RC2078419835: Hold'em No Limit ($0.02/$0.05) - 2023/12/22 21:01:52
Table 'RushAndCash775832' 6-max Seat #1 is the button
Seat 1: a1dfe2ad ($4.93 in chips)
Seat 2: 8f87a7f3 ($5.45 in chips)
Seat 3: 1e3d103d ($5 in chips)
Seat 4: 9c1e8bf3 ($5 in chips)
Seat 5: Hero ($6.81 in chips)
Seat 6: 8f1c60bf ($7.34 in chips)
8f87a7f3: posts small blind $0.02
1e3d103d: posts big blind $0.05
*** HOLE CARDS ***
Dealt to a1dfe2ad 
Dealt to 8f87a7f3 
Dealt to 1e3d103d 
Dealt to 9c1e8bf3 
Dealt to Hero [Tc Ts]
Dealt to 8f1c60bf 
9c1e8bf3: folds
Hero: raises $0.05 to $0.1
8f1c60bf: folds
a1dfe2ad: folds
8f87a7f3: folds
1e3d103d: folds
Uncalled bet ($0.05) returned to Hero
*** SHOWDOWN ***
Hero collected $0.12 from pot
*** SUMMARY ***
Total pot $0.12 | Rake $0 | Jackpot $0 | Bingo $0 | Fortune $0 | Tax $0
Seat 1: a1dfe2ad (button) folded before Flop (didn't bet)
Seat 2: 8f87a7f3 (small blind) folded before Flop
Seat 3: 1e3d103d (big blind) folded before Flop
Seat 4: 9c1e8bf3 folded before Flop (didn't bet)
Seat 5: Hero collected ($0.12)
Seat 6: 8f1c60bf folded before Flop (didn't bet)


Poker Hand #RC2078419769: Hold'em No Limit ($0.02/$0.05) - 2023/12/22 21:01:48
Table 'RushAndCash775801' 6-max Seat #1 is the button
Seat 1: 11612373 ($10.75 in chips)
Seat 2: 4aadc4e8 ($3.63 in chips)
Seat 3: a1dfe2ad ($4.98 in chips)
Seat 4: Hero ($6.81 in chips)
Seat 5: 44231a0a ($18.54 in chips)
Seat 6: d3564cc0 ($5.46 in chips)
4aadc4e8: posts small blind $0.02
a1dfe2ad: posts big blind $0.05
*** HOLE CARDS ***
Dealt to 11612373 
Dealt to 4aadc4e8 
Dealt to a1dfe2ad 
Dealt to Hero [5s 6c]
Dealt to 44231a0a 
Dealt to d3564cc0 
Hero: folds
44231a0a: folds
d3564cc0: raises $0.05 to $0.1
11612373: folds
4aadc4e8: raises $0.35 to $0.45
a1dfe2ad: folds
d3564cc0: folds
Uncalled bet ($0.35) returned to 4aadc4e8
*** SHOWDOWN ***
4aadc4e8 collected $0.24 from pot
*** SUMMARY ***
Total pot $0.25 | Rake $0.01 | Jackpot $0 | Bingo $0 | Fortune $0 | Tax $0
Seat 1: 11612373 (button) folded before Flop (didn't bet)
Seat 2: 4aadc4e8 (small blind) collected ($0.24)
Seat 3: a1dfe2ad (big blind) folded before Flop
Seat 4: Hero folded before Flop (didn't bet)
Seat 5: 44231a0a folded before Flop (didn't bet)
Seat 6: d3564cc0 folded before Flop


Poker Hand #RC2078419679: Hold'em No Limit ($0.02/$0.05) - 2023/12/22 21:01:43
Table 'RushAndCash775757' 6-max Seat #1 is the button
Seat 1: Hero ($6.81 in chips)
Seat 2: fcc5325d ($4.52 in chips)
Seat 3: 6f9a9767 ($6.05 in chips)
Seat 4: e67ce721 ($4.98 in chips)
Seat 5: 21196b97 ($5.18 in chips)
Seat 6: 2588276e ($5.12 in chips)
fcc5325d: posts small blind $0.02
6f9a9767: posts big blind $0.05
*** HOLE CARDS ***
Dealt to Hero [Ah 3s]
Dealt to fcc5325d 
Dealt to 6f9a9767 
Dealt to e67ce721 
Dealt to 21196b97 
Dealt to 2588276e 
e67ce721: folds
21196b97: folds
2588276e: folds
Hero: folds
fcc5325d: folds
Uncalled bet ($0.03) returned to 6f9a9767
*** SHOWDOWN ***
6f9a9767 collected $0.04 from pot
*** SUMMARY ***
Total pot $0.04 | Rake $0 | Jackpot $0 | Bingo $0 | Fortune $0 | Tax $0
Seat 1: Hero (button) folded before Flop (didn't bet)
Seat 2: fcc5325d (small blind) folded before Flop
Seat 3: 6f9a9767 (big blind) collected ($0.04)
Seat 4: e67ce721 folded before Flop (didn't bet)
Seat 5: 21196b97 folded before Flop (didn't bet)
Seat 6: 2588276e folded before Flop (didn't bet)


Poker Hand #RC2078419480: Hold'em No Limit ($0.02/$0.05) - 2023/12/22 21:01:31
Table 'RushAndCash775664' 6-max Seat #1 is the button
Seat 1: 59da0131 ($8.82 in chips)
Seat 2: 6b8a648f ($5 in chips)
Seat 3: Hero ($6.86 in chips)
Seat 4: 3f112fc ($8.7 in chips)
Seat 5: 9fd86997 ($18.39 in chips)
Seat 6: 72f7386e ($9.31 in chips)
6b8a648f: posts small blind $0.02
Hero: posts big blind $0.05
*** HOLE CARDS ***
Dealt to 59da0131 
Dealt to 6b8a648f 
Dealt to Hero [5c 7d]
Dealt to 3f112fc 
Dealt to 9fd86997 
Dealt to 72f7386e 
3f112fc: folds
9fd86997: calls $0.05
72f7386e: calls $0.05
59da0131: folds
6b8a648f: folds
Hero: checks
*** FLOP *** [Ac 5h 4s]
Hero: checks
9fd86997: checks
72f7386e: checks
*** TURN *** [Ac 5h 4s] [Jc]
Hero: checks
9fd86997: checks
72f7386e: checks
*** RIVER *** [Ac 5h 4s Jc] [Kd]
Hero: checks
9fd86997: checks
72f7386e: checks
Hero: shows [5c 7d] (Pair of Fives)
9fd86997: shows [2c Js] (Pair of Jacks)
72f7386e: shows [Ah Qc] (Pair of Aces)
*** SHOWDOWN ***
72f7386e collected $0.17 from pot
*** SUMMARY ***
Total pot $0.17 | Rake $0 | Jackpot $0 | Bingo $0 | Fortune $0 | Tax $0
Board [Ac 5h 4s Jc Kd]
Seat 1: 59da0131 (button) folded before Flop (didn't bet)
Seat 2: 6b8a648f (small blind) folded before Flop
Seat 3: Hero (big blind) showed [5c 7d] and lost with Pair of Fives
Seat 4: 3f112fc folded before Flop (didn't bet)
Seat 5: 9fd86997 showed [2c Js] and lost with Pair of Jacks
Seat 6: 72f7386e showed [Ah Qc] and won ($0.17) with Pair of Aces


Poker Hand #RC2078419418: Hold'em No Limit ($0.02/$0.05) - 2023/12/22 21:01:27
Table 'RushAndCash775633' 6-max Seat #1 is the button
Seat 1: c320c189 ($5 in chips)
Seat 2: 7020d421 ($16.55 in chips)
Seat 3: 3c41b7f8 ($5 in chips)
Seat 4: Hero ($6.86 in chips)
Seat 5: 3928912e ($5 in chips)
Seat 6: 12953fac ($6.19 in chips)
7020d421: posts small blind $0.02
3c41b7f8: posts big blind $0.05
*** HOLE CARDS ***
Dealt to c320c189 
Dealt to 7020d421 
Dealt to 3c41b7f8 
Dealt to Hero [6s 2s]
Dealt to 3928912e 
Dealt to 12953fac 
Hero: folds
3928912e: folds
12953fac: folds
c320c189: raises $0.08 to $0.13
7020d421: folds
3c41b7f8: folds
Uncalled bet ($0.08) returned to c320c189
*** SHOWDOWN ***
c320c189 collected $0.12 from pot
*** SUMMARY ***
Total pot $0.12 | Rake $0 | Jackpot $0 | Bingo $0 | Fortune $0 | Tax $0
Seat 1: c320c189 (button) collected ($0.12)
Seat 2: 7020d421 (small blind) folded before Flop
Seat 3: 3c41b7f8 (big blind) folded before Flop
Seat 4: Hero folded before Flop (didn't bet)
Seat 5: 3928912e folded before Flop (didn't bet)
Seat 6: 12953fac folded before Flop (didn't bet)


Poker Hand #RC2078419349: Hold'em No Limit ($0.02/$0.05) - 2023/12/22 21:01:23
Table 'RushAndCash775602' 6-max Seat #1 is the button
Seat 1: fcc5325d ($4.57 in chips)
Seat 2: 9fd86997 ($18.41 in chips)
Seat 3: b2b4173f ($3.17 in chips)
Seat 4: cf6f5635 ($5.55 in chips)
Seat 5: Hero ($6.86 in chips)
Seat 6: 294b7dd8 ($11.05 in chips)
9fd86997: posts small blind $0.02
b2b4173f: posts big blind $0.05
*** HOLE CARDS ***
Dealt to fcc5325d 
Dealt to 9fd86997 
Dealt to b2b4173f 
Dealt to cf6f5635 
Dealt to Hero [5s 2d]
Dealt to 294b7dd8 
cf6f5635: raises $0.08 to $0.13
Hero: folds
294b7dd8: folds
fcc5325d: folds
9fd86997: folds
b2b4173f: folds
Uncalled bet ($0.08) returned to cf6f5635
*** SHOWDOWN ***
cf6f5635 collected $0.12 from pot
*** SUMMARY ***
Total pot $0.12 | Rake $0 | Jackpot $0 | Bingo $0 | Fortune $0 | Tax $0
Seat 1: fcc5325d (button) folded before Flop (didn't bet)
Seat 2: 9fd86997 (small blind) folded before Flop
Seat 3: b2b4173f (big blind) folded before Flop
Seat 4: cf6f5635 collected ($0.12)
Seat 5: Hero folded before Flop (didn't bet)
Seat 6: 294b7dd8 folded before Flop (didn't bet)


Poker Hand #RC2078419253: Hold'em No Limit ($0.02/$0.05) - 2023/12/22 21:01:18
Table 'RushAndCash775558' 6-max Seat #1 is the button
Seat 1: d52ccee4 ($9.2 in chips)
Seat 2: Hero ($6.88 in chips)
Seat 3: ebeb62f7 ($5.64 in chips)
Seat 4: 3a44e48f ($5.02 in chips)
Seat 5: a0ef5108 ($3.06 in chips)
Seat 6: 519b3ed7 ($3.83 in chips)
Hero: posts small blind $0.02
ebeb62f7: posts big blind $0.05
*** HOLE CARDS ***
Dealt to d52ccee4 
Dealt to Hero [7s 2h]
Dealt to ebeb62f7 
Dealt to 3a44e48f 
Dealt to a0ef5108 
Dealt to 519b3ed7 
3a44e48f: raises $0.06 to $0.11
a0ef5108: folds
519b3ed7: folds
d52ccee4: folds
Hero: folds
ebeb62f7: folds
Uncalled bet ($0.06) returned to 3a44e48f
*** SHOWDOWN ***
3a44e48f collected $0.12 from pot
*** SUMMARY ***
Total pot $0.12 | Rake $0 | Jackpot $0 | Bingo $0 | Fortune $0 | Tax $0
Seat 1: d52ccee4 (button) folded before Flop (didn't bet)
Seat 2: Hero (small blind) folded before Flop
Seat 3: ebeb62f7 (big blind) folded before Flop
Seat 4: 3a44e48f collected ($0.12)
Seat 5: a0ef5108 folded before Flop (didn't bet)
Seat 6: 519b3ed7 folded before Flop (didn't bet)


Poker Hand #RC2078418435: Hold'em No Limit ($0.02/$0.05) - 2023/12/22 21:00:30
Table 'RushAndCash775194' 6-max Seat #1 is the button
Seat 1: 21f1ca58 ($4.93 in chips)
Seat 2: 983d74a ($6.39 in chips)
Seat 3: a0ef5108 ($3.49 in chips)
Seat 4: b00070f4 ($6.43 in chips)
Seat 5: Hero ($6.47 in chips)
Seat 6: 2ec85018 ($4.9 in chips)
983d74a: posts small blind $0.02
a0ef5108: posts big blind $0.05
*** HOLE CARDS ***
Dealt to 21f1ca58 
Dealt to 983d74a 
Dealt to a0ef5108 
Dealt to b00070f4 
Dealt to Hero [Kd Qd]
Dealt to 2ec85018 
b00070f4: folds
Hero: raises $0.05 to $0.1
2ec85018: folds
21f1ca58: folds
983d74a: folds
a0ef5108: calls $0.05
*** FLOP *** [Th Jc 5h]
a0ef5108: checks
Hero: bets $0.11
a0ef5108: calls $0.11
*** TURN *** [Th Jc 5h] [2d]
a0ef5108: checks
Hero: bets $0.22
a0ef5108: calls $0.22
*** RIVER *** [Th Jc 5h 2d] [8s]
a0ef5108: checks
Hero: bets $0.35
a0ef5108: folds
Uncalled bet ($0.35) returned to Hero
*** SHOWDOWN ***
Hero collected $0.84 from pot
*** SUMMARY ***
Total pot $0.88 | Rake $0.04 | Jackpot $0 | Bingo $0 | Fortune $0 | Tax $0
Board [Th Jc 5h 2d 8s]
Seat 1: 21f1ca58 (button) folded before Flop (didn't bet)
Seat 2: 983d74a (small blind) folded before Flop
Seat 3: a0ef5108 (big blind) folded on the River
Seat 4: b00070f4 folded before Flop (didn't bet)
Seat 5: Hero won ($0.84)
Seat 6: 2ec85018 folded before Flop (didn't bet)


Poker Hand #RC2078417743: Hold'em No Limit ($0.02/$0.05) - 2023/12/22 20:59:51
Table 'RushAndCash774897' 6-max Seat #1 is the button
Seat 1: 4aadc4e8 ($3.53 in chips)
Seat 2: a2ebb3c7 ($5 in chips)
Seat 3: fe4cd853 ($15.27 in chips)
Seat 4: c3b03cc8 ($8.88 in chips)
Seat 5: c81ea267 ($5.34 in chips)
Seat 6: Hero ($6.84 in chips)
a2ebb3c7: posts small blind $0.02
fe4cd853: posts big blind $0.05
*** HOLE CARDS ***
Dealt to 4aadc4e8 
Dealt to a2ebb3c7 
Dealt to fe4cd853 
Dealt to c3b03cc8 
Dealt to c81ea267 
Dealt to Hero [Qs Qc]
c3b03cc8: folds
c81ea267: raises $0.05 to $0.1
Hero: raises $0.27 to $0.37
4aadc4e8: folds
a2ebb3c7: folds
fe4cd853: calls $0.32
c81ea267: calls $0.27
*** FLOP *** [Ks Jh Jd]
fe4cd853: checks
c81ea267: checks
Hero: checks
*** TURN *** [Ks Jh Jd] [4c]
fe4cd853: checks
c81ea267: checks
Hero: checks
*** RIVER *** [Ks Jh Jd 4c] [9d]
fe4cd853: bets $2.06
c81ea267: folds
Hero: folds
Uncalled bet ($2.06) returned to fe4cd853
*** SHOWDOWN ***
fe4cd853 collected $1.08 from pot
*** SUMMARY ***
Total pot $1.13 | Rake $0.05 | Jackpot $0 | Bingo $0 | Fortune $0 | Tax $0
Board [Ks Jh Jd 4c 9d]
Seat 1: 4aadc4e8 (button) folded before Flop (didn't bet)
Seat 2: a2ebb3c7 (small blind) folded before Flop
Seat 3: fe4cd853 (big blind) won ($1.08)
Seat 4: c3b03cc8 folded before Flop (didn't bet)
Seat 5: c81ea267 folded on the River
Seat 6: Hero folded on the River


Poker Hand #RC2078417557: Hold'em No Limit ($0.02/$0.05) - 2023/12/22 20:59:39
Table 'RushAndCash774813' 6-max Seat #1 is the button
Seat 1: 8818ba78 ($7.49 in chips)
Seat 2: Hero ($6.86 in chips)
Seat 3: ff6f425f ($12.13 in chips)
Seat 4: d6d8d23b ($7.91 in chips)
Seat 5: 38e42730 ($5 in chips)
Seat 6: 809e45f6 ($4.84 in chips)
Hero: posts small blind $0.02
ff6f425f: posts big blind $0.05
*** HOLE CARDS ***
Dealt to 8818ba78 
Dealt to Hero [As 8h]
Dealt to ff6f425f 
Dealt to d6d8d23b 
Dealt to 38e42730 
Dealt to 809e45f6 
d6d8d23b: folds
38e42730: raises $0.1 to $0.15
809e45f6: folds
8818ba78: folds
Hero: folds
ff6f425f: folds
Uncalled bet ($0.1) returned to 38e42730
*** SHOWDOWN ***
38e42730 collected $0.12 from pot
*** SUMMARY ***
Total pot $0.12 | Rake $0 | Jackpot $0 | Bingo $0 | Fortune $0 | Tax $0
Seat 1: 8818ba78 (button) folded before Flop (didn't bet)
Seat 2: Hero (small blind) folded before Flop
Seat 3: ff6f425f (big blind) folded before Flop
Seat 4: d6d8d23b folded before Flop (didn't bet)
Seat 5: 38e42730 collected ($0.12)
Seat 6: 809e45f6 folded before Flop (didn't bet)


Poker Hand #RC2078417389: Hold'em No Limit ($0.02/$0.05) - 2023/12/22 20:59:30
Table 'RushAndCash774734' 6-max Seat #1 is the button
Seat 1: 81f09a8e ($5.69 in chips)
Seat 2: a7392a18 ($16.38 in chips)
Seat 3: Hero ($6.91 in chips)
Seat 4: 3da3a58a ($5.85 in chips)
Seat 5: 8e52c782 ($6.39 in chips)
Seat 6: ddbe951e ($7.91 in chips)
a7392a18: posts small blind $0.02
Hero: posts big blind $0.05
*** HOLE CARDS ***
Dealt to 81f09a8e 
Dealt to a7392a18 
Dealt to Hero [3h 4d]
Dealt to 3da3a58a 
Dealt to 8e52c782 
Dealt to ddbe951e 
3da3a58a: folds
8e52c782: folds
ddbe951e: folds
81f09a8e: folds
a7392a18: raises $0.1 to $0.15
Hero: folds
Uncalled bet ($0.1) returned to a7392a18
*** SHOWDOWN ***
a7392a18 collected $0.1 from pot
*** SUMMARY ***
Total pot $0.1 | Rake $0 | Jackpot $0 | Bingo $0 | Fortune $0 | Tax $0
Seat 1: 81f09a8e (button) folded before Flop (didn't bet)
Seat 2: a7392a18 (small blind) collected ($0.1)
Seat 3: Hero (big blind) folded before Flop
Seat 4: 3da3a58a folded before Flop (didn't bet)
Seat 5: 8e52c782 folded before Flop (didn't bet)
Seat 6: ddbe951e folded before Flop (didn't bet)


Poker Hand #RC2078416919: Hold'em No Limit ($0.02/$0.05) - 2023/12/22 20:59:02
Table 'RushAndCash774513' 6-max Seat #1 is the button
Seat 1: Hero ($6.8 in chips)
Seat 2: 5aa55d39 ($5 in chips)
Seat 3: 3a44e48f ($5 in chips)
Seat 4: 9796250f ($5.69 in chips)
Seat 5: 23378cb ($4 in chips)
Seat 6: ff6f425f ($12.28 in chips)
5aa55d39: posts small blind $0.02
3a44e48f: posts big blind $0.05
*** HOLE CARDS ***
Dealt to Hero [Ts As]
Dealt to 5aa55d39 
Dealt to 3a44e48f 
Dealt to 9796250f 
Dealt to 23378cb 
Dealt to ff6f425f 
9796250f: folds
23378cb: folds
ff6f425f: folds
Hero: raises $0.05 to $0.1
5aa55d39: folds
3a44e48f: calls $0.05
*** FLOP *** [Qc 3d Ks]
3a44e48f: checks
Hero: bets $0.1
3a44e48f: folds
Uncalled bet ($0.1) returned to Hero
*** SHOWDOWN ***
Hero collected $0.21 from pot
*** SUMMARY ***
Total pot $0.22 | Rake $0.01 | Jackpot $0 | Bingo $0 | Fortune $0 | Tax $0
Board [Qc 3d Ks]
Seat 1: Hero (button) won ($0.21)
Seat 2: 5aa55d39 (small blind) folded before Flop
Seat 3: 3a44e48f (big blind) folded on the Flop
Seat 4: 9796250f folded before Flop (didn't bet)
Seat 5: 23378cb folded before Flop (didn't bet)
Seat 6: ff6f425f folded before Flop (didn't bet)


Poker Hand #RC2078416859: Hold'em No Limit ($0.02/$0.05) - 2023/12/22 20:58:59
Table 'RushAndCash774484' 6-max Seat #1 is the button
Seat 1: 879060f7 ($18.48 in chips)
Seat 2: 2c2cc68d ($12.49 in chips)
Seat 3: d6d8d23b ($7.89 in chips)
Seat 4: Hero ($6.8 in chips)
Seat 5: 8a8eafe4 ($9.33 in chips)
Seat 6: 5fea4bbc ($6.77 in chips)
2c2cc68d: posts small blind $0.02
d6d8d23b: posts big blind $0.05
*** HOLE CARDS ***
Dealt to 879060f7 
Dealt to 2c2cc68d 
Dealt to d6d8d23b 
Dealt to Hero [5s Js]
Dealt to 8a8eafe4 
Dealt to 5fea4bbc 
Hero: folds
8a8eafe4: folds
5fea4bbc: folds
879060f7: folds
2c2cc68d: folds
Uncalled bet ($0.03) returned to d6d8d23b
*** SHOWDOWN ***
d6d8d23b collected $0.04 from pot
*** SUMMARY ***
Total pot $0.04 | Rake $0 | Jackpot $0 | Bingo $0 | Fortune $0 | Tax $0
Seat 1: 879060f7 (button) folded before Flop (didn't bet)
Seat 2: 2c2cc68d (small blind) folded before Flop
Seat 3: d6d8d23b (big blind) collected ($0.04)
Seat 4: Hero folded before Flop (didn't bet)
Seat 5: 8a8eafe4 folded before Flop (didn't bet)
Seat 6: 5fea4bbc folded before Flop (didn't bet)


Poker Hand #RC2078416764: Hold'em No Limit ($0.02/$0.05) - 2023/12/22 20:58:53
Table 'RushAndCash774441' 6-max Seat #1 is the button
Seat 1: cdd2600a ($4.34 in chips)
Seat 2: 4eb466f4 ($12.37 in chips)
Seat 3: 3759e445 ($3.57 in chips)
Seat 4: a36b8566 ($6.28 in chips)
Seat 5: Hero ($6.8 in chips)
Seat 6: 3a35e9f5 ($15.35 in chips)
4eb466f4: posts small blind $0.02
3759e445: posts big blind $0.05
*** HOLE CARDS ***
Dealt to cdd2600a 
Dealt to 4eb466f4 
Dealt to 3759e445 
Dealt to a36b8566 
Dealt to Hero [Js Td]
Dealt to 3a35e9f5 
a36b8566: folds
Hero: folds
3a35e9f5: raises $0.06 to $0.11
cdd2600a: folds
4eb466f4: folds
3759e445: folds
Uncalled bet ($0.06) returned to 3a35e9f5
*** SHOWDOWN ***
3a35e9f5 collected $0.12 from pot
*** SUMMARY ***
Total pot $0.12 | Rake $0 | Jackpot $0 | Bingo $0 | Fortune $0 | Tax $0
Seat 1: cdd2600a (button) folded before Flop (didn't bet)
Seat 2: 4eb466f4 (small blind) folded before Flop
Seat 3: 3759e445 (big blind) folded before Flop
Seat 4: a36b8566 folded before Flop (didn't bet)
Seat 5: Hero folded before Flop (didn't bet)
Seat 6: 3a35e9f5 collected ($0.12)


Poker Hand #RC2078416662: Hold'em No Limit ($0.02/$0.05) - 2023/12/22 20:58:47
Table 'RushAndCash774391' 6-max Seat #1 is the button
Seat 1: 921e997e ($8.61 in chips)
Seat 2: 98471e80 ($6.55 in chips)
Seat 3: 5e4c4d4e ($2.65 in chips)
Seat 4: Hero ($6.8 in chips)
Seat 5: 360d3b25 ($6.01 in chips)
Seat 6: 7e84e7dc ($8.94 in chips)
98471e80: posts small blind $0.02
5e4c4d4e: posts big blind $0.05
*** HOLE CARDS ***
Dealt to 921e997e 
Dealt to 98471e80 
Dealt to 5e4c4d4e 
Dealt to Hero [7d 9s]
Dealt to 360d3b25 
Dealt to 7e84e7dc 
Hero: folds
360d3b25: folds
7e84e7dc: raises $0.08 to $0.13
921e997e: folds
98471e80: raises $0.37 to $0.5
5e4c4d4e: folds
7e84e7dc: folds
Uncalled bet ($0.37) returned to 98471e80
*** SHOWDOWN ***
98471e80 collected $0.3 from pot
*** SUMMARY ***
Total pot $0.31 | Rake $0.01 | Jackpot $0 | Bingo $0 | Fortune $0 | Tax $0
Seat 1: 921e997e (button) folded before Flop (didn't bet)
Seat 2: 98471e80 (small blind) collected ($0.3)
Seat 3: 5e4c4d4e (big blind) folded before Flop
Seat 4: Hero folded before Flop (didn't bet)
Seat 5: 360d3b25 folded before Flop (didn't bet)
Seat 6: 7e84e7dc folded before Flop


Poker Hand #RC2078416530: Hold'em No Limit ($0.02/$0.05) - 2023/12/22 20:58:40
Table 'RushAndCash774329' 6-max Seat #1 is the button
Seat 1: cb749fd0 ($3.86 in chips)
Seat 2: b8103a2d ($8.22 in chips)
Seat 3: 59c7f4b1 ($9.2 in chips)
Seat 4: Hero ($6.8 in chips)
Seat 5: ac89ef05 ($9.28 in chips)
Seat 6: 44d3a861 ($5.07 in chips)
b8103a2d: posts small blind $0.02
59c7f4b1: posts big blind $0.05
*** HOLE CARDS ***
Dealt to cb749fd0 
Dealt to b8103a2d 
Dealt to 59c7f4b1 
Dealt to Hero [Js 8h]
Dealt to ac89ef05 
Dealt to 44d3a861 
Hero: folds
ac89ef05: folds
44d3a861: raises $0.06 to $0.11
cb749fd0: raises $0.29 to $0.4
b8103a2d: folds
59c7f4b1: folds
44d3a861: calls $0.29
*** FLOP *** [Kd Ks Jd]
44d3a861: checks
cb749fd0: bets $0.29
44d3a861: folds
Uncalled bet ($0.29) returned to cb749fd0
*** SHOWDOWN ***
cb749fd0 collected $0.83 from pot
*** SUMMARY ***
Total pot $0.87 | Rake $0.04 | Jackpot $0 | Bingo $0 | Fortune $0 | Tax $0
Board [Kd Ks Jd]
Seat 1: cb749fd0 (button) won ($0.83)
Seat 2: b8103a2d (small blind) folded before Flop
Seat 3: 59c7f4b1 (big blind) folded before Flop
Seat 4: Hero folded before Flop (didn't bet)
Seat 5: ac89ef05 folded before Flop (didn't bet)
Seat 6: 44d3a861 folded on the Flop


Poker Hand #RC2078416300: Hold'em No Limit ($0.02/$0.05) - 2023/12/22 20:58:27
Table 'RushAndCash774226' 6-max Seat #1 is the button
Seat 1: ad963d07 ($2.49 in chips)
Seat 2: Hero ($6.82 in chips)
Seat 3: 2372be7b ($6.58 in chips)
Seat 4: 494d7c43 ($5.19 in chips)
Seat 5: 21073025 ($18.28 in chips)
Seat 6: 174c9c7e ($2.58 in chips)
Hero: posts small blind $0.02
2372be7b: posts big blind $0.05
*** HOLE CARDS ***
Dealt to ad963d07 
Dealt to Hero [Qc Ah]
Dealt to 2372be7b 
Dealt to 494d7c43 
Dealt to 21073025 
Dealt to 174c9c7e 
494d7c43: folds
21073025: folds
174c9c7e: raises $0.06 to $0.11
ad963d07: raises $0.22 to $0.33
Hero: folds
2372be7b: folds
174c9c7e: raises $1.29 to $1.62
ad963d07: raises $0.87 to $2.49 and is all-in
174c9c7e: calls $0.87
ad963d07: shows [Td Th]
174c9c7e: shows [Kd Kc]
*** FLOP *** [9s 8h Tc]
ad963d07: Chooses to EV Cashout 
*** TURN *** [9s 8h Tc] [5s]
*** RIVER *** [9s 8h Tc 5s] [3h]
ad963d07: Pays Cashout Risk ($0.62)
*** SHOWDOWN ***
ad963d07 collected $4.83 from pot
*** SUMMARY ***
Total pot $5.05 | Rake $0.15 | Jackpot $0.07 | Bingo $0 | Fortune $0 | Tax $0
Board [9s 8h Tc 5s 3h]
Seat 1: ad963d07 (button) showed [Td Th] and won ($4.83) with Three Tens, Cashout Risk ($0.62)
Seat 2: Hero (small blind) folded before Flop
Seat 3: 2372be7b (big blind) folded before Flop
Seat 4: 494d7c43 folded before Flop (didn't bet)
Seat 5: 21073025 folded before Flop (didn't bet)
Seat 6: 174c9c7e showed [Kd Kc] and lost with Pair of Kings


Poker Hand #RC2078416115: Hold'em No Limit ($0.02/$0.05) - 2023/12/22 20:58:16
Table 'RushAndCash774147' 6-max Seat #1 is the button
Seat 1: d9ac0d0f ($5.35 in chips)
Seat 2: 794cade2 ($2.59 in chips)
Seat 3: Hero ($6.87 in chips)
Seat 4: 85f8105e ($20.07 in chips)
Seat 5: c5f82acb ($2.41 in chips)
Seat 6: 373d8880 ($5.24 in chips)
794cade2: posts small blind $0.02
Hero: posts big blind $0.05
*** HOLE CARDS ***
Dealt to d9ac0d0f 
Dealt to 794cade2 
Dealt to Hero [5c 4s]
Dealt to 85f8105e 
Dealt to c5f82acb 
Dealt to 373d8880 
85f8105e: folds
c5f82acb: raises $0.08 to $0.13
373d8880: folds
d9ac0d0f: folds
794cade2: raises $0.16 to $0.29
Hero: folds
c5f82acb: calls $0.16
*** FLOP *** [Tc 4h 2s]
794cade2: bets $0.32
c5f82acb: calls $0.32
*** TURN *** [Tc 4h 2s] [9h]
794cade2: bets $0.96
c5f82acb: calls $0.96
*** RIVER *** [Tc 4h 2s 9h] [Jd]
794cade2: bets $1.02 and is all-in
c5f82acb: calls $0.84 and is all-in
Uncalled bet ($0.18) returned to 794cade2
794cade2: shows [Kh Kd] (Pair of Kings)
c5f82acb: shows [Ks Ac] (Ace-High)
*** SHOWDOWN ***
794cade2 collected $4.65 from pot
*** SUMMARY ***
Total pot $4.87 | Rake $0.15 | Jackpot $0.07 | Bingo $0 | Fortune $0 | Tax $0
Board [Tc 4h 2s 9h Jd]
Seat 1: d9ac0d0f (button) folded before Flop (didn't bet)
Seat 2: 794cade2 (small blind) showed [Kh Kd] and won ($4.65) with Pair of Kings
Seat 3: Hero (big blind) folded before Flop
Seat 4: 85f8105e folded before Flop (didn't bet)
Seat 5: c5f82acb showed [Ks Ac] and lost with Ace-High
Seat 6: 373d8880 folded before Flop (didn't bet)


Poker Hand #RC2078416050: Hold'em No Limit ($0.02/$0.05) - 2023/12/22 20:58:13
Table 'RushAndCash774116' 6-max Seat #1 is the button
Seat 1: Hero ($6.87 in chips)
Seat 2: e44205f6 ($8.68 in chips)
Seat 3: ee1f67f7 ($9.36 in chips)
Seat 4: 17206484 ($9.47 in chips)
Seat 5: 81f9a1e6 ($14.33 in chips)
Seat 6: 98471e80 ($6.41 in chips)
e44205f6: posts small blind $0.02
ee1f67f7: posts big blind $0.05
*** HOLE CARDS ***
Dealt to Hero [Jh 6h]
Dealt to e44205f6 
Dealt to ee1f67f7 
Dealt to 17206484 
Dealt to 81f9a1e6 
Dealt to 98471e80 
17206484: folds
81f9a1e6: folds
98471e80: folds
Hero: folds
e44205f6: folds
Uncalled bet ($0.03) returned to ee1f67f7
*** SHOWDOWN ***
ee1f67f7 collected $0.04 from pot
*** SUMMARY ***
Total pot $0.04 | Rake $0 | Jackpot $0 | Bingo $0 | Fortune $0 | Tax $0
Seat 1: Hero (button) folded before Flop (didn't bet)
Seat 2: e44205f6 (small blind) folded before Flop
Seat 3: ee1f67f7 (big blind) collected ($0.04)
Seat 4: 17206484 folded before Flop (didn't bet)
Seat 5: 81f9a1e6 folded before Flop (didn't bet)
Seat 6: 98471e80 folded before Flop (didn't bet)


Poker Hand #RC2078415987: Hold'em No Limit ($0.02/$0.05) - 2023/12/22 20:58:09
Table 'RushAndCash774088' 6-max Seat #1 is the button
Seat 1: 1adb19a8 ($4.19 in chips)
Seat 2: aa6d4c49 ($17.73 in chips)
Seat 3: 8a8eafe4 ($9.85 in chips)
Seat 4: f804ce50 ($15.32 in chips)
Seat 5: Hero ($6.87 in chips)
Seat 6: d3b1f4ed ($5.35 in chips)
aa6d4c49: posts small blind $0.02
8a8eafe4: posts big blind $0.05
*** HOLE CARDS ***
Dealt to 1adb19a8 
Dealt to aa6d4c49 
Dealt to 8a8eafe4 
Dealt to f804ce50 
Dealt to Hero [2c 8d]
Dealt to d3b1f4ed 
f804ce50: folds
Hero: folds
d3b1f4ed: folds
1adb19a8: folds
aa6d4c49: folds
Uncalled bet ($0.03) returned to 8a8eafe4
*** SHOWDOWN ***
8a8eafe4 collected $0.04 from pot
*** SUMMARY ***
Total pot $0.04 | Rake $0 | Jackpot $0 | Bingo $0 | Fortune $0 | Tax $0
Seat 1: 1adb19a8 (button) folded before Flop (didn't bet)
Seat 2: aa6d4c49 (small blind) folded before Flop
Seat 3: 8a8eafe4 (big blind) collected ($0.04)
Seat 4: f804ce50 folded before Flop (didn't bet)
Seat 5: Hero folded before Flop (didn't bet)
Seat 6: d3b1f4ed folded before Flop (didn't bet)


Poker Hand #RC2078415930: Hold'em No Limit ($0.02/$0.05) - 2023/12/22 20:58:06
Table 'RushAndCash774061' 6-max Seat #1 is the button
Seat 1: 680eb0e1 ($9.59 in chips)
Seat 2: Hero ($6.89 in chips)
Seat 3: 5b2bf61b ($5 in chips)
Seat 4: d6d8d23b ($7.35 in chips)
Seat 5: 5703e2fa ($13.85 in chips)
Seat 6: af92dfc8 ($4.47 in chips)
Hero: posts small blind $0.02
5b2bf61b: posts big blind $0.05
*** HOLE CARDS ***
Dealt to 680eb0e1 
Dealt to Hero [2c 3h]
Dealt to 5b2bf61b 
Dealt to d6d8d23b 
Dealt to 5703e2fa 
Dealt to af92dfc8 
d6d8d23b: folds
5703e2fa: folds
af92dfc8: folds
680eb0e1: raises $0.08 to $0.13
Hero: folds
5b2bf61b: folds
Uncalled bet ($0.08) returned to 680eb0e1
*** SHOWDOWN ***
680eb0e1 collected $0.12 from pot
*** SUMMARY ***
Total pot $0.12 | Rake $0 | Jackpot $0 | Bingo $0 | Fortune $0 | Tax $0
Seat 1: 680eb0e1 (button) collected ($0.12)
Seat 2: Hero (small blind) folded before Flop
Seat 3: 5b2bf61b (big blind) folded before Flop
Seat 4: d6d8d23b folded before Flop (didn't bet)
Seat 5: 5703e2fa folded before Flop (didn't bet)
Seat 6: af92dfc8 folded before Flop (didn't bet)


Poker Hand #RC2078415844: Hold'em No Limit ($0.02/$0.05) - 2023/12/22 20:58:01
Table 'RushAndCash774018' 6-max Seat #1 is the button
Seat 1: Hero ($6.89 in chips)
Seat 2: 8e45cdc4 ($4.95 in chips)
Seat 3: 50d599ea ($5.17 in chips)
Seat 4: 292f111d ($6.05 in chips)
Seat 5: 8e8d144e ($5.07 in chips)
Seat 6: ae12e969 ($5 in chips)
8e45cdc4: posts small blind $0.02
50d599ea: posts big blind $0.05
*** HOLE CARDS ***
Dealt to Hero [8c 4h]
Dealt to 8e45cdc4 
Dealt to 50d599ea 
Dealt to 292f111d 
Dealt to 8e8d144e 
Dealt to ae12e969 
292f111d: folds
8e8d144e: folds
ae12e969: folds
Hero: folds
8e45cdc4: raises $0.1 to $0.15
50d599ea: raises $0.38 to $0.53
8e45cdc4: calls $0.38
*** FLOP *** [8d Js 5c]
8e45cdc4: checks
50d599ea: bets $0.35
8e45cdc4: calls $0.35
*** TURN *** [8d Js 5c] [7d]
8e45cdc4: checks
50d599ea: checks
*** RIVER *** [8d Js 5c 7d] [Jd]
8e45cdc4: bets $0.88
50d599ea: calls $0.88
8e45cdc4: shows [9s Qs] (Pair of Jacks)
50d599ea: shows [Kc Ks] (Pair of Kings and Pair of Jacks)
*** SHOWDOWN ***
50d599ea collected $3.3 from pot
*** SUMMARY ***
Total pot $3.52 | Rake $0.15 | Jackpot $0.07 | Bingo $0 | Fortune $0 | Tax $0
Board [8d Js 5c 7d Jd]
Seat 1: Hero (button) folded before Flop (didn't bet)
Seat 2: 8e45cdc4 (small blind) showed [9s Qs] and lost with Pair of Jacks
Seat 3: 50d599ea (big blind) showed [Kc Ks] and won ($3.3) with Pair of Kings and Pair of Jacks
Seat 4: 292f111d folded before Flop (didn't bet)
Seat 5: 8e8d144e folded before Flop (didn't bet)
Seat 6: ae12e969 folded before Flop (didn't bet)


Poker Hand #RC2078415390: Hold'em No Limit ($0.02/$0.05) - 2023/12/22 20:57:36
Table 'RushAndCash773806' 6-max Seat #1 is the button
Seat 1: 22426c35 ($5.07 in chips)
Seat 2: 50d599ea ($5 in chips)
Seat 3: Hero ($7.07 in chips)
Seat 4: 6ddc293e ($5.32 in chips)
Seat 5: 55e2d3e1 ($2.01 in chips)
Seat 6: a04ab5b3 ($5 in chips)
50d599ea: posts small blind $0.02
Hero: posts big blind $0.05
*** HOLE CARDS ***
Dealt to 22426c35 
Dealt to 50d599ea 
Dealt to Hero [3s 3c]
Dealt to 6ddc293e 
Dealt to 55e2d3e1 
Dealt to a04ab5b3 
6ddc293e: folds
55e2d3e1: folds
a04ab5b3: folds
22426c35: folds
50d599ea: raises $0.13 to $0.18
Hero: calls $0.13
*** FLOP *** [Jc Kc Ah]
50d599ea: bets $0.09
Hero: folds
Uncalled bet ($0.09) returned to 50d599ea
*** SHOWDOWN ***
50d599ea collected $0.35 from pot
*** SUMMARY ***
Total pot $0.36 | Rake $0.01 | Jackpot $0 | Bingo $0 | Fortune $0 | Tax $0
Board [Jc Kc Ah]
Seat 1: 22426c35 (button) folded before Flop (didn't bet)
Seat 2: 50d599ea (small blind) won ($0.35)
Seat 3: Hero (big blind) folded on the Flop
Seat 4: 6ddc293e folded before Flop (didn't bet)
Seat 5: 55e2d3e1 folded before Flop (didn't bet)
Seat 6: a04ab5b3 folded before Flop (didn't bet)


Poker Hand #RC2078415331: Hold'em No Limit ($0.02/$0.05) - 2023/12/22 20:57:33
Table 'RushAndCash773777' 6-max Seat #1 is the button
Seat 1: 960a23e5 ($3.15 in chips)
Seat 2: d29426f7 ($5 in chips)
Seat 3: 5f60cea0 ($2.47 in chips)
Seat 4: 8a8eafe4 ($9.61 in chips)
Seat 5: 22426c35 ($5.07 in chips)
Seat 6: Hero ($7.07 in chips)
d29426f7: posts small blind $0.02
5f60cea0: posts big blind $0.05
*** HOLE CARDS ***
Dealt to 960a23e5 
Dealt to d29426f7 
Dealt to 5f60cea0 
Dealt to 8a8eafe4 
Dealt to 22426c35 
Dealt to Hero [Th 8s]
8a8eafe4: folds
22426c35: folds
Hero: folds
960a23e5: folds
d29426f7: folds
Uncalled bet ($0.03) returned to 5f60cea0
*** SHOWDOWN ***
5f60cea0 collected $0.04 from pot
*** SUMMARY ***
Total pot $0.04 | Rake $0 | Jackpot $0 | Bingo $0 | Fortune $0 | Tax $0
Seat 1: 960a23e5 (button) folded before Flop (didn't bet)
Seat 2: d29426f7 (small blind) folded before Flop
Seat 3: 5f60cea0 (big blind) collected ($0.04)
Seat 4: 8a8eafe4 folded before Flop (didn't bet)
Seat 5: 22426c35 folded before Flop (didn't bet)
Seat 6: Hero folded before Flop (didn't bet)


Poker Hand #RC2078415266: Hold'em No Limit ($0.02/$0.05) - 2023/12/22 20:57:29
Table 'RushAndCash773749' 6-max Seat #1 is the button
Seat 1: 5da5ce8d ($18.82 in chips)
Seat 2: c18ede1f ($5.09 in chips)
Seat 3: 294b7dd8 ($10.28 in chips)
Seat 4: Hero ($7.07 in chips)
Seat 5: 4e20b85a ($9.17 in chips)
Seat 6: c295eed2 ($6.76 in chips)
c18ede1f: posts small blind $0.02
294b7dd8: posts big blind $0.05
*** HOLE CARDS ***
Dealt to 5da5ce8d 
Dealt to c18ede1f 
Dealt to 294b7dd8 
Dealt to Hero [Ah 7s]
Dealt to 4e20b85a 
Dealt to c295eed2 
Hero: folds
4e20b85a: folds
c295eed2: folds
5da5ce8d: folds
c18ede1f: raises $0.09 to $0.14
294b7dd8: folds
Uncalled bet ($0.09) returned to c18ede1f
*** SHOWDOWN ***
c18ede1f collected $0.1 from pot
*** SUMMARY ***
Total pot $0.1 | Rake $0 | Jackpot $0 | Bingo $0 | Fortune $0 | Tax $0
Seat 1: 5da5ce8d (button) folded before Flop (didn't bet)
Seat 2: c18ede1f (small blind) collected ($0.1)
Seat 3: 294b7dd8 (big blind) folded before Flop
Seat 4: Hero folded before Flop (didn't bet)
Seat 5: 4e20b85a folded before Flop (didn't bet)
Seat 6: c295eed2 folded before Flop (didn't bet)


Poker Hand #RC2078415201: Hold'em No Limit ($0.02/$0.05) - 2023/12/22 20:57:26
Table 'RushAndCash773719' 6-max Seat #1 is the button
Seat 1: 8eb71456 ($10.42 in chips)
Seat 2: feab607e ($5 in chips)
Seat 3: 517da49 ($6.98 in chips)
Seat 4: 292f111d ($5.73 in chips)
Seat 5: 6ffefba2 ($6.47 in chips)
Seat 6: Hero ($7.07 in chips)
feab607e: posts small blind $0.02
517da49: posts big blind $0.05
*** HOLE CARDS ***
Dealt to 8eb71456 
Dealt to feab607e 
Dealt to 517da49 
Dealt to 292f111d 
Dealt to 6ffefba2 
Dealt to Hero [Qc 6c]
292f111d: folds
6ffefba2: raises $0.08 to $0.13
Hero: folds
8eb71456: raises $0.25 to $0.38
feab607e: folds
517da49: raises $0.7 to $1.08
6ffefba2: folds
8eb71456: calls $0.7
*** FLOP *** [Kc 4c 6s]
517da49: bets $0.89
8eb71456: calls $0.89
*** TURN *** [Kc 4c 6s] [7c]
517da49: checks
8eb71456: bets $4.09
517da49: folds
Uncalled bet ($4.09) returned to 8eb71456
*** SHOWDOWN ***
8eb71456 collected $3.87 from pot
*** SUMMARY ***
Total pot $4.09 | Rake $0.15 | Jackpot $0.07 | Bingo $0 | Fortune $0 | Tax $0
Board [Kc 4c 6s 7c]
Seat 1: 8eb71456 (button) won ($3.87)
Seat 2: feab607e (small blind) folded before Flop
Seat 3: 517da49 (big blind) folded on the Turn
Seat 4: 292f111d folded before Flop (didn't bet)
Seat 5: 6ffefba2 folded before Flop
Seat 6: Hero folded before Flop (didn't bet)


Poker Hand #RC2078414821: Hold'em No Limit ($0.02/$0.05) - 2023/12/22 20:57:05
Table 'RushAndCash773552' 6-max Seat #1 is the button
Seat 1: 3a35e9f5 ($15.66 in chips)
Seat 2: 6c88f65e ($3.93 in chips)
Seat 3: 365a060c ($4.76 in chips)
Seat 4: 8eb71456 ($10.57 in chips)
Seat 5: 5d55167a ($9.89 in chips)
Seat 6: Hero ($6.86 in chips)
6c88f65e: posts small blind $0.02
365a060c: posts big blind $0.05
*** HOLE CARDS ***
Dealt to 3a35e9f5 
Dealt to 6c88f65e 
Dealt to 365a060c 
Dealt to 8eb71456 
Dealt to 5d55167a 
Dealt to Hero [Ad Js]
8eb71456: raises $0.1 to $0.15
5d55167a: folds
Hero: raises $0.37 to $0.52
3a35e9f5: folds
6c88f65e: folds
365a060c: folds
8eb71456: folds
Uncalled bet ($0.37) returned to Hero
*** SHOWDOWN ***
Hero collected $0.36 from pot
*** SUMMARY ***
Total pot $0.37 | Rake $0.01 | Jackpot $0 | Bingo $0 | Fortune $0 | Tax $0
Seat 1: 3a35e9f5 (button) folded before Flop (didn't bet)
Seat 2: 6c88f65e (small blind) folded before Flop
Seat 3: 365a060c (big blind) folded before Flop
Seat 4: 8eb71456 folded before Flop
Seat 5: 5d55167a folded before Flop (didn't bet)
Seat 6: Hero collected ($0.36)


Poker Hand #RC2078414751: Hold'em No Limit ($0.02/$0.05) - 2023/12/22 20:57:01
Table 'RushAndCash773518' 6-max Seat #1 is the button
Seat 1: Hero ($6.86 in chips)
Seat 2: 3721b8cb ($4.21 in chips)
Seat 3: d21cc812 ($6.73 in chips)
Seat 4: bc7afeb2 ($5.39 in chips)
Seat 5: 4c660603 ($5.18 in chips)
Seat 6: 3091c4e7 ($5 in chips)
3721b8cb: posts small blind $0.02
d21cc812: posts big blind $0.05
*** HOLE CARDS ***
Dealt to Hero [Ac 6d]
Dealt to 3721b8cb 
Dealt to d21cc812 
Dealt to bc7afeb2 
Dealt to 4c660603 
Dealt to 3091c4e7 
bc7afeb2: folds
4c660603: folds
3091c4e7: folds
Hero: folds
3721b8cb: folds
Uncalled bet ($0.03) returned to d21cc812
*** SHOWDOWN ***
d21cc812 collected $0.04 from pot
*** SUMMARY ***
Total pot $0.04 | Rake $0 | Jackpot $0 | Bingo $0 | Fortune $0 | Tax $0
Seat 1: Hero (button) folded before Flop (didn't bet)
Seat 2: 3721b8cb (small blind) folded before Flop
Seat 3: d21cc812 (big blind) collected ($0.04)
Seat 4: bc7afeb2 folded before Flop (didn't bet)
Seat 5: 4c660603 folded before Flop (didn't bet)
Seat 6: 3091c4e7 folded before Flop (didn't bet)


Poker Hand #RC2078404530: Hold'em No Limit ($0.02/$0.05) - 2023/12/22 20:56:48
Table 'RushAndCash773414' 6-max Seat #1 is the button
Seat 1: f92e05a8 ($15.48 in chips)
Seat 2: Hero ($6.88 in chips)
Seat 3: c295eed2 ($6.76 in chips)
Seat 4: 3a35e9f5 ($15.73 in chips)
Seat 5: c0da017f ($7.28 in chips)
Seat 6: e530eac5 ($5 in chips)
Hero: posts small blind $0.02
c295eed2: posts big blind $0.05
*** HOLE CARDS ***
Dealt to f92e05a8 
Dealt to Hero [5c Qh]
Dealt to c295eed2 
Dealt to 3a35e9f5 
Dealt to c0da017f 
Dealt to e530eac5 
3a35e9f5: folds
c0da017f: folds
e530eac5: folds
f92e05a8: raises $0.1 to $0.15
Hero: folds
c295eed2: folds
Uncalled bet ($0.1) returned to f92e05a8
*** SHOWDOWN ***
f92e05a8 collected $0.12 from pot
*** SUMMARY ***
Total pot $0.12 | Rake $0 | Jackpot $0 | Bingo $0 | Fortune $0 | Tax $0
Seat 1: f92e05a8 (button) collected ($0.12)
Seat 2: Hero (small blind) folded before Flop
Seat 3: c295eed2 (big blind) folded before Flop
Seat 4: 3a35e9f5 folded before Flop (didn't bet)
Seat 5: c0da017f folded before Flop (didn't bet)
Seat 6: e530eac5 folded before Flop (didn't bet)


Poker Hand #RC2078404465: Hold'em No Limit ($0.02/$0.05) - 2023/12/22 20:56:45
Table 'RushAndCash773383' 6-max Seat #1 is the button
Seat 1: b8534e0 ($11.88 in chips)
Seat 2: cabfa413 ($5.11 in chips)
Seat 3: Hero ($6.93 in chips)
Seat 4: ba70b427 ($5 in chips)
Seat 5: 3a35e9f5 ($15.73 in chips)
Seat 6: 2372be7b ($5.12 in chips)
cabfa413: posts small blind $0.02
Hero: posts big blind $0.05
*** HOLE CARDS ***
Dealt to b8534e0 
Dealt to cabfa413 
Dealt to Hero [2s 4s]
Dealt to ba70b427 
Dealt to 3a35e9f5 
Dealt to 2372be7b 
ba70b427: folds
3a35e9f5: folds
2372be7b: raises $0.05 to $0.1
b8534e0: folds
cabfa413: folds
Hero: folds
Uncalled bet ($0.05) returned to 2372be7b
*** SHOWDOWN ***
2372be7b collected $0.12 from pot
*** SUMMARY ***
Total pot $0.12 | Rake $0 | Jackpot $0 | Bingo $0 | Fortune $0 | Tax $0
Seat 1: b8534e0 (button) folded before Flop (didn't bet)
Seat 2: cabfa413 (small blind) folded before Flop
Seat 3: Hero (big blind) folded before Flop
Seat 4: ba70b427 folded before Flop (didn't bet)
Seat 5: 3a35e9f5 folded before Flop (didn't bet)
Seat 6: 2372be7b collected ($0.12)


Poker Hand #RC2078404408: Hold'em No Limit ($0.02/$0.05) - 2023/12/22 20:56:41
Table 'RushAndCash773358' 6-max Seat #1 is the button
Seat 1: 89ac50e8 ($14.38 in chips)
Seat 2: 53d2996c ($4.91 in chips)
Seat 3: e8df5901 ($8.92 in chips)
Seat 4: a55de19c ($35.52 in chips)
Seat 5: 3d292096 ($5 in chips)
Seat 6: Hero ($6.93 in chips)
53d2996c: posts small blind $0.02
e8df5901: posts big blind $0.05
*** HOLE CARDS ***
Dealt to 89ac50e8 
Dealt to 53d2996c 
Dealt to e8df5901 
Dealt to a55de19c 
Dealt to 3d292096 
Dealt to Hero [7h 3s]
a55de19c: folds
3d292096: raises $0.08 to $0.13
Hero: folds
89ac50e8: folds
53d2996c: folds
e8df5901: folds
Uncalled bet ($0.08) returned to 3d292096
*** SHOWDOWN ***
3d292096 collected $0.12 from pot
*** SUMMARY ***
Total pot $0.12 | Rake $0 | Jackpot $0 | Bingo $0 | Fortune $0 | Tax $0
Seat 1: 89ac50e8 (button) folded before Flop (didn't bet)
Seat 2: 53d2996c (small blind) folded before Flop
Seat 3: e8df5901 (big blind) folded before Flop
Seat 4: a55de19c folded before Flop (didn't bet)
Seat 5: 3d292096 collected ($0.12)
Seat 6: Hero folded before Flop (didn't bet)


Poker Hand #RC2078404293: Hold'em No Limit ($0.02/$0.05) - 2023/12/22 20:56:35
Table 'RushAndCash773299' 6-max Seat #1 is the button
Seat 1: ceb10c49 ($5.85 in chips)
Seat 2: a55de19c ($35.54 in chips)
Seat 3: fe2f394b ($5 in chips)
Seat 4: b8103a2d ($8.05 in chips)
Seat 5: a58677de ($2.49 in chips)
Seat 6: Hero ($6.93 in chips)
a55de19c: posts small blind $0.02
fe2f394b: posts big blind $0.05
*** HOLE CARDS ***
Dealt to ceb10c49 
Dealt to a55de19c 
Dealt to fe2f394b 
Dealt to b8103a2d 
Dealt to a58677de 
Dealt to Hero [7c Tc]
b8103a2d: folds
a58677de: folds
Hero: folds
ceb10c49: raises $0.05 to $0.1
a55de19c: folds
fe2f394b: folds
Uncalled bet ($0.05) returned to ceb10c49
*** SHOWDOWN ***
ceb10c49 collected $0.12 from pot
*** SUMMARY ***
Total pot $0.12 | Rake $0 | Jackpot $0 | Bingo $0 | Fortune $0 | Tax $0
Seat 1: ceb10c49 (button) collected ($0.12)
Seat 2: a55de19c (small blind) folded before Flop
Seat 3: fe2f394b (big blind) folded before Flop
Seat 4: b8103a2d folded before Flop (didn't bet)
Seat 5: a58677de folded before Flop (didn't bet)
Seat 6: Hero folded before Flop (didn't bet)


Poker Hand #RC2078404221: Hold'em No Limit ($0.02/$0.05) - 2023/12/22 20:56:31
Table 'RushAndCash773264' 6-max Seat #1 is the button
Seat 1: 395dbfbb ($7.44 in chips)
Seat 2: 611f7388 ($14.37 in chips)
Seat 3: cf6f5635 ($7.26 in chips)
Seat 4: 40c4a4f ($11.62 in chips)
Seat 5: Hero ($6.93 in chips)
Seat 6: 8429395c ($5.33 in chips)
611f7388: posts small blind $0.02
cf6f5635: posts big blind $0.05
*** HOLE CARDS ***
Dealt to 395dbfbb 
Dealt to 611f7388 
Dealt to cf6f5635 
Dealt to 40c4a4f 
Dealt to Hero [Ah 2c]
Dealt to 8429395c 
40c4a4f: raises $0.05 to $0.1
Hero: folds
8429395c: folds
395dbfbb: folds
611f7388: folds
cf6f5635: raises $0.33 to $0.43
40c4a4f: calls $0.33
*** FLOP *** [Kh 7d 3d]
cf6f5635: bets $0.3
40c4a4f: folds
Uncalled bet ($0.3) returned to cf6f5635
*** SHOWDOWN ***
cf6f5635 collected $0.84 from pot
*** SUMMARY ***
Total pot $0.88 | Rake $0.04 | Jackpot $0 | Bingo $0 | Fortune $0 | Tax $0
Board [Kh 7d 3d]
Seat 1: 395dbfbb (button) folded before Flop (didn't bet)
Seat 2: 611f7388 (small blind) folded before Flop
Seat 3: cf6f5635 (big blind) won ($0.84)
Seat 4: 40c4a4f folded on the Flop
Seat 5: Hero folded before Flop (didn't bet)
Seat 6: 8429395c folded before Flop (didn't bet)


Poker Hand #RC2078403781: Hold'em No Limit ($0.02/$0.05) - 2023/12/22 20:56:06
Table 'RushAndCash773065' 6-max Seat #1 is the button
Seat 1: 561e5b01 ($6.36 in chips)
Seat 2: Hero ($7.08 in chips)
Seat 3: 40c4a4f ($11.48 in chips)
Seat 4: d7f451d5 ($6.92 in chips)
Seat 5: 9b0ec3a ($9.59 in chips)
Seat 6: bbf08286 ($2.69 in chips)
Hero: posts small blind $0.02
40c4a4f: posts big blind $0.05
*** HOLE CARDS ***
Dealt to 561e5b01 
Dealt to Hero [6c 5c]
Dealt to 40c4a4f 
Dealt to d7f451d5 
Dealt to 9b0ec3a 
Dealt to bbf08286 
d7f451d5: folds
9b0ec3a: folds
bbf08286: folds
561e5b01: folds
Hero: raises $0.1 to $0.15
40c4a4f: raises $0.3 to $0.45
Hero: folds
Uncalled bet ($0.3) returned to 40c4a4f
*** SHOWDOWN ***
40c4a4f collected $0.29 from pot
*** SUMMARY ***
Total pot $0.3 | Rake $0.01 | Jackpot $0 | Bingo $0 | Fortune $0 | Tax $0
Seat 1: 561e5b01 (button) folded before Flop (didn't bet)
Seat 2: Hero (small blind) folded before Flop
Seat 3: 40c4a4f (big blind) collected ($0.29)
Seat 4: d7f451d5 folded before Flop (didn't bet)
Seat 5: 9b0ec3a folded before Flop (didn't bet)
Seat 6: bbf08286 folded before Flop (didn't bet)


Poker Hand #RC2078403723: Hold'em No Limit ($0.02/$0.05) - 2023/12/22 20:56:03
Table 'RushAndCash773041' 6-max Seat #1 is the button
Seat 1: Hero ($7.08 in chips)
Seat 2: aeda30e3 ($5 in chips)
Seat 3: b61f5bde ($8.34 in chips)
Seat 4: d6363be2 ($5 in chips)
Seat 5: b5259737 ($15.47 in chips)
Seat 6: 74bf44f1 ($5 in chips)
aeda30e3: posts small blind $0.02
b61f5bde: posts big blind $0.05
*** HOLE CARDS ***
Dealt to Hero [6h 3d]
Dealt to aeda30e3 
Dealt to b61f5bde 
Dealt to d6363be2 
Dealt to b5259737 
Dealt to 74bf44f1 
d6363be2: folds
b5259737: raises $0.05 to $0.1
74bf44f1: folds
Hero: folds
aeda30e3: folds
b61f5bde: calls $0.05
*** FLOP *** [Qd Ad Th]
b61f5bde: checks
b5259737: bets $0.08
b61f5bde: calls $0.08
*** TURN *** [Qd Ad Th] [4s]
b61f5bde: checks
b5259737: checks
*** RIVER *** [Qd Ad Th 4s] [2s]
b61f5bde: checks
b5259737: checks
b61f5bde: shows [Qs 8s] (Pair of Queens)
b5259737: shows [6d 5d] (Ace-High)
*** SHOWDOWN ***
b61f5bde collected $0.37 from pot
*** SUMMARY ***
Total pot $0.38 | Rake $0.01 | Jackpot $0 | Bingo $0 | Fortune $0 | Tax $0
Board [Qd Ad Th 4s 2s]
Seat 1: Hero (button) folded before Flop (didn't bet)
Seat 2: aeda30e3 (small blind) folded before Flop
Seat 3: b61f5bde (big blind) showed [Qs 8s] and won ($0.37) with Pair of Queens
Seat 4: d6363be2 folded before Flop (didn't bet)
Seat 5: b5259737 showed [6d 5d] and lost with Ace-High
Seat 6: 74bf44f1 folded before Flop (didn't bet)


Poker Hand #RC2078402599: Hold'em No Limit ($0.02/$0.05) - 2023/12/22 20:55:00
Table 'RushAndCash772502' 6-max Seat #1 is the button
Seat 1: b61f5bde ($8.46 in chips)
Seat 2: d22a3e70 ($8.19 in chips)
Seat 3: Hero ($6.95 in chips)
Seat 4: 59a39874 ($8.43 in chips)
Seat 5: c0da017f ($7.55 in chips)
Seat 6: 44d3a861 ($5.7 in chips)
d22a3e70: posts small blind $0.02
Hero: posts big blind $0.05
*** HOLE CARDS ***
Dealt to b61f5bde 
Dealt to d22a3e70 
Dealt to Hero [Ad 6d]
Dealt to 59a39874 
Dealt to c0da017f 
Dealt to 44d3a861 
59a39874: folds
c0da017f: folds
44d3a861: folds
b61f5bde: raises $0.07 to $0.12
d22a3e70: folds
Hero: calls $0.07
*** FLOP *** [4c 2h Qs]
Hero: checks
b61f5bde: checks
*** TURN *** [4c 2h Qs] [9h]
Hero: checks
b61f5bde: checks
*** RIVER *** [4c 2h Qs 9h] [8s]
Hero: checks
b61f5bde: checks
Hero: shows [Ad 6d] (Ace-High)
b61f5bde: shows [Kd 7d] (King-High)
*** SHOWDOWN ***
Hero collected $0.25 from pot
*** SUMMARY ***
Total pot $0.26 | Rake $0.01 | Jackpot $0 | Bingo $0 | Fortune $0 | Tax $0
Board [4c 2h Qs 9h 8s]
Seat 1: b61f5bde (button) showed [Kd 7d] and lost with King-High
Seat 2: d22a3e70 (small blind) folded before Flop
Seat 3: Hero (big blind) showed [Ad 6d] and won ($0.25) with Ace-High
Seat 4: 59a39874 folded before Flop (didn't bet)
Seat 5: c0da017f folded before Flop (didn't bet)
Seat 6: 44d3a861 folded before Flop (didn't bet)


Poker Hand #RC2078402504: Hold'em No Limit ($0.02/$0.05) - 2023/12/22 20:54:54
Table 'RushAndCash772459' 6-max Seat #1 is the button
Seat 1: 1f940f2d ($5.06 in chips)
Seat 2: 25941725 ($4.8 in chips)
Seat 3: edaa2500 ($5.73 in chips)
Seat 4: Hero ($6.95 in chips)
Seat 5: 7c10f852 ($14.01 in chips)
Seat 6: 49ea92ea ($5.96 in chips)
25941725: posts small blind $0.02
edaa2500: posts big blind $0.05
*** HOLE CARDS ***
Dealt to 1f940f2d 
Dealt to 25941725 
Dealt to edaa2500 
Dealt to Hero [Kh Tc]
Dealt to 7c10f852 
Dealt to 49ea92ea 
Hero: folds
7c10f852: folds
49ea92ea: folds
1f940f2d: folds
25941725: raises $0.05 to $0.1
edaa2500: folds
Uncalled bet ($0.05) returned to 25941725
*** SHOWDOWN ***
25941725 collected $0.1 from pot
*** SUMMARY ***
Total pot $0.1 | Rake $0 | Jackpot $0 | Bingo $0 | Fortune $0 | Tax $0
Seat 1: 1f940f2d (button) folded before Flop (didn't bet)
Seat 2: 25941725 (small blind) collected ($0.1)
Seat 3: edaa2500 (big blind) folded before Flop
Seat 4: Hero folded before Flop (didn't bet)
Seat 5: 7c10f852 folded before Flop (didn't bet)
Seat 6: 49ea92ea folded before Flop (didn't bet)


Poker Hand #RC2078402439: Hold'em No Limit ($0.02/$0.05) - 2023/12/22 20:54:50
Table 'RushAndCash772428' 6-max Seat #1 is the button
Seat 1: c6dd581a ($9.79 in chips)
Seat 2: d42ee966 ($5.7 in chips)
Seat 3: 488f1674 ($6.63 in chips)
Seat 4: cabfa413 ($5 in chips)
Seat 5: Hero ($6.95 in chips)
Seat 6: d3d9088 ($6.77 in chips)
d42ee966: posts small blind $0.02
488f1674: posts big blind $0.05
*** HOLE CARDS ***
Dealt to c6dd581a 
Dealt to d42ee966 
Dealt to 488f1674 
Dealt to cabfa413 
Dealt to Hero [2d 9c]
Dealt to d3d9088 
cabfa413: raises $0.06 to $0.11
Hero: folds
d3d9088: folds
c6dd581a: folds
d42ee966: folds
488f1674: raises $0.39 to $0.5
cabfa413: folds
Uncalled bet ($0.39) returned to 488f1674
*** SHOWDOWN ***
488f1674 collected $0.23 from pot
*** SUMMARY ***
Total pot $0.24 | Rake $0.01 | Jackpot $0 | Bingo $0 | Fortune $0 | Tax $0
Seat 1: c6dd581a (button) folded before Flop (didn't bet)
Seat 2: d42ee966 (small blind) folded before Flop
Seat 3: 488f1674 (big blind) collected ($0.23)
Seat 4: cabfa413 folded before Flop
Seat 5: Hero folded before Flop (didn't bet)
Seat 6: d3d9088 folded before Flop (didn't bet)


Poker Hand #RC2078402342: Hold'em No Limit ($0.02/$0.05) - 2023/12/22 20:54:46
Table 'RushAndCash772384' 6-max Seat #1 is the button
Seat 1: 8a1c58b7 ($6.31 in chips)
Seat 2: 6189c6df ($5 in chips)
Seat 3: 88ea63ea ($5 in chips)
Seat 4: 680eb0e1 ($8.16 in chips)
Seat 5: 23800602 ($4.51 in chips)
Seat 6: Hero ($6.95 in chips)
6189c6df: posts small blind $0.02
88ea63ea: posts big blind $0.05
*** HOLE CARDS ***
Dealt to 8a1c58b7 
Dealt to 6189c6df 
Dealt to 88ea63ea 
Dealt to 680eb0e1 
Dealt to 23800602 
Dealt to Hero [2h Jc]
680eb0e1: folds
23800602: folds
Hero: folds
8a1c58b7: raises $0.05 to $0.1
6189c6df: folds
88ea63ea: calls $0.05
*** FLOP *** [Ts Jd 6s]
88ea63ea: checks
8a1c58b7: checks
*** TURN *** [Ts Jd 6s] [Kd]
88ea63ea: checks
8a1c58b7: checks
*** RIVER *** [Ts Jd 6s Kd] [9h]
88ea63ea: bets $0.12
8a1c58b7: folds
Uncalled bet ($0.12) returned to 88ea63ea
*** SHOWDOWN ***
88ea63ea collected $0.21 from pot
*** SUMMARY ***
Total pot $0.22 | Rake $0.01 | Jackpot $0 | Bingo $0 | Fortune $0 | Tax $0
Board [Ts Jd 6s Kd 9h]
Seat 1: 8a1c58b7 (button) folded on the River
Seat 2: 6189c6df (small blind) folded before Flop
Seat 3: 88ea63ea (big blind) won ($0.21)
Seat 4: 680eb0e1 folded before Flop (didn't bet)
Seat 5: 23800602 folded before Flop (didn't bet)
Seat 6: Hero folded before Flop (didn't bet)


Poker Hand #RC2078402269: Hold'em No Limit ($0.02/$0.05) - 2023/12/22 20:54:41
Table 'RushAndCash772354' 6-max Seat #1 is the button
Seat 1: Hero ($6.95 in chips)
Seat 2: 5a5ed55f ($6.52 in chips)
Seat 3: 2e26b9c1 ($5.59 in chips)
Seat 4: 4d43d419 ($9.75 in chips)
Seat 5: fe9fbc4f ($5.42 in chips)
Seat 6: bddd3d8b ($6.1 in chips)
5a5ed55f: posts small blind $0.02
2e26b9c1: posts big blind $0.05
*** HOLE CARDS ***
Dealt to Hero [2d Th]
Dealt to 5a5ed55f 
Dealt to 2e26b9c1 
Dealt to 4d43d419 
Dealt to fe9fbc4f 
Dealt to bddd3d8b 
4d43d419: folds
fe9fbc4f: folds
bddd3d8b: folds
Hero: folds
5a5ed55f: folds
Uncalled bet ($0.03) returned to 2e26b9c1
*** SHOWDOWN ***
2e26b9c1 collected $0.04 from pot
*** SUMMARY ***
Total pot $0.04 | Rake $0 | Jackpot $0 | Bingo $0 | Fortune $0 | Tax $0
Seat 1: Hero (button) folded before Flop (didn't bet)
Seat 2: 5a5ed55f (small blind) folded before Flop
Seat 3: 2e26b9c1 (big blind) collected ($0.04)
Seat 4: 4d43d419 folded before Flop (didn't bet)
Seat 5: fe9fbc4f folded before Flop (didn't bet)
Seat 6: bddd3d8b folded before Flop (didn't bet)


Poker Hand #RC2078402183: Hold'em No Limit ($0.02/$0.05) - 2023/12/22 20:54:37
Table 'RushAndCash772317' 6-max Seat #1 is the button
Seat 1: 2f160a64 ($9.64 in chips)
Seat 2: Hero ($6.97 in chips)
Seat 3: a9abc4b1 ($7.77 in chips)
Seat 4: 7d406e41 ($2.88 in chips)
Seat 5: 18f0f05c ($11.02 in chips)
Seat 6: b5259737 ($15.56 in chips)
Hero: posts small blind $0.02
a9abc4b1: posts big blind $0.05
*** HOLE CARDS ***
Dealt to 2f160a64 
Dealt to Hero [8s Th]
Dealt to a9abc4b1 
Dealt to 7d406e41 
Dealt to 18f0f05c 
Dealt to b5259737 
7d406e41: folds
18f0f05c: folds
b5259737: folds
2f160a64: folds
Hero: folds
Uncalled bet ($0.03) returned to a9abc4b1
*** SHOWDOWN ***
a9abc4b1 collected $0.04 from pot
*** SUMMARY ***
Total pot $0.04 | Rake $0 | Jackpot $0 | Bingo $0 | Fortune $0 | Tax $0
Seat 1: 2f160a64 (button) folded before Flop (didn't bet)
Seat 2: Hero (small blind) folded before Flop
Seat 3: a9abc4b1 (big blind) collected ($0.04)
Seat 4: 7d406e41 folded before Flop (didn't bet)
Seat 5: 18f0f05c folded before Flop (didn't bet)
Seat 6: b5259737 folded before Flop (didn't bet)


Poker Hand #RC2078402009: Hold'em No Limit ($0.02/$0.05) - 2023/12/22 20:54:28
Table 'RushAndCash772239' 6-max Seat #1 is the button
Seat 1: 220b0aae ($10.29 in chips)
Seat 2: f6b5f68e ($5 in chips)
Seat 3: Hero ($7.02 in chips)
Seat 4: 89ac50e8 ($14.62 in chips)
Seat 5: 8d15f06b ($6.24 in chips)
Seat 6: c9b8a495 ($5.29 in chips)
f6b5f68e: posts small blind $0.02
Hero: posts big blind $0.05
*** HOLE CARDS ***
Dealt to 220b0aae 
Dealt to f6b5f68e 
Dealt to Hero [9h 8s]
Dealt to 89ac50e8 
Dealt to 8d15f06b 
Dealt to c9b8a495 
89ac50e8: folds
8d15f06b: raises $0.06 to $0.11
c9b8a495: folds
220b0aae: folds
f6b5f68e: folds
Hero: folds
Uncalled bet ($0.06) returned to 8d15f06b
*** SHOWDOWN ***
8d15f06b collected $0.12 from pot
*** SUMMARY ***
Total pot $0.12 | Rake $0 | Jackpot $0 | Bingo $0 | Fortune $0 | Tax $0
Seat 1: 220b0aae (button) folded before Flop (didn't bet)
Seat 2: f6b5f68e (small blind) folded before Flop
Seat 3: Hero (big blind) folded before Flop
Seat 4: 89ac50e8 folded before Flop (didn't bet)
Seat 5: 8d15f06b collected ($0.12)
Seat 6: c9b8a495 folded before Flop (didn't bet)


Poker Hand #RC2078401919: Hold'em No Limit ($0.02/$0.05) - 2023/12/22 20:54:23
Table 'RushAndCash772198' 6-max Seat #1 is the button
Seat 1: b9b63cdf ($7.34 in chips)
Seat 2: 86aa2c94 ($4.88 in chips)
Seat 3: 902f08d7 ($4.59 in chips)
Seat 4: 610bd7fc ($11.08 in chips)
Seat 5: Hero ($7.02 in chips)
Seat 6: dc851cb6 ($5.71 in chips)
86aa2c94: posts small blind $0.02
902f08d7: posts big blind $0.05
*** HOLE CARDS ***
Dealt to b9b63cdf 
Dealt to 86aa2c94 
Dealt to 902f08d7 
Dealt to 610bd7fc 
Dealt to Hero [Ad 6c]
Dealt to dc851cb6 
610bd7fc: folds
Hero: folds
dc851cb6: folds
b9b63cdf: folds
86aa2c94: folds
Uncalled bet ($0.03) returned to 902f08d7
*** SHOWDOWN ***
902f08d7 collected $0.04 from pot
*** SUMMARY ***
Total pot $0.04 | Rake $0 | Jackpot $0 | Bingo $0 | Fortune $0 | Tax $0
Seat 1: b9b63cdf (button) folded before Flop (didn't bet)
Seat 2: 86aa2c94 (small blind) folded before Flop
Seat 3: 902f08d7 (big blind) collected ($0.04)
Seat 4: 610bd7fc folded before Flop (didn't bet)
Seat 5: Hero folded before Flop (didn't bet)
Seat 6: dc851cb6 folded before Flop (didn't bet)


Poker Hand #RC2078401776: Hold'em No Limit ($0.02/$0.05) - 2023/12/22 20:54:16
Table 'RushAndCash772132' 6-max Seat #1 is the button
Seat 1: 2e26b9c1 ($5.4 in chips)
Seat 2: b3dac847 ($8.14 in chips)
Seat 3: 3580bebf ($5.51 in chips)
Seat 4: Hero ($7.02 in chips)
Seat 5: 2075befd ($6.26 in chips)
Seat 6: 4d43d419 ($9.88 in chips)
b3dac847: posts small blind $0.02
3580bebf: posts big blind $0.05
*** HOLE CARDS ***
Dealt to 2e26b9c1 
Dealt to b3dac847 
Dealt to 3580bebf 
Dealt to Hero [7c Jh]
Dealt to 2075befd 
Dealt to 4d43d419 
Hero: folds
2075befd: folds
4d43d419: raises $0.08 to $0.13
2e26b9c1: calls $0.13
b3dac847: folds
3580bebf: folds
*** FLOP *** [Js 6d 7h]
4d43d419: checks
2e26b9c1: bets $0.17
4d43d419: folds
Uncalled bet ($0.17) returned to 2e26b9c1
*** SHOWDOWN ***
2e26b9c1 collected $0.32 from pot
*** SUMMARY ***
Total pot $0.33 | Rake $0.01 | Jackpot $0 | Bingo $0 | Fortune $0 | Tax $0
Board [Js 6d 7h]
Seat 1: 2e26b9c1 (button) won ($0.32)
Seat 2: b3dac847 (small blind) folded before Flop
Seat 3: 3580bebf (big blind) folded before Flop
Seat 4: Hero folded before Flop (didn't bet)
Seat 5: 2075befd folded before Flop (didn't bet)
Seat 6: 4d43d419 folded on the Flop


Poker Hand #RC2078401641: Hold'em No Limit ($0.02/$0.05) - 2023/12/22 20:54:08
Table 'RushAndCash772068' 6-max Seat #1 is the button
Seat 1: d6126048 ($7.88 in chips)
Seat 2: d2739eda ($0.87 in chips)
Seat 3: 5703e2fa ($13.9 in chips)
Seat 4: Hero ($7.02 in chips)
Seat 5: 5b035bcb ($3.49 in chips)
Seat 6: c2881b52 ($15.41 in chips)
d2739eda: posts small blind $0.02
5703e2fa: posts big blind $0.05
*** HOLE CARDS ***
Dealt to d6126048 
Dealt to d2739eda 
Dealt to 5703e2fa 
Dealt to Hero [9d Jd]
Dealt to 5b035bcb 
Dealt to c2881b52 
Hero: folds
5b035bcb: folds
c2881b52: raises $0.06 to $0.11
d6126048: folds
d2739eda: folds
5703e2fa: folds
Uncalled bet ($0.06) returned to c2881b52
*** SHOWDOWN ***
c2881b52 collected $0.12 from pot
*** SUMMARY ***
Total pot $0.12 | Rake $0 | Jackpot $0 | Bingo $0 | Fortune $0 | Tax $0
Seat 1: d6126048 (button) folded before Flop (didn't bet)
Seat 2: d2739eda (small blind) folded before Flop
Seat 3: 5703e2fa (big blind) folded before Flop
Seat 4: Hero folded before Flop (didn't bet)
Seat 5: 5b035bcb folded before Flop (didn't bet)
Seat 6: c2881b52 collected ($0.12)


Poker Hand #RC2078401516: Hold'em No Limit ($0.02/$0.05) - 2023/12/22 20:54:02
Table 'RushAndCash772005' 6-max Seat #1 is the button
Seat 1: Hero ($7.02 in chips)
Seat 2: 1db6ddb1 ($5.1 in chips)
Seat 3: d18647ce ($5.45 in chips)
Seat 4: 2f160a64 ($9.73 in chips)
Seat 5: 9b87805 ($8.32 in chips)
Seat 6: d21cc812 ($7.21 in chips)
1db6ddb1: posts small blind $0.02
d18647ce: posts big blind $0.05
*** HOLE CARDS ***
Dealt to Hero [4c As]
Dealt to 1db6ddb1 
Dealt to d18647ce 
Dealt to 2f160a64 
Dealt to 9b87805 
Dealt to d21cc812 
2f160a64: folds
9b87805: folds
d21cc812: folds
Hero: folds
1db6ddb1: folds
Uncalled bet ($0.03) returned to d18647ce
*** SHOWDOWN ***
d18647ce collected $0.04 from pot
*** SUMMARY ***
Total pot $0.04 | Rake $0 | Jackpot $0 | Bingo $0 | Fortune $0 | Tax $0
Seat 1: Hero (button) folded before Flop (didn't bet)
Seat 2: 1db6ddb1 (small blind) folded before Flop
Seat 3: d18647ce (big blind) collected ($0.04)
Seat 4: 2f160a64 folded before Flop (didn't bet)
Seat 5: 9b87805 folded before Flop (didn't bet)
Seat 6: d21cc812 folded before Flop (didn't bet)


Poker Hand #RC2078401262: Hold'em No Limit ($0.02/$0.05) - 2023/12/22 20:53:48
Table 'RushAndCash771885' 6-max Seat #1 is the button
Seat 1: 816eac8 ($5.55 in chips)
Seat 2: Hero ($7.04 in chips)
Seat 3: edb6154b ($5 in chips)
Seat 4: 3034205c ($5.05 in chips)
Seat 5: 38e5e2fb ($5 in chips)
Seat 6: 53d2996c ($4.43 in chips)
Hero: posts small blind $0.02
edb6154b: posts big blind $0.05
*** HOLE CARDS ***
Dealt to 816eac8 
Dealt to Hero [8d 3d]
Dealt to edb6154b 
Dealt to 3034205c 
Dealt to 38e5e2fb 
Dealt to 53d2996c 
3034205c: folds
38e5e2fb: folds
53d2996c: raises $0.08 to $0.13
816eac8: folds
Hero: folds
edb6154b: folds
Uncalled bet ($0.08) returned to 53d2996c
*** SHOWDOWN ***
53d2996c collected $0.12 from pot
*** SUMMARY ***
Total pot $0.12 | Rake $0 | Jackpot $0 | Bingo $0 | Fortune $0 | Tax $0
Seat 1: 816eac8 (button) folded before Flop (didn't bet)
Seat 2: Hero (small blind) folded before Flop
Seat 3: edb6154b (big blind) folded before Flop
Seat 4: 3034205c folded before Flop (didn't bet)
Seat 5: 38e5e2fb folded before Flop (didn't bet)
Seat 6: 53d2996c collected ($0.12)


Poker Hand #RC2078401060: Hold'em No Limit ($0.02/$0.05) - 2023/12/22 20:53:36
Table 'RushAndCash771804' 6-max Seat #1 is the button
Seat 1: 11676b65 ($5.79 in chips)
Seat 2: d0d9a2a3 ($5.27 in chips)
Seat 3: Hero ($7.02 in chips)
Seat 4: d71ab80c ($6.62 in chips)
Seat 5: c9faf803 ($12.04 in chips)
Seat 6: 3b97cce8 ($7.99 in chips)
d0d9a2a3: posts small blind $0.02
Hero: posts big blind $0.05
*** HOLE CARDS ***
Dealt to 11676b65 
Dealt to d0d9a2a3 
Dealt to Hero [5d 3s]
Dealt to d71ab80c 
Dealt to c9faf803 
Dealt to 3b97cce8 
d71ab80c: folds
c9faf803: folds
3b97cce8: folds
11676b65: folds
d0d9a2a3: folds
Uncalled bet ($0.03) returned to Hero
*** SHOWDOWN ***
Hero collected $0.04 from pot
*** SUMMARY ***
Total pot $0.04 | Rake $0 | Jackpot $0 | Bingo $0 | Fortune $0 | Tax $0
Seat 1: 11676b65 (button) folded before Flop (didn't bet)
Seat 2: d0d9a2a3 (small blind) folded before Flop
Seat 3: Hero (big blind) collected ($0.04)
Seat 4: d71ab80c folded before Flop (didn't bet)
Seat 5: c9faf803 folded before Flop (didn't bet)
Seat 6: 3b97cce8 folded before Flop (didn't bet)


Poker Hand #RC2078400357: Hold'em No Limit ($0.02/$0.05) - 2023/12/22 20:52:58
Table 'RushAndCash771486' 6-max Seat #1 is the button
Seat 1: 5d317abf ($7.76 in chips)
Seat 2: 1fc1f571 ($8.8 in chips)
Seat 3: 6fe9f1e4 ($6.52 in chips)
Seat 4: Hero ($5 in chips)
Seat 5: 7727a0d4 ($2.07 in chips)
Seat 6: 33d498f7 ($5.65 in chips)
1fc1f571: posts small blind $0.02
6fe9f1e4: posts big blind $0.05
*** HOLE CARDS ***
Dealt to 5d317abf 
Dealt to 1fc1f571 
Dealt to 6fe9f1e4 
Dealt to Hero [Kd Kc]
Dealt to 7727a0d4 
Dealt to 33d498f7 
Hero: raises $0.05 to $0.1
7727a0d4: calls $0.1
33d498f7: folds
5d317abf: calls $0.1
1fc1f571: folds
6fe9f1e4: folds
*** FLOP *** [3h Ts Ks]
Hero: checks
7727a0d4: checks
5d317abf: checks
*** TURN *** [3h Ts Ks] [5h]
Hero: bets $0.19
7727a0d4: calls $0.19
5d317abf: folds
*** RIVER *** [3h Ts Ks 5h] [4d]
Hero: bets $0.38
7727a0d4: raises $1.4 to $1.78 and is all-in
Hero: calls $1.4
7727a0d4: shows [5c 4c] (Pair of Fives and Pair of Fours)
Hero: shows [Kd Kc] (Three Kings)
*** SHOWDOWN ***
Hero collected $4.09 from pot
*** SUMMARY ***
Total pot $4.31 | Rake $0.15 | Jackpot $0.07 | Bingo $0 | Fortune $0 | Tax $0
Board [3h Ts Ks 5h 4d]
Seat 1: 5d317abf (button) folded on the Turn
Seat 2: 1fc1f571 (small blind) folded before Flop
Seat 3: 6fe9f1e4 (big blind) folded before Flop
Seat 4: Hero showed [Kd Kc] and won ($4.09) with Three Kings
Seat 5: 7727a0d4 showed [5c 4c] and lost with Pair of Fives and Pair of Fours
Seat 6: 33d498f7 folded before Flop (didn't bet)


Poker Hand #RC2078400289: Hold'em No Limit ($0.02/$0.05) - 2023/12/22 20:52:54
Table 'RushAndCash771455' 6-max Seat #1 is the button
Seat 1: 8bde3280 ($12.5 in chips)
Seat 2: 3d929f9f ($5.17 in chips)
Seat 3: ee2ef16e ($5.48 in chips)
Seat 4: 5703e2fa ($13.92 in chips)
Seat 5: d0ea92a4 ($5.07 in chips)
Seat 6: Hero ($5 in chips)
3d929f9f: posts small blind $0.02
ee2ef16e: posts big blind $0.05
*** HOLE CARDS ***
Dealt to 8bde3280 
Dealt to 3d929f9f 
Dealt to ee2ef16e 
Dealt to 5703e2fa 
Dealt to d0ea92a4 
Dealt to Hero [3s Ad]
5703e2fa: folds
d0ea92a4: folds
Hero: folds
8bde3280: raises $0.05 to $0.1
3d929f9f: folds
ee2ef16e: folds
Uncalled bet ($0.05) returned to 8bde3280
*** SHOWDOWN ***
8bde3280 collected $0.12 from pot
*** SUMMARY ***
Total pot $0.12 | Rake $0 | Jackpot $0 | Bingo $0 | Fortune $0 | Tax $0
Seat 1: 8bde3280 (button) collected ($0.12)
Seat 2: 3d929f9f (small blind) folded before Flop
Seat 3: ee2ef16e (big blind) folded before Flop
Seat 4: 5703e2fa folded before Flop (didn't bet)
Seat 5: d0ea92a4 folded before Flop (didn't bet)
Seat 6: Hero folded before Flop (didn't bet)


Poker Hand #RC2078400225: Hold'em No Limit ($0.02/$0.05) - 2023/12/22 20:52:50
Table 'RushAndCash771426' 6-max Seat #1 is the button
Seat 1: 1adb19a8 ($4.98 in chips)
Seat 2: b599e449 ($6.53 in chips)
Seat 3: 915de7e4 ($5.28 in chips)
Seat 4: Hero ($5 in chips)
Seat 5: 7c950e30 ($5 in chips)
Seat 6: f1ad1c02 ($2.04 in chips)
b599e449: posts small blind $0.02
915de7e4: posts big blind $0.05
*** HOLE CARDS ***
Dealt to 1adb19a8 
Dealt to b599e449 
Dealt to 915de7e4 
Dealt to Hero [Ah 9d]
Dealt to 7c950e30 
Dealt to f1ad1c02 
Hero: folds
7c950e30: folds
f1ad1c02: folds
1adb19a8: folds
b599e449: folds
Uncalled bet ($0.03) returned to 915de7e4
*** SHOWDOWN ***
915de7e4 collected $0.04 from pot
*** SUMMARY ***
Total pot $0.04 | Rake $0 | Jackpot $0 | Bingo $0 | Fortune $0 | Tax $0
Seat 1: 1adb19a8 (button) folded before Flop (didn't bet)
Seat 2: b599e449 (small blind) folded before Flop
Seat 3: 915de7e4 (big blind) collected ($0.04)
Seat 4: Hero folded before Flop (didn't bet)
Seat 5: 7c950e30 folded before Flop (didn't bet)
Seat 6: f1ad1c02 folded before Flop (didn't bet)


Poker Hand #RC2078400156: Hold'em No Limit ($0.02/$0.05) - 2023/12/22 20:52:47
Table 'RushAndCash771393' 6-max Seat #1 is the button
Seat 1: Hero ($5 in chips)
Seat 2: 5261fe21 ($5.11 in chips)
Seat 3: 697fb04a ($42.15 in chips)
Seat 4: b3dac847 ($8.51 in chips)
Seat 5: 875f34a0 ($4.49 in chips)
Seat 6: 520ea8e9 ($10.28 in chips)
5261fe21: posts small blind $0.02
697fb04a: posts big blind $0.05
*** HOLE CARDS ***
Dealt to Hero [4s 8c]
Dealt to 5261fe21 
Dealt to 697fb04a 
Dealt to b3dac847 
Dealt to 875f34a0 
Dealt to 520ea8e9 
b3dac847: folds
875f34a0: raises $0.05 to $0.1
520ea8e9: folds
Hero: folds
5261fe21: folds
697fb04a: calls $0.05
*** FLOP *** [Qd 3c Js]
697fb04a: checks
875f34a0: bets $0.08
697fb04a: calls $0.08
*** TURN *** [Qd 3c Js] [2s]
697fb04a: checks
875f34a0: checks
*** RIVER *** [Qd 3c Js 2s] [Tc]
697fb04a: bets $0.29
875f34a0: folds
Uncalled bet ($0.29) returned to 697fb04a
*** SHOWDOWN ***
697fb04a collected $0.37 from pot
*** SUMMARY ***
Total pot $0.38 | Rake $0.01 | Jackpot $0 | Bingo $0 | Fortune $0 | Tax $0
Board [Qd 3c Js 2s Tc]
Seat 1: Hero (button) folded before Flop (didn't bet)
Seat 2: 5261fe21 (small blind) folded before Flop
Seat 3: 697fb04a (big blind) won ($0.37)
Seat 4: b3dac847 folded before Flop (didn't bet)
Seat 5: 875f34a0 folded on the River
Seat 6: 520ea8e9 folded before Flop (didn't bet)


Poker Hand #RC2078400071: Hold'em No Limit ($0.02/$0.05) - 2023/12/22 20:52:42
Table 'RushAndCash771353' 6-max Seat #1 is the button
Seat 1: d03e1a8e ($7.31 in chips)
Seat 2: Hero ($5 in chips)
Seat 3: 54daf47b ($10.71 in chips)
Seat 4: 53d2996c ($4.88 in chips)
Seat 5: f677406 ($5.29 in chips)
Seat 6: c295eed2 ($7.04 in chips)
Hero: posts small blind $0.02
54daf47b: posts big blind $0.05
*** HOLE CARDS ***
Dealt to d03e1a8e 
Dealt to Hero [Td 9c]
Dealt to 54daf47b 
Dealt to 53d2996c 
Dealt to f677406 
Dealt to c295eed2 
53d2996c: folds
f677406: raises $0.05 to $0.1
c295eed2: folds
d03e1a8e: folds
Hero: folds
54daf47b: calls $0.05
*** FLOP *** [Tc Js 9s]
54daf47b: bets $0.08
f677406: folds
Uncalled bet ($0.08) returned to 54daf47b
*** SHOWDOWN ***
54daf47b collected $0.21 from pot
*** SUMMARY ***
Total pot $0.22 | Rake $0.01 | Jackpot $0 | Bingo $0 | Fortune $0 | Tax $0
Board [Tc Js 9s]
Seat 1: d03e1a8e (button) folded before Flop (didn't bet)
Seat 2: Hero (small blind) folded before Flop
Seat 3: 54daf47b (big blind) won ($0.21)
Seat 4: 53d2996c folded before Flop (didn't bet)
Seat 5: f677406 folded on the Flop
Seat 6: c295eed2 folded before Flop (didn't bet)


Poker Hand #RC2078399923: Hold'em No Limit ($0.02/$0.05) - 2023/12/22 20:52:33
Table 'RushAndCash771286' 6-max Seat #1 is the button
Seat 1: 6b0bdb9e ($5.07 in chips)
Seat 2: f03725f ($11.2 in chips)
Seat 3: Hero ($5 in chips)
Seat 4: 3759e445 ($4.49 in chips)
Seat 5: ce5771af ($6.62 in chips)
Seat 6: 816eac8 ($4.93 in chips)
f03725f: posts small blind $0.02
Hero: posts big blind $0.05
*** HOLE CARDS ***
Dealt to 6b0bdb9e 
Dealt to f03725f 
Dealt to Hero [7c Qh]
Dealt to 3759e445 
Dealt to ce5771af 
Dealt to 816eac8 
3759e445: folds
ce5771af: raises $0.08 to $0.13
816eac8: folds
6b0bdb9e: folds
f03725f: calls $0.11
Hero: folds
*** FLOP *** [8d 4d 2s]
f03725f: checks
ce5771af: checks
*** TURN *** [8d 4d 2s] [3d]
f03725f: bets $0.14
ce5771af: folds
Uncalled bet ($0.14) returned to f03725f
*** SHOWDOWN ***
f03725f collected $0.3 from pot
*** SUMMARY ***
Total pot $0.31 | Rake $0.01 | Jackpot $0 | Bingo $0 | Fortune $0 | Tax $0
Board [8d 4d 2s 3d]
Seat 1: 6b0bdb9e (button) folded before Flop (didn't bet)
Seat 2: f03725f (small blind) won ($0.3)
Seat 3: Hero (big blind) folded before Flop
Seat 4: 3759e445 folded before Flop (didn't bet)
Seat 5: ce5771af folded on the Turn
Seat 6: 816eac8 folded before Flop (didn't bet)


Poker Hand #RC2078399861: Hold'em No Limit ($0.02/$0.05) - 2023/12/22 20:52:30
Table 'RushAndCash771258' 6-max Seat #1 is the button
Seat 1: e49e39a2 ($18.92 in chips)
Seat 2: a7b5e712 ($5.03 in chips)
Seat 3: e9433577 ($6.06 in chips)
Seat 4: d2f469dd ($14.61 in chips)
Seat 5: Hero ($5 in chips)
Seat 6: a0d73ae9 ($3.79 in chips)
a7b5e712: posts small blind $0.02
e9433577: posts big blind $0.05
*** HOLE CARDS ***
Dealt to e49e39a2 
Dealt to a7b5e712 
Dealt to e9433577 
Dealt to d2f469dd 
Dealt to Hero [5d 7c]
Dealt to a0d73ae9 
d2f469dd: folds
Hero: folds
a0d73ae9: folds
e49e39a2: raises $0.1 to $0.15
a7b5e712: folds
e9433577: folds
Uncalled bet ($0.1) returned to e49e39a2
*** SHOWDOWN ***
e49e39a2 collected $0.12 from pot
*** SUMMARY ***
Total pot $0.12 | Rake $0 | Jackpot $0 | Bingo $0 | Fortune $0 | Tax $0
Seat 1: e49e39a2 (button) collected ($0.12)
Seat 2: a7b5e712 (small blind) folded before Flop
Seat 3: e9433577 (big blind) folded before Flop
Seat 4: d2f469dd folded before Flop (didn't bet)
Seat 5: Hero folded before Flop (didn't bet)
Seat 6: a0d73ae9 folded before Flop (didn't bet)


Poker Hand #RC2078399720: Hold'em No Limit ($0.02/$0.05) - 2023/12/22 20:52:23
Table 'RushAndCash771195' 6-max Seat #1 is the button
Seat 1: b5756669 ($5.39 in chips)
Seat 2: 5a5ed55f ($6.58 in chips)
Seat 3: e2f19b93 ($6.51 in chips)
Seat 4: e40a779 ($4.91 in chips)
Seat 5: Hero ($5 in chips)
Seat 6: 688f0ff0 ($5.17 in chips)
5a5ed55f: posts small blind $0.02
e2f19b93: posts big blind $0.05
*** HOLE CARDS ***
Dealt to b5756669 
Dealt to 5a5ed55f 
Dealt to e2f19b93 
Dealt to e40a779 
Dealt to Hero [8s Ts]
Dealt to 688f0ff0 
e40a779: raises $0.1 to $0.15
Hero: folds
688f0ff0: folds
b5756669: folds
5a5ed55f: folds
e2f19b93: calls $0.1
*** FLOP *** [5h Ah Kh]
e2f19b93: checks
e40a779: checks
*** TURN *** [5h Ah Kh] [Qc]
e2f19b93: checks
e40a779: bets $0.24
e2f19b93: folds
Uncalled bet ($0.24) returned to e40a779
*** SHOWDOWN ***
e40a779 collected $0.31 from pot
*** SUMMARY ***
Total pot $0.32 | Rake $0.01 | Jackpot $0 | Bingo $0 | Fortune $0 | Tax $0
Board [5h Ah Kh Qc]
Seat 1: b5756669 (button) folded before Flop (didn't bet)
Seat 2: 5a5ed55f (small blind) folded before Flop
Seat 3: e2f19b93 (big blind) folded on the Turn
Seat 4: e40a779 won ($0.31)
Seat 5: Hero folded before Flop (didn't bet)
Seat 6: 688f0ff0 folded before Flop (didn't bet)


Poker Hand #RC2078399647: Hold'em No Limit ($0.02/$0.05) - 2023/12/22 20:52:19
Table 'RushAndCash771164' 6-max Seat #1 is the button
Seat 1: c87acea2 ($5 in chips)
Seat 2: 873b5865 ($5.05 in chips)
Seat 3: 93990934 ($13.91 in chips)
Seat 4: f6b5f68e ($5 in chips)
Seat 5: a0ef5108 ($4.93 in chips)
Seat 6: Hero ($5 in chips)
873b5865: posts small blind $0.02
93990934: posts big blind $0.05
*** HOLE CARDS ***
Dealt to c87acea2 
Dealt to 873b5865 
Dealt to 93990934 
Dealt to f6b5f68e 
Dealt to a0ef5108 
Dealt to Hero [6h 9s]
f6b5f68e: folds
a0ef5108: folds
Hero: folds
c87acea2: folds
873b5865: folds
Uncalled bet ($0.03) returned to 93990934
*** SHOWDOWN ***
93990934 collected $0.04 from pot
*** SUMMARY ***
Total pot $0.04 | Rake $0 | Jackpot $0 | Bingo $0 | Fortune $0 | Tax $0
Seat 1: c87acea2 (button) folded before Flop (didn't bet)
Seat 2: 873b5865 (small blind) folded before Flop
Seat 3: 93990934 (big blind) collected ($0.04)
Seat 4: f6b5f68e folded before Flop (didn't bet)
Seat 5: a0ef5108 folded before Flop (didn't bet)
Seat 6: Hero folded before Flop (didn't bet)


Poker Hand #RC2078399152: Hold'em No Limit ($0.02/$0.05) - 2023/12/22 20:51:51
Table 'RushAndCash770946' 6-max Seat #1 is the button
Seat 1: a505a336 ($5.12 in chips)
Seat 2: 34b95cee ($5.1 in chips)
Seat 3: 175b9638 ($5.39 in chips)
Seat 4: Hero ($5 in chips)
Seat 5: a9db0c00 ($8.4 in chips)
Seat 6: c3c9a58d ($1.95 in chips)
34b95cee: posts small blind $0.02
175b9638: posts big blind $0.05
*** HOLE CARDS ***
Dealt to a505a336 
Dealt to 34b95cee 
Dealt to 175b9638 
Dealt to Hero [Td Qd]
Dealt to a9db0c00 
Dealt to c3c9a58d 
Hero: raises $0.05 to $0.1
a9db0c00: folds
c3c9a58d: folds
a505a336: calls $0.1
34b95cee: raises $0.45 to $0.55
175b9638: folds
Hero: folds
a505a336: calls $0.45
*** FLOP *** [6c Ad 2h]
34b95cee: bets $0.42
a505a336: calls $0.42
*** TURN *** [6c Ad 2h] [Qc]
34b95cee: bets $1.3
a505a336: folds
Uncalled bet ($1.3) returned to 34b95cee
*** SHOWDOWN ***
34b95cee collected $1.92 from pot
*** SUMMARY ***
Total pot $2.09 | Rake $0.1 | Jackpot $0.07 | Bingo $0 | Fortune $0 | Tax $0
Board [6c Ad 2h Qc]
Seat 1: a505a336 (button) folded on the Turn
Seat 2: 34b95cee (small blind) won ($1.92)
Seat 3: 175b9638 (big blind) folded before Flop
Seat 4: Hero folded before Flop
Seat 5: a9db0c00 folded before Flop (didn't bet)
Seat 6: c3c9a58d folded before Flop (didn't bet)


Poker Hand #RC2078399057: Hold'em No Limit ($0.02/$0.05) - 2023/12/22 20:51:45
Table 'RushAndCash770904' 6-max Seat #1 is the button
Seat 1: Hero ($5 in chips)
Seat 2: 72f7386e ($10.17 in chips)
Seat 3: c581b38e ($9.08 in chips)
Seat 4: b00070f4 ($5.63 in chips)
Seat 5: af92dfc8 ($5.01 in chips)
Seat 6: 488f1674 ($5 in chips)
72f7386e: posts small blind $0.02
c581b38e: posts big blind $0.05
*** HOLE CARDS ***
Dealt to Hero [3h Qh]
Dealt to 72f7386e 
Dealt to c581b38e 
Dealt to b00070f4 
Dealt to af92dfc8 
Dealt to 488f1674 
b00070f4: folds
af92dfc8: folds
488f1674: folds
Hero: folds
72f7386e: folds
Uncalled bet ($0.03) returned to c581b38e
*** SHOWDOWN ***
c581b38e collected $0.04 from pot
*** SUMMARY ***
Total pot $0.04 | Rake $0 | Jackpot $0 | Bingo $0 | Fortune $0 | Tax $0
Seat 1: Hero (button) folded before Flop (didn't bet)
Seat 2: 72f7386e (small blind) folded before Flop
Seat 3: c581b38e (big blind) collected ($0.04)
Seat 4: b00070f4 folded before Flop (didn't bet)
Seat 5: af92dfc8 folded before Flop (didn't bet)
Seat 6: 488f1674 folded before Flop (didn't bet)


Poker Hand #RC2078398967: Hold'em No Limit ($0.02/$0.05) - 2023/12/22 20:51:41
Table 'RushAndCash770863' 6-max Seat #1 is the button
Seat 1: c7be9492 ($6.73 in chips)
Seat 2: Hero ($5.02 in chips)
Seat 3: 14df4256 ($8.44 in chips)
Seat 4: 801c157f ($16.28 in chips)
Seat 5: 5945e592 ($2.2 in chips)
Seat 6: 2471888a ($6.38 in chips)
Hero: posts small blind $0.02
14df4256: posts big blind $0.05
*** HOLE CARDS ***
Dealt to c7be9492 
Dealt to Hero [9d 3h]
Dealt to 14df4256 
Dealt to 801c157f 
Dealt to 5945e592 
Dealt to 2471888a 
801c157f: raises $0.05 to $0.1
5945e592: folds
2471888a: folds
c7be9492: folds
Hero: folds
14df4256: folds
Uncalled bet ($0.05) returned to 801c157f
*** SHOWDOWN ***
801c157f collected $0.12 from pot
*** SUMMARY ***
Total pot $0.12 | Rake $0 | Jackpot $0 | Bingo $0 | Fortune $0 | Tax $0
Seat 1: c7be9492 (button) folded before Flop (didn't bet)
Seat 2: Hero (small blind) folded before Flop
Seat 3: 14df4256 (big blind) folded before Flop
Seat 4: 801c157f collected ($0.12)
Seat 5: 5945e592 folded before Flop (didn't bet)
Seat 6: 2471888a folded before Flop (didn't bet)


Poker Hand #RC2078398835: Hold'em No Limit ($0.02/$0.05) - 2023/12/22 20:51:34
Table 'RushAndCash770805' 6-max Seat #1 is the button
Seat 1: 1e4a5551 ($4.9 in chips)
Seat 2: d56f57b9 ($5.07 in chips)
Seat 3: Hero ($5 in chips)
Seat 4: 74c7187f ($4.91 in chips)
Seat 5: 780930d2 ($6.6 in chips)
Seat 6: 66605bf3 ($6.13 in chips)
d56f57b9: posts small blind $0.02
Hero: posts big blind $0.05
*** HOLE CARDS ***
Dealt to 1e4a5551 
Dealt to d56f57b9 
Dealt to Hero [8d Jd]
Dealt to 74c7187f 
Dealt to 780930d2 
Dealt to 66605bf3 
74c7187f: folds
780930d2: folds
66605bf3: folds
1e4a5551: folds
d56f57b9: folds
Uncalled bet ($0.03) returned to Hero
*** SHOWDOWN ***
Hero collected $0.04 from pot
*** SUMMARY ***
Total pot $0.04 | Rake $0 | Jackpot $0 | Bingo $0 | Fortune $0 | Tax $0
Seat 1: 1e4a5551 (button) folded before Flop (didn't bet)
Seat 2: d56f57b9 (small blind) folded before Flop
Seat 3: Hero (big blind) collected ($0.04)
Seat 4: 74c7187f folded before Flop (didn't bet)
Seat 5: 780930d2 folded before Flop (didn't bet)
Seat 6: 66605bf3 folded before Flop (didn't bet)


